"pais","departamento","provincia","municipio","recinto","latitud","longitud","ABSTENCION","BLANCOS","EMITIDOS","INSCRITOS","NO","NULOS","SI","VALIDOS"
"Bolivia","Beni","Cercado","San Javier","ESCUELA ESPIRITU SANTO",-64.80295,-14.63469,7,0,34,41,13,0,21,34
"Bolivia","Beni","Cercado","San Javier","ESCUELA LAGUNA COLORADA",-64.63057,-14.63861,15,0,33,48,14,0,19,33
"Bolivia","Beni","Cercado","San Javier","ESCUELA NUEVA ISRAEL",-64.3355,-14.67209,110,7,420,530,195,36,182,377
"Bolivia","Beni","Cercado","San Javier","ESCUELA PEDRO IGNACIO MUIBA",-64.08376,-14.49183,23,1,161,184,74,0,86,160
"Bolivia","Beni","Cercado","San Javier","ESCUELA SAN JAVIER",-64.88087,-14.59987,63,4,287,350,141,2,140,281
"Bolivia","Beni","Cercado","San Javier","ESCUELA SAN PEDRO",-64.90086,-14.33668,79,2,319,398,157,10,150,307
"Bolivia","Beni","Cercado","San Javier","U.E. LA CURVA",-64.20807,-14.58863,41,2,100,141,37,3,58,95
"Bolivia","Beni","Cercado","Trinidad","CARCEL DE MUJERES",-64.90281,-14.84692,9,1,36,45,19,0,16,35
"Bolivia","Beni","Cercado","Trinidad","CARCEL MOCOBI",-64.90376,-14.77958,0,0,178,178,62,50,66,128
"Bolivia","Beni","Cercado","Trinidad","CENTRO INTEGRADO SAN FRANCISCO DE ASIS",-64.88588,-14.82278,85,4,686,771,488,11,183,671
"Bolivia","Beni","Cercado","Trinidad","COL. JOAQUIN HURTADO CHAVEZ",-64.90425,-14.81511,383,17,1922,2305,1225,38,642,1867
"Bolivia","Beni","Cercado","Trinidad","COL. LA SALLE",-64.89569,-14.82676,329,5,1457,1786,1045,38,369,1414
"Bolivia","Beni","Cercado","Trinidad","COL. SAN VICENTE (EX UAB)",-64.91093,-14.8346,631,20,3141,3772,2072,80,969,3041
"Bolivia","Beni","Cercado","Trinidad","ESC.4 DE  FEBRERO",-64.90131,-14.84447,801,36,3606,4407,2139,91,1340,3479
"Bolivia","Beni","Cercado","Trinidad","ESC.CORINA HURTADO DE",-64.89422,-14.84378,458,15,2434,2892,1438,50,931,2369
"Bolivia","Beni","Cercado","Trinidad","ESC.J.AZURDUY DE PADILLA",-64.8893,-14.82634,271,8,1612,1883,1128,36,440,1568
"Bolivia","Beni","Cercado","Trinidad","ESC.J. CHAVEZ SUAREZ",-64.90463,-14.8414,1158,36,5202,6360,3120,112,1934,5054
"Bolivia","Beni","Cercado","Trinidad","ESC.J. LORENZO CAMPERO",-64.89998,-14.8257,226,7,1423,1649,982,23,411,1393
"Bolivia","Beni","Cercado","Trinidad","ESC. LOMA SUAREZ",-64.96272,-14.76063,202,7,444,646,182,19,236,418
"Bolivia","Beni","Cercado","Trinidad","ESC. MANGALITO",-64.91572,-14.84847,371,11,1608,1979,872,32,693,1565
"Bolivia","Beni","Cercado","Trinidad","ESC.MARY RIBERA G.",-64.88783,-14.81399,613,20,3832,4445,2571,95,1146,3717
"Bolivia","Beni","Cercado","Trinidad","ESC.MAYOR PEDRO VACA DIEZ",-64.96582,-14.86952,100,3,236,336,109,1,123,232
"Bolivia","Beni","Cercado","Trinidad","ESC.NICOLAS SUAREZ",-64.90492,-14.83268,444,10,2080,2524,1516,37,517,2033
"Bolivia","Beni","Cercado","Trinidad","ESC. NUESTRA SEÑORA DE FATIMA",-64.89811,-14.83099,758,18,3338,4096,2229,82,1009,3238
"Bolivia","Beni","Cercado","Trinidad","ESC. PEDRO IGNACIO MUIBA",-64.91414,-14.84481,472,25,2346,2818,1413,96,812,2225
"Bolivia","Beni","Cercado","Trinidad","ESC.PUERTO BALLIVIAN",-64.97205,-14.79312,20,2,119,139,55,0,62,117
"Bolivia","Beni","Cercado","Trinidad","ESC. PUERTO VARADOR",-64.99762,-14.87702,128,13,453,581,242,21,177,419
"Bolivia","Beni","Cercado","Trinidad","ESC. RAUL MONJE ROCA",-64.8938,-14.83707,439,7,2240,2679,1414,74,745,2159
"Bolivia","Beni","Cercado","Trinidad","ESC.SAN ANTONIO",-64.91032,-14.83844,573,47,3077,3650,2005,42,983,2988
"Bolivia","Beni","Cercado","Trinidad","ESC.SAN JOSE",-64.90439,-14.82626,209,9,1272,1481,931,21,311,1242
"Bolivia","Beni","Cercado","Trinidad","ESC.SAN JUAN DE AGUAS DULCES",-64.57809,-14.80817,12,0,89,101,67,0,22,89
"Bolivia","Beni","Cercado","Trinidad","ESCUELA 13 DE ABRIL",-64.8902,-14.83764,333,22,2304,2637,1262,129,891,2153
"Bolivia","Beni","Cercado","Trinidad","ESCUELA CASARABE",-64.47997,-14.87161,112,3,415,527,228,9,175,403
"Bolivia","Beni","Cercado","Trinidad","ESCUELA EMILIO CAMPOS PEDRIEL",-64.8847,-14.81962,388,12,1994,2382,1324,39,619,1943
"Bolivia","Beni","Cercado","Trinidad","ESCUELA IVIATO",-64.44854,-14.83285,40,1,172,212,94,0,77,171
"Bolivia","Beni","Cercado","Trinidad","ESCUELA NUEVA TRINIDAD",-64.8754,-14.82357,857,28,3145,4002,1882,72,1163,3045
"Bolivia","Beni","Cercado","Trinidad","ESC. URBANIZ.MANA",-64.9059,-14.77769,100,2,512,612,306,5,199,505
"Bolivia","Beni","Cercado","Trinidad","ESC. VILLA VECINAL",-64.87392,-14.81023,400,26,2609,3009,1791,40,752,2543
"Bolivia","Beni","Cercado","Trinidad","INFOCAL",-64.90236,-14.82328,231,7,1082,1313,736,19,320,1056
"Bolivia","Beni","Cercado","Trinidad","LICEO MARIO SAIELLY",-64.90276,-14.83593,321,6,1655,1976,1150,17,482,1632
"Bolivia","Beni","Cercado","Trinidad","U.A.B. (CARRERA DE DERECHO)",-64.91308,-14.83274,454,46,2151,2605,1438,31,636,2074
"Bolivia","Beni","Cercado","Trinidad","U.E 15 DE AGOSTO",-64.92943,-14.83425,115,11,811,926,454,19,327,781
"Bolivia","Beni","Cercado","Trinidad","U.E GONZALO SUAREZ D.",-64.90136,-14.85325,80,5,337,417,214,4,114,328
"Bolivia","Beni","Cercado","Trinidad","U.E LUIS ESPINAL CAMS",-64.92085,-14.84365,160,16,1065,1225,577,22,450,1027
"Bolivia","Beni","Cercado","Trinidad","U.E. ORLANDO MONASTERIO CLAURE",-64.93098,-14.8181,22,7,259,281,151,4,97,248
"Bolivia","Beni","General Jose Ballivián Segurola","Puerto Rurrenabaque","ESC. ASUNCION DEL QUIQUIBEY",-67.51161,-14.64125,29,2,73,102,36,2,33,69
"Bolivia","Beni","General Jose Ballivián Segurola","Puerto Rurrenabaque","ESC.CENTRAL NUEVOS HORIZONTES",-67.27888,-14.59985,115,9,374,489,122,29,214,336
"Bolivia","Beni","General Jose Ballivián Segurola","Puerto Rurrenabaque","ESC.CENTRAL PIEDRAS BLANCAS",-67.15208,-14.78934,100,16,586,686,79,15,476,555
"Bolivia","Beni","General Jose Ballivián Segurola","Puerto Rurrenabaque","ESC.GUALBERTO VILLARRUEL",-67.5281,-14.44452,861,31,2868,3729,1703,52,1082,2785
"Bolivia","Beni","General Jose Ballivián Segurola","Puerto Rurrenabaque","ESC. PLAYA ANCHA",-67.26197,-14.62954,27,5,164,191,12,9,138,150
"Bolivia","Beni","General Jose Ballivián Segurola","Puerto Rurrenabaque","ESCUELA VILLA LOURDES",-67.5043,-14.42944,45,5,152,197,71,3,73,144
"Bolivia","Beni","General Jose Ballivián Segurola","Puerto Rurrenabaque","UNIDAD EDUCATIVA LUCIO LENS",-67.52292,-14.44037,953,50,3672,4625,2055,165,1402,3457
"Bolivia","Beni","General Jose Ballivián Segurola","Reyes","COL. NACIONAL REYES",-67.33482,-14.29558,370,16,1409,1779,779,27,587,1366
"Bolivia","Beni","General Jose Ballivián Segurola","Reyes","ESC. BUEN DESTINO",-66.76987,-11.76321,21,4,102,123,17,2,79,96
"Bolivia","Beni","General Jose Ballivián Segurola","Reyes","ESC. CENTRAL BAQUETY",-66.79783,-12.53514,65,0,48,113,4,1,43,47
"Bolivia","Beni","General Jose Ballivián Segurola","Reyes","ESC.CENTRAL PUERTO CAVINAS",-66.91502,-12.53129,85,5,133,218,46,1,81,127
"Bolivia","Beni","General Jose Ballivián Segurola","Reyes","ESC. CONSTANZA VARGAS",-66.73828,-11.73581,11,0,24,35,13,2,9,22
"Bolivia","Beni","General Jose Ballivián Segurola","Reyes","ESC.JESUS ALVAREZ",-67.3343,-14.29483,471,23,1650,2121,912,74,641,1553
"Bolivia","Beni","General Jose Ballivián Segurola","Reyes","ESC.PEÑA AMARILLA",-66.67179,-11.5471,61,2,95,156,77,2,14,91
"Bolivia","Beni","General Jose Ballivián Segurola","Reyes","ESC. RENE BARRIENTOS ORTUÑO",-67.33835,-14.29512,113,1,310,423,174,9,126,300
"Bolivia","Beni","General Jose Ballivián Segurola","Reyes","ESC. SAN JOSE",-67.37435,-14.30772,12,1,89,101,41,5,42,83
"Bolivia","Beni","General Jose Ballivián Segurola","Reyes","ESC. SAN MARCOS",-67.50578,-13.81978,3,0,22,25,18,1,3,21
"Bolivia","Beni","General Jose Ballivián Segurola","Reyes","ESC. SORAIDA",-67.50439,-14.05581,17,0,24,41,14,0,10,24
"Bolivia","Beni","General Jose Ballivián Segurola","Reyes","ESCUELA DE CALIFORNIA",-66.90263,-11.95482,16,0,54,70,22,1,31,53
"Bolivia","Beni","General Jose Ballivián Segurola","Reyes","U.E. CARMEN ALTO",-66.36278,-11.71022,6,4,88,94,39,1,44,83
"Bolivia","Beni","General Jose Ballivián Segurola","San Borja","COL. ARNULFO MARTINEZ",-66.74274,-14.86135,1010,35,3361,4371,1946,68,1312,3258
"Bolivia","Beni","General Jose Ballivián Segurola","San Borja","COL.INDUSTRIAL INGAVI",-67.03596,-15.14148,666,37,2392,3058,828,69,1458,2286
"Bolivia","Beni","General Jose Ballivián Segurola","San Borja","COL.SAN FRANCISCO DE BORJA",-66.75023,-14.85829,760,29,2731,3491,1804,62,836,2640
"Bolivia","Beni","General Jose Ballivián Segurola","San Borja","ESC.DE PUERTO YUCUMO",-66.93755,-15.19761,36,3,276,312,16,6,251,267
"Bolivia","Beni","General Jose Ballivián Segurola","San Borja","ESC.EL CHACAL",-66.62759,-14.75295,62,6,300,362,3,3,288,291
"Bolivia","Beni","General Jose Ballivián Segurola","San Borja","ESC.EL PALMAR",-67.08794,-14.97903,131,20,688,819,150,19,499,649
"Bolivia","Beni","General Jose Ballivián Segurola","San Borja","ESC.GERMAN BUSCH",-66.74983,-14.85664,707,19,2407,3114,1615,47,726,2341
"Bolivia","Beni","General Jose Ballivián Segurola","San Borja","ESC. INDIGENA ARENALES",-66.9127,-15.10867,41,8,455,496,13,12,422,435
"Bolivia","Beni","General Jose Ballivián Segurola","San Borja","ESC.JUNRRENO",-66.93327,-14.37257,11,1,32,43,15,0,16,31
"Bolivia","Beni","General Jose Ballivián Segurola","San Borja","ESC. LA CRUZ",-66.73125,-14.97601,78,14,584,662,38,9,523,561
"Bolivia","Beni","General Jose Ballivián Segurola","San Borja","ESC.LA EMBOCADA",-66.73125,-14.97601,85,1,254,339,96,7,150,246
"Bolivia","Beni","General Jose Ballivián Segurola","San Borja","ESC.LAS ABRAS",-66.93307,-14.4615,12,4,77,89,6,0,67,73
"Bolivia","Beni","General Jose Ballivián Segurola","San Borja","ESC. MISION FATIMA",-66.746,-15.45636,43,7,352,395,23,3,319,342
"Bolivia","Beni","General Jose Ballivián Segurola","San Borja","ESC.SANTA ELENA DEL CARIPO",-66.82342,-14.5799,19,1,102,121,39,0,62,101
"Bolivia","Beni","General Jose Ballivián Segurola","San Borja","ESC.S.JUAN DEL REMANZO",-66.5321,-14.67902,8,0,39,47,7,0,32,39
"Bolivia","Beni","General Jose Ballivián Segurola","San Borja","ESC. TACUARAL DE MATTOS",-66.53598,-14.99362,39,46,471,510,17,8,400,417
"Bolivia","Beni","General Jose Ballivián Segurola","San Borja","ESCUELA EL ORIENTE DEL YACUMA",-66.99512,-14.35404,26,1,79,105,34,0,44,78
"Bolivia","Beni","General Jose Ballivián Segurola","San Borja","U.E. MANGUITO",-66.63986,-14.89842,39,10,458,497,56,3,389,445
"Bolivia","Beni","General Jose Ballivián Segurola","San Borja","U.E MARCA COROICO",-67.08862,-14.78361,10,4,109,119,14,7,84,98
"Bolivia","Beni","General Jose Ballivián Segurola","San Borja","U.E. QUIQUIBEY",-67.0975,-15.36358,27,1,174,201,22,1,150,172
"Bolivia","Beni","General Jose Ballivián Segurola","San Borja","U.E SAN IGNACIO DEL MANIQUI",-66.72903,-14.85899,101,7,365,466,195,8,155,350
"Bolivia","Beni","General Jose Ballivián Segurola","San Borja","U.E VILLA SAN ANTONIO",-66.74652,-14.87003,108,6,463,571,252,13,192,444
"Bolivia","Beni","General Jose Ballivián Segurola","Santa Rosa","COLEGIO NACIONAL SANTA ROSA",-66.78864,-14.07823,263,4,654,917,407,23,220,627
"Bolivia","Beni","General Jose Ballivián Segurola","Santa Rosa","ESC.CENTRAL PALMA FLOR",-66.6287,-12.96253,45,1,71,116,40,9,21,61
"Bolivia","Beni","General Jose Ballivián Segurola","Santa Rosa","ESC.EL CANDADO",-66.84259,-13.50823,30,2,80,110,25,1,52,77
"Bolivia","Beni","General Jose Ballivián Segurola","Santa Rosa","ESC. EL CERRITO",-66.7103,-13.09042,22,1,82,104,53,1,27,80
"Bolivia","Beni","General Jose Ballivián Segurola","Santa Rosa","ESC.EL TRIUNFO",-66.76116,-13.86169,58,0,223,281,118,1,104,222
"Bolivia","Beni","General Jose Ballivián Segurola","Santa Rosa","ESC.GERARDO REYES",-66.79248,-14.07916,509,30,2303,2812,1545,43,685,2230
"Bolivia","Beni","General Jose Ballivián Segurola","Santa Rosa","ESC. PUERTO TERESA",-66.60133,-13.44813,18,0,67,85,49,1,17,66
"Bolivia","Beni","General Jose Ballivián Segurola","Santa Rosa","ESC.PUERTO YATA",-66.63308,-13.45108,66,5,119,185,81,1,32,113
"Bolivia","Beni","General Jose Ballivián Segurola","Santa Rosa","ESCUELA AUSTRALIA",-66.52208,-12.78946,79,2,155,234,75,3,75,150
"Bolivia","Beni","General Jose Ballivián Segurola","Santa Rosa","ESCUELA EL ROSARIO",-66.71803,-13.82903,14,8,130,144,61,4,57,118
"Bolivia","Beni","Iténez","Baures","ESC. ALTA GRACIA",-63.66943,-13.63675,8,0,51,59,32,0,19,51
"Bolivia","Beni","Iténez","Baures","ESC. CAIRO II",-63.52425,-14.20468,7,0,22,29,0,0,22,22
"Bolivia","Beni","Iténez","Baures","ESC.CARMELO LOPEZ",-63.69662,-13.65491,305,11,1213,1518,674,7,521,1195
"Bolivia","Beni","Iténez","Baures","ESC.EL CAIRO",-63.72225,-13.72575,10,1,95,105,42,3,49,91
"Bolivia","Beni","Iténez","Baures","ESC.EL REMANZO",-61.8741,-13.52387,114,4,291,405,126,5,156,282
"Bolivia","Beni","Iténez","Baures","ESC. MONTE CRISTO DEL TIQUIN",-61.97526,-13.62647,100,3,121,221,21,3,94,115
"Bolivia","Beni","Iténez","Baures","ESC. RURAL JASIAQUIRI",-63.7384,-13.72094,12,0,150,162,70,1,79,149
"Bolivia","Beni","Iténez","Baures","ESC.SAN SIMON",-62.02819,-13.61491,54,4,138,192,40,2,92,132
"Bolivia","Beni","Iténez","Baures","ESC.SECCIONAL CAFETAL",-61.88521,-13.49341,98,1,122,220,40,0,81,121
"Bolivia","Beni","Iténez","Huacaraje","ESC.EL CARMEN",-63.80146,-14.23021,129,2,461,590,275,5,179,454
"Bolivia","Beni","Iténez","Huacaraje","ESC.JUAN ALBERTO ORELLANA",-63.87964,-13.59328,313,15,1104,1417,627,17,445,1072
"Bolivia","Beni","Iténez","Huacaraje","NUCLEO ESCOLAR LA EMBROLLA",-63.82495,-13.6832,3,0,58,61,10,6,42,52
"Bolivia","Beni","Iténez","Magdalena","COL.CNEL.CARMELO CUELLAR J.",-63.79037,-13.23383,30,1,219,249,109,2,107,216
"Bolivia","Beni","Iténez","Magdalena","ESC.ANGEL CHAVEZ ARZA",-64.24437,-12.89689,10,1,112,122,30,0,81,111
"Bolivia","Beni","Iténez","Magdalena","ESC.BUENA VISTA",-64.23037,-12.45551,133,7,236,369,109,4,116,225
"Bolivia","Beni","Iténez","Magdalena","ESC.CENTRAL 1O. DE MAYO",-63.37995,-12.65748,2,0,36,38,3,0,33,36
"Bolivia","Beni","Iténez","Magdalena","ESC.GIL COIMBRA",-64.05195,-13.25954,419,19,1839,2258,1018,22,780,1798
"Bolivia","Beni","Iténez","Magdalena","ESC.JOSE BALLIVIAN",-64.05527,-13.26313,184,9,1079,1263,584,30,456,1040
"Bolivia","Beni","Iténez","Magdalena","ESC.LA CAYOBA",-64.08502,-13.09004,9,0,69,78,45,2,22,67
"Bolivia","Beni","Iténez","Magdalena","ESC. SAN BORJA RIO BLANCO",-64.10181,-12.62778,25,4,146,171,77,1,64,141
"Bolivia","Beni","Iténez","Magdalena","ESC.SANTA MARIA",-63.825,-13.11831,8,0,84,92,55,0,29,84
"Bolivia","Beni","Iténez","Magdalena","U.E. MACEDONIO PAZ PINO",-63.70535,-13.27234,226,8,927,1153,454,23,442,896
"Bolivia","Beni","Mamoré","Puerto Siles","ESC.ALEJANDRIA",-65.06511,-12.08011,3,2,47,50,12,1,32,44
"Bolivia","Beni","Mamoré","Puerto Siles","ESC.ANTOFAGASTA",-65.00496,-12.80045,57,1,159,216,43,3,112,155
"Bolivia","Beni","Mamoré","Puerto Siles","ESC.SANTA ROSA",-65.11021,-12.29405,48,3,121,169,90,0,28,118
"Bolivia","Beni","Mamoré","San Joaquín","ESC.CAP.ARTURO CUELLAR REA",-64.66712,-13.04515,431,9,1044,1475,506,80,449,955
"Bolivia","Beni","Mamoré","San Joaquín","ESC.CHACO LEJOS",-64.9071,-12.83958,3,1,29,32,9,0,19,28
"Bolivia","Beni","Mamoré","San Joaquín","ESC.LAS PEÑITAS",-64.4332,-12.65806,0,0,5,5,0,1,4,4
"Bolivia","Beni","Mamoré","San Joaquín","ESC. MORE-MONTE AZUL",-64.91856,-12.09472,12,0,50,62,0,0,50,50
"Bolivia","Beni","Mamoré","San Joaquín","ESC. PUERTO USTAREZ",-64.45786,-12.40728,10,1,44,54,14,1,28,42
"Bolivia","Beni","Mamoré","San Joaquín","UNIDAD EDUCATIVA 21 DE AGOSTO",-64.6656,-13.04053,381,11,1044,1425,583,20,430,1013
"Bolivia","Beni","Mamoré","San Ramón","ESC. EL CARMEN DE GUACAYANE",-64.37999,-13.12766,5,0,38,43,0,0,38,38
"Bolivia","Beni","Mamoré","San Ramón","ESC.EL POYORI",-64.42094,-13.00931,2,1,38,40,6,0,31,37
"Bolivia","Beni","Mamoré","San Ramón","ESC.NAPOLEON AÑEZ ORTIZ",-64.61865,-13.26702,463,16,1835,2298,999,24,796,1795
"Bolivia","Beni","Mamoré","San Ramón","U.E. LAS PEÑAS",-64.39467,-12.63922,7,0,4,11,2,0,2,4
"Bolivia","Beni","Marbán","Loreto","ESC.CAMIACO",-64.86686,-15.33278,57,0,246,303,155,7,84,239
"Bolivia","Beni","Marbán","Loreto","ESC.GUNDONOVIA",-65.11512,-15.51444,62,4,135,197,79,1,51,130
"Bolivia","Beni","Marbán","Loreto","ESC.PERFECTA VDA. DE BEJARANO",-64.76012,-15.19398,155,3,335,490,130,10,192,322
"Bolivia","Beni","Marbán","Loreto","ESC.SACHOJERE",-64.75289,-14.98731,60,1,183,243,79,2,101,180
"Bolivia","Beni","Marbán","Loreto","ESC.SAN ANTONIO",-64.99944,-15.1992,23,0,55,78,26,1,28,54
"Bolivia","Beni","Marbán","Loreto","ESC.SAN PABLO-ISIBORO",-65.14317,-15.70741,33,1,138,171,31,5,101,132
"Bolivia","Beni","Marbán","Loreto","ESCUELA SANTA ROSA DEL CHAPARE",-64.75703,-15.93923,22,0,27,49,21,0,6,27
"Bolivia","Beni","Marbán","Loreto","SANTA ROSA DEL ISIBORO",-65.20737,-16.26001,23,2,71,94,16,0,53,69
"Bolivia","Beni","Marbán","Loreto","U.E. PALERMO",-64.65648,-15.88381,3,0,21,24,8,0,13,21
"Bolivia","Beni","Marbán","Loreto","U.E. VILLA EL CARMEN DEL REMANZO",-65.00182,-15.25932,18,0,63,81,21,1,41,62
"Bolivia","Beni","Marbán","San Andrés","ESC.BUEN JESUS",-64.37089,-14.98918,45,5,248,293,153,4,86,239
"Bolivia","Beni","Marbán","San Andrés","ESC.CAIMANES",-64.05082,-15.16342,32,7,163,195,87,2,67,154
"Bolivia","Beni","Marbán","San Andrés","ESC.CENTRAL 2 DE AGOSTO",-63.86697,-15.24271,419,28,1546,1965,595,33,890,1485
"Bolivia","Beni","Marbán","San Andrés","ESC.HUMBERTO VELARDE",-64.66631,-15.02232,61,2,225,286,110,5,108,218
"Bolivia","Beni","Marbán","San Andrés","ESC.LA ISIGA-PERSEVERA",-64.32283,-15.39423,38,1,38,76,22,0,15,37
"Bolivia","Beni","Marbán","San Andrés","ESC. MONTE CRISTO",-64.37347,-15.61208,29,1,46,75,21,0,24,45
"Bolivia","Beni","Marbán","San Andrés","ESC.PEROTO",-64.63706,-14.97516,41,3,145,186,82,1,59,141
"Bolivia","Beni","Marbán","San Andrés","ESC.SAN LORENZO",-64.7207,-15.03478,32,2,73,105,34,1,36,70
"Bolivia","Beni","Marbán","San Andrés","ESC.SANTA ROSA",-64.244,-15.10586,97,8,407,504,181,6,212,393
"Bolivia","Beni","Marbán","San Andrés","ESC.SOMOPAE",-64.65401,-14.94441,41,1,194,235,99,2,92,191
"Bolivia","Beni","Marbán","San Andrés","ESCUELA 4 DE JULIO",-63.46377,-15.73327,59,6,243,302,35,7,195,230
"Bolivia","Beni","Marbán","San Andrés","ESCUELA DE NUEVA BETANIA",-64.34632,-15.02995,55,3,219,274,90,3,123,213
"Bolivia","Beni","Marbán","San Andrés","ESCUELA ELVIRA",-64.60383,-14.92893,43,2,181,224,102,2,75,177
"Bolivia","Beni","Marbán","San Andrés","ESCUELA LIMONCITO",-63.46377,-15.73327,0,0,30,30,15,1,14,29
"Bolivia","Beni","Marbán","San Andrés","ESCUELA NUEVA MAGDALENA",-63.69929,-15.48585,51,0,117,168,31,0,86,117
"Bolivia","Beni","Marbán","San Andrés","ESCUELA TAJIBOTE",-64.08765,-15.63134,5,0,9,14,3,0,6,9
"Bolivia","Beni","Marbán","San Andrés","ESC. VILLA ALBA",-64.68153,-15.06132,30,0,135,165,65,2,68,133
"Bolivia","Beni","Marbán","San Andrés","ESC.VILLA BANZER",-64.41677,-14.94876,17,0,64,81,25,0,39,64
"Bolivia","Beni","Moxos","San Ignacio","COL.SOCRATES PARADA EGUEZ",-65.64265,-14.9983,661,55,2892,3553,1138,64,1635,2773
"Bolivia","Beni","Moxos","San Ignacio","ESC.CENTRAL SAN IGNACITO",-65.64748,-15.4581,8,0,21,29,6,0,15,21
"Bolivia","Beni","Moxos","San Ignacio","ESC.CENTRAL SANTA ROSA",-65.85181,-15.22264,5,2,91,96,10,0,79,89
"Bolivia","Beni","Moxos","San Ignacio","ESC. EL DESENGAÑO",-65.44534,-14.27502,45,2,121,166,59,2,58,117
"Bolivia","Beni","Moxos","San Ignacio","ESC.FATIMA",-65.34778,-14.91402,20,0,78,98,44,0,34,78
"Bolivia","Beni","Moxos","San Ignacio","ESC.LA ARGENTINA",-65.32679,-14.82843,9,0,68,77,24,1,43,67
"Bolivia","Beni","Moxos","San Ignacio","ESC.LITORAL",-65.57434,-14.97235,10,3,107,117,10,0,94,104
"Bolivia","Beni","Moxos","San Ignacio","ESC.MERCEDES DE LOJOJOTA",-65.57259,-16.5034,22,4,74,96,8,4,58,66
"Bolivia","Beni","Moxos","San Ignacio","ESC.MONTE GRANDE",-65.82966,-15.63879,23,1,90,113,16,8,65,81
"Bolivia","Beni","Moxos","San Ignacio","ESC.MONTE MAE",-65.72498,-15.53512,36,0,49,85,28,0,21,49
"Bolivia","Beni","Moxos","San Ignacio","ESC. OROMOMO",-66.18743,-16.04399,46,28,279,325,37,6,208,245
"Bolivia","Beni","Moxos","San Ignacio","ESC.OVIDIO ROCA C.",-65.55151,-15.55553,123,1,430,553,225,7,197,422
"Bolivia","Beni","Moxos","San Ignacio","ESC.PTO.SAN LORENZO",-65.4773,-15.77166,29,6,98,127,41,5,46,87
"Bolivia","Beni","Moxos","San Ignacio","ESC. PUERTO SAN BORJA",-65.79875,-14.98267,28,0,83,111,12,2,69,81
"Bolivia","Beni","Moxos","San Ignacio","ESC.RETIRO",-65.80604,-15.34924,15,1,106,121,2,2,101,103
"Bolivia","Beni","Moxos","San Ignacio","ESC.SAN ANTONIO DE IMOSE",-65.35487,-15.95693,45,2,94,139,48,9,35,83
"Bolivia","Beni","Moxos","San Ignacio","ESC.SAN FRANCISCO",-65.35629,-15.41029,63,8,231,294,68,7,148,216
"Bolivia","Beni","Moxos","San Ignacio","ESC.SAN JOSE DEL CABITU",-65.9744,-15.26368,60,1,163,223,35,6,121,156
"Bolivia","Beni","Moxos","San Ignacio","ESC.SAN JOSE DE PATROCINIO",-65.29938,-15.7724,16,0,22,38,20,0,2,22
"Bolivia","Beni","Moxos","San Ignacio","ESC.SAN MIGUELITO ISIBORO",-65.44078,-16.52943,15,1,68,83,6,4,57,63
"Bolivia","Beni","Moxos","San Ignacio","ESC.SUB-CENTRAL PUEBLO NUEVO",-65.88788,-15.24535,13,0,32,45,5,0,27,32
"Bolivia","Beni","Moxos","San Ignacio","ESC.TRINIDACITO",-65.30994,-15.76319,19,0,31,50,27,0,4,31
"Bolivia","Beni","Moxos","San Ignacio","ESCUELA DE BERMEO",-65.3772,-14.89496,28,1,82,110,30,0,51,81
"Bolivia","Beni","Moxos","San Ignacio","ESCUELA SANTÍSIMA TRINIDAD",-65.76534,-16.61358,21,3,160,181,42,2,113,155
"Bolivia","Beni","Moxos","San Ignacio","L.GILFREDO CORTEZ CANDIA",-65.64448,-14.99516,671,44,2561,3232,964,47,1506,2470
"Bolivia","Beni","Moxos","San Ignacio","U.E. SAN BERNARDO",-65.2933,-15.65132,43,2,92,135,73,3,14,87
"Bolivia","Beni","Vaca Diéz","Puerto Guayaramerín","(CÁRCEL) PENAL GUAYARAMERIN",-65.35279,-10.81292,11,0,22,33,11,1,10,21
"Bolivia","Beni","Vaca Diéz","Puerto Guayaramerín","CENTRO EDUCATIVO SIMON BOLIVAR",-65.36375,-10.83101,75,4,283,358,175,3,101,276
"Bolivia","Beni","Vaca Diéz","Puerto Guayaramerín","COL. 6 DE JUNIO",-65.34737,-10.82762,365,9,1476,1841,976,27,464,1440
"Bolivia","Beni","Vaca Diéz","Puerto Guayaramerín","COL. ALTO DE LA ALIANZA",-65.36181,-10.82369,485,15,1787,2272,1098,40,634,1732
"Bolivia","Beni","Vaca Diéz","Puerto Guayaramerín","COLEGIO ANTONIO VACA DIEZ",-65.35497,-10.81294,92,3,342,434,224,2,113,337
"Bolivia","Beni","Vaca Diéz","Puerto Guayaramerín","COLEGIO MANUEL VICENTE BALLIVIAN",-65.35051,-10.81116,182,1,302,484,218,5,78,296
"Bolivia","Beni","Vaca Diéz","Puerto Guayaramerín","COL. EVANGELICO NACIONAL",-65.35439,-10.81791,541,9,1442,1983,905,25,503,1408
"Bolivia","Beni","Vaca Diéz","Puerto Guayaramerín","COL.MANUEL ANTONIO OJOPI",-65.35567,-10.81322,732,14,2585,3317,1703,32,836,2539
"Bolivia","Beni","Vaca Diéz","Puerto Guayaramerín","DR.ELMER BOTSFORD",-65.35297,-10.8088,225,6,701,926,471,17,207,678
"Bolivia","Beni","Vaca Diéz","Puerto Guayaramerín","ESC.ANTOFAGASTA",-65.39104,-10.39382,15,0,51,66,28,0,23,51
"Bolivia","Beni","Vaca Diéz","Puerto Guayaramerín","ESC.CENTRAL SAN LORENZO",-65.23228,-11.73968,22,0,85,107,34,1,50,84
"Bolivia","Beni","Vaca Diéz","Puerto Guayaramerín","ESC.JUDDI DE SUAREZ",-65.58167,-10.53687,80,5,257,337,179,3,70,249
"Bolivia","Beni","Vaca Diéz","Puerto Guayaramerín","ESC. MEJILLONES",-65.35355,-10.82544,908,42,3354,4262,2205,58,1049,3254
"Bolivia","Beni","Vaca Diéz","Puerto Guayaramerín","ESC.ROSARIO DEL YATA",-65.57995,-10.99195,72,3,200,272,84,6,107,191
"Bolivia","Beni","Vaca Diéz","Puerto Guayaramerín","ESC. SAN FRANCISCO DEL YATA",-65.51111,-10.61194,15,1,46,61,29,0,16,45
"Bolivia","Beni","Vaca Diéz","Puerto Guayaramerín","ESC. SAN JOSE",-65.34554,-10.81522,402,12,1405,1807,904,25,464,1368
"Bolivia","Beni","Vaca Diéz","Puerto Guayaramerín","ESCUELA BRASIL",-65.3572,-10.8307,153,1,472,625,316,8,147,463
"Bolivia","Beni","Vaca Diéz","Puerto Guayaramerín","ESCUELA LOS ALMENDROS",-65.3472,-10.83402,425,10,1488,1913,890,44,544,1434
"Bolivia","Beni","Vaca Diéz","Puerto Guayaramerín","LIC.MIXTO GUAYAMERIN",-65.35883,-10.82098,541,8,1386,1927,891,24,463,1354
"Bolivia","Beni","Vaca Diéz","Puerto Guayaramerín","U.E. 9 DE ABRIL",-65.36181,-10.84011,25,2,266,291,154,5,105,259
"Bolivia","Beni","Vaca Diéz","Puerto Guayaramerín","U.E. BELEN",-65.35558,-10.83641,96,1,433,529,258,10,164,422
"Bolivia","Beni","Vaca Diéz","Puerto Guayaramerín","U.E MIGUEL ANTELO",-65.34438,-10.82256,49,0,186,235,111,8,67,178
"Bolivia","Beni","Vaca Diéz","Riberalta","(CÁRCEL) PENAL RIBERALTA",-66.0738,-10.99669,29,1,17,46,9,1,6,15
"Bolivia","Beni","Vaca Diéz","Riberalta","COL. 6 DE JUNIO",-66.077,-11.00458,534,11,1371,1905,1014,18,328,1342
"Bolivia","Beni","Vaca Diéz","Riberalta","COLEGIO EDUARDO ABAROA",-66.06204,-11.00703,637,23,2435,3072,1638,47,727,2365
"Bolivia","Beni","Vaca Diéz","Riberalta","COLEGIO ISMAEL CARRASCO TELLERIA",-66.05402,-11.01021,122,8,387,509,215,12,152,367
"Bolivia","Beni","Vaca Diéz","Riberalta","COLEGIO SAN FRANCISCO",-66.07206,-11.00753,81,3,359,440,244,7,105,349
"Bolivia","Beni","Vaca Diéz","Riberalta","COLEGIO SAN JUAN",-66.04671,-11.03188,542,57,1894,2436,967,57,813,1780
"Bolivia","Beni","Vaca Diéz","Riberalta","COLEGIO WALTER ALPIRE DURAN",-66.05729,-11.01164,157,6,638,795,429,8,195,624
"Bolivia","Beni","Vaca Diéz","Riberalta","COL. PEDRO KRAMER",-66.06915,-10.99869,391,8,1297,1688,929,37,323,1252
"Bolivia","Beni","Vaca Diéz","Riberalta","COL. SAN JOSE OBRERO",-66.06607,-10.99754,484,12,1271,1755,894,21,344,1238
"Bolivia","Beni","Vaca Diéz","Riberalta","COMITE CIVICO TUMICHUCUA",-66.16624,-11.14738,73,11,254,327,145,20,78,223
"Bolivia","Beni","Vaca Diéz","Riberalta","ESC.BRITANICA",-66.05006,-11.01523,915,39,2819,3734,1780,89,911,2691
"Bolivia","Beni","Vaca Diéz","Riberalta","ESC.FELIX SATTORY ROMAN",-66.06739,-11.00182,858,22,3384,4242,2517,66,779,3296
"Bolivia","Beni","Vaca Diéz","Riberalta","ESC. JUANA AZURDUY DE PADILLA",-66.07388,-10.99538,257,4,847,1104,649,23,171,820
"Bolivia","Beni","Vaca Diéz","Riberalta","ESCUELA 12 DE OCTUBRE",-65.69309,-11.0167,65,6,206,271,93,2,105,198
"Bolivia","Beni","Vaca Diéz","Riberalta","ESCUELA 1RO DE DICIEMBRE",-66.07318,-11.01311,454,12,1301,1755,933,18,338,1271
"Bolivia","Beni","Vaca Diéz","Riberalta","ESCUELA ALTO IVON",-66.03656,-11.87361,21,4,244,265,4,3,233,237
"Bolivia","Beni","Vaca Diéz","Riberalta","ESCUELA BOLIVAR",-65.9,-11.00223,93,5,268,361,124,6,133,257
"Bolivia","Beni","Vaca Diéz","Riberalta","ESCUELA LOS TAJIBOS",-66.04456,-11.02086,1118,41,3198,4316,1929,76,1152,3081
"Bolivia","Beni","Vaca Diéz","Riberalta","ESCUELA MARIPOSA",-66.1415,-12.27631,20,1,87,107,51,5,30,81
"Bolivia","Beni","Vaca Diéz","Riberalta","ESCUELA NAZARETH",-66.3375,-11.38739,22,2,92,114,60,3,27,87
"Bolivia","Beni","Vaca Diéz","Riberalta","ESCUELA PETROLERA",-66.05014,-11.00229,1526,58,4261,5787,2792,100,1311,4103
"Bolivia","Beni","Vaca Diéz","Riberalta","ESCUELA SANTA MARIA",-65.93813,-11.1185,68,9,280,348,112,6,153,265
"Bolivia","Beni","Vaca Diéz","Riberalta","ESCUELA SANTUARIO",-66.4724,-11.5389,6,2,53,59,23,6,22,45
"Bolivia","Beni","Vaca Diéz","Riberalta","ESCUELA WARNES",-65.96947,-10.92752,166,10,185,351,105,4,66,171
"Bolivia","Beni","Vaca Diéz","Riberalta","KINDER JHON F. KENNEDY",-66.06571,-10.99814,298,18,1487,1785,1094,20,355,1449
"Bolivia","Beni","Vaca Diéz","Riberalta","POLITECNICO BENJAMIN BOWLES",-66.05167,-11.00485,866,24,2961,3827,1945,58,934,2879
"Bolivia","Beni","Vaca Diéz","Riberalta","U.E. BELLA FLOR",-66.21178,-11.33017,4,0,71,75,31,2,38,69
"Bolivia","Beni","Vaca Diéz","Riberalta","U.E FEDERICO DEMMER",-66.04344,-10.99968,429,20,1389,1818,904,42,423,1327
"Bolivia","Beni","Vaca Diéz","Riberalta","U.E. LA ESPERANZA",-66.0544,-11.06529,16,3,147,163,85,14,45,130
"Bolivia","Beni","Vaca Diéz","Riberalta","U.E. NUESTRA SEÑORA DEL CARMEN",-66.07724,-10.99875,465,15,1549,2014,1070,31,433,1503
"Bolivia","Beni","Vaca Diéz","Riberalta","U.E. POPECHI",-66.07248,-11.13074,26,11,186,212,78,7,90,168
"Bolivia","Beni","Vaca Diéz","Riberalta","UNIDAD EDUCATIVA NATANIEL GARCÍA CHAVEZ",-66.07935,-11.00858,687,35,2572,3259,1803,101,633,2436
"Bolivia","Beni","Yacuma","Exaltación","ESC. CAMPO ANA MARIA",-65.57471,-12.94433,4,0,23,27,6,0,17,23
"Bolivia","Beni","Yacuma","Exaltación","ESC.COOPERATIVA",-65.04883,-12.6354,15,0,46,61,19,1,26,45
"Bolivia","Beni","Yacuma","Exaltación","ESC.COQUINAL",-65.85875,-12.97027,26,2,165,191,35,2,126,161
"Bolivia","Beni","Yacuma","Exaltación","ESC.EL MOTACUSAL",-65.4307,-12.91581,10,1,71,81,34,0,36,70
"Bolivia","Beni","Yacuma","Exaltación","ESC.EL TROMPILLO",-65.11865,-13.11602,7,0,10,17,6,0,4,10
"Bolivia","Beni","Yacuma","Exaltación","ESC.JOSE MAX PAREDES",-65.25107,-13.32101,133,1,411,544,149,3,258,407
"Bolivia","Beni","Yacuma","Exaltación","ESC. NUEVA ESPERANZA",-66.00737,-12.97329,9,0,17,26,9,0,8,17
"Bolivia","Beni","Yacuma","Exaltación","ESC.SAN CARLOS",-65.70103,-13.23234,15,0,44,59,11,0,33,44
"Bolivia","Beni","Yacuma","Exaltación","ESC.SANTA ROSA",-66.16964,-13.51003,1,0,9,10,4,0,5,9
"Bolivia","Beni","Yacuma","Exaltación","ESCUELA PUERTO SANTIAGO",-65.20205,-13.10789,2,0,16,18,11,0,5,16
"Bolivia","Beni","Yacuma","Exaltación","ESCUELA SAN JUAN DEL JORDAN",-66.42942,-12.88492,12,0,22,34,12,0,10,22
"Bolivia","Beni","Yacuma","Santa Ana (de Yacuma)","COL.ANDRES ALBERDI SALEGUI",-65.4307,-13.7505,621,21,2129,2750,1406,29,673,2079
"Bolivia","Beni","Yacuma","Santa Ana (de Yacuma)","COLEGIO GUILLERMO SEARLE",-65.42456,-13.74432,225,7,663,888,403,10,243,646
"Bolivia","Beni","Yacuma","Santa Ana (de Yacuma)","COL.MONS.DANIEL RIVERO",-65.42525,-13.74378,971,44,3247,4218,1945,65,1193,3138
"Bolivia","Beni","Yacuma","Santa Ana (de Yacuma)","ESC.CEC EL TOTAISAL",-66.32708,-14.87791,58,1,158,216,58,5,94,152
"Bolivia","Beni","Yacuma","Santa Ana (de Yacuma)","ESC.LOS MONTES DE ORO",-65.8585,-14.33763,11,1,13,24,6,0,6,12
"Bolivia","Beni","Yacuma","Santa Ana (de Yacuma)","ESC.WENCESLAO AÑEZ",-65.63189,-14.60486,123,3,350,473,185,8,154,339
"Bolivia","Chuquisaca","Azurduy","Tarvita (Villa Orías)","ESCUELA 12 DE OCTUBRE",-64.46204,-19.78101,146,18,552,698,176,21,337,513
"Bolivia","Chuquisaca","Azurduy","Tarvita (Villa Orías)","ESCUELA CHUNCA CANCHA",-64.68405,-19.58565,6,2,73,79,4,10,57,61
"Bolivia","Chuquisaca","Azurduy","Tarvita (Villa Orías)","ESCUELA CRUZ CKASA",-64.57745,-19.87214,132,9,572,704,123,21,419,542
"Bolivia","Chuquisaca","Azurduy","Tarvita (Villa Orías)","ESCUELA LUIS EVENCIO ORÍAS",-64.44648,-19.61855,173,9,567,740,272,16,270,542
"Bolivia","Chuquisaca","Azurduy","Tarvita (Villa Orías)","ESCUELA MARISCAL BRAUN",-64.56983,-19.97382,66,13,388,454,143,15,217,360
"Bolivia","Chuquisaca","Azurduy","Tarvita (Villa Orías)","ESCUELA MOLLE CANCHA",-64.61646,-19.74335,6,0,75,81,4,1,70,74
"Bolivia","Chuquisaca","Azurduy","Tarvita (Villa Orías)","ESCUELA SAN JOSE DE ALISOS",-64.63702,-19.69949,45,6,207,252,44,5,152,196
"Bolivia","Chuquisaca","Azurduy","Tarvita (Villa Orías)","U.E. VILLA PAMPA",-64.51918,-19.65606,37,6,172,209,62,3,101,163
"Bolivia","Chuquisaca","Azurduy","Tarvita (Villa Orías)","UNIDAD EDUCATIVA ANTONIO TOVAR",-64.48597,-19.92718,198,31,807,1005,294,34,448,742
"Bolivia","Chuquisaca","Azurduy","Tarvita (Villa Orías)","UNIDAD EDUCATIVA JESÚS MAESTRO",-64.68082,-19.674,157,17,786,943,56,31,682,738
"Bolivia","Chuquisaca","Azurduy","Tarvita (Villa Orías)","UNIDAD EDUCATIVA PAMPAS DE LEQUE",-64.57776,-19.72431,27,5,288,315,22,3,258,280
"Bolivia","Chuquisaca","Azurduy","Villa Azurduy","ESCUELA DURAZNAL",-64.42482,-20.41302,37,2,193,230,18,5,168,186
"Bolivia","Chuquisaca","Azurduy","Villa Azurduy","ESCUELA HUANCARANI",-64.48476,-20.23491,29,1,131,160,3,7,120,123
"Bolivia","Chuquisaca","Azurduy","Villa Azurduy","ESCUELA PINOS",-64.45695,-20.32877,52,0,177,229,5,1,171,176
"Bolivia","Chuquisaca","Azurduy","Villa Azurduy","ESCUELA  RODEO CHICO",-64.53408,-20.24856,63,5,380,443,12,10,353,365
"Bolivia","Chuquisaca","Azurduy","Villa Azurduy","ESCUELA TABLANI",-64.56451,-20.06003,82,2,315,397,27,24,262,289
"Bolivia","Chuquisaca","Azurduy","Villa Azurduy","ESCUELA TORRECILLAS",-64.3971,-19.9672,56,3,133,189,36,9,85,121
"Bolivia","Chuquisaca","Azurduy","Villa Azurduy","U.E. COLLPAMAYU",-64.51823,-20.08899,51,9,282,333,14,8,251,265
"Bolivia","Chuquisaca","Azurduy","Villa Azurduy","U.E. QUEHUEÑAL",-64.4158,-19.92459,12,3,73,85,23,3,44,67
"Bolivia","Chuquisaca","Azurduy","Villa Azurduy","UNIDAD EDUCATIVA NICANOR LOPEZ",-64.41391,-20.10486,400,54,1556,1956,633,68,801,1434
"Bolivia","Chuquisaca","Azurduy","Villa Azurduy","UNIDAD EDUCATIVA SAN ROQUE",-64.51511,-20.13545,45,1,162,207,6,9,146,152
"Bolivia","Chuquisaca","Azurduy","Villa Azurduy","UNIDAD EDUCATIVA SANTA ROSA",-64.3904,-19.88058,76,2,138,214,33,5,98,131
"Bolivia","Chuquisaca","Belisario Boeto","Villa Serrano","COLEGIO DANIEL SANCHEZ BUSTAMANTE",-64.42113,-19.01643,85,9,476,561,67,25,375,442
"Bolivia","Chuquisaca","Belisario Boeto","Villa Serrano","ESCUELA DARIO OVANDO CUELLAR",-64.3476,-18.8886,38,2,134,172,4,8,120,124
"Bolivia","Chuquisaca","Belisario Boeto","Villa Serrano","ESCUELA ELISARDO PEREZ",-64.19292,-19.11728,61,5,240,301,67,9,159,226
"Bolivia","Chuquisaca","Belisario Boeto","Villa Serrano","ESCUELA HEROES DEL CHACO",-64.13771,-19.06195,54,3,199,253,15,3,178,193
"Bolivia","Chuquisaca","Belisario Boeto","Villa Serrano","ESCUELA JORGE ANIBARRO ZAPATA",-64.29203,-18.99208,127,13,442,569,87,20,322,409
"Bolivia","Chuquisaca","Belisario Boeto","Villa Serrano","ESCUELA LUIS SANTOS PRADO",-64.2653,-19.1737,20,0,95,115,4,3,88,92
"Bolivia","Chuquisaca","Belisario Boeto","Villa Serrano","ESCUELA MARISCAL SUCRE",-64.32195,-19.12737,494,67,2485,2979,948,112,1358,2306
"Bolivia","Chuquisaca","Belisario Boeto","Villa Serrano","ESCUELA RENÉ ANIBARRO GÓMEZ",-64.396,-18.8268,99,4,201,300,16,11,170,186
"Bolivia","Chuquisaca","Belisario Boeto","Villa Serrano","U.E. LAMPAZOS",-64.39145,-18.76599,3,0,72,75,15,2,55,70
"Bolivia","Chuquisaca","Belisario Boeto","Villa Serrano","U.E. LOTHAR BRUCKER",-64.36176,-18.82008,3,0,97,100,1,3,93,94
"Bolivia","Chuquisaca","Belisario Boeto","Villa Serrano","UNIDAD EDUCATIVA MAMERTO NAVA DURAN",-64.37803,-18.94884,47,3,150,197,15,10,122,137
"Bolivia","Chuquisaca","Belisario Boeto","Villa Serrano","UNID. EDUC. SAN MIGUEL DE LA QUEBRADA",-64.24857,-19.1079,29,2,91,120,6,5,78,84
"Bolivia","Chuquisaca","Hernando Siles","Monteagudo","ESCUELA 6 DE JUNIO",-64.11983,-20.33284,125,2,368,493,159,16,191,350
"Bolivia","Chuquisaca","Hernando Siles","Monteagudo","ESCUELA BERNARDO MONTEAGUDO",-63.95635,-19.78872,594,59,3297,3891,1692,101,1445,3137
"Bolivia","Chuquisaca","Hernando Siles","Monteagudo","ESCUELA CHAPIMAYU",-64.14899,-19.87584,70,2,268,338,62,8,196,258
"Bolivia","Chuquisaca","Hernando Siles","Monteagudo","ESCUELA DESPENSAS",-64.1007,-20.04283,61,2,173,234,71,10,90,161
"Bolivia","Chuquisaca","Hernando Siles","Monteagudo","ESCUELA EL ZAPALLAR",-63.93938,-19.80897,32,7,194,226,60,8,119,179
"Bolivia","Chuquisaca","Hernando Siles","Monteagudo","ESCUELA FERNANDEZ",-64.23994,-20.16429,46,3,168,214,72,4,89,161
"Bolivia","Chuquisaca","Hernando Siles","Monteagudo","ESCUELA MARÍA VDA. DE VALDA",-63.95535,-19.80042,630,50,3353,3983,1657,124,1522,3179
"Bolivia","Chuquisaca","Hernando Siles","Monteagudo","ESCUELA PAMPA HEREDIA",-64.0597,-19.80225,37,2,118,155,40,5,71,111
"Bolivia","Chuquisaca","Hernando Siles","Monteagudo","ESCUELA PEDERNAL",-64.11466,-19.77911,52,8,246,298,45,7,186,231
"Bolivia","Chuquisaca","Hernando Siles","Monteagudo","ESCUELA SAN LORENZO",-64.20084,-19.92886,24,2,139,163,31,5,101,132
"Bolivia","Chuquisaca","Hernando Siles","Monteagudo","ESCUELA YANA YANA",-64.13422,-20.19204,24,0,34,58,19,2,13,32
"Bolivia","Chuquisaca","Hernando Siles","Monteagudo","NUCLEO ESCOLAR BARTOLO",-64.03931,-19.66221,13,1,94,107,11,1,81,92
"Bolivia","Chuquisaca","Hernando Siles","Monteagudo","U. EDU. JUANA AZURDUY DE PADILLA",-63.9845,-20.0189,99,16,495,594,164,45,270,434
"Bolivia","Chuquisaca","Hernando Siles","Monteagudo","U. EDU. SAN MIGUEL DEL BAÑADO",-63.88668,-20.0789,87,22,503,590,198,23,260,458
"Bolivia","Chuquisaca","Hernando Siles","Monteagudo","U. EDU. SAN PEDRO DEL PARAPETI",-63.88159,-20.16382,15,0,59,74,35,1,23,58
"Bolivia","Chuquisaca","Hernando Siles","Monteagudo","UNIDAD EDUCATIVA AZERO NORTE",-63.99007,-19.56839,4,0,42,46,13,2,27,40
"Bolivia","Chuquisaca","Hernando Siles","Monteagudo","UNIDAD EDUCATIVA INGAVI",-64.0831,-20.21808,8,2,92,100,45,0,45,90
"Bolivia","Chuquisaca","Hernando Siles","Monteagudo","UNIDAD EDUCATIVA LOS ARCOS",-64.22605,-20.3155,25,0,92,117,21,4,67,88
"Bolivia","Chuquisaca","Hernando Siles","Monteagudo","UNIDAD EDUCATIVA REBECA DE LA VEGA",-63.97173,-19.81358,269,37,1608,1877,630,82,859,1489
"Bolivia","Chuquisaca","Hernando Siles","Monteagudo","UNIDAD EDUCATIVA ROLDANA",-64.12152,-19.80378,13,4,101,114,23,1,73,96
"Bolivia","Chuquisaca","Hernando Siles","Monteagudo","UNIDAD EDUCATIVA VALLE NUEVO",-63.98814,-19.9332,29,6,181,210,43,10,122,165
"Bolivia","Chuquisaca","Hernando Siles","San Pablo de Huacareta","COLEGIO AMISTAD A",-64.00413,-20.36557,328,14,1206,1534,748,26,418,1166
"Bolivia","Chuquisaca","Hernando Siles","San Pablo de Huacareta","ESCUELA MIGUEL JHASTER",-64.02778,-20.71865,46,5,189,235,120,1,63,183
"Bolivia","Chuquisaca","Hernando Siles","San Pablo de Huacareta","ESCUELA RAFAEL PABON",-64.14964,-20.57222,94,8,366,460,176,16,166,342
"Bolivia","Chuquisaca","Hernando Siles","San Pablo de Huacareta","ESCUELA SALVIO LANUZA",-63.89535,-20.5817,106,11,312,418,189,20,92,281
"Bolivia","Chuquisaca","Hernando Siles","San Pablo de Huacareta","UNIDAD BALDOMERO LOPEZ",-63.96331,-20.16225,65,8,254,319,109,8,129,238
"Bolivia","Chuquisaca","Hernando Siles","San Pablo de Huacareta","UNIDAD EDUCATIVA ATIRIMBIA",-63.93389,-20.8244,24,8,92,116,37,3,44,81
"Bolivia","Chuquisaca","Hernando Siles","San Pablo de Huacareta","UNIDAD EDUCATIVA ERNESTO THEOBALD",-64.15099,-20.51959,146,6,433,579,159,14,254,413
"Bolivia","Chuquisaca","Hernando Siles","San Pablo de Huacareta","UNIDAD EDUCATIVA HUIRASAI",-63.992,-20.61985,23,0,123,146,17,3,103,120
"Bolivia","Chuquisaca","Hernando Siles","San Pablo de Huacareta","UNIDAD EDUCATIVA SAN JORGE DE IPATY",-63.8552,-20.42435,51,9,298,349,18,10,261,279
"Bolivia","Chuquisaca","Luis Calvo","Macharetí","COLEGIO 27 DE MARZO",-63.28704,-20.70558,54,0,221,275,61,36,124,185
"Bolivia","Chuquisaca","Luis Calvo","Macharetí","COLEGIO FRAY QUEBRACHO",-63.32757,-20.99875,13,2,118,131,50,4,62,112
"Bolivia","Chuquisaca","Luis Calvo","Macharetí","ESCUELA 25 DE MAYO",-63.42398,-20.45202,75,10,410,485,110,7,283,393
"Bolivia","Chuquisaca","Luis Calvo","Macharetí","ESCUELA EDUARDO AVAROA",-63.3611,-20.81543,284,22,938,1222,464,37,415,879
"Bolivia","Chuquisaca","Luis Calvo","Macharetí","ESCUELA EL SIMBOLAR",-62.9492,-20.5253,16,2,55,71,25,4,24,49
"Bolivia","Chuquisaca","Luis Calvo","Macharetí","ESCUELA EL VINAL",-63.10925,-20.70269,18,3,53,71,23,3,24,47
"Bolivia","Chuquisaca","Luis Calvo","Macharetí","ESCUELA IPATI",-63.40212,-20.54343,25,7,139,164,73,2,57,130
"Bolivia","Chuquisaca","Luis Calvo","Macharetí","ESCUELA PEDRO DOMINGO MURILLO",-63.3061,-20.86273,10,1,62,72,4,0,57,61
"Bolivia","Chuquisaca","Luis Calvo","Macharetí","ESCUELA SAN JUAN DE CAMATINDI",-63.39542,-20.99425,37,5,147,184,44,6,92,136
"Bolivia","Chuquisaca","Luis Calvo","Macharetí","ESCUELA TIGUIPA PUEBLO",-63.38359,-20.91519,24,4,147,171,76,5,62,138
"Bolivia","Chuquisaca","Luis Calvo","Macharetí","U. EDU. HEROES DEL CHACO HERNADO SILES",-63.07143,-20.75865,106,8,259,365,151,6,94,245
"Bolivia","Chuquisaca","Luis Calvo","Macharetí","U.E. ISIPOTINDI",-63.31057,-20.61732,13,0,118,131,21,16,81,102
"Bolivia","Chuquisaca","Luis Calvo","Macharetí","U.E. TENTAMI",-63.3348,-20.937,13,1,75,88,7,2,65,72
"Bolivia","Chuquisaca","Luis Calvo","Macharetí","U.E. TIMBOYCITO",-63.311,-20.7379,5,1,46,51,13,0,32,45
"Bolivia","Chuquisaca","Luis Calvo","Macharetí","UNIDAD EDUCATIVA CUATRO VIENTOS",-62.68652,-20.86266,6,1,24,30,20,0,3,23
"Bolivia","Chuquisaca","Luis Calvo","Macharetí","UNIDAD EDUCATIVA MANUEL MARIANO GÓMEZ",-63.06475,-20.53849,2,2,34,36,16,3,13,29
"Bolivia","Chuquisaca","Luis Calvo","Villa de Huacaya","ESCUELA BOYCOBO",-63.65736,-20.69879,17,2,102,119,24,2,74,98
"Bolivia","Chuquisaca","Luis Calvo","Villa de Huacaya","ESCUELA CHIMBE",-63.55851,-20.64951,10,0,34,44,4,1,29,33
"Bolivia","Chuquisaca","Luis Calvo","Villa de Huacaya","ESCUELA FRAY MARCOS OZETI",-63.52636,-20.48822,118,7,450,568,118,11,314,432
"Bolivia","Chuquisaca","Luis Calvo","Villa de Huacaya","ESCUELA SAN ANTONIO",-63.66537,-20.74458,57,0,177,234,78,3,96,174
"Bolivia","Chuquisaca","Luis Calvo","Villa de Huacaya","UNIDAD EDUCATIVA ANKAGUAZU",-63.67434,-20.88688,2,0,33,35,7,0,26,33
"Bolivia","Chuquisaca","Luis Calvo","Villa de Huacaya","UNIDAD EDUCATIVA BORORIGUA",-63.63357,-20.56405,22,0,140,162,26,2,112,138
"Bolivia","Chuquisaca","Luis Calvo","Villa Vaca Guzmán (Muyupampa)","CASA COMUNAL AGUAIRENDA",-63.76873,-19.46924,66,4,205,271,34,1,166,200
"Bolivia","Chuquisaca","Luis Calvo","Villa Vaca Guzmán (Muyupampa)","CASA COMUNAL TENTAYAPI",-63.85,-20.86667,21,1,190,211,2,0,187,189
"Bolivia","Chuquisaca","Luis Calvo","Villa Vaca Guzmán (Muyupampa)","ESCUELA HERNANDO SILES",-63.75016,-19.8965,490,42,2498,2988,1405,108,943,2348
"Bolivia","Chuquisaca","Luis Calvo","Villa Vaca Guzmán (Muyupampa)","ESCUELA RUFINO SALAZAR",-63.8163,-19.67933,67,7,200,267,70,6,117,187
"Bolivia","Chuquisaca","Luis Calvo","Villa Vaca Guzmán (Muyupampa)","ESCUELA SAPIRANGUIMIRI",-63.76806,-20.09122,16,2,78,94,26,6,44,70
"Bolivia","Chuquisaca","Luis Calvo","Villa Vaca Guzmán (Muyupampa)","ESCUELA TICUCHA",-63.82461,-19.62364,18,2,97,115,38,6,51,89
"Bolivia","Chuquisaca","Luis Calvo","Villa Vaca Guzmán (Muyupampa)","NUCLEO ESCOLAR CUMANDAITI",-63.84387,-19.45372,53,4,193,246,64,2,123,187
"Bolivia","Chuquisaca","Luis Calvo","Villa Vaca Guzmán (Muyupampa)","U.E. LEO SCHWARZ",-63.88537,-19.26629,5,1,58,63,17,2,38,55
"Bolivia","Chuquisaca","Luis Calvo","Villa Vaca Guzmán (Muyupampa)","UNIDAD EDUCATIVA IGUEMBE",-63.7504,-20.55215,86,6,326,412,115,26,179,294
"Bolivia","Chuquisaca","Luis Calvo","Villa Vaca Guzmán (Muyupampa)","UNIDAD EDUCATIVA ITAU",-63.76336,-20.27766,19,0,57,76,17,2,38,55
"Bolivia","Chuquisaca","Luis Calvo","Villa Vaca Guzmán (Muyupampa)","UNIDAD EDUCATIVA ITY",-63.7644,-19.6085,11,2,181,192,48,2,129,177
"Bolivia","Chuquisaca","Nor Cinti","Camargo","(CÁRCEL) CARCELETA PÚBLICA DE CAMARGO",-65.20866,-20.64096,6,0,15,21,6,0,9,15
"Bolivia","Chuquisaca","Nor Cinti","Camargo","COLEGIO BOLIVIA",-65.20852,-20.6396,414,32,1894,2308,1048,64,750,1798
"Bolivia","Chuquisaca","Nor Cinti","Camargo","COLEGIO NACIONAL MIXTO 3 DE ABRIL",-65.21046,-20.64259,475,27,2154,2629,1169,82,876,2045
"Bolivia","Chuquisaca","Nor Cinti","Camargo","ESCUELA EL CHURO",-65.13138,-20.63216,21,0,57,78,2,1,54,56
"Bolivia","Chuquisaca","Nor Cinti","Camargo","ESCUELA LA QUEMADA",-65.29808,-20.75148,13,2,98,111,33,10,53,86
"Bolivia","Chuquisaca","Nor Cinti","Camargo","ESCUELA RIO CHICO",-65.22565,-20.69902,23,1,127,150,42,4,80,122
"Bolivia","Chuquisaca","Nor Cinti","Camargo","ESCUELA YURAC CABALLO",-65.13165,-20.74312,41,3,144,185,27,7,107,134
"Bolivia","Chuquisaca","Nor Cinti","Camargo","UNIDAD EDUCATIVA CARPACHACRA",-65.34814,-20.64821,18,1,99,117,21,6,71,92
"Bolivia","Chuquisaca","Nor Cinti","Camargo","UNIDAD EDUCATIVA CUEVA PAMPA",-65.04705,-20.45579,45,4,167,212,14,3,146,160
"Bolivia","Chuquisaca","Nor Cinti","Camargo","UNIDAD EDUCATIVA HIGUERA HUAYCO",-65.22394,-20.79629,47,5,174,221,48,3,118,166
"Bolivia","Chuquisaca","Nor Cinti","Camargo","UNIDAD EDUCATIVA HUACA CANCHA",-64.95026,-20.47788,57,4,118,175,6,8,100,106
"Bolivia","Chuquisaca","Nor Cinti","Camargo","UNIDAD EDUCATIVA JATUN QUINRAY",-64.9914,-20.5823,16,1,86,102,7,0,78,85
"Bolivia","Chuquisaca","Nor Cinti","Camargo","UNIDAD EDUCATIVA LINTACA",-65.34542,-20.73311,15,0,24,39,7,0,17,24
"Bolivia","Chuquisaca","Nor Cinti","Camargo","UNIDAD EDUCATIVA MUYUQUIRI",-65.14874,-20.49716,106,11,471,577,57,14,389,446
"Bolivia","Chuquisaca","Nor Cinti","Camargo","UNIDAD EDUCATIVA PALCA GRANDE",-65.23849,-20.7456,48,3,151,199,90,9,49,139
"Bolivia","Chuquisaca","Nor Cinti","Camargo","UNIDAD EDUCATIVA QUIRUCILLANI",-64.88852,-20.49862,0,0,28,28,0,0,28,28
"Bolivia","Chuquisaca","Nor Cinti","Camargo","UNIDAD EDUCATIVA SUQUISTACA",-65.09431,-20.38414,45,5,208,253,21,5,177,198
"Bolivia","Chuquisaca","Nor Cinti","Camargo","UNIDAD EDUCATIVA TACAQUIRA",-65.14967,-20.54018,107,0,260,367,69,12,179,248
"Bolivia","Chuquisaca","Nor Cinti","Incahuasi","ESCUELA 2 DE AGOSTO",-64.70975,-20.70182,52,6,334,386,14,7,307,321
"Bolivia","Chuquisaca","Nor Cinti","Incahuasi","ESCUELA EL VERANO",-64.6666,-20.56279,21,0,181,202,4,1,176,180
"Bolivia","Chuquisaca","Nor Cinti","Incahuasi","ESCUELA HUAJLAYA",-64.5423,-20.59936,109,15,256,365,28,4,209,237
"Bolivia","Chuquisaca","Nor Cinti","Incahuasi","ESCUELA JOLENCIA",-64.86333,-20.71497,72,11,316,388,60,24,221,281
"Bolivia","Chuquisaca","Nor Cinti","Incahuasi","ESCUELA LAMPAZAR",-64.4935,-20.5347,46,0,115,161,3,0,112,115
"Bolivia","Chuquisaca","Nor Cinti","Incahuasi","ESCUELA SAN LORENCITO",-64.87055,-20.79387,7,2,32,39,4,6,20,24
"Bolivia","Chuquisaca","Nor Cinti","Incahuasi","U.E. YATINA",-64.73019,-20.61985,90,10,285,375,19,8,248,267
"Bolivia","Chuquisaca","Nor Cinti","Incahuasi","UNIDAD EDUCATIVA EDUARDO AVAROA",-64.86781,-20.78048,398,24,1297,1695,493,57,723,1216
"Bolivia","Chuquisaca","Nor Cinti","Incahuasi","UNIDAD EDUCATIVA EL QUEMADO",-64.5985,-20.57037,5,2,257,262,3,2,250,253
"Bolivia","Chuquisaca","Nor Cinti","San Lucas","ESCUELA HUAYLLANI",-64.93605,-20.36235,66,6,194,260,6,4,178,184
"Bolivia","Chuquisaca","Nor Cinti","San Lucas","ESCUELA MOLLE PATA",-64.64008,-20.41311,81,7,264,345,36,17,204,240
"Bolivia","Chuquisaca","Nor Cinti","San Lucas","ESCUELA PAYACOTA DEL CARMEN",-65.25732,-20.21278,104,8,367,471,75,14,270,345
"Bolivia","Chuquisaca","Nor Cinti","San Lucas","U.E. CINTEÑO TAMBO",-65.01966,-20.22208,61,3,296,357,71,8,214,285
"Bolivia","Chuquisaca","Nor Cinti","San Lucas","U.E. CRUZ MAYU",-64.87011,-20.03394,2,2,90,92,1,0,87,88
"Bolivia","Chuquisaca","Nor Cinti","San Lucas","U. EDU. EDUARDO AVAROA",-65.13464,-20.1035,537,55,2040,2577,664,101,1220,1884
"Bolivia","Chuquisaca","Nor Cinti","San Lucas","U.E. EL TERRADO",-64.98693,-20.39509,15,2,133,148,5,1,125,130
"Bolivia","Chuquisaca","Nor Cinti","San Lucas","U.E. TORRE DE LINARES",-64.7693,-19.901,55,8,171,226,8,0,155,163
"Bolivia","Chuquisaca","Nor Cinti","San Lucas","UNIDAD EDUCATIVA 12 DE ABRIL",-65.02613,-20.27677,159,12,691,850,96,13,570,666
"Bolivia","Chuquisaca","Nor Cinti","San Lucas","UNIDAD EDUCATIVA ACCHILLA",-64.80387,-20.32539,141,13,250,391,16,11,210,226
"Bolivia","Chuquisaca","Nor Cinti","San Lucas","UNIDAD EDUCATIVA BUENA VISTA",-64.93593,-19.9318,52,1,175,227,5,3,166,171
"Bolivia","Chuquisaca","Nor Cinti","San Lucas","UNIDAD EDUCATIVA CANCHAS BLANCAS",-64.79684,-20.03145,104,8,256,360,16,6,226,242
"Bolivia","Chuquisaca","Nor Cinti","San Lucas","UNIDAD EDUCATIVA CHILLAGUA",-64.96616,-20.26884,62,1,265,327,14,3,247,261
"Bolivia","Chuquisaca","Nor Cinti","San Lucas","UNIDAD EDUCATIVA CIVITA",-64.90813,-20.00292,8,0,110,118,0,3,107,107
"Bolivia","Chuquisaca","Nor Cinti","San Lucas","UNIDAD EDUCATIVA HUAÑUMILLA",-64.74733,-19.94859,81,1,267,348,18,6,242,260
"Bolivia","Chuquisaca","Nor Cinti","San Lucas","UNIDAD EDUCATIVA JAPO",-64.77112,-20.09636,34,2,113,147,9,2,100,109
"Bolivia","Chuquisaca","Nor Cinti","San Lucas","UNIDAD EDUCATIVA KOLLPA",-64.65379,-20.03951,66,0,257,323,2,6,249,251
"Bolivia","Chuquisaca","Nor Cinti","San Lucas","UNIDAD EDUCATIVA LAJA CKASA",-64.94637,-20.19596,87,5,190,277,24,8,153,177
"Bolivia","Chuquisaca","Nor Cinti","San Lucas","UNIDAD EDUCATIVA MURIFAYA",-65.00114,-20.13484,13,3,94,107,9,4,78,87
"Bolivia","Chuquisaca","Nor Cinti","San Lucas","UNIDAD EDUCATIVA OCURI",-65.05057,-20.21683,74,21,392,466,30,7,334,364
"Bolivia","Chuquisaca","Nor Cinti","San Lucas","UNIDAD EDUCATIVA PADCOYO",-65.15222,-20.23535,186,23,665,851,96,17,529,625
"Bolivia","Chuquisaca","Nor Cinti","San Lucas","UNIDAD EDUCATIVA PALACIO TAMBO",-64.9901,-20.21117,278,36,822,1100,181,38,567,748
"Bolivia","Chuquisaca","Nor Cinti","San Lucas","UNIDAD EDUCATIVA PASLA",-64.78234,-19.94768,27,4,151,178,1,0,146,147
"Bolivia","Chuquisaca","Nor Cinti","San Lucas","UNIDAD EDUCATIVA PIRHUANI",-64.6492,-20.16914,111,4,290,401,2,4,280,282
"Bolivia","Chuquisaca","Nor Cinti","San Lucas","UNIDAD EDUCATIVA ROSENDO LA FUENTE",-65.01423,-20.3716,149,17,529,678,92,15,405,497
"Bolivia","Chuquisaca","Nor Cinti","San Lucas","UNIDAD EDUCATIVA SACAVILLQUE CHICO",-64.6198,-20.30524,112,8,204,316,13,11,172,185
"Bolivia","Chuquisaca","Nor Cinti","San Lucas","UNIDAD EDUCATIVA SAN PEDRO DE HUANAYA",-64.69353,-20.28096,16,3,91,107,1,0,87,88
"Bolivia","Chuquisaca","Nor Cinti","San Lucas","UNIDAD EDUCATIVA TAMBILLOS",-65.27066,-20.04161,102,33,284,386,18,4,229,247
"Bolivia","Chuquisaca","Nor Cinti","San Lucas","UNIDAD EDUCATIVA TAMBO CKASA",-64.7476,-20.33026,120,1,223,343,0,1,221,221
"Bolivia","Chuquisaca","Nor Cinti","San Lucas","UNIDAD EDUCATIVA TOROJCHI",-64.9986,-19.99369,32,1,122,154,13,4,104,117
"Bolivia","Chuquisaca","Nor Cinti","San Lucas","UNIDAD EDUCATIVA URUCHINI",-64.98957,-19.87956,53,3,129,182,27,7,92,119
"Bolivia","Chuquisaca","Nor Cinti","Villa Charcas","COLEGIO PADRE LANDINI SIMON BOLIVAR",-64.88494,-20.72522,756,80,2586,3342,773,151,1582,2355
"Bolivia","Chuquisaca","Nor Cinti","Villa Charcas","ESCUELA BOMBOMA",-64.69144,-20.44497,8,1,75,83,7,0,67,74
"Bolivia","Chuquisaca","Nor Cinti","Villa Charcas","ESCUELA CAIZA K",-64.74667,-20.52791,76,8,232,308,8,5,211,219
"Bolivia","Chuquisaca","Nor Cinti","Villa Charcas","ESCUELA LLUJLLAYA",-64.73945,-20.54849,45,20,255,300,12,6,217,229
"Bolivia","Chuquisaca","Nor Cinti","Villa Charcas","ESCUELA SANTA ELENA",-64.77654,-20.58304,86,5,359,445,15,9,330,345
"Bolivia","Chuquisaca","Nor Cinti","Villa Charcas","ESCUELA SUPAS",-64.77631,-20.43394,57,17,314,371,11,4,282,293
"Bolivia","Chuquisaca","Nor Cinti","Villa Charcas","U.E. MOLLINI",-64.71598,-20.45341,17,1,57,74,3,1,52,55
"Bolivia","Chuquisaca","Nor Cinti","Villa Charcas","UNIDAD EDUCATIVA JOSE ANTONIO ZAMPA",-64.85761,-20.66362,78,10,682,760,84,13,575,659
"Bolivia","Chuquisaca","Oropeza","Poroma","COLEGIOMANUEL OVANDO SAN JUAN DE ORCAS",-65.31216,-18.73248,86,10,251,337,37,16,188,225
"Bolivia","Chuquisaca","Oropeza","Poroma","COLEGIO RAFAEL CAMPOS DE LUJE",-65.21857,-18.78213,49,3,186,235,35,5,143,178
"Bolivia","Chuquisaca","Oropeza","Poroma","ESCUELA CENTRAL CHALLCHA",-65.54505,-18.44033,64,2,296,360,89,13,192,281
"Bolivia","Chuquisaca","Oropeza","Poroma","ESCUELA KAYNACAS",-65.404,-18.86573,32,4,171,203,26,3,138,164
"Bolivia","Chuquisaca","Oropeza","Poroma","ESCUELA SAN SALVADOR DE POJPO",-65.32699,-18.79455,75,14,259,334,61,10,174,235
"Bolivia","Chuquisaca","Oropeza","Poroma","POSTA SANITARIA",-65.28516,-18.49988,15,0,23,38,4,1,18,22
"Bolivia","Chuquisaca","Oropeza","Poroma","PUESTO DE SALUD VIRU VIRU",-65.651,-18.38448,21,9,124,145,26,8,81,107
"Bolivia","Chuquisaca","Oropeza","Poroma","SUB ALCALDÍA DE SAPSE",-65.27885,-18.72523,36,7,152,188,43,3,99,142
"Bolivia","Chuquisaca","Oropeza","Poroma","U. EDU. SAN ANDRES DE POROMA",-65.42594,-18.53917,368,25,941,1309,278,51,587,865
"Bolivia","Chuquisaca","Oropeza","Poroma","UNIDAD EDUCATIVA CALIZAYA",-65.33015,-18.48993,11,1,104,115,20,3,80,100
"Bolivia","Chuquisaca","Oropeza","Poroma","UNIDAD EDUCATIVA CHIJMURI",-65.39856,-18.81042,38,8,146,184,34,3,101,135
"Bolivia","Chuquisaca","Oropeza","Poroma","UNIDAD EDUCATIVA COPAVILLQUE",-65.2855,-18.62391,90,3,292,382,48,16,225,273
"Bolivia","Chuquisaca","Oropeza","Poroma","UNIDAD EDUCATIVA CUCURI",-65.30397,-18.84813,34,8,212,246,43,9,152,195
"Bolivia","Chuquisaca","Oropeza","Poroma","UNIDAD EDUCATIVA HUAÑOMA",-65.59436,-18.45855,171,4,351,522,70,38,239,309
"Bolivia","Chuquisaca","Oropeza","Poroma","UNIDAD EDUCATIVA IRU KKOTA",-65.36794,-18.6862,53,11,192,245,42,7,132,174
"Bolivia","Chuquisaca","Oropeza","Poroma","UNIDAD EDUCATIVA LOS ALAMOS",-65.34219,-18.87337,29,12,225,254,53,5,155,208
"Bolivia","Chuquisaca","Oropeza","Poroma","UNIDAD EDUCATIVA PALAJLA",-65.46515,-18.45122,43,3,178,221,19,9,147,166
"Bolivia","Chuquisaca","Oropeza","Poroma","UNIDAD EDUCATIVA  PANGORASI",-65.39965,-18.60243,23,4,105,128,11,2,88,99
"Bolivia","Chuquisaca","Oropeza","Poroma","UNIDAD EDUCATIVA PIOCERA",-65.40269,-18.74838,21,3,111,132,20,2,86,106
"Bolivia","Chuquisaca","Oropeza","Poroma","UNIDAD EDUCATIVA SANABRIA",-65.33897,-18.93845,21,3,185,206,60,3,119,179
"Bolivia","Chuquisaca","Oropeza","Poroma","UNIDAD EDUCATIVA SIJCHA ALTA",-65.30686,-18.92584,13,3,128,141,17,1,107,124
"Bolivia","Chuquisaca","Oropeza","Poroma","UNIDAD EDUCATIVA URUGUAYO",-65.35072,-18.61396,13,2,104,117,10,4,88,98
"Bolivia","Chuquisaca","Oropeza","Poroma","UNIDAD EDUCATIVA YANANI",-65.43656,-18.59779,23,2,191,214,12,2,175,187
"Bolivia","Chuquisaca","Oropeza","Sucre","AASANA",-65.29323,-19.01331,650,58,5298,5948,3156,242,1842,4998
"Bolivia","Chuquisaca","Oropeza","Sucre","CAMPO DEPORTIVO 20 DE OCTUBRE",-65.28734,-19.02233,101,19,955,1056,600,27,309,909
"Bolivia","Chuquisaca","Oropeza","Sucre","CARCEL PUBLICA",-65.26225,-19.05368,52,0,172,224,97,4,71,168
"Bolivia","Chuquisaca","Oropeza","Sucre","COL. BERNARDO MONTEAGUDO",-65.25573,-19.04699,168,8,1134,1302,897,65,164,1061
"Bolivia","Chuquisaca","Oropeza","Sucre","COL. CARDENAL MAURER",-65.26183,-19.05324,275,10,1884,2159,1529,36,309,1838
"Bolivia","Chuquisaca","Oropeza","Sucre","COL. DON BOSCO",-65.26269,-19.04767,232,6,1365,1597,1121,24,214,1335
"Bolivia","Chuquisaca","Oropeza","Sucre","COLEGIO 23 DE MARZO",-65.2681,-19.04329,236,6,1573,1809,1198,48,321,1519
"Bolivia","Chuquisaca","Oropeza","Sucre","COLEGIO 24 DE SEPTIEMBRE - MARAGUA",-65.4332,-19.05204,78,15,275,353,50,20,190,240
"Bolivia","Chuquisaca","Oropeza","Sucre","COLEGIO DOMINGO SABIO",-65.27417,-19.04843,271,24,1829,2100,1228,74,503,1731
"Bolivia","Chuquisaca","Oropeza","Sucre","COLEGIO FE Y ALEGRIA",-65.26789,-19.03673,534,25,3944,4478,2832,132,955,3787
"Bolivia","Chuquisaca","Oropeza","Sucre","COLEGIO JUEZ BALTAZAR GARZÓN",-65.21569,-19.0804,34,11,492,526,218,26,237,455
"Bolivia","Chuquisaca","Oropeza","Sucre","COLEGIO JUNIN",-65.25817,-19.04907,226,6,1139,1365,943,22,168,1111
"Bolivia","Chuquisaca","Oropeza","Sucre","COLEGIO SIMÓN RODRÍGUEZ",-65.25462,-19.05121,332,4,1292,1624,1051,47,190,1241
"Bolivia","Chuquisaca","Oropeza","Sucre","COL. EMILIO HOSCHMAN",-65.26781,-19.01751,606,76,4854,5460,2608,289,1881,4489
"Bolivia","Chuquisaca","Oropeza","Sucre","COLISEO JORGE REVILLA ALDANA",-65.25701,-19.03738,189,9,1172,1361,921,26,216,1137
"Bolivia","Chuquisaca","Oropeza","Sucre","COL.JORGE REVILLA",-65.25858,-19.02505,714,44,5101,5815,3476,197,1384,4860
"Bolivia","Chuquisaca","Oropeza","Sucre","COL.MARIANO SERRANO",-65.25015,-19.04412,480,17,3392,3872,2667,67,641,3308
"Bolivia","Chuquisaca","Oropeza","Sucre","COL. SAGRADO CORAZON",-65.26104,-19.04679,218,4,1015,1233,849,19,143,992
"Bolivia","Chuquisaca","Oropeza","Sucre","COL. VICTORINO VEGA",-65.23779,-19.04786,623,40,4119,4742,2706,153,1220,3926
"Bolivia","Chuquisaca","Oropeza","Sucre","ESC. ANGEL BASPINEIRO",-65.31149,-19.00419,100,34,985,1085,397,68,486,883
"Bolivia","Chuquisaca","Oropeza","Sucre","ESC. ANICETO ARCE",-65.27341,-19.06394,778,39,4055,4833,2485,209,1322,3807
"Bolivia","Chuquisaca","Oropeza","Sucre","ESC. BENJAMIN GUZMAN",-65.25764,-19.03901,181,8,1433,1614,1102,37,286,1388
"Bolivia","Chuquisaca","Oropeza","Sucre","ESC. GUIDO VILLAGOMEZ",-65.28304,-19.02838,465,42,3786,4251,2348,177,1219,3567
"Bolivia","Chuquisaca","Oropeza","Sucre","ESC. HORNO KHASA",-65.25737,-19.01756,528,52,3914,4442,2197,200,1465,3662
"Bolivia","Chuquisaca","Oropeza","Sucre","ESC. JOSEFINA GOYTIA",-65.26051,-19.05899,177,14,1511,1688,1069,37,391,1460
"Bolivia","Chuquisaca","Oropeza","Sucre","ESC. LA RECOLETA",-65.25409,-19.05475,484,24,3405,3889,2508,126,747,3255
"Bolivia","Chuquisaca","Oropeza","Sucre","ESC.MARISCAL DE AYACUCHO",-65.25534,-19.0489,89,1,583,672,507,9,66,573
"Bolivia","Chuquisaca","Oropeza","Sucre","ESC. OVANDO",-65.2598,-19.0377,111,1,728,839,564,18,145,709
"Bolivia","Chuquisaca","Oropeza","Sucre","ESC. ROBERTO ALVARADO",-65.24728,-19.03056,630,31,4423,5053,2964,155,1273,4237
"Bolivia","Chuquisaca","Oropeza","Sucre","ESC.SAGRADA FAMILIA",-65.24627,-19.0241,671,41,4774,5445,3109,251,1373,4482
"Bolivia","Chuquisaca","Oropeza","Sucre","ESC. SAN JAVIER",-65.24428,-19.04221,353,10,3014,3367,2448,64,492,2940
"Bolivia","Chuquisaca","Oropeza","Sucre","ESC. SAN JUANILLO",-65.2558,-19.0316,1119,50,7280,8399,5102,255,1873,6975
"Bolivia","Chuquisaca","Oropeza","Sucre","ESC.TALLER DE INTEGRACION ETI",-65.23871,-19.04204,132,8,1257,1389,1001,31,217,1218
"Bolivia","Chuquisaca","Oropeza","Sucre","ESCUELA ARABATE",-65.15241,-19.07256,67,2,92,159,16,3,71,87
"Bolivia","Chuquisaca","Oropeza","Sucre","ESCUELA DANIEL CALVO",-65.26105,-19.04571,93,2,653,746,540,15,96,636
"Bolivia","Chuquisaca","Oropeza","Sucre","ESCUELA ELIZARDO PEREZ",-65.20616,-19.1318,35,5,255,290,92,15,143,235
"Bolivia","Chuquisaca","Oropeza","Sucre","ESCUELA FALAFAYA",-65.2095,-18.94874,43,6,191,234,85,18,82,167
"Bolivia","Chuquisaca","Oropeza","Sucre","ESCUELA FRAY GABRIEL MARIA LANDINI",-65.12765,-18.77743,119,39,608,727,185,26,358,543
"Bolivia","Chuquisaca","Oropeza","Sucre","ESCUELA FRAY GABRIEL MARISCAL",-65.1773,-18.63784,47,5,192,239,37,12,138,175
"Bolivia","Chuquisaca","Oropeza","Sucre","ESCUELA JOSÉ SAMPA",-65.17965,-18.89784,37,4,210,247,83,9,114,197
"Bolivia","Chuquisaca","Oropeza","Sucre","ESCUELA LLINFI",-65.30132,-18.98218,50,18,429,479,193,9,209,402
"Bolivia","Chuquisaca","Oropeza","Sucre","ESCUELA PUNILLA",-65.37293,-18.95657,32,6,235,267,110,12,107,217
"Bolivia","Chuquisaca","Oropeza","Sucre","ESCUELA SECCIONAL DE CHAUNACA",-65.43951,-18.99047,43,1,294,337,46,10,237,283
"Bolivia","Chuquisaca","Oropeza","Sucre","ESCUELA TUCSUPAYA",-65.27917,-19.0231,355,33,2798,3153,1781,144,840,2621
"Bolivia","Chuquisaca","Oropeza","Sucre","ESTACIÓN DE BOMBEROS",-65.2486,-19.04844,242,4,1870,2112,1433,38,395,1828
"Bolivia","Chuquisaca","Oropeza","Sucre","ESTADIUM PATRIA",-65.25877,-19.03283,550,20,3385,3935,2507,115,743,3250
"Bolivia","Chuquisaca","Oropeza","Sucre","FAC. DERECHO",-65.24686,-19.04547,351,3,2494,2845,1981,40,470,2451
"Bolivia","Chuquisaca","Oropeza","Sucre","FACULTAD DE MEDICINA",-65.26635,-19.04619,867,20,3949,4816,3035,109,785,3820
"Bolivia","Chuquisaca","Oropeza","Sucre","FACULTAD DE TECNOLOGÍA",-65.25661,-19.03967,728,22,3834,4562,2905,76,831,3736
"Bolivia","Chuquisaca","Oropeza","Sucre","FED. DE CHOFERES",-65.24286,-19.03716,419,22,3382,3801,2495,79,786,3281
"Bolivia","Chuquisaca","Oropeza","Sucre","FUNDACION PACHAMAMA",-65.26746,-19.04067,136,9,1120,1256,849,21,241,1090
"Bolivia","Chuquisaca","Oropeza","Sucre","H. VIRGEN DE LA HIEDRA",-65.27728,-19.03624,166,18,1533,1699,1025,60,430,1455
"Bolivia","Chuquisaca","Oropeza","Sucre","IGLESIA SAN MATÍAS",-65.26208,-19.03669,388,22,2753,3141,2097,64,570,2667
"Bolivia","Chuquisaca","Oropeza","Sucre","IPTK-N.AGUIRRE 560 / CERPI",-65.25272,-19.03685,341,10,2395,2736,1845,58,482,2327
"Bolivia","Chuquisaca","Oropeza","Sucre","JARDÍN DE NIÑOS SAN LÁZARO",-65.24966,-19.05094,248,15,1764,2012,1325,37,387,1712
"Bolivia","Chuquisaca","Oropeza","Sucre","KINDER ECHEVERRIA",-65.25982,-19.05163,144,0,925,1069,793,21,111,904
"Bolivia","Chuquisaca","Oropeza","Sucre","KINDER GERARDO VACA GUZMAN",-65.26248,-19.04274,84,3,501,585,396,11,91,487
"Bolivia","Chuquisaca","Oropeza","Sucre","KINDER MUNICIPAL",-65.26814,-19.05075,223,9,1704,1927,1313,42,340,1653
"Bolivia","Chuquisaca","Oropeza","Sucre","KINDER SAN VICENTE DE PAUL",-65.25596,-19.04462,265,7,1731,1996,1413,23,288,1701
"Bolivia","Chuquisaca","Oropeza","Sucre","KINDER SERRANO",-65.24963,-19.04423,98,2,640,738,491,15,132,623
"Bolivia","Chuquisaca","Oropeza","Sucre","LICEO MARÍA JOSEFA MUJIA",-65.26344,-19.04962,276,6,1720,1996,1367,48,299,1666
"Bolivia","Chuquisaca","Oropeza","Sucre","MERCADO YURAC YURAC",-65.27402,-19.02921,184,17,1677,1861,1092,89,479,1571
"Bolivia","Chuquisaca","Oropeza","Sucre","PLAZUELA SAN MATÍAS",-65.26157,-19.03634,271,14,1758,2029,1332,41,371,1703
"Bolivia","Chuquisaca","Oropeza","Sucre","SAL. MULT. BARRIO NUEVOS HORIZONTES",-65.24062,-19.07006,81,6,728,809,436,42,244,680
"Bolivia","Chuquisaca","Oropeza","Sucre","SAL.MULT. PLANTA DIESEL",-65.27349,-19.05489,194,3,1343,1537,1029,32,279,1308
"Bolivia","Chuquisaca","Oropeza","Sucre","SALON MULT. ALTO LOYOLA",-65.25202,-19.02552,224,24,1415,1639,905,56,430,1335
"Bolivia","Chuquisaca","Oropeza","Sucre","SALON MULTIFUNCIONAL AMERICA",-65.26705,-19.0604,176,21,1204,1380,737,47,399,1136
"Bolivia","Chuquisaca","Oropeza","Sucre","SALON MULTIFUNCIONAL EL ABRA",-65.24494,-19.06586,331,25,2380,2711,1506,98,751,2257
"Bolivia","Chuquisaca","Oropeza","Sucre","SALON MULTIFUNCIONAL EL NIÑO",-65.28127,-19.01439,61,4,533,594,395,10,124,519
"Bolivia","Chuquisaca","Oropeza","Sucre","SALON MULTIFUNCIONAL LA HOYADA",-65.26664,-19.05572,130,8,756,886,515,18,215,730
"Bolivia","Chuquisaca","Oropeza","Sucre","SALON MULTIFUNCIONAL PEDRO MEDRANO",-65.23917,-19.02556,19,2,319,338,189,10,118,307
"Bolivia","Chuquisaca","Oropeza","Sucre","SALON MULTIFUNCIONAL SAN FRANCISCO",-65.25436,-19.05559,113,5,1082,1195,826,28,223,1049
"Bolivia","Chuquisaca","Oropeza","Sucre","SALÓN MULTIFUNCIONAL SAN JUAN CACHIMAYU",-65.30952,-19.08966,7,2,132,139,62,3,65,127
"Bolivia","Chuquisaca","Oropeza","Sucre","SEMINARIO TEOLOGICO DEL SUR",-65.25397,-19.03208,322,16,2383,2705,1665,91,611,2276
"Bolivia","Chuquisaca","Oropeza","Sucre","TERMINAL DE BUSES",-65.24707,-19.0392,569,21,3822,4391,2986,73,742,3728
"Bolivia","Chuquisaca","Oropeza","Sucre","U.ED.FRANCISCO CERMEÑO",-65.25917,-19.02858,293,13,2239,2532,1692,49,485,2177
"Bolivia","Chuquisaca","Oropeza","Sucre","U. EDU. GUALBERTO VILLARROEL",-65.53341,-19.0159,157,24,846,1003,235,58,529,764
"Bolivia","Chuquisaca","Oropeza","Sucre","U.E. GASTÓN VILAR CASSO",-65.28537,-19.01114,35,8,639,674,370,38,223,593
"Bolivia","Chuquisaca","Oropeza","Sucre","U.E. LAS AMERICAS",-65.25094,-19.01372,664,53,4428,5092,2729,209,1437,4166
"Bolivia","Chuquisaca","Oropeza","Sucre","UNIDAD EDUCATIVA 6 DE JUNIO",-65.26705,-19.02696,635,59,4275,4910,2651,193,1372,4023
"Bolivia","Chuquisaca","Oropeza","Sucre","UNIDAD EDUCATIVA ALBERTO BOHORQUEZ",-65.29878,-19.02849,97,38,987,1084,397,72,480,877
"Bolivia","Chuquisaca","Oropeza","Sucre","UNIDAD EDUCATIVA ALEGRÍA",-65.27406,-18.99063,182,36,1414,1596,604,79,695,1299
"Bolivia","Chuquisaca","Oropeza","Sucre","UNIDAD EDUCATIVA CANTU MOLINO",-65.23275,-18.86053,30,3,154,184,36,5,110,146
"Bolivia","Chuquisaca","Oropeza","Sucre","UNIDAD EDUCATIVA CHUQUI CHUQUI",-65.1201,-18.82506,77,30,472,549,149,21,272,421
"Bolivia","Chuquisaca","Oropeza","Sucre","UNIDAD EDUCATIVA LA BARRANCA",-65.31851,-18.97461,40,12,451,491,189,24,226,415
"Bolivia","Chuquisaca","Oropeza","Sucre","UNIDAD EDUCATIVA LA PALMA",-65.12672,-18.95262,105,31,554,659,166,20,337,503
"Bolivia","Chuquisaca","Oropeza","Sucre","UNIDAD EDUCATIVA LUIS ESPINAL",-65.11092,-18.89592,58,8,457,515,184,15,250,434
"Bolivia","Chuquisaca","Oropeza","Sucre","UNIDAD EDUCATIVA QUILA QUILA",-65.377,-19.11972,126,20,454,580,183,38,213,396
"Bolivia","Chuquisaca","Oropeza","Sucre","UNIDAD EDUCATIVA RUFFO",-65.2886,-19.05783,61,17,648,709,311,33,287,598
"Bolivia","Chuquisaca","Oropeza","Sucre","UNIDAD EDUCATIVA SIMÓN BOLIVAR LA PALCA",-65.24233,-18.62139,27,1,95,122,21,3,70,91
"Bolivia","Chuquisaca","Oropeza","Sucre","UNIDAD EDUCATIVA SOICO",-65.26456,-18.81216,39,5,103,142,15,4,79,94
"Bolivia","Chuquisaca","Oropeza","Sucre","UNID. ED. HUGO POPPE ENTRAMBASAGUAS",-65.23246,-19.05145,390,39,2913,3303,1971,127,776,2747
"Bolivia","Chuquisaca","Oropeza","Sucre","UNID. ED. JOSE CLEMENTE MAURER",-65.23655,-19.08533,400,62,3216,3616,1716,122,1316,3032
"Bolivia","Chuquisaca","Oropeza","Sucre","UNID.EDUCATIVA VICTORIA DIEZ",-65.30588,-19.00942,689,137,5227,5916,2478,333,2279,4757
"Bolivia","Chuquisaca","Oropeza","Sucre","U.PEDAG.MARISCAL SUCRE",-65.26093,-19.03903,155,4,920,1075,743,21,152,895
"Bolivia","Chuquisaca","Oropeza","Yotala","CASA POSADA DE HUAYLLAS",-65.32174,-19.15824,63,6,188,251,34,8,140,174
"Bolivia","Chuquisaca","Oropeza","Yotala","CENTRO EDUCATIVO SANTA ROSA",-65.26758,-19.16187,184,8,887,1071,420,55,404,824
"Bolivia","Chuquisaca","Oropeza","Yotala","COLEGIO GREGORIO PACHECO",-65.26525,-19.16197,192,25,1040,1232,415,30,570,985
"Bolivia","Chuquisaca","Oropeza","Yotala","COLEGIO SAN ISIDRO DE ANFAYA",-65.21962,-19.25604,46,5,317,363,44,11,257,301
"Bolivia","Chuquisaca","Oropeza","Yotala","COLEGIO TASA PAMPA",-65.25967,-19.30862,22,2,200,222,11,4,183,194
"Bolivia","Chuquisaca","Oropeza","Yotala","ESCUELA ANTONIO TOVAR HINOJOSA",-65.17021,-19.30317,31,4,224,255,60,7,153,213
"Bolivia","Chuquisaca","Oropeza","Yotala","ESCUELA TIPAKA",-65.3103,-19.26145,18,0,133,151,25,6,102,127
"Bolivia","Chuquisaca","Oropeza","Yotala","POSTA DE SALUD Y SALÓN DE LA COMUNIDAD",-65.1908,-19.24057,17,0,132,149,14,3,115,129
"Bolivia","Chuquisaca","Oropeza","Yotala","UNIDAD EDUCATIVA CAMPANARIO",-65.26763,-19.10636,13,2,151,164,73,7,69,142
"Bolivia","Chuquisaca","Oropeza","Yotala","UNIDAD EDUCATIVA GERMAN BUSCH",-65.28329,-19.20276,37,3,188,225,71,5,109,180
"Bolivia","Chuquisaca","Oropeza","Yotala","UNIDAD EDUCATIVA JOSÉ VILLEGAS",-65.29339,-19.1495,16,0,135,151,29,4,102,131
"Bolivia","Chuquisaca","Oropeza","Yotala","UNIDAD EDUCATIVA TUERO CHICO",-65.21132,-19.33957,11,1,96,107,17,1,77,94
"Bolivia","Chuquisaca","Oropeza","Yotala","UNIDAD EDUCATIVA VICTOR SANDI",-65.24226,-19.15815,48,3,348,396,129,18,198,327
"Bolivia","Chuquisaca","Sur Cinti","Camataqui (Villa Abecia)","U. EDU. DANIEL SANCHEZ BUSTAMANTE",-65.2789,-21.0675,17,0,86,103,29,11,46,75
"Bolivia","Chuquisaca","Sur Cinti","Camataqui (Villa Abecia)","UNIDAD EDUCATIVA 23 DE MARZO",-65.23078,-20.97539,222,23,810,1032,282,49,456,738
"Bolivia","Chuquisaca","Sur Cinti","Camataqui (Villa Abecia)","UNIDAD EDUCATIVA 2 DE AGOSTO",-65.36425,-21.02694,24,4,116,140,6,0,106,112
"Bolivia","Chuquisaca","Sur Cinti","Camataqui (Villa Abecia)","UNIDAD EDUCATIVA ACHUMA",-65.3415,-20.9139,6,2,89,95,8,6,73,81
"Bolivia","Chuquisaca","Sur Cinti","Camataqui (Villa Abecia)","UNIDAD EDUCATIVA JAILIA",-65.27052,-20.93037,16,5,120,136,33,10,72,105
"Bolivia","Chuquisaca","Sur Cinti","Camataqui (Villa Abecia)","UNIDAD EDUCATIVA TARCANA",-65.26554,-21.0909,15,0,47,62,10,3,34,44
"Bolivia","Chuquisaca","Sur Cinti","Culpina","ESCUELA CAÑON VERDE",-64.23112,-21.13576,12,0,72,84,47,2,23,70
"Bolivia","Chuquisaca","Sur Cinti","Culpina","ESCUELA EL MANZANAL",-64.4059,-21.0985,45,1,59,104,7,0,51,58
"Bolivia","Chuquisaca","Sur Cinti","Culpina","U. EDU. JOSE ANTONIO ZAMPA",-64.94446,-20.8238,768,89,2870,3638,1084,121,1576,2660
"Bolivia","Chuquisaca","Sur Cinti","Culpina","UNIDAD EDUCATIVA EL CAMPAMENTO",-64.51948,-20.90218,45,2,132,177,29,2,99,128
"Bolivia","Chuquisaca","Sur Cinti","Culpina","UNIDAD EDUCATIVA EL MONTE",-64.91585,-21.00441,59,8,291,350,75,29,179,254
"Bolivia","Chuquisaca","Sur Cinti","Culpina","UNIDAD EDUCATIVA EL PALMAR",-64.31755,-20.85209,100,14,435,535,212,35,174,386
"Bolivia","Chuquisaca","Sur Cinti","Culpina","UNIDAD EDUCATIVA HUAJLITA",-64.60419,-20.82584,45,1,141,186,14,7,119,133
"Bolivia","Chuquisaca","Sur Cinti","Culpina","UNIDAD EDUCATIVA LA CIENEGA",-64.96812,-20.9327,15,1,59,74,24,5,29,53
"Bolivia","Chuquisaca","Sur Cinti","Culpina","UNIDAD EDUCATIVA LA CUEVA",-64.88244,-20.9315,45,3,158,203,21,6,128,149
"Bolivia","Chuquisaca","Sur Cinti","Culpina","UNIDAD EDUCATIVA LA LOMA",-64.72974,-20.85919,72,4,107,179,0,7,96,96
"Bolivia","Chuquisaca","Sur Cinti","Culpina","UNIDAD EDUCATIVA PILAYA",-64.689,-20.94015,36,7,57,93,14,2,34,48
"Bolivia","Chuquisaca","Sur Cinti","Culpina","UNIDAD EDUCATIVA PUCA LAJA",-64.64645,-20.77685,4,0,37,41,4,2,31,35
"Bolivia","Chuquisaca","Sur Cinti","Culpina","UNIDAD EDUCATIVA PUCA PAMPA",-64.5965,-20.77545,74,3,238,312,35,25,175,210
"Bolivia","Chuquisaca","Sur Cinti","Culpina","UNIDAD EDUCATIVA PUMA CKASA",-64.6648,-20.74907,64,1,87,151,12,6,68,80
"Bolivia","Chuquisaca","Sur Cinti","Culpina","UNIDAD EDUCATIVA SAJLINA",-64.99879,-20.80951,113,18,456,569,132,47,259,391
"Bolivia","Chuquisaca","Sur Cinti","Culpina","UNIDAD EDUCATIVA SALITRE",-64.90742,-20.90935,19,4,82,101,14,1,63,77
"Bolivia","Chuquisaca","Sur Cinti","Culpina","UNIDAD EDUCATIVA SAN FRANCISCO",-64.7111,-20.75573,54,7,78,132,16,4,51,67
"Bolivia","Chuquisaca","Sur Cinti","Culpina","UNIDAD EDUCATIVA SUMAYA",-64.78716,-20.75736,63,5,96,159,25,7,59,84
"Bolivia","Chuquisaca","Sur Cinti","Culpina","UNIDAD EDUCATIVA TOJLASA",-64.91499,-20.85254,91,12,367,458,103,31,221,324
"Bolivia","Chuquisaca","Sur Cinti","Las Carreras (Las carretas)","ESCUELA EL MONTE DE SANDOVAL",-65.21051,-21.16683,31,3,124,155,12,5,104,116
"Bolivia","Chuquisaca","Sur Cinti","Las Carreras (Las carretas)","ESCUELA MONTE DE TARAYA",-65.35029,-21.47675,8,0,24,32,0,0,24,24
"Bolivia","Chuquisaca","Sur Cinti","Las Carreras (Las carretas)","ESCUELA SOCPORA",-65.23065,-21.35275,3,2,47,50,16,3,26,42
"Bolivia","Chuquisaca","Sur Cinti","Las Carreras (Las carretas)","UNIDAD EDUCATIVA IMPORA",-65.27929,-21.36126,20,2,99,119,21,3,73,94
"Bolivia","Chuquisaca","Sur Cinti","Las Carreras (Las carretas)","UNIDAD EDUCATIVA JAIME MENDOZA",-65.21003,-21.2103,96,6,441,537,144,23,268,412
"Bolivia","Chuquisaca","Sur Cinti","Las Carreras (Las carretas)","UNIDAD EDUCATIVA LA TORRE",-65.2924,-21.2021,25,3,104,129,18,2,81,99
"Bolivia","Chuquisaca","Sur Cinti","Las Carreras (Las carretas)","UNIDAD EDUCATIVA LIME",-65.2624,-21.2043,42,1,160,202,18,3,138,156
"Bolivia","Chuquisaca","Sur Cinti","Las Carreras (Las carretas)","UNIDAD EDUCATIVA SAN JUAN",-65.21146,-21.21964,16,6,132,148,39,6,81,120
"Bolivia","Chuquisaca","Sur Cinti","Las Carreras (Las carretas)","UNIDAD EDUCATIVA SANTA ROSA",-65.22454,-21.32046,13,1,75,88,18,4,52,70
"Bolivia","Chuquisaca","Sur Cinti","Las Carreras (Las carretas)","UNIDAD EDUCATIVA TARAYA",-65.24155,-21.42857,8,0,95,103,32,5,58,90
"Bolivia","Chuquisaca","Tomina","El Villar","COLEGIO EDUARDO ABAROA",-64.31137,-19.6299,199,24,734,933,203,34,473,676
"Bolivia","Chuquisaca","Tomina","El Villar","ESCUELA SECCIONAL LA REVUELTA",-64.19889,-19.82226,65,8,435,500,106,19,302,408
"Bolivia","Chuquisaca","Tomina","El Villar","U.E. BARBECHOS",-64.29641,-19.5529,6,3,100,106,19,0,78,97
"Bolivia","Chuquisaca","Tomina","El Villar","UNIDAD EDUCATIVA EL DORADO",-64.3289,-19.79042,35,8,220,255,16,8,188,204
"Bolivia","Chuquisaca","Tomina","El Villar","UNIDAD EDUCATIVA SAN BLAS",-64.39065,-19.63341,38,0,135,173,7,5,123,130
"Bolivia","Chuquisaca","Tomina","Padilla","COLEGIO SAN PIO X",-64.3012,-19.30634,275,29,1520,1795,571,43,877,1448
"Bolivia","Chuquisaca","Tomina","Padilla","ESCUELA MANUEL A. PADILLA",-64.30116,-19.30746,292,35,1627,1919,606,59,927,1533
"Bolivia","Chuquisaca","Tomina","Padilla","NUCLEO ESCOLAR ADRIÁN MOYA TAPIA",-64.14172,-19.33275,103,2,235,338,47,4,182,229
"Bolivia","Chuquisaca","Tomina","Padilla","NUCLEO ESCOLAR HUMBERTO DELGADILLO",-64.1024,-19.56468,66,12,385,451,68,25,280,348
"Bolivia","Chuquisaca","Tomina","Padilla","U.E. CACIANO RODAS CARDENAS",-64.0046,-19.2876,19,0,90,109,15,2,73,88
"Bolivia","Chuquisaca","Tomina","Padilla","U.E. FRANZ TAMAYO",-64.23646,-19.50273,17,0,70,87,4,2,64,68
"Bolivia","Chuquisaca","Tomina","Padilla","U.E. MARISCAL SUCRE",-64.2164,-19.37816,15,1,75,90,18,7,49,67
"Bolivia","Chuquisaca","Tomina","Padilla","UNIDAD EDUCATIVA 29 DE MARZO",-64.21652,-19.24916,10,1,39,49,7,3,28,35
"Bolivia","Chuquisaca","Tomina","Padilla","UNIDAD EDUCATIVA 2 DE ABRIL LA CIENEGA",-64.29996,-19.21987,51,5,233,284,29,12,187,216
"Bolivia","Chuquisaca","Tomina","Padilla","UNIDAD EDUCATIVA SUSANA DURAN",-64.00618,-19.42285,16,4,85,101,17,3,61,78
"Bolivia","Chuquisaca","Tomina","Padilla","UNIDAD EDUCATIVA TELEMINA BARJA",-64.175,-19.4771,51,8,206,257,29,8,161,190
"Bolivia","Chuquisaca","Tomina","Sopachuy","COLEGIO 25 DE MAYO",-64.47521,-19.48693,125,12,529,654,169,20,328,497
"Bolivia","Chuquisaca","Tomina","Sopachuy","ESCUELA JUAN BOSING",-64.47478,-19.48648,155,18,740,895,228,44,450,678
"Bolivia","Chuquisaca","Tomina","Sopachuy","ESCUELA SIPICANI",-64.57142,-19.43305,28,1,230,258,13,3,213,226
"Bolivia","Chuquisaca","Tomina","Sopachuy","INTERNADO SANTA ROSA DE AMANCAYA",-64.55762,-19.32515,88,6,451,539,25,7,413,438
"Bolivia","Chuquisaca","Tomina","Sopachuy","U.E. PAMPAS PUNTA",-64.4611,-19.41523,9,0,143,152,23,6,114,137
"Bolivia","Chuquisaca","Tomina","Sopachuy","U.E. PASLAPAYA",-64.51927,-19.42884,3,1,109,112,2,5,101,103
"Bolivia","Chuquisaca","Tomina","Sopachuy","U.E. SAN JUAN DE HORCAS",-64.51885,-19.46673,8,1,123,131,5,3,114,119
"Bolivia","Chuquisaca","Tomina","Sopachuy","UNIDAD EDUCATIVA MAMA HUASI",-64.62706,-19.33403,2,0,176,178,1,1,174,175
"Bolivia","Chuquisaca","Tomina","Sopachuy","UNIDAD EDUCATIVA PAMPAS DEL CARMEN",-64.4129,-19.54599,30,1,108,138,7,3,97,104
"Bolivia","Chuquisaca","Tomina","Sopachuy","UNIDAD EDUCATIVA SECCIONAL MILANES",-64.47321,-19.5312,9,0,70,79,9,3,58,67
"Bolivia","Chuquisaca","Tomina","Tomina","ESCUELA LORENZO CATALA",-64.58754,-19.05812,36,4,288,324,35,13,236,271
"Bolivia","Chuquisaca","Tomina","Tomina","ESCUELA SIMÓN RODRIGUEZ",-64.47535,-19.35414,110,10,526,636,98,36,382,480
"Bolivia","Chuquisaca","Tomina","Tomina","U.E. ANTOFAGASTA",-64.44697,-19.25202,12,10,272,284,42,15,205,247
"Bolivia","Chuquisaca","Tomina","Tomina","U. E. SECCIONAL FAUSTINO SUAREZ",-64.56383,-19.18622,73,1,256,329,11,6,238,249
"Bolivia","Chuquisaca","Tomina","Tomina","UNIDAD EDUCATIVA EDUARDO AVAROA",-64.46201,-19.18713,294,35,1314,1608,393,58,828,1221
"Bolivia","Chuquisaca","Tomina","Tomina","UNIDAD EDUCATIVA KAWASIRI",-64.41315,-19.14396,12,2,74,86,11,3,58,69
"Bolivia","Chuquisaca","Tomina","Tomina","UNIDAD EDUCATIVA SECCIONAL FUERTE RUA",-64.49466,-19.24193,26,1,211,237,3,5,202,205
"Bolivia","Chuquisaca","Tomina","Tomina","UNIDAD EDUCATIVA VILLA FLORES",-64.55251,-19.30332,9,1,101,110,11,3,86,97
"Bolivia","Chuquisaca","Tomina","Tomina","UNIDA EDUCATIVA PUCARA",-64.5126,-19.05801,14,3,149,163,24,5,117,141
"Bolivia","Chuquisaca","Tomina","Villa Alcalá","ESCUELA OSCAR ALFARO",-64.33492,-19.5059,208,3,309,517,47,16,243,290
"Bolivia","Chuquisaca","Tomina","Villa Alcalá","UNIDAD EDUCATIVA ALCALA",-64.38977,-19.36522,167,22,880,1047,283,35,540,823
"Bolivia","Chuquisaca","Yamparaez","Tarabuco","COLEGIO ANICETO ARCE",-64.91212,-19.18131,337,49,1413,1750,469,95,800,1269
"Bolivia","Chuquisaca","Yamparaez","Tarabuco","COLEGIO NACIONAL MIXTO BOLIVIA",-64.90345,-19.06883,129,8,490,619,167,25,290,457
"Bolivia","Chuquisaca","Yamparaez","Tarabuco","COLEGIO PAMPA LUPIARA",-64.78364,-19.25895,131,10,523,654,170,14,329,499
"Bolivia","Chuquisaca","Yamparaez","Tarabuco","ESCUELA ALFREDO MARTINEZ RODAS",-64.86771,-19.02727,25,2,207,232,26,7,172,198
"Bolivia","Chuquisaca","Yamparaez","Tarabuco","ESCUELA COLLACAMANI",-64.90224,-19.25274,85,8,217,302,43,6,160,203
"Bolivia","Chuquisaca","Yamparaez","Tarabuco","ESCUELA GUSTAVO VALDIVIA DE PAJCHA",-65.03048,-18.97762,113,11,380,493,73,14,282,355
"Bolivia","Chuquisaca","Yamparaez","Tarabuco","ESCUELA TUNAS CHILLCA",-64.95135,-19.17794,42,4,164,206,9,3,148,157
"Bolivia","Chuquisaca","Yamparaez","Tarabuco","U. ED. SAN ANTONIO DE TOCA",-64.93372,-19.00779,9,1,119,128,23,5,90,113
"Bolivia","Chuquisaca","Yamparaez","Tarabuco","U. EDU. JAIME VILLA ZAMORA",-64.91453,-19.05788,46,18,312,358,74,8,212,286
"Bolivia","Chuquisaca","Yamparaez","Tarabuco","U. EDU. ROSALIA VDA. DE ANTEZANA",-64.91234,-19.18218,327,57,1488,1815,435,70,926,1361
"Bolivia","Chuquisaca","Yamparaez","Tarabuco","U. EDU. SALVADOR GÓMEZ RODRIGUEZ",-64.76074,-19.27787,46,7,166,212,21,10,128,149
"Bolivia","Chuquisaca","Yamparaez","Tarabuco","U. EDU. SAN JOSÉ DEL PAREDON",-64.83658,-19.25209,80,10,318,398,39,12,257,296
"Bolivia","Chuquisaca","Yamparaez","Tarabuco","UNIDAD EDUCATIVA CAYAMBUCO",-64.86732,-19.09398,22,1,162,184,12,10,139,151
"Bolivia","Chuquisaca","Yamparaez","Tarabuco","UNIDAD EDUCATIVA EL CARMEN",-64.99706,-19.06575,34,2,194,228,14,3,175,189
"Bolivia","Chuquisaca","Yamparaez","Tarabuco","UNIDAD EDUCATIVA LA CIENEGA",-64.99545,-19.15368,112,11,323,435,57,15,240,297
"Bolivia","Chuquisaca","Yamparaez","Tarabuco","UNIDAD EDUCATIVA SARUFAYA",-64.80127,-19.1101,56,10,254,310,32,5,207,239
"Bolivia","Chuquisaca","Yamparaez","Yamparez","COLEGIO ANA LEON DE HUASA CANCHA",-65.04116,-19.17783,72,3,319,391,45,15,256,301
"Bolivia","Chuquisaca","Yamparaez","Yamparez","COLEGIO GERARDO RIOS",-65.07349,-19.25555,77,9,360,437,89,12,250,339
"Bolivia","Chuquisaca","Yamparaez","Yamparez","ESCUELA EDUARDO SEMPERTEGUI",-65.11996,-19.18805,228,38,895,1123,329,58,470,799
"Bolivia","Chuquisaca","Yamparaez","Yamparez","ESCUELA JATUN CKAKA",-65.00366,-19.28829,39,7,213,252,8,4,194,202
"Bolivia","Chuquisaca","Yamparaez","Yamparez","U.E. PATA LLAJTA",-65.07769,-19.11113,4,2,103,107,13,4,84,97
"Bolivia","Chuquisaca","Yamparaez","Yamparez","UNIDAD EDUCATIVA CARAMA",-65.05508,-19.33958,17,1,147,164,10,4,132,142
"Bolivia","Chuquisaca","Yamparaez","Yamparez","UNIDAD EDUCATIVA PULKI AVAROA",-65.12865,-19.24094,124,16,473,597,92,20,345,437
"Bolivia","Chuquisaca","Yamparaez","Yamparez","UNIDAD EDUCATIVA SAJPAYA",-65.12679,-19.15392,21,10,372,393,32,21,309,341
"Bolivia","Chuquisaca","Yamparaez","Yamparez","UNIDAD EDUCATIVA SOTOMAYOR",-64.99535,-19.3425,106,5,620,726,146,21,448,594
"Bolivia","Chuquisaca","Zudáñez","Icla (Ricardo Mujia)","COLEGIO ANTONIO JOSÉ DE SUCRE",-64.79297,-19.36361,153,14,586,739,155,23,394,549
"Bolivia","Chuquisaca","Zudáñez","Icla (Ricardo Mujia)","COLEGIO ELIZARDO PEREZ",-64.78985,-19.29836,93,11,380,473,121,13,235,356
"Bolivia","Chuquisaca","Zudáñez","Icla (Ricardo Mujia)","COLEGIO ROSENDO LA FUENTE",-64.8336,-19.44706,192,0,66,258,10,0,56,66
"Bolivia","Chuquisaca","Zudáñez","Icla (Ricardo Mujia)","ESCUELA CANTAR GALLO",-64.69359,-19.51735,37,3,125,162,20,2,100,120
"Bolivia","Chuquisaca","Zudáñez","Icla (Ricardo Mujia)","ESCUELA JATUN MAYU",-64.72372,-19.40604,27,3,213,240,30,1,179,209
"Bolivia","Chuquisaca","Zudáñez","Icla (Ricardo Mujia)","ESCUELA RODEO",-64.73968,-19.44641,18,0,198,216,10,1,187,197
"Bolivia","Chuquisaca","Zudáñez","Icla (Ricardo Mujia)","ESCUELA SAN JACINTO",-64.7461,-19.32193,31,2,331,362,45,6,278,323
"Bolivia","Chuquisaca","Zudáñez","Icla (Ricardo Mujia)","ESCUELA SANTA LUCIA",-64.72717,-19.56465,27,0,69,96,11,0,58,69
"Bolivia","Chuquisaca","Zudáñez","Icla (Ricardo Mujia)","ESCUELA SUMALA",-64.78291,-19.63519,33,1,93,126,8,1,83,91
"Bolivia","Chuquisaca","Zudáñez","Icla (Ricardo Mujia)","ESCUELA THACO PAMPA",-64.7289,-19.38551,37,2,253,290,19,5,227,246
"Bolivia","Chuquisaca","Zudáñez","Icla (Ricardo Mujia)","U. EDU. SECCIONAL CHUNCA CANCHA BAJA",-64.69682,-19.58073,70,7,299,369,23,10,259,282
"Bolivia","Chuquisaca","Zudáñez","Icla (Ricardo Mujia)","UNIDAD EDUCATIVA SOROMA",-64.82072,-19.50851,18,0,140,158,3,2,135,138
"Bolivia","Chuquisaca","Zudáñez","Presto","ESCUELA ELISARDO PEREZ",-64.94286,-18.77106,85,13,304,389,88,13,190,278
"Bolivia","Chuquisaca","Zudáñez","Presto","ESCUELA JOSÉ MARÍA MARTÍNEZ",-64.87681,-18.74306,220,10,560,780,110,50,390,500
"Bolivia","Chuquisaca","Zudáñez","Presto","PUESTO DE SALUD PUNO KHASA",-64.80189,-18.89501,37,4,146,183,51,7,84,135
"Bolivia","Chuquisaca","Zudáñez","Presto","UNIDAD EDUCATIVA EL PALMAR",-64.9127,-18.6944,10,5,137,147,14,17,101,115
"Bolivia","Chuquisaca","Zudáñez","Presto","UNIDAD EDUCATIVA RICARDO MUJIA",-64.93723,-18.92988,316,35,1108,1424,340,52,681,1021
"Bolivia","Chuquisaca","Zudáñez","Presto","UNIDAD EDUCATIVA TOMOROCO",-64.88657,-18.97326,95,15,351,446,121,15,200,321
"Bolivia","Chuquisaca","Zudáñez","Villa Mojocoya","COLEGIO FRANZ TAMAYO",-64.61874,-18.83001,397,40,1850,2247,610,54,1146,1756
"Bolivia","Chuquisaca","Zudáñez","Villa Mojocoya","ESCUELA GUADALUPE",-64.56116,-18.9363,46,5,238,284,49,5,179,228
"Bolivia","Chuquisaca","Zudáñez","Villa Mojocoya","ESCUELA HILARION VIDES CHOQUE",-64.73502,-18.61781,39,4,237,276,26,2,205,231
"Bolivia","Chuquisaca","Zudáñez","Villa Mojocoya","ESCUELA JAIME MENDOZA",-64.51095,-18.87217,28,2,116,144,25,2,87,112
"Bolivia","Chuquisaca","Zudáñez","Villa Mojocoya","ESCUELA JORGE ANIBARRO ZAPATA",-64.62067,-18.91616,18,4,116,134,21,3,88,109
"Bolivia","Chuquisaca","Zudáñez","Villa Mojocoya","UNIDAD EDUCATIVA EDUARDO AVAROA",-64.61971,-18.76382,59,3,195,254,76,8,108,184
"Bolivia","Chuquisaca","Zudáñez","Villa Zudañez (Tacopaya)","COL. IGNACIO PRUDENCIO BUSTILLOS",-64.70309,-19.11358,254,40,1389,1643,280,46,1023,1303
"Bolivia","Chuquisaca","Zudáñez","Villa Zudañez (Tacopaya)","COL. JAIME DE ZUDAÑEZ",-64.70162,-19.11868,183,21,944,1127,244,41,638,882
"Bolivia","Chuquisaca","Zudáñez","Villa Zudañez (Tacopaya)","ESCUELA MANDINGA",-64.69581,-19.25081,25,4,142,167,11,9,118,129
"Bolivia","Chuquisaca","Zudáñez","Villa Zudañez (Tacopaya)","ESCUELA SAYAN CHACA",-64.63419,-19.24422,41,5,224,265,18,8,193,211
"Bolivia","Chuquisaca","Zudáñez","Villa Zudañez (Tacopaya)","UNIDAD EDUCATIVA CAPILLA LLAVE",-64.70795,-18.98042,36,0,69,105,1,1,67,68
"Bolivia","Chuquisaca","Zudáñez","Villa Zudañez (Tacopaya)","UNIDAD EDUCATIVA HUACA HUASI",-64.78075,-18.98111,14,2,141,155,14,1,124,138
"Bolivia","Cochabamba","Arani","Arani","ESCUELA GUALBERTO VILLARROEL",-65.77542,-17.57345,361,59,2584,2945,907,108,1510,2417
"Bolivia","Cochabamba","Arani","Arani","ESCUELA MIXTA POCOATA",-65.72654,-17.60998,82,16,385,467,86,21,262,348
"Bolivia","Cochabamba","Arani","Arani","LICEO DE SEÑORITAS ARANI",-65.77344,-17.57311,374,52,2410,2784,1009,80,1269,2278
"Bolivia","Cochabamba","Arani","Arani","UNIDAD EDUCATIVA COLLPACIACO",-65.76109,-17.60128,103,18,505,608,116,26,345,461
"Bolivia","Cochabamba","Arani","Vacas","ESCUELA EXPERIMENTAL VACAS",-65.58172,-17.57544,371,73,2590,2961,349,95,2073,2422
"Bolivia","Cochabamba","Arani","Vacas","ESCUELA SECCIONAL RODEO A",-65.63733,-17.6298,111,68,926,1037,90,26,742,832
"Bolivia","Cochabamba","Arani","Vacas","U.E. DAVID MORATO CAÑADAS",-65.64141,-17.53415,30,26,517,547,56,21,414,470
"Bolivia","Cochabamba","Arani","Vacas","UNIDAD EDUCATIVA TOTORAPAMPA",-65.55066,-17.67862,16,5,210,226,14,1,190,204
"Bolivia","Cochabamba","Arque","Arque","ESCUELA E INTERNADO DARIO ANTEZANA V.",-66.29219,-17.94894,98,1,548,646,7,22,518,525
"Bolivia","Cochabamba","Arque","Arque","ESCUELA JUANA AZURDUY - PONGO K'ASA",-66.55169,-17.71174,84,21,375,459,45,25,284,329
"Bolivia","Cochabamba","Arque","Arque","ESCUELA MARCELO QUIROGA SANTA CRUZ",-66.39861,-17.90448,172,11,638,810,65,54,508,573
"Bolivia","Cochabamba","Arque","Arque","ESCUELA NATANIEL AGUIRRE",-66.40426,-17.8204,145,24,746,891,82,32,608,690
"Bolivia","Cochabamba","Arque","Arque","U.E. SAN PEDRO",-66.41895,-17.85651,54,11,193,247,14,3,165,179
"Bolivia","Cochabamba","Arque","Arque","UNIDAD EDUCATIVA CHANGOLLA",-66.46826,-17.77408,26,4,298,324,11,6,277,288
"Bolivia","Cochabamba","Arque","Arque","UNIDAD EDUCATIVA HUAYCHA",-66.32418,-17.89401,24,2,321,345,9,12,298,307
"Bolivia","Cochabamba","Arque","Arque","UNIDAD ESCOLAR TUPAC KATARI - TARUJAYÑA",-66.47985,-17.69246,32,7,445,477,38,13,387,425
"Bolivia","Cochabamba","Arque","Tacopaya","ESCUELA ADOLFO MERCADO",-66.53604,-17.83581,114,22,1030,1144,120,40,848,968
"Bolivia","Cochabamba","Arque","Tacopaya","ESCUELA ELIZARDO PEREZ (TOTORAPAMPA)",-66.61689,-17.88263,66,11,713,779,67,50,585,652
"Bolivia","Cochabamba","Arque","Tacopaya","ESCUELA MARTIN CARDENAS (TUJUTA)",-66.73995,-17.71179,55,3,277,332,25,11,238,263
"Bolivia","Cochabamba","Arque","Tacopaya","ESCUELA SECCIONAL RENE BARRIENTOS",-66.67029,-17.79752,95,15,473,568,61,29,368,429
"Bolivia","Cochabamba","Arque","Tacopaya","ESCUELA VICENTE DONOSO (AGUAS CALIENTES)",-66.6131,-17.82217,35,5,327,362,29,11,282,311
"Bolivia","Cochabamba","Arque","Tacopaya","UNIDAD EDUCATIVA ANICETO ARCE",-66.5975,-17.76939,68,4,290,358,29,21,236,265
"Bolivia","Cochabamba","Arque","Tacopaya","UNIDAD EDUCATIVA AUQUIPAMPA",-66.53737,-17.78284,48,1,523,571,33,17,472,505
"Bolivia","Cochabamba","Arque","Tacopaya","UNIDAD EDUCATIVA MICHAYANI GRANDE",-66.70185,-17.86216,47,0,225,272,12,12,201,213
"Bolivia","Cochabamba","Ayopaya","Ayopaya (Villa de Independencia)","COLEGIO CHAMACOMA",-66.70333,-17.40771,95,6,474,569,67,24,377,444
"Bolivia","Cochabamba","Ayopaya","Ayopaya (Villa de Independencia)","COLEGIO SIMON BOLIVAR FE Y ALEGRIA",-66.81453,-17.38495,230,39,2038,2268,502,89,1408,1910
"Bolivia","Cochabamba","Ayopaya","Ayopaya (Villa de Independencia)","ESCUELA MARIANO BAPTISTA (CALCHANI)",-66.69013,-17.32464,101,19,641,742,33,51,538,571
"Bolivia","Cochabamba","Ayopaya","Ayopaya (Villa de Independencia)","U.E. JOSE MIGUEL LANZA",-66.82125,-17.08193,508,67,2313,2821,498,138,1610,2108
"Bolivia","Cochabamba","Ayopaya","Ayopaya (Villa de Independencia)","UNIDAD EDUCATIVA CHAPISUYO A",-66.62987,-17.35943,100,13,619,719,42,24,540,582
"Bolivia","Cochabamba","Ayopaya","Ayopaya (Villa de Independencia)","UNIDAD EDUCATIVA CHARAHUAYTU",-66.79765,-17.26413,161,45,1018,1179,167,52,754,921
"Bolivia","Cochabamba","Ayopaya","Ayopaya (Villa de Independencia)","UNIDAD EDUCATIVA MACHACA",-66.86737,-17.12325,42,5,225,267,34,9,177,211
"Bolivia","Cochabamba","Ayopaya","Ayopaya (Villa de Independencia)","UNIDAD EDUCATIVA POCANCHE",-66.83318,-16.93553,70,7,399,469,17,24,351,368
"Bolivia","Cochabamba","Ayopaya","Ayopaya (Villa de Independencia)","UNIDAD EDUCATIVA SABINO WALLKU",-66.73064,-17.11669,54,13,393,447,34,14,332,366
"Bolivia","Cochabamba","Ayopaya","Ayopaya (Villa de Independencia)","UNIDAD EDUCATIVA SISI PALERMO",-66.83698,-17.20461,42,5,335,377,34,50,246,280
"Bolivia","Cochabamba","Ayopaya","Ayopaya (Villa de Independencia)","UNIDAD EDUCATIVA TAPAZA",-66.74503,-17.17871,11,3,136,147,15,4,114,129
"Bolivia","Cochabamba","Ayopaya","Ayopaya (Villa de Independencia)","UNIDAD EDUCATIVA VILLA PUCARA",-66.96396,-16.99085,123,27,507,630,74,20,386,460
"Bolivia","Cochabamba","Ayopaya","Cocapata","COLEGIO SECUNDARIO COCAPATA",-66.67577,-16.79244,71,10,258,329,53,19,176,229
"Bolivia","Cochabamba","Ayopaya","Cocapata","ESCUELA 15 DE FEBRERO (EL CHORO)",-66.65108,-16.79413,109,3,605,714,134,23,445,579
"Bolivia","Cochabamba","Ayopaya","Cocapata","ESCUELA CHOQUECAMATA (FALSURI)",-66.63028,-16.83837,27,7,611,638,217,32,355,572
"Bolivia","Cochabamba","Ayopaya","Cocapata","ESCUELA OSCAR ALFARO - VILLA VINTO",-66.46751,-16.84676,189,7,873,1062,170,58,638,808
"Bolivia","Cochabamba","Ayopaya","Cocapata","ESCUELA PEDRO DOMINGO MURILLO -CALIENTES",-66.55274,-17.01225,91,8,471,562,80,30,353,433
"Bolivia","Cochabamba","Ayopaya","Cocapata","ESCUELA SECCIONAL MACHACAYMA",-66.40887,-16.89995,117,6,674,791,112,63,493,605
"Bolivia","Cochabamba","Ayopaya","Cocapata","NUCLEO ESCOLAR PEDRO LAIME CHUSPI",-66.66877,-16.86044,64,0,237,301,47,25,165,212
"Bolivia","Cochabamba","Ayopaya","Cocapata","NUCLEO GERMAN BUSCH (CHILLAVI)",-66.59884,-16.8523,21,5,166,187,31,7,123,154
"Bolivia","Cochabamba","Ayopaya","Cocapata","SEDE SUB - CENTRAL VISCACHAS",-66.45755,-17.10735,26,2,33,59,11,0,20,31
"Bolivia","Cochabamba","Ayopaya","Cocapata","UNIDAD EDUCATIVA CHIARAJE",-66.38669,-17.05231,16,2,225,241,41,18,164,205
"Bolivia","Cochabamba","Ayopaya","Cocapata","UNIDAD EDUCATIVA COLORADO",-66.87921,-15.88327,37,2,197,234,33,4,158,191
"Bolivia","Cochabamba","Ayopaya","Cocapata","UNIDAD EDUCATIVA EL CHORITO",-66.60498,-16.94332,18,3,208,226,58,9,138,196
"Bolivia","Cochabamba","Ayopaya","Cocapata","UNIDAD EDUCATIVA ICARI",-66.3419,-17.02058,52,2,313,365,77,10,224,301
"Bolivia","Cochabamba","Ayopaya","Cocapata","UNIDAD EDUCATIVA MARAVILLAS",-66.71464,-16.60081,67,9,366,433,43,17,297,340
"Bolivia","Cochabamba","Ayopaya","Cocapata","UNIDAD EDUCATIVA TOTORANI",-66.39165,-17.01361,45,2,349,394,38,3,306,344
"Bolivia","Cochabamba","Ayopaya","Cocapata","UNIDAD EDUCATIVA TUNARI (PUCARITA)",-66.73937,-16.93249,98,10,460,558,27,18,405,432
"Bolivia","Cochabamba","Ayopaya","Morochata","COLEGIO RENE BARRIENTOS ORTUÑO -PIUSILLA",-66.49365,-17.23084,91,18,575,666,121,24,412,533
"Bolivia","Cochabamba","Ayopaya","Morochata","ESCUELA 26 DE MAYO - CHAUPISUYO B",-66.55013,-17.30591,84,11,723,807,116,46,550,666
"Bolivia","Cochabamba","Ayopaya","Morochata","ESCUELA GILDARO ANTEZANA ROJAS",-66.60968,-17.18441,130,37,893,1023,88,47,721,809
"Bolivia","Cochabamba","Ayopaya","Morochata","ESCUELA HILARION GRAGEDA - YAYANI",-66.65623,-17.21181,121,30,707,828,118,53,506,624
"Bolivia","Cochabamba","Ayopaya","Morochata","ESCUELA JULIO ESPINOZA CANELAS-PUNACACHI",-66.61133,-17.25125,134,46,714,848,112,59,497,609
"Bolivia","Cochabamba","Ayopaya","Morochata","ESCUELA MARIANO BAPTISTA- MOROCHATA",-66.53392,-17.23173,151,27,1561,1712,177,94,1263,1440
"Bolivia","Cochabamba","Ayopaya","Morochata","UNIDAD EDUCATIVA HUMAMARCA",-66.5562,-17.10199,16,8,235,251,31,14,182,213
"Bolivia","Cochabamba","Ayopaya","Morochata","UNIDAD EDUCATIVA IGLESIANI",-66.50184,-17.31038,17,0,175,192,39,2,134,173
"Bolivia","Cochabamba","Ayopaya","Morochata","UNIDAD EDUCATIVA PUCARANI GRANDE",-66.66244,-17.08579,29,0,118,147,7,3,108,115
"Bolivia","Cochabamba","Bolívar","Bolívar","ESCUELA COYUMA",-66.74062,-18.08522,23,3,86,109,31,7,45,76
"Bolivia","Cochabamba","Bolívar","Bolívar","ESCUELA JORENKO VILLA VERDE",-66.66763,-17.98483,8,5,404,412,79,16,304,383
"Bolivia","Cochabamba","Bolívar","Bolívar","ESCUELA MEJILLONES",-66.68706,-18.08409,92,3,352,444,71,18,260,331
"Bolivia","Cochabamba","Bolívar","Bolívar","ESCUELA SAN JUAN DE LA COMUNA",-66.46785,-17.9682,29,4,137,166,25,9,99,124
"Bolivia","Cochabamba","Bolívar","Bolívar","ESCUELA SIMON BOLIVAR",-66.53779,-17.9682,147,14,641,788,161,35,431,592
"Bolivia","Cochabamba","Bolívar","Bolívar","ESCUELA TANGALIQUE",-66.5484,-18.02263,22,3,224,246,43,9,169,212
"Bolivia","Cochabamba","Bolívar","Bolívar","ESCUELA VILACAYMA",-66.57627,-17.96971,24,14,308,332,76,15,203,279
"Bolivia","Cochabamba","Bolívar","Bolívar","ESCUELA YARVICOYA",-66.51677,-18.01299,65,5,260,325,14,6,235,249
"Bolivia","Cochabamba","Bolívar","Bolívar","NUCLEO ESCOLAR CARPANI",-66.61453,-17.93365,20,3,467,487,68,20,376,444
"Bolivia","Cochabamba","Bolívar","Bolívar","UNIDAD EDUCATIVA CHALLOMA",-66.54604,-17.89978,24,3,185,209,46,13,123,169
"Bolivia","Cochabamba","Bolívar","Bolívar","UNIDAD EDUCATIVA VILAPAMPA",-66.69617,-18.049,4,0,198,202,54,9,135,189
"Bolivia","Cochabamba","Campero","Aiquile","ESCUELA 20 DE DICIEMBRE",-65.17914,-18.20377,436,56,2234,2670,970,111,1097,2067
"Bolivia","Cochabamba","Campero","Aiquile","ESCUELA MANUEL DE UGARTE",-65.18247,-18.20012,405,33,2026,2431,849,62,1082,1931
"Bolivia","Cochabamba","Campero","Aiquile","ESCUELA SIMON RODRIGUEZ",-65.18458,-18.20073,417,54,2337,2754,972,87,1224,2196
"Bolivia","Cochabamba","Campero","Aiquile","NUCLEO EDUCATIVO TIPAJARA",-65.27975,-18.13377,30,6,274,304,45,8,215,260
"Bolivia","Cochabamba","Campero","Aiquile","NUCLEO ESCOLAR EL CERCADO",-65.17767,-18.10226,78,13,326,404,36,8,269,305
"Bolivia","Cochabamba","Campero","Aiquile","NUCLEO ESCOLAR VILLA GRANADO",-65.03775,-18.20921,175,22,907,1082,143,32,710,853
"Bolivia","Cochabamba","Campero","Aiquile","UNIDAD EDUCATIVA CHAQUI MAYU",-65.28205,-18.26553,20,4,158,178,9,4,141,150
"Bolivia","Cochabamba","Campero","Aiquile","UNIDAD EDUCATIVA EJE PAMPA",-65.1711,-18.5389,52,11,284,336,31,17,225,256
"Bolivia","Cochabamba","Campero","Aiquile","UNIDAD EDUCATIVA ESTANZUELA",-64.8748,-18.33058,54,2,228,282,21,4,201,222
"Bolivia","Cochabamba","Campero","Aiquile","UNIDAD EDUCATIVA KEWIÑAL",-65.3177,-18.37376,27,11,188,215,50,15,112,162
"Bolivia","Cochabamba","Campero","Aiquile","UNIDAD EDUCATIVA LAGARPAMPA",-64.98984,-18.45282,71,3,214,285,13,4,194,207
"Bolivia","Cochabamba","Campero","Aiquile","UNIDAD EDUCATIVA LAIME",-65.09598,-18.45015,23,5,175,198,8,9,153,161
"Bolivia","Cochabamba","Campero","Aiquile","UNIDAD EDUCATIVA NOVILLERO",-65.23428,-18.30105,103,11,532,635,130,20,371,501
"Bolivia","Cochabamba","Campero","Aiquile","UNIDAD EDUCATIVA PANAMA",-65.10865,-18.30899,36,3,256,292,44,5,204,248
"Bolivia","Cochabamba","Campero","Aiquile","UNIDAD EDUCATIVA QUIROGA",-65.21684,-18.42329,165,24,849,1014,106,33,686,792
"Bolivia","Cochabamba","Campero","Omereque","ESCUELA CENTRAL PEÑA COLORADA",-64.87029,-18.17198,52,5,342,394,63,13,261,324
"Bolivia","Cochabamba","Campero","Omereque","ESCUELA SECCIONAL CHARI CHARI",-65.01819,-18.02485,12,3,67,79,23,5,36,59
"Bolivia","Cochabamba","Campero","Omereque","ESCUELA SECCIONAL PEREZ",-64.76694,-18.11378,21,2,167,188,32,6,127,159
"Bolivia","Cochabamba","Campero","Omereque","UNIDAD EDUCATIVA HUANACUNI GRANDE",-64.98838,-17.92877,22,2,162,184,22,2,136,158
"Bolivia","Cochabamba","Campero","Omereque","UNIDAD EDUCATIVA OMEREQUE",-64.90799,-18.1062,303,37,1547,1850,467,34,1009,1476
"Bolivia","Cochabamba","Campero","Omereque","UNIDAD EDUCATIVA PERERETA",-64.82058,-18.1318,28,5,178,206,42,9,122,164
"Bolivia","Cochabamba","Campero","Pasorapa","COLEGIO TTE.CNEL. NATANIEL VERDUGUEZ",-64.67598,-18.31635,181,11,748,929,404,26,307,711
"Bolivia","Cochabamba","Campero","Pasorapa","ESCUELA CENTRAL QUINORI",-64.39658,-18.50312,63,1,228,291,35,4,188,223
"Bolivia","Cochabamba","Campero","Pasorapa","SEDE SINDICAL YAJO PAMPA",-64.55951,-18.13656,2,0,37,39,14,0,23,37
"Bolivia","Cochabamba","Campero","Pasorapa","U.E. REDONDO",-64.31445,-18.50069,3,2,69,72,8,4,55,63
"Bolivia","Cochabamba","Campero","Pasorapa","UNIDAD EDUCATIVA PAMPAS",-64.51284,-18.40247,11,0,112,123,21,0,91,112
"Bolivia","Cochabamba","Campero","Pasorapa","UNIDAD EDUCATIVA SEIBAS",-64.57413,-18.49377,36,5,141,177,24,2,110,134
"Bolivia","Cochabamba","Capinota","Capinota","ESCUELA APILLAPAMPA",-66.2554,-17.8624,55,16,662,717,38,24,584,622
"Bolivia","Cochabamba","Capinota","Capinota","ESCUELA CENTRAL MARCAVI",-66.19489,-17.68572,38,14,320,358,20,10,276,296
"Bolivia","Cochabamba","Capinota","Capinota","ESCUELA VICTOR BARRIENTOS",-66.26445,-17.71407,716,109,4531,5247,1681,208,2533,4214
"Bolivia","Cochabamba","Capinota","Capinota","NUCLEO CENTRAL HORNOMA",-66.20175,-17.88647,38,19,363,401,9,8,327,336
"Bolivia","Cochabamba","Capinota","Capinota","UNIDAD EDUCATIVA CUSTODIO AYAVIRI",-66.28507,-17.72167,346,52,2853,3199,1223,93,1485,2708
"Bolivia","Cochabamba","Capinota","Capinota","UNIDAD EDUCATIVA GUSTAVO GARCIA (CHARAMO",-66.29135,-17.61348,91,23,719,810,229,29,438,667
"Bolivia","Cochabamba","Capinota","Capinota","UNIDAD EDUCATIVA JUANA AZURDUY DE PADILLA",-66.26445,-17.71408,103,5,421,524,116,18,282,398
"Bolivia","Cochabamba","Capinota","Capinota","UNIDAD EDUCATIVA TOCOHALLA",-66.13054,-17.86209,20,0,81,101,1,4,76,77
"Bolivia","Cochabamba","Capinota","Capinota","UNIDAD EDUCATIVA YATAMOCO",-66.27116,-17.73293,40,5,475,515,122,13,335,457
"Bolivia","Cochabamba","Capinota","Santivañez","DOMICILIO PARTICULAR",-66.26903,-17.55104,24,4,189,213,44,6,135,179
"Bolivia","Cochabamba","Capinota","Santivañez","ESCUELA PRUDENCIO ARAUCO (SANTIVAÑEZ)",-66.24799,-17.54894,249,24,1618,1867,434,45,1115,1549
"Bolivia","Cochabamba","Capinota","Santivañez","SUB CENTRAL ENRIQUE ENCINAS (EX CALERA)",-66.21689,-17.57849,73,5,509,582,61,13,430,491
"Bolivia","Cochabamba","Capinota","Santivañez","U. E. CASTOR ZAMBRANA HUAYÑACOTA",-66.20436,-17.53515,75,4,419,494,65,6,344,409
"Bolivia","Cochabamba","Capinota","Santivañez","UNIDAD EDUCATIVA CAPORAYA",-66.2821,-17.50345,31,9,247,278,25,5,208,233
"Bolivia","Cochabamba","Capinota","Santivañez","UNIDAD EDUCATIVA JOSE RIVERA",-66.26288,-17.61516,34,2,183,217,54,4,123,177
"Bolivia","Cochabamba","Capinota","Santivañez","UNIDAD EDUCATIVA PAMPA CHURIHUA",-66.14667,-17.61767,18,4,141,159,5,4,128,133
"Bolivia","Cochabamba","Capinota","Santivañez","UNIDAD EDUCATIVA ROCHA RANCHO",-66.18881,-17.54504,83,9,460,543,74,15,362,436
"Bolivia","Cochabamba","Capinota","Sicaya","ESCUELA GERMAN BUSCH",-66.35415,-17.74645,74,23,535,609,81,25,406,487
"Bolivia","Cochabamba","Capinota","Sicaya","NUCLEO HUMANISTICO SICAYA",-66.33362,-17.80072,110,24,817,927,69,42,682,751
"Bolivia","Cochabamba","Carrasco","Chimoré","ESCUELA GERÓNIMO UZEDA FE Y ALEGRIA",-65.15494,-16.99398,1485,117,7075,8560,1647,222,5089,6736
"Bolivia","Cochabamba","Carrasco","Chimoré","ESCUELA LA MISION",-65.14838,-16.71407,39,3,348,387,98,9,238,336
"Bolivia","Cochabamba","Carrasco","Chimoré","NUCLEO EDUCATIVO ENTRE RIOS TACUARAL",-65.20777,-17.08086,60,2,570,630,43,7,518,561
"Bolivia","Cochabamba","Carrasco","Chimoré","NUCLEO ESCOLAR PUERTO AURORA",-65.18625,-16.8472,62,18,475,537,56,11,390,446
"Bolivia","Cochabamba","Carrasco","Chimoré","UNIDAD EDUCATIVA CESAR ZAMA (CHIMORE)",-65.07787,-16.99658,162,21,1626,1788,154,32,1419,1573
"Bolivia","Cochabamba","Carrasco","Chimoré","UNIDAD EDUCATIVA EL CARMEN",-64.90653,-16.16878,32,1,98,130,23,5,69,92
"Bolivia","Cochabamba","Carrasco","Chimoré","UNIDAD EDUCATIVA PUERTO LAS FLORES",-64.67742,-16.40432,12,3,65,77,24,3,35,59
"Bolivia","Cochabamba","Carrasco","Chimoré","UNIDAD EDUCATIVA SAN ANDRÉS",-65.10363,-17.0901,59,5,543,602,25,12,501,526
"Bolivia","Cochabamba","Carrasco","Chimoré","UNIDAD EDUCATIVA SANTA ANITA",-64.82532,-16.11419,42,2,89,131,19,5,63,82
"Bolivia","Cochabamba","Carrasco","Chimoré","UNIDAD EDUCATIVA SANTA ISABEL",-64.72911,-16.50484,19,1,51,70,13,1,36,49
"Bolivia","Cochabamba","Carrasco","Chimoré","UNIDAD EDUCATIVA TRES ISLAS",-64.8566,-16.75232,30,5,170,200,27,3,135,162
"Bolivia","Cochabamba","Carrasco","Chimoré","UNIDAD EDUCATIVA TRINIDADCITO",-64.94166,-16.44957,8,0,61,69,31,0,30,61
"Bolivia","Cochabamba","Carrasco","Entre Ríos (Bulo Bulo)","COLEGIO FRANZ TAMAYO",-64.53572,-17.1993,1086,104,7861,8947,1358,224,6175,7533
"Bolivia","Cochabamba","Carrasco","Entre Ríos (Bulo Bulo)","COLEGIO NACIONAL SAN MARCOS",-64.35905,-17.25389,390,53,3533,3923,441,72,2967,3408
"Bolivia","Cochabamba","Carrasco","Entre Ríos (Bulo Bulo)","ESCUELA EDUARDO AVAROA (ISARZAMA)",-64.68122,-17.13931,202,12,2085,2287,130,27,1916,2046
"Bolivia","Cochabamba","Carrasco","Entre Ríos (Bulo Bulo)","U.E. ESTEBAN ARCE",-64.61887,-17.26742,9,4,254,263,7,8,235,242
"Bolivia","Cochabamba","Carrasco","Entre Ríos (Bulo Bulo)","U. E. JOSÉ CARRASCO (MANCO KAPAC)",-64.56224,-17.18527,270,33,2874,3144,243,48,2550,2793
"Bolivia","Cochabamba","Carrasco","Entre Ríos (Bulo Bulo)","U.E. NACIONAL AYACUCHO",-64.54228,-17.20041,7,0,66,73,10,0,56,66
"Bolivia","Cochabamba","Carrasco","Entre Ríos (Bulo Bulo)","UNIDAD EDUCATIVA RIO BLANCO",-64.45576,-17.22547,260,18,1278,1538,170,42,1048,1218
"Bolivia","Cochabamba","Carrasco","Pocona","CENTRO DE ATENCION AL TURISTA",-65.40996,-17.6073,12,5,369,381,34,9,321,355
"Bolivia","Cochabamba","Carrasco","Pocona","ESCUELA LADISLAO CABRERA",-65.34206,-17.66848,68,11,418,486,61,12,334,395
"Bolivia","Cochabamba","Carrasco","Pocona","NUCLEO ESCOLAR ISMAEL MONTES",-65.38327,-17.72318,80,14,821,901,104,26,677,781
"Bolivia","Cochabamba","Carrasco","Pocona","UNIDAD EDUCATIVA 6 DE AGOSTO",-65.37962,-17.52965,165,22,936,1101,139,44,731,870
"Bolivia","Cochabamba","Carrasco","Pocona","UNIDAD EDUCATIVA CHIMBOATA",-65.28564,-17.66047,24,3,402,426,46,12,341,387
"Bolivia","Cochabamba","Carrasco","Pocona","UNIDAD EDUCATIVA HUAYAPACHA",-65.40794,-17.55243,85,30,837,922,98,35,674,772
"Bolivia","Cochabamba","Carrasco","Pocona","UNIDAD EDUCATIVA JAVIER GONZALES",-65.50449,-17.61416,3,0,61,64,1,1,59,60
"Bolivia","Cochabamba","Carrasco","Pocona","UNIDAD EDUCATIVA LA TRANCA",-65.45638,-17.73257,10,4,109,119,8,0,97,105
"Bolivia","Cochabamba","Carrasco","Pocona","UNIDAD EDUCATIVA MONTE PUNCU",-65.30296,-17.58503,55,13,394,449,46,17,318,364
"Bolivia","Cochabamba","Carrasco","Pocona","UNIDAD EDUCATIVA POCONA",-65.41882,-17.67324,106,18,389,495,72,18,281,353
"Bolivia","Cochabamba","Carrasco","Pojo","COLEGIO VENANCIO LOSS",-64.86312,-17.75708,225,31,1448,1673,246,38,1133,1379
"Bolivia","Cochabamba","Carrasco","Pojo","NUCLEO ESCOLAR DURAZNILLO",-65.01938,-17.78679,39,3,142,181,14,2,123,137
"Bolivia","Cochabamba","Carrasco","Pojo","UNIDAD EDUCATIVA CHALLHUANI",-64.89679,-17.84557,73,0,648,721,13,34,601,614
"Bolivia","Cochabamba","Carrasco","Pojo","UNIDAD EDUCATIVA DIAN PAMPA",-64.70919,-17.71177,31,3,322,353,26,12,281,307
"Bolivia","Cochabamba","Carrasco","Pojo","UNIDAD EDUCATIVA JAIME LAREDO",-64.98014,-17.84581,5,1,104,109,5,3,95,100
"Bolivia","Cochabamba","Carrasco","Pojo","UNIDAD EDUCATIVA KARA HUASI - POJO",-64.74367,-17.73957,23,2,246,269,20,10,214,234
"Bolivia","Cochabamba","Carrasco","Pojo","UNIDAD EDUCATIVA LA HABANA",-64.92303,-17.7378,29,2,289,318,17,2,268,285
"Bolivia","Cochabamba","Carrasco","Pojo","UNIDAD EDUCATIVA PALCA C",-64.97747,-17.70329,20,2,511,531,17,4,488,505
"Bolivia","Cochabamba","Carrasco","Pojo","UNIDAD EDUCATIVA RODEO C",-64.78306,-17.83571,52,1,341,393,4,24,312,316
"Bolivia","Cochabamba","Carrasco","Pojo","UNIDAD EDUCATIVA THAGO LAGUNA",-64.86137,-17.95306,0,0,61,61,0,4,57,57
"Bolivia","Cochabamba","Carrasco","Pojo","UNIDAD EDUCATIVA YUTHUPAMPA",-64.99229,-17.74813,59,7,532,591,25,11,489,514
"Bolivia","Cochabamba","Carrasco","Puerto Villarroel","COLEGIO EDUARDO AVAROA (P.VILLARROEL)",-64.79533,-16.83211,297,17,1057,1354,336,18,686,1022
"Bolivia","Cochabamba","Carrasco","Puerto Villarroel","COLEGIO JUAN PABLO II (SACTA)",-64.76898,-17.11968,408,40,3634,4042,344,74,3176,3520
"Bolivia","Cochabamba","Carrasco","Puerto Villarroel","COLEGIO LIBERTAD",-64.84208,-17.07051,75,6,849,924,64,17,762,826
"Bolivia","Cochabamba","Carrasco","Puerto Villarroel","COLEGIO MARCELO QUIROGA SANTA CRUZ",-65.04104,-17.0115,245,17,2028,2273,215,41,1755,1970
"Bolivia","Cochabamba","Carrasco","Puerto Villarroel","ESCUELA AYOPAYA (P.VILLAROEL)",-65.00072,-16.90683,77,8,900,977,49,15,828,877
"Bolivia","Cochabamba","Carrasco","Puerto Villarroel","ESCUELA BUENAS NUEVAS (VALLE IVIRZA)",-64.91539,-17.11546,182,23,1235,1417,134,22,1056,1190
"Bolivia","Cochabamba","Carrasco","Puerto Villarroel","ESCUELA CENTRAL VILLA NUEVA",-65.00124,-17.11282,71,6,722,793,40,9,667,707
"Bolivia","Cochabamba","Carrasco","Puerto Villarroel","ESCUELA SENDA 6",-64.95086,-17.01844,130,18,1312,1442,84,25,1185,1269
"Bolivia","Cochabamba","Carrasco","Puerto Villarroel","ESCUELA TORIBIO CLAURE (V. HERMOSO)",-64.96452,-17.15555,204,14,1538,1742,156,26,1342,1498
"Bolivia","Cochabamba","Carrasco","Puerto Villarroel","UNIDAD EDUCATIVA 2 DE MARZO",-64.92152,-17.21806,56,4,670,726,30,9,627,657
"Bolivia","Cochabamba","Carrasco","Puerto Villarroel","UNIDAD EDUCATIVA BIARECUATÉ",-64.94436,-16.78322,31,0,59,90,5,0,54,59
"Bolivia","Cochabamba","Carrasco","Puerto Villarroel","UNIDAD EDUCATIVA CESAR ZAMA (P. VILLARRO",-65.07753,-16.99568,20,2,177,197,14,6,155,169
"Bolivia","Cochabamba","Carrasco","Puerto Villarroel","UNIDAD EDUCATIVA ISRAEL",-64.83989,-17.22177,38,7,536,574,45,8,476,521
"Bolivia","Cochabamba","Carrasco","Puerto Villarroel","UNIDAD EDUCATIVA JUANA AZURDUY DE PADILLA",-64.85532,-17.04719,90,3,527,617,79,10,435,514
"Bolivia","Cochabamba","Carrasco","Puerto Villarroel","UNIDAD EDUCATIVA SAN FRANCISCO DE ASIS",-64.85681,-17.03161,1395,123,9073,10468,1583,289,7078,8661
"Bolivia","Cochabamba","Carrasco","Puerto Villarroel","UNIDAD EDUCATIVA VALLE TUNARI",-64.69701,-17.26063,175,17,1599,1774,101,28,1453,1554
"Bolivia","Cochabamba","Carrasco","Totora","COLEGIO 8 DE SEPTIEMBRE",-65.08691,-17.71779,44,9,554,598,51,16,478,529
"Bolivia","Cochabamba","Carrasco","Totora","SEDE DE LA JUNTA VECINAL DE EPIZANA",-65.22901,-17.63718,72,12,785,857,95,28,650,745
"Bolivia","Cochabamba","Carrasco","Totora","SEDE SOCIAL YUNGAS DE VANDIOLA",-65.23582,-17.42609,74,8,477,551,130,12,327,457
"Bolivia","Cochabamba","Carrasco","Totora","UNIDAD EDUCATIVA ANTAQAWA",-65.13827,-17.87289,8,0,131,139,9,1,121,130
"Bolivia","Cochabamba","Carrasco","Totora","UNIDAD EDUCATIVA LAIME TORO",-65.05975,-17.66721,42,8,572,614,46,18,500,546
"Bolivia","Cochabamba","Carrasco","Totora","UNIDAD EDUCATIVA POTRERO",-65.04145,-17.88901,14,1,119,133,5,0,113,118
"Bolivia","Cochabamba","Carrasco","Totora","UNIDAD EDUCATIVA RODEO GRANDE",-65.13137,-17.66049,59,10,861,920,43,12,796,839
"Bolivia","Cochabamba","Carrasco","Totora","UNIDAD EDUCATIVA TIKA PAMPA",-65.25523,-17.7844,17,4,125,142,4,4,113,117
"Bolivia","Cochabamba","Carrasco","Totora","UNIDAD EDUCATIVA TIRAQUE C",-65.09571,-17.67045,14,4,305,319,16,4,281,297
"Bolivia","Cochabamba","Carrasco","Totora","UNIDA EDUCATIVA LA PAZ",-65.19115,-17.74041,425,48,2708,3133,516,83,2061,2577
"Bolivia","Cochabamba","Cercado","Cochabamba","CAMPO FERIAL",-66.12955,-17.41828,634,33,4556,5190,2374,149,2000,4374
"Bolivia","Cochabamba","Cercado","Cochabamba","(CÁRCEL) PENITENCIARIA SAN ANTONIO",-66.15704,-17.40325,92,2,151,243,70,6,73,143
"Bolivia","Cochabamba","Cercado","Cochabamba","(CÁRCEL) PENITENCIARIA SAN SEBASTIAN MUJERES",-66.16058,-17.39862,48,0,77,125,29,0,48,77
"Bolivia","Cochabamba","Cercado","Cochabamba","(CÁRCEL) PENITENCIARIA SAN SEBASTIAN  VARONES",-66.15989,-17.39794,84,1,192,276,61,10,120,181
"Bolivia","Cochabamba","Cercado","Cochabamba","CEMA CENTRO FRUTILLITAS",-66.20207,-17.38553,39,1,481,520,347,14,119,466
"Bolivia","Cochabamba","Cercado","Cochabamba","CENTRO EDUCATIVO P.  MARIA AUXILIADORA",-66.15949,-17.43581,703,41,5203,5906,2680,191,2291,4971
"Bolivia","Cochabamba","Cercado","Cochabamba","CENTRO EDUCATIVO SAN FRANCISCO DE ASIS",-66.16775,-17.41353,185,6,1313,1498,861,18,428,1289
"Bolivia","Cochabamba","Cercado","Cochabamba","CENTRO INMACULADA CONCEPCION",-66.15766,-17.37703,394,9,2504,2898,2142,37,316,2458
"Bolivia","Cochabamba","Cercado","Cochabamba","CENTRO INTEGRADO EL SALVADOR S-VERA CRUZ",-66.1243,-17.46039,436,26,2949,3385,1227,102,1594,2821
"Bolivia","Cochabamba","Cercado","Cochabamba","CENTRO KANATA",-66.15925,-17.41386,145,2,879,1024,560,25,292,852
"Bolivia","Cochabamba","Cercado","Cochabamba","CENTRO PARTICULAR GERONIMO DE OSORIO",-66.1866,-17.397,883,24,5680,6563,3767,147,1742,5509
"Bolivia","Cochabamba","Cercado","Cochabamba","COLEGIO ABAROA",-66.1585,-17.39535,540,12,3076,3616,2308,56,700,3008
"Bolivia","Cochabamba","Cercado","Cochabamba","COLEGIO ALBERT EINSTEIN",-66.17524,-17.38465,368,13,3155,3523,2474,98,570,3044
"Bolivia","Cochabamba","Cercado","Cochabamba","COLEGIO ALEMAN SANTA MARIA",-66.15275,-17.39123,351,8,2029,2380,1666,34,321,1987
"Bolivia","Cochabamba","Cercado","Cochabamba","COLEGIO AMOR DE DIOS",-66.15005,-17.40731,1164,33,6625,7789,4045,135,2412,6457
"Bolivia","Cochabamba","Cercado","Cochabamba","COLEGIO BOLIVAR",-66.1534,-17.39354,297,11,1610,1907,1191,20,388,1579
"Bolivia","Cochabamba","Cercado","Cochabamba","COLEGIO BOLIVIANO ARGENTINO",-66.15808,-17.39156,151,5,713,864,551,10,147,698
"Bolivia","Cochabamba","Cercado","Cochabamba","COLEGIO BRANCO PETRICEVIC",-66.18783,-17.37372,837,32,6224,7061,4425,146,1621,6046
"Bolivia","Cochabamba","Cercado","Cochabamba","COLEGIO BUENAS NUEVAS C",-66.14614,-17.41905,730,42,4605,5335,2290,140,2133,4423
"Bolivia","Cochabamba","Cercado","Cochabamba","COLEGIO CRISTO REY",-66.17203,-17.39057,590,9,4395,4985,3349,88,949,4298
"Bolivia","Cochabamba","Cercado","Cochabamba","COLEGIO DON BOSCO",-66.15103,-17.38246,694,15,4015,4709,3327,58,615,3942
"Bolivia","Cochabamba","Cercado","Cochabamba","COLEGIO FEDERICO FROEBEL",-66.14729,-17.36183,428,14,3451,3879,2475,76,886,3361
"Bolivia","Cochabamba","Cercado","Cochabamba","COLEGIO HISPANO BOLIVIANO",-66.15182,-17.39768,479,14,2579,3058,1866,66,633,2499
"Bolivia","Cochabamba","Cercado","Cochabamba","COLEGIO IRLANDES",-66.13731,-17.37605,71,1,536,607,447,8,80,527
"Bolivia","Cochabamba","Cercado","Cochabamba","COLEGIO ISMAEL MONTES O LUIS ESPINAL",-66.14464,-17.4156,562,33,3962,4524,1912,124,1893,3805
"Bolivia","Cochabamba","Cercado","Cochabamba","COLEGIO JAIME ESCALANTE",-66.15813,-17.368,188,9,1369,1557,1122,21,217,1339
"Bolivia","Cochabamba","Cercado","Cochabamba","COLEGIO LA SALLE",-66.1608,-17.38936,736,11,3643,4379,3037,45,550,3587
"Bolivia","Cochabamba","Cercado","Cochabamba","COLEGIO LA SALLE FISCAL",-66.16738,-17.40489,700,22,4983,5683,3548,98,1315,4863
"Bolivia","Cochabamba","Cercado","Cochabamba","COLEGIO LAURA VICUÑA",-66.19179,-17.4425,129,15,1094,1223,419,33,627,1046
"Bolivia","Cochabamba","Cercado","Cochabamba","COLEGIO LOYOLA",-66.14664,-17.38733,321,4,1795,2116,1486,28,277,1763
"Bolivia","Cochabamba","Cercado","Cochabamba","COLEGIO LUIS QUINTIN VILA",-66.1864,-17.37541,788,21,6106,6894,4295,189,1601,5896
"Bolivia","Cochabamba","Cercado","Cochabamba","COLEGIO MARISTA",-66.16205,-17.36185,580,16,4753,5333,3384,87,1266,4650
"Bolivia","Cochabamba","Cercado","Cochabamba","COLEGIO MARISTA NUESTRA SEÑORA DEL PILAR",-66.16751,-17.35473,778,26,5557,6335,3331,161,2039,5370
"Bolivia","Cochabamba","Cercado","Cochabamba","COLEGIO MARTIN CARDENAS",-66.13716,-17.41997,489,20,4069,4558,2209,94,1746,3955
"Bolivia","Cochabamba","Cercado","Cochabamba","COLEGIO MARYKNOLL",-66.16751,-17.37765,779,8,4947,5726,4183,64,692,4875
"Bolivia","Cochabamba","Cercado","Cochabamba","COLEGIO NACIONAL MIXTO COCHABAMBA",-66.17643,-17.36379,701,29,5441,6142,3787,92,1533,5320
"Bolivia","Cochabamba","Cercado","Cochabamba","COLEGIO PAULO VI",-66.16972,-17.3896,369,8,2610,2979,2079,52,471,2550
"Bolivia","Cochabamba","Cercado","Cochabamba","COLEGIO PIO XII",-66.15453,-17.40197,233,7,1454,1687,1045,21,381,1426
"Bolivia","Cochabamba","Cercado","Cochabamba","COLEGIO RICHARD VON WEIZACKER",-66.18177,-17.37842,305,10,2765,3070,2173,38,544,2717
"Bolivia","Cochabamba","Cercado","Cochabamba","COLEGIO SAN ANTONIO DE PUCARA",-66.1666,-17.45451,1458,92,8964,10422,3375,324,5173,8548
"Bolivia","Cochabamba","Cercado","Cochabamba","COLEGIO SAN FRANCISCO DE ASIS",-66.15719,-17.43316,813,34,5774,6587,3177,138,2425,5602
"Bolivia","Cochabamba","Cercado","Cochabamba","COLEGIO SAN FRANCISCO (VILLA PAGADOR)",-66.11565,-17.43498,820,66,5571,6391,1769,211,3525,5294
"Bolivia","Cochabamba","Cercado","Cochabamba","COLEGIO SAN RAFAEL",-66.13949,-17.39816,653,16,4393,5046,3310,49,1018,4328
"Bolivia","Cochabamba","Cercado","Cochabamba","COLEGIO SANTA LUISA MARILLAC",-66.12972,-17.42876,730,49,5518,6248,2277,172,3020,5297
"Bolivia","Cochabamba","Cercado","Cochabamba","COLEGIO SANTO DOMINGO SAVIO",-66.15925,-17.42091,297,16,2234,2531,1401,60,757,2158
"Bolivia","Cochabamba","Cercado","Cochabamba","COLEGIO SEBASTIAN PAGADOR",-66.11807,-17.4396,1528,101,11230,12758,3900,353,6876,10776
"Bolivia","Cochabamba","Cercado","Cochabamba","COLEGIO SERGIO ALMARAZ PAZ",-66.15983,-17.42155,766,23,5259,6025,3325,143,1768,5093
"Bolivia","Cochabamba","Cercado","Cochabamba","COLEGIO TECNICO HUMANISTICO ABAROA",-66.18008,-17.39791,147,6,1098,1245,738,23,331,1069
"Bolivia","Cochabamba","Cercado","Cochabamba","COLEGIO VENEZUELA",-66.17432,-17.38003,420,16,2985,3405,2348,52,569,2917
"Bolivia","Cochabamba","Cercado","Cochabamba","COLEGIO VENJAMNIN",-66.12346,-17.42547,264,29,2102,2366,892,70,1111,2003
"Bolivia","Cochabamba","Cercado","Cochabamba","COLEGIO YUGOSLAVIA ( EX MARISCAL SANTA CRUZ)",-66.15756,-17.4142,355,11,2438,2793,1665,53,709,2374
"Bolivia","Cochabamba","Cercado","Cochabamba","ESC. FISCAL JUAN XXIII A – JUANCITO PINTO",-66.20342,-17.3892,214,5,1650,1864,1081,31,533,1614
"Bolivia","Cochabamba","Cercado","Cochabamba","ESC. REPUBLICA DEL PERU O I. VASQUEZ",-66.16631,-17.41514,1100,29,6962,8062,4546,136,2251,6797
"Bolivia","Cochabamba","Cercado","Cochabamba","ESCUELA 6 DE AGOSTO",-66.17321,-17.48531,604,71,4681,5285,1408,160,3042,4450
"Bolivia","Cochabamba","Cercado","Cochabamba","ESCUELA ANTOFAGASTA",-66.18551,-17.38673,721,45,5926,6647,4016,133,1732,5748
"Bolivia","Cochabamba","Cercado","Cochabamba","ESCUELA BOLIVAR",-66.15719,-17.40203,239,5,1240,1479,857,19,359,1216
"Bolivia","Cochabamba","Cercado","Cochabamba","ESCUELA BUENAS NUEVAS A",-66.14575,-17.41985,411,25,2759,3170,1307,81,1346,2653
"Bolivia","Cochabamba","Cercado","Cochabamba","ESCUELA CAMARA JUNIOR",-66.15968,-17.42823,346,17,2088,2434,1166,78,827,1993
"Bolivia","Cochabamba","Cercado","Cochabamba","ESCUELA CARLOS MEDINACELI",-66.14594,-17.44799,765,40,5459,6224,2177,157,3085,5262
"Bolivia","Cochabamba","Cercado","Cochabamba","ESCUELA CEFERINO NAMUNCURA",-66.22959,-17.44222,181,8,1063,1244,381,34,640,1021
"Bolivia","Cochabamba","Cercado","Cochabamba","ESCUELA CENTRAL TAQUIÑA A",-66.17831,-17.34379,706,52,5677,6383,2965,161,2499,5464
"Bolivia","Cochabamba","Cercado","Cochabamba","ESCUELA CENTRAL TAQUIÑA C",-66.17863,-17.3427,686,30,5223,5909,2725,147,2321,5046
"Bolivia","Cochabamba","Cercado","Cochabamba","ESCUELA EUSEBIO TUDELA",-66.21059,-17.44574,450,48,3770,4220,1177,135,2410,3587
"Bolivia","Cochabamba","Cercado","Cochabamba","ESCUELA FISCAL JUAN XXIII A",-66.20212,-17.38982,540,14,4012,4552,2580,66,1352,3932
"Bolivia","Cochabamba","Cercado","Cochabamba","ESCUELA GERARDO VARGAS",-66.12848,-17.43969,872,64,5519,6391,1967,190,3298,5265
"Bolivia","Cochabamba","Cercado","Cochabamba","ESCUELA GUALBERTO VILLARROEL",-66.14348,-17.38926,292,4,1962,2254,1557,24,377,1934
"Bolivia","Cochabamba","Cercado","Cochabamba","ESCUELA GUTIERREZ MARISCAL",-66.19385,-17.39756,652,46,5679,6331,3301,162,2170,5471
"Bolivia","Cochabamba","Cercado","Cochabamba","ESCUELA HUMBERTO PORTOCARRERO",-66.14091,-17.45442,592,23,4078,4670,1757,127,2171,3928
"Bolivia","Cochabamba","Cercado","Cochabamba","ESCUELA IV CENTENARIO",-66.18991,-17.35495,698,33,5144,5842,3146,117,1848,4994
"Bolivia","Cochabamba","Cercado","Cochabamba","ESCUELA JOSE GABRIEL DE GUMUCIO",-66.16722,-17.38438,246,3,1779,2025,1468,32,276,1744
"Bolivia","Cochabamba","Cercado","Cochabamba","ESCUELA JOSE MARIA SANTIVAÑEZ",-66.17485,-17.36938,604,10,4205,4809,3397,48,750,4147
"Bolivia","Cochabamba","Cercado","Cochabamba","ESCUELA MARYKNOLL",-66.16147,-17.37132,172,1,1224,1396,1064,15,144,1208
"Bolivia","Cochabamba","Cercado","Cochabamba","ESCUELA MIXTA FISCAL TEMPORAL A",-66.15884,-17.36139,656,29,5205,5861,3175,152,1849,5024
"Bolivia","Cochabamba","Cercado","Cochabamba","ESCUELA OTTO FELIPE BRAWN",-66.18926,-17.36244,555,19,4174,4729,2655,97,1403,4058
"Bolivia","Cochabamba","Cercado","Cochabamba","ESCUELA RICARDO PRUDENCIO",-66.14006,-17.42105,449,22,2988,3437,1337,95,1534,2871
"Bolivia","Cochabamba","Cercado","Cochabamba","ESCUELA WALTER VALLEJO",-66.14645,-17.40012,240,3,1370,1610,861,30,476,1337
"Bolivia","Cochabamba","Cercado","Cochabamba","ESCUELA WILGE RODRIGUEZ",-66.15132,-17.39204,163,6,900,1063,676,22,196,872
"Bolivia","Cochabamba","Cercado","Cochabamba","INSTITUTO AMERICANO",-66.15434,-17.36889,933,22,5993,6926,4669,95,1207,5876
"Bolivia","Cochabamba","Cercado","Cochabamba","INSTITUTO EDUARDO LAREDO",-66.1526,-17.38101,454,2,2164,2618,1825,21,316,2141
"Bolivia","Cochabamba","Cercado","Cochabamba","LICEO ADELA ZAMUDIO",-66.16859,-17.39639,546,8,2869,3415,2130,77,654,2784
"Bolivia","Cochabamba","Cercado","Cochabamba","LICEO ELENA ARZE DE ARZE",-66.16439,-17.37035,568,11,3531,4099,2871,59,590,3461
"Bolivia","Cochabamba","Cercado","Cochabamba","LICEO GUINDALINA LOAYZA",-66.16626,-17.38111,153,7,1293,1446,1083,15,188,1271
"Bolivia","Cochabamba","Cercado","Cochabamba","LICEO  MERCEDES CANDIA DE OVANDO",-66.13917,-17.39435,551,19,3684,4235,2701,90,874,3575
"Bolivia","Cochabamba","Cercado","Cochabamba","SEMINARIO SAN JOSE",-66.19784,-17.38371,361,9,2916,3277,2014,69,824,2838
"Bolivia","Cochabamba","Cercado","Cochabamba","U.E. MADRE DE LA DIVINA PROVIDENCIA",-66.14977,-17.43951,31,4,443,474,186,17,236,422
"Bolivia","Cochabamba","Cercado","Cochabamba","U.E. NACIONAL SAN ISIDRO",-66.15123,-17.46888,545,57,4004,4549,1009,162,2776,3785
"Bolivia","Cochabamba","Cercado","Cochabamba","U. E. SAN NICOLAS CLUB DE LEONES",-66.15354,-17.4825,180,33,1796,1976,381,75,1307,1688
"Bolivia","Cochabamba","Cercado","Cochabamba","UNIDAD EDUCATIVA 14 DE SEPTIEMBRE",-66.18018,-17.36749,87,1,933,1020,708,15,209,917
"Bolivia","Cochabamba","Cercado","Cochabamba","UNIDAD EDUCATIVA 26 DE OCTUBRE",-66.12116,-17.42092,39,0,545,584,269,15,261,530
"Bolivia","Cochabamba","Cercado","Cochabamba","UNIDAD EDUCATIVA 9 DE MARZO",-66.10553,-17.44673,76,15,1007,1083,263,32,697,960
"Bolivia","Cochabamba","Cercado","Cochabamba","UNIDAD EDUCATIVA ALTO COCHABAMBA",-66.14483,-17.42332,48,4,422,470,132,13,273,405
"Bolivia","Cochabamba","Cercado","Cochabamba","UNIDAD EDUCATIVA AMERICA DEL SUR - MEJILLONES A",-66.13793,-17.42199,39,7,342,381,158,11,166,324
"Bolivia","Cochabamba","Cercado","Cochabamba","UNIDAD EDUCATIVA ANDRES BELLO",-66.15125,-17.4158,596,25,3737,4333,1845,91,1776,3621
"Bolivia","Cochabamba","Cercado","Cochabamba","UNIDAD EDUCATIVA ANTONIO DIEZ",-66.17933,-17.47178,93,14,1553,1646,522,57,960,1482
"Bolivia","Cochabamba","Cercado","Cochabamba","UNIDAD EDUCATIVA ATIY",-66.15207,-17.46361,124,12,1138,1262,378,26,722,1100
"Bolivia","Cochabamba","Cercado","Cochabamba","UNIDAD EDUCATIVA BARBARA LAMAS",-66.10529,-17.46267,469,55,3502,3971,796,151,2500,3296
"Bolivia","Cochabamba","Cercado","Cochabamba","UNIDAD EDUCATIVA BOLIVIA (LA MAICA)",-66.21881,-17.41461,145,9,1277,1422,351,42,875,1226
"Bolivia","Cochabamba","Cercado","Cochabamba","UNIDAD EDUCATIVA CATOLICO GUADALUPANO (EX CALIFORNIA AMERICAN SCHOOL)",-66.1447,-17.36928,367,11,2791,3158,2054,50,676,2730
"Bolivia","Cochabamba","Cercado","Cochabamba","UNIDAD EDUCATIVA CLUB DE LEONES",-66.16528,-17.36456,502,19,3494,3996,2514,73,888,3402
"Bolivia","Cochabamba","Cercado","Cochabamba","UNIDAD EDUCATIVA DANIEL SALAMANCA (EX COLEGIO NAL. MIXTO 6 DE AGOSTO)",-66.16353,-17.39569,82,3,583,665,448,10,122,570
"Bolivia","Cochabamba","Cercado","Cochabamba","UNIDAD EDUCATIVA DE LA FUERZA AEREA",-66.16742,-17.42138,196,3,658,854,397,19,239,636
"Bolivia","Cochabamba","Cercado","Cochabamba","UNIDAD EDUCATIVA DEMETRIO CANELAS",-66.20225,-17.42305,217,24,1874,2091,627,56,1167,1794
"Bolivia","Cochabamba","Cercado","Cochabamba","UNIDAD EDUCATIVA DIONISIO MORALES CHOQUE",-66.12429,-17.46519,929,91,7321,8250,1596,285,5349,6945
"Bolivia","Cochabamba","Cercado","Cochabamba","UNIDAD EDUCATIVA DOMINGO SAVIO (EX LORENZO FILHO)",-66.14401,-17.38117,218,1,1194,1412,939,26,228,1167
"Bolivia","Cochabamba","Cercado","Cochabamba","UNIDAD EDUCATIVA EL SALVADOR SAN JAVIER",-66.12055,-17.44695,584,38,3769,4353,1520,85,2126,3646
"Bolivia","Cochabamba","Cercado","Cochabamba","UNIDAD EDUCATIVA ESTADOS UNIDOS",-66.16256,-17.41906,219,11,1660,1879,1034,42,573,1607
"Bolivia","Cochabamba","Cercado","Cochabamba","UNIDAD EDUCATIVA ESTEBAN ARZE",-66.18428,-17.39833,431,8,3409,3840,2256,104,1041,3297
"Bolivia","Cochabamba","Cercado","Cochabamba","UNIDAD EDUCATIVA FACUNDO QUIROGA",-66.18948,-17.37427,47,3,366,413,274,8,81,355
"Bolivia","Cochabamba","Cercado","Cochabamba","UNIDAD EDUCATIVA FELIX CAPRILES",-66.18253,-17.40841,73,4,784,857,534,19,227,761
"Bolivia","Cochabamba","Cercado","Cochabamba","UNIDAD EDUCATIVA GARIBALDI",-66.19059,-17.35455,222,13,1744,1966,1027,25,679,1706
"Bolivia","Cochabamba","Cercado","Cochabamba","UNIDAD EDUCATIVA HNO PACIFICO FELETTI",-66.20975,-17.46777,98,13,905,1003,205,33,654,859
"Bolivia","Cochabamba","Cercado","Cochabamba","UNIDAD EDUCATIVA JOSE IGNACIO SANJINES",-66.20641,-17.38527,95,7,1050,1145,661,27,355,1016
"Bolivia","Cochabamba","Cercado","Cochabamba","UNIDAD EDUCATIVA JUAN JOSE TORREZ",-66.11476,-17.44767,149,17,1415,1564,442,40,916,1358
"Bolivia","Cochabamba","Cercado","Cochabamba","UNIDAD EDUCATIVA MARIA EMILIA RIQUELME (EX MARIA CRISTINA)",-66.20455,-17.39834,479,20,3711,4190,2143,117,1431,3574
"Bolivia","Cochabamba","Cercado","Cochabamba","UNIDAD EDUCATIVA MARIA JOSEFA MUJIA",-66.14333,-17.42708,325,42,2969,3294,862,119,1946,2808
"Bolivia","Cochabamba","Cercado","Cochabamba","UNIDAD EDUCATIVA NATANIEL AGUIRRE",-66.16888,-17.39892,22,1,332,354,237,8,86,323
"Bolivia","Cochabamba","Cercado","Cochabamba","UNIDAD EDUCATIVA NUEVA ESPERANZA",-66.17866,-17.48736,628,77,5669,6297,1543,230,3819,5362
"Bolivia","Cochabamba","Cercado","Cochabamba","UNIDAD EDUCATIVA NUEVA VERA CRUZ",-66.11756,-17.46273,420,21,2889,3309,1009,97,1762,2771
"Bolivia","Cochabamba","Cercado","Cochabamba","UNIDAD EDUCATIVA OBISPO ANAYA",-66.12938,-17.45243,340,21,2445,2785,1038,64,1322,2360
"Bolivia","Cochabamba","Cercado","Cochabamba","UNIDAD EDUCATIVA PRIMERO DE MAYO",-66.20525,-17.46752,798,74,5989,6787,1676,212,4027,5703
"Bolivia","Cochabamba","Cercado","Cochabamba","UNIDAD EDUCATIVA PROF. OSCAR ROJAS CABALLERO",-66.15136,-17.43501,34,2,318,352,157,6,153,310
"Bolivia","Cochabamba","Cercado","Cochabamba","UNIDAD EDUCATIVA RENE BARRIENTOS ORTUÑO",-66.11013,-17.47701,993,89,6018,7011,1732,243,3954,5686
"Bolivia","Cochabamba","Cercado","Cochabamba","UNIDAD EDUCATIVA RENE CRESPO",-66.151,-17.42624,95,6,823,918,275,33,509,784
"Bolivia","Cochabamba","Cercado","Cochabamba","UNIDAD EDUCATIVA ROSENDO PEÑA",-66.19244,-17.37992,45,1,481,526,361,12,107,468
"Bolivia","Cochabamba","Cercado","Cochabamba","UNIDAD EDUCATIVA SAN MIGUEL",-66.14757,-17.40514,471,22,2432,2903,1105,67,1238,2343
"Bolivia","Cochabamba","Cercado","Cochabamba","UNIDAD EDUCATIVA SAN MIGUEL ALTA TENSION",-66.13224,-17.43877,79,16,649,728,215,13,405,620
"Bolivia","Cochabamba","Cercado","Cochabamba","UNIDAD EDUCATIVA SANTA CRUZ - EDUARDO OCAMPO MOSCOSO",-66.15053,-17.41479,20,1,132,152,51,2,78,129
"Bolivia","Cochabamba","Cercado","Cochabamba","UNIDAD EDUCATIVA SANTA MARIA MICAELA",-66.17656,-17.40725,717,16,5180,5897,3518,125,1521,5039
"Bolivia","Cochabamba","Cercado","Cochabamba","UNIDAD EDUCATIVA SANTIAGO",-66.1651,-17.3495,383,23,3641,4024,1680,131,1807,3487
"Bolivia","Cochabamba","Cercado","Cochabamba","UNIDAD EDUCATIVA SIGLO XX - GABRIELA MISTRAL",-66.12198,-17.43334,140,16,1338,1478,485,38,799,1284
"Bolivia","Cochabamba","Cercado","Cochabamba","UNIDAD EDUCATIVA STEFANO HOTELLIER",-66.13995,-17.46966,184,24,1891,2075,487,75,1305,1792
"Bolivia","Cochabamba","Cercado","Cochabamba","UNIDAD EDUCATIVA VERDAD Y VIDA",-66.10658,-17.47467,235,33,2227,2462,598,80,1516,2114
"Bolivia","Cochabamba","Cercado","Cochabamba","UNIDAD EDUCATIVA VISION MUNDIAL",-66.1441,-17.43991,692,39,4831,5523,2164,146,2482,4646
"Bolivia","Cochabamba","Cercado","Cochabamba","UNIDAD EDUCATIVA VOCES LIBRES",-66.13216,-17.47402,23,7,329,352,66,9,247,313
"Bolivia","Cochabamba","Cercado","Cochabamba","UNIDAD EDU. EDUARDO LOPEZ O E.DON BOSCO",-66.17724,-17.4273,373,29,2362,2735,1017,57,1259,2276
"Bolivia","Beni","Cercado","San Javier","ESCUELA ESPIRITU SANTO",-64.80295,-14.63469,7,0,34,41,13,0,21,34
"Bolivia","Beni","Cercado","San Javier","ESCUELA LAGUNA COLORADA",-64.63057,-14.63861,15,0,33,48,14,0,19,33
"Bolivia","Beni","Cercado","San Javier","ESCUELA NUEVA ISRAEL",-64.3355,-14.67209,110,7,420,530,195,36,182,377
"Bolivia","Beni","Cercado","San Javier","ESCUELA PEDRO IGNACIO MUIBA",-64.08376,-14.49183,23,1,161,184,74,0,86,160
"Bolivia","Beni","Cercado","San Javier","ESCUELA SAN JAVIER",-64.88087,-14.59987,63,4,287,350,141,2,140,281
"Bolivia","Beni","Cercado","San Javier","ESCUELA SAN PEDRO",-64.90086,-14.33668,79,2,319,398,157,10,150,307
"Bolivia","Beni","Cercado","San Javier","U.E. LA CURVA",-64.20807,-14.58863,41,2,100,141,37,3,58,95
"Bolivia","Beni","Cercado","Trinidad","CARCEL DE MUJERES",-64.90281,-14.84692,9,1,36,45,19,0,16,35
"Bolivia","Beni","Cercado","Trinidad","CARCEL MOCOBI",-64.90376,-14.77958,0,0,178,178,62,50,66,128
"Bolivia","Beni","Cercado","Trinidad","CENTRO INTEGRADO SAN FRANCISCO DE ASIS",-64.88588,-14.82278,85,4,686,771,488,11,183,671
"Bolivia","Beni","Cercado","Trinidad","COL. JOAQUIN HURTADO CHAVEZ",-64.90425,-14.81511,383,17,1922,2305,1225,38,642,1867
"Bolivia","Beni","Cercado","Trinidad","COL. LA SALLE",-64.89569,-14.82676,329,5,1457,1786,1045,38,369,1414
"Bolivia","Beni","Cercado","Trinidad","COL. SAN VICENTE (EX UAB)",-64.91093,-14.8346,631,20,3141,3772,2072,80,969,3041
"Bolivia","Beni","Cercado","Trinidad","ESC.4 DE  FEBRERO",-64.90131,-14.84447,801,36,3606,4407,2139,91,1340,3479
"Bolivia","Beni","Cercado","Trinidad","ESC.CORINA HURTADO DE",-64.89422,-14.84378,458,15,2434,2892,1438,50,931,2369
"Bolivia","Beni","Cercado","Trinidad","ESC.J.AZURDUY DE PADILLA",-64.8893,-14.82634,271,8,1612,1883,1128,36,440,1568
"Bolivia","Beni","Cercado","Trinidad","ESC.J. CHAVEZ SUAREZ",-64.90463,-14.8414,1158,36,5202,6360,3120,112,1934,5054
"Bolivia","Beni","Cercado","Trinidad","ESC.J. LORENZO CAMPERO",-64.89998,-14.8257,226,7,1423,1649,982,23,411,1393
"Bolivia","Beni","Cercado","Trinidad","ESC. LOMA SUAREZ",-64.96272,-14.76063,202,7,444,646,182,19,236,418
"Bolivia","Beni","Cercado","Trinidad","ESC. MANGALITO",-64.91572,-14.84847,371,11,1608,1979,872,32,693,1565
"Bolivia","Beni","Cercado","Trinidad","ESC.MARY RIBERA G.",-64.88783,-14.81399,613,20,3832,4445,2571,95,1146,3717
"Bolivia","Beni","Cercado","Trinidad","ESC.MAYOR PEDRO VACA DIEZ",-64.96582,-14.86952,100,3,236,336,109,1,123,232
"Bolivia","Beni","Cercado","Trinidad","ESC.NICOLAS SUAREZ",-64.90492,-14.83268,444,10,2080,2524,1516,37,517,2033
"Bolivia","Beni","Cercado","Trinidad","ESC. NUESTRA SEÑORA DE FATIMA",-64.89811,-14.83099,758,18,3338,4096,2229,82,1009,3238
"Bolivia","Beni","Cercado","Trinidad","ESC. PEDRO IGNACIO MUIBA",-64.91414,-14.84481,472,25,2346,2818,1413,96,812,2225
"Bolivia","Beni","Cercado","Trinidad","ESC.PUERTO BALLIVIAN",-64.97205,-14.79312,20,2,119,139,55,0,62,117
"Bolivia","Beni","Cercado","Trinidad","ESC. PUERTO VARADOR",-64.99762,-14.87702,128,13,453,581,242,21,177,419
"Bolivia","Beni","Cercado","Trinidad","ESC. RAUL MONJE ROCA",-64.8938,-14.83707,439,7,2240,2679,1414,74,745,2159
"Bolivia","Beni","Cercado","Trinidad","ESC.SAN ANTONIO",-64.91032,-14.83844,573,47,3077,3650,2005,42,983,2988
"Bolivia","Beni","Cercado","Trinidad","ESC.SAN JOSE",-64.90439,-14.82626,209,9,1272,1481,931,21,311,1242
"Bolivia","Beni","Cercado","Trinidad","ESC.SAN JUAN DE AGUAS DULCES",-64.57809,-14.80817,12,0,89,101,67,0,22,89
"Bolivia","Beni","Cercado","Trinidad","ESCUELA 13 DE ABRIL",-64.8902,-14.83764,333,22,2304,2637,1262,129,891,2153
"Bolivia","Beni","Cercado","Trinidad","ESCUELA CASARABE",-64.47997,-14.87161,112,3,415,527,228,9,175,403
"Bolivia","Beni","Cercado","Trinidad","ESCUELA EMILIO CAMPOS PEDRIEL",-64.8847,-14.81962,388,12,1994,2382,1324,39,619,1943
"Bolivia","Beni","Cercado","Trinidad","ESCUELA IVIATO",-64.44854,-14.83285,40,1,172,212,94,0,77,171
"Bolivia","Beni","Cercado","Trinidad","ESCUELA NUEVA TRINIDAD",-64.8754,-14.82357,857,28,3145,4002,1882,72,1163,3045
"Bolivia","Beni","Cercado","Trinidad","ESC. URBANIZ.MANA",-64.9059,-14.77769,100,2,512,612,306,5,199,505
"Bolivia","Beni","Cercado","Trinidad","ESC. VILLA VECINAL",-64.87392,-14.81023,400,26,2609,3009,1791,40,752,2543
"Bolivia","Beni","Cercado","Trinidad","INFOCAL",-64.90236,-14.82328,231,7,1082,1313,736,19,320,1056
"Bolivia","Beni","Cercado","Trinidad","LICEO MARIO SAIELLY",-64.90276,-14.83593,321,6,1655,1976,1150,17,482,1632
"Bolivia","Beni","Cercado","Trinidad","U.A.B. (CARRERA DE DERECHO)",-64.91308,-14.83274,454,46,2151,2605,1438,31,636,2074
"Bolivia","Beni","Cercado","Trinidad","U.E 15 DE AGOSTO",-64.92943,-14.83425,115,11,811,926,454,19,327,781
"Bolivia","Beni","Cercado","Trinidad","U.E GONZALO SUAREZ D.",-64.90136,-14.85325,80,5,337,417,214,4,114,328
"Bolivia","Beni","Cercado","Trinidad","U.E LUIS ESPINAL CAMS",-64.92085,-14.84365,160,16,1065,1225,577,22,450,1027
"Bolivia","Beni","Cercado","Trinidad","U.E. ORLANDO MONASTERIO CLAURE",-64.93098,-14.8181,22,7,259,281,151,4,97,248
"Bolivia","Beni","General Jose Ballivián Segurola","Puerto Rurrenabaque","ESC. ASUNCION DEL QUIQUIBEY",-67.51161,-14.64125,29,2,73,102,36,2,33,69
"Bolivia","Beni","General Jose Ballivián Segurola","Puerto Rurrenabaque","ESC.CENTRAL NUEVOS HORIZONTES",-67.27888,-14.59985,115,9,374,489,122,29,214,336
"Bolivia","Beni","General Jose Ballivián Segurola","Puerto Rurrenabaque","ESC.CENTRAL PIEDRAS BLANCAS",-67.15208,-14.78934,100,16,586,686,79,15,476,555
"Bolivia","Beni","General Jose Ballivián Segurola","Puerto Rurrenabaque","ESC.GUALBERTO VILLARRUEL",-67.5281,-14.44452,861,31,2868,3729,1703,52,1082,2785
"Bolivia","Beni","General Jose Ballivián Segurola","Puerto Rurrenabaque","ESC. PLAYA ANCHA",-67.26197,-14.62954,27,5,164,191,12,9,138,150
"Bolivia","Beni","General Jose Ballivián Segurola","Puerto Rurrenabaque","ESCUELA VILLA LOURDES",-67.5043,-14.42944,45,5,152,197,71,3,73,144
"Bolivia","Beni","General Jose Ballivián Segurola","Puerto Rurrenabaque","UNIDAD EDUCATIVA LUCIO LENS",-67.52292,-14.44037,953,50,3672,4625,2055,165,1402,3457
"Bolivia","Beni","General Jose Ballivián Segurola","Reyes","COL. NACIONAL REYES",-67.33482,-14.29558,370,16,1409,1779,779,27,587,1366
"Bolivia","Beni","General Jose Ballivián Segurola","Reyes","ESC. BUEN DESTINO",-66.76987,-11.76321,21,4,102,123,17,2,79,96
"Bolivia","Beni","General Jose Ballivián Segurola","Reyes","ESC. CENTRAL BAQUETY",-66.79783,-12.53514,65,0,48,113,4,1,43,47
"Bolivia","Beni","General Jose Ballivián Segurola","Reyes","ESC.CENTRAL PUERTO CAVINAS",-66.91502,-12.53129,85,5,133,218,46,1,81,127
"Bolivia","Beni","General Jose Ballivián Segurola","Reyes","ESC. CONSTANZA VARGAS",-66.73828,-11.73581,11,0,24,35,13,2,9,22
"Bolivia","Beni","General Jose Ballivián Segurola","Reyes","ESC.JESUS ALVAREZ",-67.3343,-14.29483,471,23,1650,2121,912,74,641,1553
"Bolivia","Beni","General Jose Ballivián Segurola","Reyes","ESC.PEÑA AMARILLA",-66.67179,-11.5471,61,2,95,156,77,2,14,91
"Bolivia","Beni","General Jose Ballivián Segurola","Reyes","ESC. RENE BARRIENTOS ORTUÑO",-67.33835,-14.29512,113,1,310,423,174,9,126,300
"Bolivia","Beni","General Jose Ballivián Segurola","Reyes","ESC. SAN JOSE",-67.37435,-14.30772,12,1,89,101,41,5,42,83
"Bolivia","Beni","General Jose Ballivián Segurola","Reyes","ESC. SAN MARCOS",-67.50578,-13.81978,3,0,22,25,18,1,3,21
"Bolivia","Beni","General Jose Ballivián Segurola","Reyes","ESC. SORAIDA",-67.50439,-14.05581,17,0,24,41,14,0,10,24
"Bolivia","Beni","General Jose Ballivián Segurola","Reyes","ESCUELA DE CALIFORNIA",-66.90263,-11.95482,16,0,54,70,22,1,31,53
"Bolivia","Beni","General Jose Ballivián Segurola","Reyes","U.E. CARMEN ALTO",-66.36278,-11.71022,6,4,88,94,39,1,44,83
"Bolivia","Beni","General Jose Ballivián Segurola","San Borja","COL. ARNULFO MARTINEZ",-66.74274,-14.86135,1010,35,3361,4371,1946,68,1312,3258
"Bolivia","Beni","General Jose Ballivián Segurola","San Borja","COL.INDUSTRIAL INGAVI",-67.03596,-15.14148,666,37,2392,3058,828,69,1458,2286
"Bolivia","Beni","General Jose Ballivián Segurola","San Borja","COL.SAN FRANCISCO DE BORJA",-66.75023,-14.85829,760,29,2731,3491,1804,62,836,2640
"Bolivia","Beni","General Jose Ballivián Segurola","San Borja","ESC.DE PUERTO YUCUMO",-66.93755,-15.19761,36,3,276,312,16,6,251,267
"Bolivia","Beni","General Jose Ballivián Segurola","San Borja","ESC.EL CHACAL",-66.62759,-14.75295,62,6,300,362,3,3,288,291
"Bolivia","Beni","General Jose Ballivián Segurola","San Borja","ESC.EL PALMAR",-67.08794,-14.97903,131,20,688,819,150,19,499,649
"Bolivia","Beni","General Jose Ballivián Segurola","San Borja","ESC.GERMAN BUSCH",-66.74983,-14.85664,707,19,2407,3114,1615,47,726,2341
"Bolivia","Beni","General Jose Ballivián Segurola","San Borja","ESC. INDIGENA ARENALES",-66.9127,-15.10867,41,8,455,496,13,12,422,435
"Bolivia","Beni","General Jose Ballivián Segurola","San Borja","ESC.JUNRRENO",-66.93327,-14.37257,11,1,32,43,15,0,16,31
"Bolivia","Beni","General Jose Ballivián Segurola","San Borja","ESC. LA CRUZ",-66.73125,-14.97601,78,14,584,662,38,9,523,561
"Bolivia","Beni","General Jose Ballivián Segurola","San Borja","ESC.LA EMBOCADA",-66.73125,-14.97601,85,1,254,339,96,7,150,246
"Bolivia","Beni","General Jose Ballivián Segurola","San Borja","ESC.LAS ABRAS",-66.93307,-14.4615,12,4,77,89,6,0,67,73
"Bolivia","Beni","General Jose Ballivián Segurola","San Borja","ESC. MISION FATIMA",-66.746,-15.45636,43,7,352,395,23,3,319,342
"Bolivia","Beni","General Jose Ballivián Segurola","San Borja","ESC.SANTA ELENA DEL CARIPO",-66.82342,-14.5799,19,1,102,121,39,0,62,101
"Bolivia","Beni","General Jose Ballivián Segurola","San Borja","ESC.S.JUAN DEL REMANZO",-66.5321,-14.67902,8,0,39,47,7,0,32,39
"Bolivia","Beni","General Jose Ballivián Segurola","San Borja","ESC. TACUARAL DE MATTOS",-66.53598,-14.99362,39,46,471,510,17,8,400,417
"Bolivia","Beni","General Jose Ballivián Segurola","San Borja","ESCUELA EL ORIENTE DEL YACUMA",-66.99512,-14.35404,26,1,79,105,34,0,44,78
"Bolivia","Beni","General Jose Ballivián Segurola","San Borja","U.E. MANGUITO",-66.63986,-14.89842,39,10,458,497,56,3,389,445
"Bolivia","Beni","General Jose Ballivián Segurola","San Borja","U.E MARCA COROICO",-67.08862,-14.78361,10,4,109,119,14,7,84,98
"Bolivia","Beni","General Jose Ballivián Segurola","San Borja","U.E. QUIQUIBEY",-67.0975,-15.36358,27,1,174,201,22,1,150,172
"Bolivia","Beni","General Jose Ballivián Segurola","San Borja","U.E SAN IGNACIO DEL MANIQUI",-66.72903,-14.85899,101,7,365,466,195,8,155,350
"Bolivia","Beni","General Jose Ballivián Segurola","San Borja","U.E VILLA SAN ANTONIO",-66.74652,-14.87003,108,6,463,571,252,13,192,444
"Bolivia","Beni","General Jose Ballivián Segurola","Santa Rosa","COLEGIO NACIONAL SANTA ROSA",-66.78864,-14.07823,263,4,654,917,407,23,220,627
"Bolivia","Beni","General Jose Ballivián Segurola","Santa Rosa","ESC.CENTRAL PALMA FLOR",-66.6287,-12.96253,45,1,71,116,40,9,21,61
"Bolivia","Beni","General Jose Ballivián Segurola","Santa Rosa","ESC.EL CANDADO",-66.84259,-13.50823,30,2,80,110,25,1,52,77
"Bolivia","Beni","General Jose Ballivián Segurola","Santa Rosa","ESC. EL CERRITO",-66.7103,-13.09042,22,1,82,104,53,1,27,80
"Bolivia","Beni","General Jose Ballivián Segurola","Santa Rosa","ESC.EL TRIUNFO",-66.76116,-13.86169,58,0,223,281,118,1,104,222
"Bolivia","Beni","General Jose Ballivián Segurola","Santa Rosa","ESC.GERARDO REYES",-66.79248,-14.07916,509,30,2303,2812,1545,43,685,2230
"Bolivia","Beni","General Jose Ballivián Segurola","Santa Rosa","ESC. PUERTO TERESA",-66.60133,-13.44813,18,0,67,85,49,1,17,66
"Bolivia","Beni","General Jose Ballivián Segurola","Santa Rosa","ESC.PUERTO YATA",-66.63308,-13.45108,66,5,119,185,81,1,32,113
"Bolivia","Beni","General Jose Ballivián Segurola","Santa Rosa","ESCUELA AUSTRALIA",-66.52208,-12.78946,79,2,155,234,75,3,75,150
"Bolivia","Beni","General Jose Ballivián Segurola","Santa Rosa","ESCUELA EL ROSARIO",-66.71803,-13.82903,14,8,130,144,61,4,57,118
"Bolivia","Beni","Iténez","Baures","ESC. ALTA GRACIA",-63.66943,-13.63675,8,0,51,59,32,0,19,51
"Bolivia","Beni","Iténez","Baures","ESC. CAIRO II",-63.52425,-14.20468,7,0,22,29,0,0,22,22
"Bolivia","Beni","Iténez","Baures","ESC.CARMELO LOPEZ",-63.69662,-13.65491,305,11,1213,1518,674,7,521,1195
"Bolivia","Beni","Iténez","Baures","ESC.EL CAIRO",-63.72225,-13.72575,10,1,95,105,42,3,49,91
"Bolivia","Beni","Iténez","Baures","ESC.EL REMANZO",-61.8741,-13.52387,114,4,291,405,126,5,156,282
"Bolivia","Beni","Iténez","Baures","ESC. MONTE CRISTO DEL TIQUIN",-61.97526,-13.62647,100,3,121,221,21,3,94,115
"Bolivia","Beni","Iténez","Baures","ESC. RURAL JASIAQUIRI",-63.7384,-13.72094,12,0,150,162,70,1,79,149
"Bolivia","Beni","Iténez","Baures","ESC.SAN SIMON",-62.02819,-13.61491,54,4,138,192,40,2,92,132
"Bolivia","Beni","Iténez","Baures","ESC.SECCIONAL CAFETAL",-61.88521,-13.49341,98,1,122,220,40,0,81,121
"Bolivia","Beni","Iténez","Huacaraje","ESC.EL CARMEN",-63.80146,-14.23021,129,2,461,590,275,5,179,454
"Bolivia","Beni","Iténez","Huacaraje","ESC.JUAN ALBERTO ORELLANA",-63.87964,-13.59328,313,15,1104,1417,627,17,445,1072
"Bolivia","Beni","Iténez","Huacaraje","NUCLEO ESCOLAR LA EMBROLLA",-63.82495,-13.6832,3,0,58,61,10,6,42,52
"Bolivia","Beni","Iténez","Magdalena","COL.CNEL.CARMELO CUELLAR J.",-63.79037,-13.23383,30,1,219,249,109,2,107,216
"Bolivia","Beni","Iténez","Magdalena","ESC.ANGEL CHAVEZ ARZA",-64.24437,-12.89689,10,1,112,122,30,0,81,111
"Bolivia","Beni","Iténez","Magdalena","ESC.BUENA VISTA",-64.23037,-12.45551,133,7,236,369,109,4,116,225
"Bolivia","Beni","Iténez","Magdalena","ESC.CENTRAL 1O. DE MAYO",-63.37995,-12.65748,2,0,36,38,3,0,33,36
"Bolivia","Beni","Iténez","Magdalena","ESC.GIL COIMBRA",-64.05195,-13.25954,419,19,1839,2258,1018,22,780,1798
"Bolivia","Beni","Iténez","Magdalena","ESC.JOSE BALLIVIAN",-64.05527,-13.26313,184,9,1079,1263,584,30,456,1040
"Bolivia","Beni","Iténez","Magdalena","ESC.LA CAYOBA",-64.08502,-13.09004,9,0,69,78,45,2,22,67
"Bolivia","Beni","Iténez","Magdalena","ESC. SAN BORJA RIO BLANCO",-64.10181,-12.62778,25,4,146,171,77,1,64,141
"Bolivia","Beni","Iténez","Magdalena","ESC.SANTA MARIA",-63.825,-13.11831,8,0,84,92,55,0,29,84
"Bolivia","Beni","Iténez","Magdalena","U.E. MACEDONIO PAZ PINO",-63.70535,-13.27234,226,8,927,1153,454,23,442,896
"Bolivia","Beni","Mamoré","Puerto Siles","ESC.ALEJANDRIA",-65.06511,-12.08011,3,2,47,50,12,1,32,44
"Bolivia","Beni","Mamoré","Puerto Siles","ESC.ANTOFAGASTA",-65.00496,-12.80045,57,1,159,216,43,3,112,155
"Bolivia","Beni","Mamoré","Puerto Siles","ESC.SANTA ROSA",-65.11021,-12.29405,48,3,121,169,90,0,28,118
"Bolivia","Beni","Mamoré","San Joaquín","ESC.CAP.ARTURO CUELLAR REA",-64.66712,-13.04515,431,9,1044,1475,506,80,449,955
"Bolivia","Beni","Mamoré","San Joaquín","ESC.CHACO LEJOS",-64.9071,-12.83958,3,1,29,32,9,0,19,28
"Bolivia","Beni","Mamoré","San Joaquín","ESC.LAS PEÑITAS",-64.4332,-12.65806,0,0,5,5,0,1,4,4
"Bolivia","Beni","Mamoré","San Joaquín","ESC. MORE-MONTE AZUL",-64.91856,-12.09472,12,0,50,62,0,0,50,50
"Bolivia","Beni","Mamoré","San Joaquín","ESC. PUERTO USTAREZ",-64.45786,-12.40728,10,1,44,54,14,1,28,42
"Bolivia","Beni","Mamoré","San Joaquín","UNIDAD EDUCATIVA 21 DE AGOSTO",-64.6656,-13.04053,381,11,1044,1425,583,20,430,1013
"Bolivia","Beni","Mamoré","San Ramón","ESC. EL CARMEN DE GUACAYANE",-64.37999,-13.12766,5,0,38,43,0,0,38,38
"Bolivia","Beni","Mamoré","San Ramón","ESC.EL POYORI",-64.42094,-13.00931,2,1,38,40,6,0,31,37
"Bolivia","Beni","Mamoré","San Ramón","ESC.NAPOLEON AÑEZ ORTIZ",-64.61865,-13.26702,463,16,1835,2298,999,24,796,1795
"Bolivia","Beni","Mamoré","San Ramón","U.E. LAS PEÑAS",-64.39467,-12.63922,7,0,4,11,2,0,2,4
"Bolivia","Beni","Marbán","Loreto","ESC.CAMIACO",-64.86686,-15.33278,57,0,246,303,155,7,84,239
"Bolivia","Beni","Marbán","Loreto","ESC.GUNDONOVIA",-65.11512,-15.51444,62,4,135,197,79,1,51,130
"Bolivia","Beni","Marbán","Loreto","ESC.PERFECTA VDA. DE BEJARANO",-64.76012,-15.19398,155,3,335,490,130,10,192,322
"Bolivia","Beni","Marbán","Loreto","ESC.SACHOJERE",-64.75289,-14.98731,60,1,183,243,79,2,101,180
"Bolivia","Beni","Marbán","Loreto","ESC.SAN ANTONIO",-64.99944,-15.1992,23,0,55,78,26,1,28,54
"Bolivia","Beni","Marbán","Loreto","ESC.SAN PABLO-ISIBORO",-65.14317,-15.70741,33,1,138,171,31,5,101,132
"Bolivia","Beni","Marbán","Loreto","ESCUELA SANTA ROSA DEL CHAPARE",-64.75703,-15.93923,22,0,27,49,21,0,6,27
"Bolivia","Beni","Marbán","Loreto","SANTA ROSA DEL ISIBORO",-65.20737,-16.26001,23,2,71,94,16,0,53,69
"Bolivia","Beni","Marbán","Loreto","U.E. PALERMO",-64.65648,-15.88381,3,0,21,24,8,0,13,21
"Bolivia","Beni","Marbán","Loreto","U.E. VILLA EL CARMEN DEL REMANZO",-65.00182,-15.25932,18,0,63,81,21,1,41,62
"Bolivia","Beni","Marbán","San Andrés","ESC.BUEN JESUS",-64.37089,-14.98918,45,5,248,293,153,4,86,239
"Bolivia","Beni","Marbán","San Andrés","ESC.CAIMANES",-64.05082,-15.16342,32,7,163,195,87,2,67,154
"Bolivia","Beni","Marbán","San Andrés","ESC.CENTRAL 2 DE AGOSTO",-63.86697,-15.24271,419,28,1546,1965,595,33,890,1485
"Bolivia","Beni","Marbán","San Andrés","ESC.HUMBERTO VELARDE",-64.66631,-15.02232,61,2,225,286,110,5,108,218
"Bolivia","Beni","Marbán","San Andrés","ESC.LA ISIGA-PERSEVERA",-64.32283,-15.39423,38,1,38,76,22,0,15,37
"Bolivia","Beni","Marbán","San Andrés","ESC. MONTE CRISTO",-64.37347,-15.61208,29,1,46,75,21,0,24,45
"Bolivia","Beni","Marbán","San Andrés","ESC.PEROTO",-64.63706,-14.97516,41,3,145,186,82,1,59,141
"Bolivia","Beni","Marbán","San Andrés","ESC.SAN LORENZO",-64.7207,-15.03478,32,2,73,105,34,1,36,70
"Bolivia","Beni","Marbán","San Andrés","ESC.SANTA ROSA",-64.244,-15.10586,97,8,407,504,181,6,212,393
"Bolivia","Beni","Marbán","San Andrés","ESC.SOMOPAE",-64.65401,-14.94441,41,1,194,235,99,2,92,191
"Bolivia","Beni","Marbán","San Andrés","ESCUELA 4 DE JULIO",-63.46377,-15.73327,59,6,243,302,35,7,195,230
"Bolivia","Beni","Marbán","San Andrés","ESCUELA DE NUEVA BETANIA",-64.34632,-15.02995,55,3,219,274,90,3,123,213
"Bolivia","Beni","Marbán","San Andrés","ESCUELA ELVIRA",-64.60383,-14.92893,43,2,181,224,102,2,75,177
"Bolivia","Beni","Marbán","San Andrés","ESCUELA LIMONCITO",-63.46377,-15.73327,0,0,30,30,15,1,14,29
"Bolivia","Beni","Marbán","San Andrés","ESCUELA NUEVA MAGDALENA",-63.69929,-15.48585,51,0,117,168,31,0,86,117
"Bolivia","Beni","Marbán","San Andrés","ESCUELA TAJIBOTE",-64.08765,-15.63134,5,0,9,14,3,0,6,9
"Bolivia","Beni","Marbán","San Andrés","ESC. VILLA ALBA",-64.68153,-15.06132,30,0,135,165,65,2,68,133
"Bolivia","Beni","Marbán","San Andrés","ESC.VILLA BANZER",-64.41677,-14.94876,17,0,64,81,25,0,39,64
"Bolivia","Beni","Moxos","San Ignacio","COL.SOCRATES PARADA EGUEZ",-65.64265,-14.9983,661,55,2892,3553,1138,64,1635,2773
"Bolivia","Beni","Moxos","San Ignacio","ESC.CENTRAL SAN IGNACITO",-65.64748,-15.4581,8,0,21,29,6,0,15,21
"Bolivia","Beni","Moxos","San Ignacio","ESC.CENTRAL SANTA ROSA",-65.85181,-15.22264,5,2,91,96,10,0,79,89
"Bolivia","Beni","Moxos","San Ignacio","ESC. EL DESENGAÑO",-65.44534,-14.27502,45,2,121,166,59,2,58,117
"Bolivia","Beni","Moxos","San Ignacio","ESC.FATIMA",-65.34778,-14.91402,20,0,78,98,44,0,34,78
"Bolivia","Beni","Moxos","San Ignacio","ESC.LA ARGENTINA",-65.32679,-14.82843,9,0,68,77,24,1,43,67
"Bolivia","Beni","Moxos","San Ignacio","ESC.LITORAL",-65.57434,-14.97235,10,3,107,117,10,0,94,104
"Bolivia","Beni","Moxos","San Ignacio","ESC.MERCEDES DE LOJOJOTA",-65.57259,-16.5034,22,4,74,96,8,4,58,66
"Bolivia","Beni","Moxos","San Ignacio","ESC.MONTE GRANDE",-65.82966,-15.63879,23,1,90,113,16,8,65,81
"Bolivia","Beni","Moxos","San Ignacio","ESC.MONTE MAE",-65.72498,-15.53512,36,0,49,85,28,0,21,49
"Bolivia","Beni","Moxos","San Ignacio","ESC. OROMOMO",-66.18743,-16.04399,46,28,279,325,37,6,208,245
"Bolivia","Beni","Moxos","San Ignacio","ESC.OVIDIO ROCA C.",-65.55151,-15.55553,123,1,430,553,225,7,197,422
"Bolivia","Beni","Moxos","San Ignacio","ESC.PTO.SAN LORENZO",-65.4773,-15.77166,29,6,98,127,41,5,46,87
"Bolivia","Beni","Moxos","San Ignacio","ESC. PUERTO SAN BORJA",-65.79875,-14.98267,28,0,83,111,12,2,69,81
"Bolivia","Beni","Moxos","San Ignacio","ESC.RETIRO",-65.80604,-15.34924,15,1,106,121,2,2,101,103
"Bolivia","Beni","Moxos","San Ignacio","ESC.SAN ANTONIO DE IMOSE",-65.35487,-15.95693,45,2,94,139,48,9,35,83
"Bolivia","Beni","Moxos","San Ignacio","ESC.SAN FRANCISCO",-65.35629,-15.41029,63,8,231,294,68,7,148,216
"Bolivia","Beni","Moxos","San Ignacio","ESC.SAN JOSE DEL CABITU",-65.9744,-15.26368,60,1,163,223,35,6,121,156
"Bolivia","Beni","Moxos","San Ignacio","ESC.SAN JOSE DE PATROCINIO",-65.29938,-15.7724,16,0,22,38,20,0,2,22
"Bolivia","Beni","Moxos","San Ignacio","ESC.SAN MIGUELITO ISIBORO",-65.44078,-16.52943,15,1,68,83,6,4,57,63
"Bolivia","Beni","Moxos","San Ignacio","ESC.SUB-CENTRAL PUEBLO NUEVO",-65.88788,-15.24535,13,0,32,45,5,0,27,32
"Bolivia","Beni","Moxos","San Ignacio","ESC.TRINIDACITO",-65.30994,-15.76319,19,0,31,50,27,0,4,31
"Bolivia","Beni","Moxos","San Ignacio","ESCUELA DE BERMEO",-65.3772,-14.89496,28,1,82,110,30,0,51,81
"Bolivia","Beni","Moxos","San Ignacio","ESCUELA SANTÍSIMA TRINIDAD",-65.76534,-16.61358,21,3,160,181,42,2,113,155
"Bolivia","Beni","Moxos","San Ignacio","L.GILFREDO CORTEZ CANDIA",-65.64448,-14.99516,671,44,2561,3232,964,47,1506,2470
"Bolivia","Beni","Moxos","San Ignacio","U.E. SAN BERNARDO",-65.2933,-15.65132,43,2,92,135,73,3,14,87
"Bolivia","Beni","Vaca Diéz","Puerto Guayaramerín","(CÁRCEL) PENAL GUAYARAMERIN",-65.35279,-10.81292,11,0,22,33,11,1,10,21
"Bolivia","Beni","Vaca Diéz","Puerto Guayaramerín","CENTRO EDUCATIVO SIMON BOLIVAR",-65.36375,-10.83101,75,4,283,358,175,3,101,276
"Bolivia","Beni","Vaca Diéz","Puerto Guayaramerín","COL. 6 DE JUNIO",-65.34737,-10.82762,365,9,1476,1841,976,27,464,1440
"Bolivia","Beni","Vaca Diéz","Puerto Guayaramerín","COL. ALTO DE LA ALIANZA",-65.36181,-10.82369,485,15,1787,2272,1098,40,634,1732
"Bolivia","Beni","Vaca Diéz","Puerto Guayaramerín","COLEGIO ANTONIO VACA DIEZ",-65.35497,-10.81294,92,3,342,434,224,2,113,337
"Bolivia","Beni","Vaca Diéz","Puerto Guayaramerín","COLEGIO MANUEL VICENTE BALLIVIAN",-65.35051,-10.81116,182,1,302,484,218,5,78,296
"Bolivia","Beni","Vaca Diéz","Puerto Guayaramerín","COL. EVANGELICO NACIONAL",-65.35439,-10.81791,541,9,1442,1983,905,25,503,1408
"Bolivia","Beni","Vaca Diéz","Puerto Guayaramerín","COL.MANUEL ANTONIO OJOPI",-65.35567,-10.81322,732,14,2585,3317,1703,32,836,2539
"Bolivia","Beni","Vaca Diéz","Puerto Guayaramerín","DR.ELMER BOTSFORD",-65.35297,-10.8088,225,6,701,926,471,17,207,678
"Bolivia","Beni","Vaca Diéz","Puerto Guayaramerín","ESC.ANTOFAGASTA",-65.39104,-10.39382,15,0,51,66,28,0,23,51
"Bolivia","Beni","Vaca Diéz","Puerto Guayaramerín","ESC.CENTRAL SAN LORENZO",-65.23228,-11.73968,22,0,85,107,34,1,50,84
"Bolivia","Beni","Vaca Diéz","Puerto Guayaramerín","ESC.JUDDI DE SUAREZ",-65.58167,-10.53687,80,5,257,337,179,3,70,249
"Bolivia","Beni","Vaca Diéz","Puerto Guayaramerín","ESC. MEJILLONES",-65.35355,-10.82544,908,42,3354,4262,2205,58,1049,3254
"Bolivia","Beni","Vaca Diéz","Puerto Guayaramerín","ESC.ROSARIO DEL YATA",-65.57995,-10.99195,72,3,200,272,84,6,107,191
"Bolivia","Beni","Vaca Diéz","Puerto Guayaramerín","ESC. SAN FRANCISCO DEL YATA",-65.51111,-10.61194,15,1,46,61,29,0,16,45
"Bolivia","Beni","Vaca Diéz","Puerto Guayaramerín","ESC. SAN JOSE",-65.34554,-10.81522,402,12,1405,1807,904,25,464,1368
"Bolivia","Beni","Vaca Diéz","Puerto Guayaramerín","ESCUELA BRASIL",-65.3572,-10.8307,153,1,472,625,316,8,147,463
"Bolivia","Beni","Vaca Diéz","Puerto Guayaramerín","ESCUELA LOS ALMENDROS",-65.3472,-10.83402,425,10,1488,1913,890,44,544,1434
"Bolivia","Beni","Vaca Diéz","Puerto Guayaramerín","LIC.MIXTO GUAYAMERIN",-65.35883,-10.82098,541,8,1386,1927,891,24,463,1354
"Bolivia","Beni","Vaca Diéz","Puerto Guayaramerín","U.E. 9 DE ABRIL",-65.36181,-10.84011,25,2,266,291,154,5,105,259
"Bolivia","Beni","Vaca Diéz","Puerto Guayaramerín","U.E. BELEN",-65.35558,-10.83641,96,1,433,529,258,10,164,422
"Bolivia","Beni","Vaca Diéz","Puerto Guayaramerín","U.E MIGUEL ANTELO",-65.34438,-10.82256,49,0,186,235,111,8,67,178
"Bolivia","Beni","Vaca Diéz","Riberalta","(CÁRCEL) PENAL RIBERALTA",-66.0738,-10.99669,29,1,17,46,9,1,6,15
"Bolivia","Beni","Vaca Diéz","Riberalta","COL. 6 DE JUNIO",-66.077,-11.00458,534,11,1371,1905,1014,18,328,1342
"Bolivia","Beni","Vaca Diéz","Riberalta","COLEGIO EDUARDO ABAROA",-66.06204,-11.00703,637,23,2435,3072,1638,47,727,2365
"Bolivia","Beni","Vaca Diéz","Riberalta","COLEGIO ISMAEL CARRASCO TELLERIA",-66.05402,-11.01021,122,8,387,509,215,12,152,367
"Bolivia","Beni","Vaca Diéz","Riberalta","COLEGIO SAN FRANCISCO",-66.07206,-11.00753,81,3,359,440,244,7,105,349
"Bolivia","Beni","Vaca Diéz","Riberalta","COLEGIO SAN JUAN",-66.04671,-11.03188,542,57,1894,2436,967,57,813,1780
"Bolivia","Beni","Vaca Diéz","Riberalta","COLEGIO WALTER ALPIRE DURAN",-66.05729,-11.01164,157,6,638,795,429,8,195,624
"Bolivia","Beni","Vaca Diéz","Riberalta","COL. PEDRO KRAMER",-66.06915,-10.99869,391,8,1297,1688,929,37,323,1252
"Bolivia","Beni","Vaca Diéz","Riberalta","COL. SAN JOSE OBRERO",-66.06607,-10.99754,484,12,1271,1755,894,21,344,1238
"Bolivia","Beni","Vaca Diéz","Riberalta","COMITE CIVICO TUMICHUCUA",-66.16624,-11.14738,73,11,254,327,145,20,78,223
"Bolivia","Beni","Vaca Diéz","Riberalta","ESC.BRITANICA",-66.05006,-11.01523,915,39,2819,3734,1780,89,911,2691
"Bolivia","Beni","Vaca Diéz","Riberalta","ESC.FELIX SATTORY ROMAN",-66.06739,-11.00182,858,22,3384,4242,2517,66,779,3296
"Bolivia","Beni","Vaca Diéz","Riberalta","ESC. JUANA AZURDUY DE PADILLA",-66.07388,-10.99538,257,4,847,1104,649,23,171,820
"Bolivia","Beni","Vaca Diéz","Riberalta","ESCUELA 12 DE OCTUBRE",-65.69309,-11.0167,65,6,206,271,93,2,105,198
"Bolivia","Beni","Vaca Diéz","Riberalta","ESCUELA 1RO DE DICIEMBRE",-66.07318,-11.01311,454,12,1301,1755,933,18,338,1271
"Bolivia","Beni","Vaca Diéz","Riberalta","ESCUELA ALTO IVON",-66.03656,-11.87361,21,4,244,265,4,3,233,237
"Bolivia","Beni","Vaca Diéz","Riberalta","ESCUELA BOLIVAR",-65.9,-11.00223,93,5,268,361,124,6,133,257
"Bolivia","Beni","Vaca Diéz","Riberalta","ESCUELA LOS TAJIBOS",-66.04456,-11.02086,1118,41,3198,4316,1929,76,1152,3081
"Bolivia","Beni","Vaca Diéz","Riberalta","ESCUELA MARIPOSA",-66.1415,-12.27631,20,1,87,107,51,5,30,81
"Bolivia","Beni","Vaca Diéz","Riberalta","ESCUELA NAZARETH",-66.3375,-11.38739,22,2,92,114,60,3,27,87
"Bolivia","Beni","Vaca Diéz","Riberalta","ESCUELA PETROLERA",-66.05014,-11.00229,1526,58,4261,5787,2792,100,1311,4103
"Bolivia","Beni","Vaca Diéz","Riberalta","ESCUELA SANTA MARIA",-65.93813,-11.1185,68,9,280,348,112,6,153,265
"Bolivia","Beni","Vaca Diéz","Riberalta","ESCUELA SANTUARIO",-66.4724,-11.5389,6,2,53,59,23,6,22,45
"Bolivia","Beni","Vaca Diéz","Riberalta","ESCUELA WARNES",-65.96947,-10.92752,166,10,185,351,105,4,66,171
"Bolivia","Beni","Vaca Diéz","Riberalta","KINDER JHON F. KENNEDY",-66.06571,-10.99814,298,18,1487,1785,1094,20,355,1449
"Bolivia","Beni","Vaca Diéz","Riberalta","POLITECNICO BENJAMIN BOWLES",-66.05167,-11.00485,866,24,2961,3827,1945,58,934,2879
"Bolivia","Beni","Vaca Diéz","Riberalta","U.E. BELLA FLOR",-66.21178,-11.33017,4,0,71,75,31,2,38,69
"Bolivia","Beni","Vaca Diéz","Riberalta","U.E FEDERICO DEMMER",-66.04344,-10.99968,429,20,1389,1818,904,42,423,1327
"Bolivia","Beni","Vaca Diéz","Riberalta","U.E. LA ESPERANZA",-66.0544,-11.06529,16,3,147,163,85,14,45,130
"Bolivia","Beni","Vaca Diéz","Riberalta","U.E. NUESTRA SEÑORA DEL CARMEN",-66.07724,-10.99875,465,15,1549,2014,1070,31,433,1503
"Bolivia","Beni","Vaca Diéz","Riberalta","U.E. POPECHI",-66.07248,-11.13074,26,11,186,212,78,7,90,168
"Bolivia","Beni","Vaca Diéz","Riberalta","UNIDAD EDUCATIVA NATANIEL GARCÍA CHAVEZ",-66.07935,-11.00858,687,35,2572,3259,1803,101,633,2436
"Bolivia","Beni","Yacuma","Exaltación","ESC. CAMPO ANA MARIA",-65.57471,-12.94433,4,0,23,27,6,0,17,23
"Bolivia","Beni","Yacuma","Exaltación","ESC.COOPERATIVA",-65.04883,-12.6354,15,0,46,61,19,1,26,45
"Bolivia","Beni","Yacuma","Exaltación","ESC.COQUINAL",-65.85875,-12.97027,26,2,165,191,35,2,126,161
"Bolivia","Beni","Yacuma","Exaltación","ESC.EL MOTACUSAL",-65.4307,-12.91581,10,1,71,81,34,0,36,70
"Bolivia","Beni","Yacuma","Exaltación","ESC.EL TROMPILLO",-65.11865,-13.11602,7,0,10,17,6,0,4,10
"Bolivia","Beni","Yacuma","Exaltación","ESC.JOSE MAX PAREDES",-65.25107,-13.32101,133,1,411,544,149,3,258,407
"Bolivia","Beni","Yacuma","Exaltación","ESC. NUEVA ESPERANZA",-66.00737,-12.97329,9,0,17,26,9,0,8,17
"Bolivia","Beni","Yacuma","Exaltación","ESC.SAN CARLOS",-65.70103,-13.23234,15,0,44,59,11,0,33,44
"Bolivia","Beni","Yacuma","Exaltación","ESC.SANTA ROSA",-66.16964,-13.51003,1,0,9,10,4,0,5,9
"Bolivia","Beni","Yacuma","Exaltación","ESCUELA PUERTO SANTIAGO",-65.20205,-13.10789,2,0,16,18,11,0,5,16
"Bolivia","Beni","Yacuma","Exaltación","ESCUELA SAN JUAN DEL JORDAN",-66.42942,-12.88492,12,0,22,34,12,0,10,22
"Bolivia","Beni","Yacuma","Santa Ana (de Yacuma)","COL.ANDRES ALBERDI SALEGUI",-65.4307,-13.7505,621,21,2129,2750,1406,29,673,2079
"Bolivia","Beni","Yacuma","Santa Ana (de Yacuma)","COLEGIO GUILLERMO SEARLE",-65.42456,-13.74432,225,7,663,888,403,10,243,646
"Bolivia","Beni","Yacuma","Santa Ana (de Yacuma)","COL.MONS.DANIEL RIVERO",-65.42525,-13.74378,971,44,3247,4218,1945,65,1193,3138
"Bolivia","Beni","Yacuma","Santa Ana (de Yacuma)","ESC.CEC EL TOTAISAL",-66.32708,-14.87791,58,1,158,216,58,5,94,152
"Bolivia","Beni","Yacuma","Santa Ana (de Yacuma)","ESC.LOS MONTES DE ORO",-65.8585,-14.33763,11,1,13,24,6,0,6,12
"Bolivia","Beni","Yacuma","Santa Ana (de Yacuma)","ESC.WENCESLAO AÑEZ",-65.63189,-14.60486,123,3,350,473,185,8,154,339
"Bolivia","Chuquisaca","Azurduy","Tarvita (Villa Orías)","ESCUELA 12 DE OCTUBRE",-64.46204,-19.78101,146,18,552,698,176,21,337,513
"Bolivia","Chuquisaca","Azurduy","Tarvita (Villa Orías)","ESCUELA CHUNCA CANCHA",-64.68405,-19.58565,6,2,73,79,4,10,57,61
"Bolivia","Chuquisaca","Azurduy","Tarvita (Villa Orías)","ESCUELA CRUZ CKASA",-64.57745,-19.87214,132,9,572,704,123,21,419,542
"Bolivia","Chuquisaca","Azurduy","Tarvita (Villa Orías)","ESCUELA LUIS EVENCIO ORÍAS",-64.44648,-19.61855,173,9,567,740,272,16,270,542
"Bolivia","Chuquisaca","Azurduy","Tarvita (Villa Orías)","ESCUELA MARISCAL BRAUN",-64.56983,-19.97382,66,13,388,454,143,15,217,360
"Bolivia","Chuquisaca","Azurduy","Tarvita (Villa Orías)","ESCUELA MOLLE CANCHA",-64.61646,-19.74335,6,0,75,81,4,1,70,74
"Bolivia","Chuquisaca","Azurduy","Tarvita (Villa Orías)","ESCUELA SAN JOSE DE ALISOS",-64.63702,-19.69949,45,6,207,252,44,5,152,196
"Bolivia","Chuquisaca","Azurduy","Tarvita (Villa Orías)","U.E. VILLA PAMPA",-64.51918,-19.65606,37,6,172,209,62,3,101,163
"Bolivia","Chuquisaca","Azurduy","Tarvita (Villa Orías)","UNIDAD EDUCATIVA ANTONIO TOVAR",-64.48597,-19.92718,198,31,807,1005,294,34,448,742
"Bolivia","Chuquisaca","Azurduy","Tarvita (Villa Orías)","UNIDAD EDUCATIVA JESÚS MAESTRO",-64.68082,-19.674,157,17,786,943,56,31,682,738
"Bolivia","Chuquisaca","Azurduy","Tarvita (Villa Orías)","UNIDAD EDUCATIVA PAMPAS DE LEQUE",-64.57776,-19.72431,27,5,288,315,22,3,258,280
"Bolivia","Chuquisaca","Azurduy","Villa Azurduy","ESCUELA DURAZNAL",-64.42482,-20.41302,37,2,193,230,18,5,168,186
"Bolivia","Chuquisaca","Azurduy","Villa Azurduy","ESCUELA HUANCARANI",-64.48476,-20.23491,29,1,131,160,3,7,120,123
"Bolivia","Chuquisaca","Azurduy","Villa Azurduy","ESCUELA PINOS",-64.45695,-20.32877,52,0,177,229,5,1,171,176
"Bolivia","Chuquisaca","Azurduy","Villa Azurduy","ESCUELA  RODEO CHICO",-64.53408,-20.24856,63,5,380,443,12,10,353,365
"Bolivia","Chuquisaca","Azurduy","Villa Azurduy","ESCUELA TABLANI",-64.56451,-20.06003,82,2,315,397,27,24,262,289
"Bolivia","Chuquisaca","Azurduy","Villa Azurduy","ESCUELA TORRECILLAS",-64.3971,-19.9672,56,3,133,189,36,9,85,121
"Bolivia","Chuquisaca","Azurduy","Villa Azurduy","U.E. COLLPAMAYU",-64.51823,-20.08899,51,9,282,333,14,8,251,265
"Bolivia","Chuquisaca","Azurduy","Villa Azurduy","U.E. QUEHUEÑAL",-64.4158,-19.92459,12,3,73,85,23,3,44,67
"Bolivia","Chuquisaca","Azurduy","Villa Azurduy","UNIDAD EDUCATIVA NICANOR LOPEZ",-64.41391,-20.10486,400,54,1556,1956,633,68,801,1434
"Bolivia","Chuquisaca","Azurduy","Villa Azurduy","UNIDAD EDUCATIVA SAN ROQUE",-64.51511,-20.13545,45,1,162,207,6,9,146,152
"Bolivia","Chuquisaca","Azurduy","Villa Azurduy","UNIDAD EDUCATIVA SANTA ROSA",-64.3904,-19.88058,76,2,138,214,33,5,98,131
"Bolivia","Chuquisaca","Belisario Boeto","Villa Serrano","COLEGIO DANIEL SANCHEZ BUSTAMANTE",-64.42113,-19.01643,85,9,476,561,67,25,375,442
"Bolivia","Chuquisaca","Belisario Boeto","Villa Serrano","ESCUELA DARIO OVANDO CUELLAR",-64.3476,-18.8886,38,2,134,172,4,8,120,124
"Bolivia","Chuquisaca","Belisario Boeto","Villa Serrano","ESCUELA ELISARDO PEREZ",-64.19292,-19.11728,61,5,240,301,67,9,159,226
"Bolivia","Chuquisaca","Belisario Boeto","Villa Serrano","ESCUELA HEROES DEL CHACO",-64.13771,-19.06195,54,3,199,253,15,3,178,193
"Bolivia","Chuquisaca","Belisario Boeto","Villa Serrano","ESCUELA JORGE ANIBARRO ZAPATA",-64.29203,-18.99208,127,13,442,569,87,20,322,409
"Bolivia","Chuquisaca","Belisario Boeto","Villa Serrano","ESCUELA LUIS SANTOS PRADO",-64.2653,-19.1737,20,0,95,115,4,3,88,92
"Bolivia","Chuquisaca","Belisario Boeto","Villa Serrano","ESCUELA MARISCAL SUCRE",-64.32195,-19.12737,494,67,2485,2979,948,112,1358,2306
"Bolivia","Chuquisaca","Belisario Boeto","Villa Serrano","ESCUELA RENÉ ANIBARRO GÓMEZ",-64.396,-18.8268,99,4,201,300,16,11,170,186
"Bolivia","Chuquisaca","Belisario Boeto","Villa Serrano","U.E. LAMPAZOS",-64.39145,-18.76599,3,0,72,75,15,2,55,70
"Bolivia","Chuquisaca","Belisario Boeto","Villa Serrano","U.E. LOTHAR BRUCKER",-64.36176,-18.82008,3,0,97,100,1,3,93,94
"Bolivia","Chuquisaca","Belisario Boeto","Villa Serrano","UNIDAD EDUCATIVA MAMERTO NAVA DURAN",-64.37803,-18.94884,47,3,150,197,15,10,122,137
"Bolivia","Chuquisaca","Belisario Boeto","Villa Serrano","UNID. EDUC. SAN MIGUEL DE LA QUEBRADA",-64.24857,-19.1079,29,2,91,120,6,5,78,84
"Bolivia","Chuquisaca","Hernando Siles","Monteagudo","ESCUELA 6 DE JUNIO",-64.11983,-20.33284,125,2,368,493,159,16,191,350
"Bolivia","Chuquisaca","Hernando Siles","Monteagudo","ESCUELA BERNARDO MONTEAGUDO",-63.95635,-19.78872,594,59,3297,3891,1692,101,1445,3137
"Bolivia","Chuquisaca","Hernando Siles","Monteagudo","ESCUELA CHAPIMAYU",-64.14899,-19.87584,70,2,268,338,62,8,196,258
"Bolivia","Chuquisaca","Hernando Siles","Monteagudo","ESCUELA DESPENSAS",-64.1007,-20.04283,61,2,173,234,71,10,90,161
"Bolivia","Chuquisaca","Hernando Siles","Monteagudo","ESCUELA EL ZAPALLAR",-63.93938,-19.80897,32,7,194,226,60,8,119,179
"Bolivia","Chuquisaca","Hernando Siles","Monteagudo","ESCUELA FERNANDEZ",-64.23994,-20.16429,46,3,168,214,72,4,89,161
"Bolivia","Chuquisaca","Hernando Siles","Monteagudo","ESCUELA MARÍA VDA. DE VALDA",-63.95535,-19.80042,630,50,3353,3983,1657,124,1522,3179
"Bolivia","Chuquisaca","Hernando Siles","Monteagudo","ESCUELA PAMPA HEREDIA",-64.0597,-19.80225,37,2,118,155,40,5,71,111
"Bolivia","Chuquisaca","Hernando Siles","Monteagudo","ESCUELA PEDERNAL",-64.11466,-19.77911,52,8,246,298,45,7,186,231
"Bolivia","Chuquisaca","Hernando Siles","Monteagudo","ESCUELA SAN LORENZO",-64.20084,-19.92886,24,2,139,163,31,5,101,132
"Bolivia","Chuquisaca","Hernando Siles","Monteagudo","ESCUELA YANA YANA",-64.13422,-20.19204,24,0,34,58,19,2,13,32
"Bolivia","Chuquisaca","Hernando Siles","Monteagudo","NUCLEO ESCOLAR BARTOLO",-64.03931,-19.66221,13,1,94,107,11,1,81,92
"Bolivia","Chuquisaca","Hernando Siles","Monteagudo","U. EDU. JUANA AZURDUY DE PADILLA",-63.9845,-20.0189,99,16,495,594,164,45,270,434
"Bolivia","Chuquisaca","Hernando Siles","Monteagudo","U. EDU. SAN MIGUEL DEL BAÑADO",-63.88668,-20.0789,87,22,503,590,198,23,260,458
"Bolivia","Chuquisaca","Hernando Siles","Monteagudo","U. EDU. SAN PEDRO DEL PARAPETI",-63.88159,-20.16382,15,0,59,74,35,1,23,58
"Bolivia","Chuquisaca","Hernando Siles","Monteagudo","UNIDAD EDUCATIVA AZERO NORTE",-63.99007,-19.56839,4,0,42,46,13,2,27,40
"Bolivia","Chuquisaca","Hernando Siles","Monteagudo","UNIDAD EDUCATIVA INGAVI",-64.0831,-20.21808,8,2,92,100,45,0,45,90
"Bolivia","Chuquisaca","Hernando Siles","Monteagudo","UNIDAD EDUCATIVA LOS ARCOS",-64.22605,-20.3155,25,0,92,117,21,4,67,88
"Bolivia","Chuquisaca","Hernando Siles","Monteagudo","UNIDAD EDUCATIVA REBECA DE LA VEGA",-63.97173,-19.81358,269,37,1608,1877,630,82,859,1489
"Bolivia","Chuquisaca","Hernando Siles","Monteagudo","UNIDAD EDUCATIVA ROLDANA",-64.12152,-19.80378,13,4,101,114,23,1,73,96
"Bolivia","Chuquisaca","Hernando Siles","Monteagudo","UNIDAD EDUCATIVA VALLE NUEVO",-63.98814,-19.9332,29,6,181,210,43,10,122,165
"Bolivia","Chuquisaca","Hernando Siles","San Pablo de Huacareta","COLEGIO AMISTAD A",-64.00413,-20.36557,328,14,1206,1534,748,26,418,1166
"Bolivia","Chuquisaca","Hernando Siles","San Pablo de Huacareta","ESCUELA MIGUEL JHASTER",-64.02778,-20.71865,46,5,189,235,120,1,63,183
"Bolivia","Chuquisaca","Hernando Siles","San Pablo de Huacareta","ESCUELA RAFAEL PABON",-64.14964,-20.57222,94,8,366,460,176,16,166,342
"Bolivia","Chuquisaca","Hernando Siles","San Pablo de Huacareta","ESCUELA SALVIO LANUZA",-63.89535,-20.5817,106,11,312,418,189,20,92,281
"Bolivia","Chuquisaca","Hernando Siles","San Pablo de Huacareta","UNIDAD BALDOMERO LOPEZ",-63.96331,-20.16225,65,8,254,319,109,8,129,238
"Bolivia","Chuquisaca","Hernando Siles","San Pablo de Huacareta","UNIDAD EDUCATIVA ATIRIMBIA",-63.93389,-20.8244,24,8,92,116,37,3,44,81
"Bolivia","Chuquisaca","Hernando Siles","San Pablo de Huacareta","UNIDAD EDUCATIVA ERNESTO THEOBALD",-64.15099,-20.51959,146,6,433,579,159,14,254,413
"Bolivia","Chuquisaca","Hernando Siles","San Pablo de Huacareta","UNIDAD EDUCATIVA HUIRASAI",-63.992,-20.61985,23,0,123,146,17,3,103,120
"Bolivia","Chuquisaca","Hernando Siles","San Pablo de Huacareta","UNIDAD EDUCATIVA SAN JORGE DE IPATY",-63.8552,-20.42435,51,9,298,349,18,10,261,279
"Bolivia","Chuquisaca","Luis Calvo","Macharetí","COLEGIO 27 DE MARZO",-63.28704,-20.70558,54,0,221,275,61,36,124,185
"Bolivia","Chuquisaca","Luis Calvo","Macharetí","COLEGIO FRAY QUEBRACHO",-63.32757,-20.99875,13,2,118,131,50,4,62,112
"Bolivia","Chuquisaca","Luis Calvo","Macharetí","ESCUELA 25 DE MAYO",-63.42398,-20.45202,75,10,410,485,110,7,283,393
"Bolivia","Chuquisaca","Luis Calvo","Macharetí","ESCUELA EDUARDO AVAROA",-63.3611,-20.81543,284,22,938,1222,464,37,415,879
"Bolivia","Chuquisaca","Luis Calvo","Macharetí","ESCUELA EL SIMBOLAR",-62.9492,-20.5253,16,2,55,71,25,4,24,49
"Bolivia","Chuquisaca","Luis Calvo","Macharetí","ESCUELA EL VINAL",-63.10925,-20.70269,18,3,53,71,23,3,24,47
"Bolivia","Chuquisaca","Luis Calvo","Macharetí","ESCUELA IPATI",-63.40212,-20.54343,25,7,139,164,73,2,57,130
"Bolivia","Chuquisaca","Luis Calvo","Macharetí","ESCUELA PEDRO DOMINGO MURILLO",-63.3061,-20.86273,10,1,62,72,4,0,57,61
"Bolivia","Chuquisaca","Luis Calvo","Macharetí","ESCUELA SAN JUAN DE CAMATINDI",-63.39542,-20.99425,37,5,147,184,44,6,92,136
"Bolivia","Chuquisaca","Luis Calvo","Macharetí","ESCUELA TIGUIPA PUEBLO",-63.38359,-20.91519,24,4,147,171,76,5,62,138
"Bolivia","Chuquisaca","Luis Calvo","Macharetí","U. EDU. HEROES DEL CHACO HERNADO SILES",-63.07143,-20.75865,106,8,259,365,151,6,94,245
"Bolivia","Chuquisaca","Luis Calvo","Macharetí","U.E. ISIPOTINDI",-63.31057,-20.61732,13,0,118,131,21,16,81,102
"Bolivia","Chuquisaca","Luis Calvo","Macharetí","U.E. TENTAMI",-63.3348,-20.937,13,1,75,88,7,2,65,72
"Bolivia","Chuquisaca","Luis Calvo","Macharetí","U.E. TIMBOYCITO",-63.311,-20.7379,5,1,46,51,13,0,32,45
"Bolivia","Chuquisaca","Luis Calvo","Macharetí","UNIDAD EDUCATIVA CUATRO VIENTOS",-62.68652,-20.86266,6,1,24,30,20,0,3,23
"Bolivia","Chuquisaca","Luis Calvo","Macharetí","UNIDAD EDUCATIVA MANUEL MARIANO GÓMEZ",-63.06475,-20.53849,2,2,34,36,16,3,13,29
"Bolivia","Chuquisaca","Luis Calvo","Villa de Huacaya","ESCUELA BOYCOBO",-63.65736,-20.69879,17,2,102,119,24,2,74,98
"Bolivia","Chuquisaca","Luis Calvo","Villa de Huacaya","ESCUELA CHIMBE",-63.55851,-20.64951,10,0,34,44,4,1,29,33
"Bolivia","Chuquisaca","Luis Calvo","Villa de Huacaya","ESCUELA FRAY MARCOS OZETI",-63.52636,-20.48822,118,7,450,568,118,11,314,432
"Bolivia","Chuquisaca","Luis Calvo","Villa de Huacaya","ESCUELA SAN ANTONIO",-63.66537,-20.74458,57,0,177,234,78,3,96,174
"Bolivia","Chuquisaca","Luis Calvo","Villa de Huacaya","UNIDAD EDUCATIVA ANKAGUAZU",-63.67434,-20.88688,2,0,33,35,7,0,26,33
"Bolivia","Chuquisaca","Luis Calvo","Villa de Huacaya","UNIDAD EDUCATIVA BORORIGUA",-63.63357,-20.56405,22,0,140,162,26,2,112,138
"Bolivia","Chuquisaca","Luis Calvo","Villa Vaca Guzmán (Muyupampa)","CASA COMUNAL AGUAIRENDA",-63.76873,-19.46924,66,4,205,271,34,1,166,200
"Bolivia","Chuquisaca","Luis Calvo","Villa Vaca Guzmán (Muyupampa)","CASA COMUNAL TENTAYAPI",-63.85,-20.86667,21,1,190,211,2,0,187,189
"Bolivia","Chuquisaca","Luis Calvo","Villa Vaca Guzmán (Muyupampa)","ESCUELA HERNANDO SILES",-63.75016,-19.8965,490,42,2498,2988,1405,108,943,2348
"Bolivia","Chuquisaca","Luis Calvo","Villa Vaca Guzmán (Muyupampa)","ESCUELA RUFINO SALAZAR",-63.8163,-19.67933,67,7,200,267,70,6,117,187
"Bolivia","Chuquisaca","Luis Calvo","Villa Vaca Guzmán (Muyupampa)","ESCUELA SAPIRANGUIMIRI",-63.76806,-20.09122,16,2,78,94,26,6,44,70
"Bolivia","Chuquisaca","Luis Calvo","Villa Vaca Guzmán (Muyupampa)","ESCUELA TICUCHA",-63.82461,-19.62364,18,2,97,115,38,6,51,89
"Bolivia","Chuquisaca","Luis Calvo","Villa Vaca Guzmán (Muyupampa)","NUCLEO ESCOLAR CUMANDAITI",-63.84387,-19.45372,53,4,193,246,64,2,123,187
"Bolivia","Chuquisaca","Luis Calvo","Villa Vaca Guzmán (Muyupampa)","U.E. LEO SCHWARZ",-63.88537,-19.26629,5,1,58,63,17,2,38,55
"Bolivia","Chuquisaca","Luis Calvo","Villa Vaca Guzmán (Muyupampa)","UNIDAD EDUCATIVA IGUEMBE",-63.7504,-20.55215,86,6,326,412,115,26,179,294
"Bolivia","Chuquisaca","Luis Calvo","Villa Vaca Guzmán (Muyupampa)","UNIDAD EDUCATIVA ITAU",-63.76336,-20.27766,19,0,57,76,17,2,38,55
"Bolivia","Chuquisaca","Luis Calvo","Villa Vaca Guzmán (Muyupampa)","UNIDAD EDUCATIVA ITY",-63.7644,-19.6085,11,2,181,192,48,2,129,177
"Bolivia","Chuquisaca","Nor Cinti","Camargo","(CÁRCEL) CARCELETA PÚBLICA DE CAMARGO",-65.20866,-20.64096,6,0,15,21,6,0,9,15
"Bolivia","Chuquisaca","Nor Cinti","Camargo","COLEGIO BOLIVIA",-65.20852,-20.6396,414,32,1894,2308,1048,64,750,1798
"Bolivia","Chuquisaca","Nor Cinti","Camargo","COLEGIO NACIONAL MIXTO 3 DE ABRIL",-65.21046,-20.64259,475,27,2154,2629,1169,82,876,2045
"Bolivia","Chuquisaca","Nor Cinti","Camargo","ESCUELA EL CHURO",-65.13138,-20.63216,21,0,57,78,2,1,54,56
"Bolivia","Chuquisaca","Nor Cinti","Camargo","ESCUELA LA QUEMADA",-65.29808,-20.75148,13,2,98,111,33,10,53,86
"Bolivia","Chuquisaca","Nor Cinti","Camargo","ESCUELA RIO CHICO",-65.22565,-20.69902,23,1,127,150,42,4,80,122
"Bolivia","Chuquisaca","Nor Cinti","Camargo","ESCUELA YURAC CABALLO",-65.13165,-20.74312,41,3,144,185,27,7,107,134
"Bolivia","Chuquisaca","Nor Cinti","Camargo","UNIDAD EDUCATIVA CARPACHACRA",-65.34814,-20.64821,18,1,99,117,21,6,71,92
"Bolivia","Chuquisaca","Nor Cinti","Camargo","UNIDAD EDUCATIVA CUEVA PAMPA",-65.04705,-20.45579,45,4,167,212,14,3,146,160
"Bolivia","Chuquisaca","Nor Cinti","Camargo","UNIDAD EDUCATIVA HIGUERA HUAYCO",-65.22394,-20.79629,47,5,174,221,48,3,118,166
"Bolivia","Chuquisaca","Nor Cinti","Camargo","UNIDAD EDUCATIVA HUACA CANCHA",-64.95026,-20.47788,57,4,118,175,6,8,100,106
"Bolivia","Chuquisaca","Nor Cinti","Camargo","UNIDAD EDUCATIVA JATUN QUINRAY",-64.9914,-20.5823,16,1,86,102,7,0,78,85
"Bolivia","Chuquisaca","Nor Cinti","Camargo","UNIDAD EDUCATIVA LINTACA",-65.34542,-20.73311,15,0,24,39,7,0,17,24
"Bolivia","Chuquisaca","Nor Cinti","Camargo","UNIDAD EDUCATIVA MUYUQUIRI",-65.14874,-20.49716,106,11,471,577,57,14,389,446
"Bolivia","Chuquisaca","Nor Cinti","Camargo","UNIDAD EDUCATIVA PALCA GRANDE",-65.23849,-20.7456,48,3,151,199,90,9,49,139
"Bolivia","Chuquisaca","Nor Cinti","Camargo","UNIDAD EDUCATIVA QUIRUCILLANI",-64.88852,-20.49862,0,0,28,28,0,0,28,28
"Bolivia","Chuquisaca","Nor Cinti","Camargo","UNIDAD EDUCATIVA SUQUISTACA",-65.09431,-20.38414,45,5,208,253,21,5,177,198
"Bolivia","Chuquisaca","Nor Cinti","Camargo","UNIDAD EDUCATIVA TACAQUIRA",-65.14967,-20.54018,107,0,260,367,69,12,179,248
"Bolivia","Chuquisaca","Nor Cinti","Incahuasi","ESCUELA 2 DE AGOSTO",-64.70975,-20.70182,52,6,334,386,14,7,307,321
"Bolivia","Chuquisaca","Nor Cinti","Incahuasi","ESCUELA EL VERANO",-64.6666,-20.56279,21,0,181,202,4,1,176,180
"Bolivia","Chuquisaca","Nor Cinti","Incahuasi","ESCUELA HUAJLAYA",-64.5423,-20.59936,109,15,256,365,28,4,209,237
"Bolivia","Chuquisaca","Nor Cinti","Incahuasi","ESCUELA JOLENCIA",-64.86333,-20.71497,72,11,316,388,60,24,221,281
"Bolivia","Chuquisaca","Nor Cinti","Incahuasi","ESCUELA LAMPAZAR",-64.4935,-20.5347,46,0,115,161,3,0,112,115
"Bolivia","Chuquisaca","Nor Cinti","Incahuasi","ESCUELA SAN LORENCITO",-64.87055,-20.79387,7,2,32,39,4,6,20,24
"Bolivia","Chuquisaca","Nor Cinti","Incahuasi","U.E. YATINA",-64.73019,-20.61985,90,10,285,375,19,8,248,267
"Bolivia","Chuquisaca","Nor Cinti","Incahuasi","UNIDAD EDUCATIVA EDUARDO AVAROA",-64.86781,-20.78048,398,24,1297,1695,493,57,723,1216
"Bolivia","Chuquisaca","Nor Cinti","Incahuasi","UNIDAD EDUCATIVA EL QUEMADO",-64.5985,-20.57037,5,2,257,262,3,2,250,253
"Bolivia","Chuquisaca","Nor Cinti","San Lucas","ESCUELA HUAYLLANI",-64.93605,-20.36235,66,6,194,260,6,4,178,184
"Bolivia","Chuquisaca","Nor Cinti","San Lucas","ESCUELA MOLLE PATA",-64.64008,-20.41311,81,7,264,345,36,17,204,240
"Bolivia","Chuquisaca","Nor Cinti","San Lucas","ESCUELA PAYACOTA DEL CARMEN",-65.25732,-20.21278,104,8,367,471,75,14,270,345
"Bolivia","Chuquisaca","Nor Cinti","San Lucas","U.E. CINTEÑO TAMBO",-65.01966,-20.22208,61,3,296,357,71,8,214,285
"Bolivia","Chuquisaca","Nor Cinti","San Lucas","U.E. CRUZ MAYU",-64.87011,-20.03394,2,2,90,92,1,0,87,88
"Bolivia","Chuquisaca","Nor Cinti","San Lucas","U. EDU. EDUARDO AVAROA",-65.13464,-20.1035,537,55,2040,2577,664,101,1220,1884
"Bolivia","Chuquisaca","Nor Cinti","San Lucas","U.E. EL TERRADO",-64.98693,-20.39509,15,2,133,148,5,1,125,130
"Bolivia","Chuquisaca","Nor Cinti","San Lucas","U.E. TORRE DE LINARES",-64.7693,-19.901,55,8,171,226,8,0,155,163
"Bolivia","Chuquisaca","Nor Cinti","San Lucas","UNIDAD EDUCATIVA 12 DE ABRIL",-65.02613,-20.27677,159,12,691,850,96,13,570,666
"Bolivia","Chuquisaca","Nor Cinti","San Lucas","UNIDAD EDUCATIVA ACCHILLA",-64.80387,-20.32539,141,13,250,391,16,11,210,226
"Bolivia","Chuquisaca","Nor Cinti","San Lucas","UNIDAD EDUCATIVA BUENA VISTA",-64.93593,-19.9318,52,1,175,227,5,3,166,171
"Bolivia","Chuquisaca","Nor Cinti","San Lucas","UNIDAD EDUCATIVA CANCHAS BLANCAS",-64.79684,-20.03145,104,8,256,360,16,6,226,242
"Bolivia","Chuquisaca","Nor Cinti","San Lucas","UNIDAD EDUCATIVA CHILLAGUA",-64.96616,-20.26884,62,1,265,327,14,3,247,261
"Bolivia","Chuquisaca","Nor Cinti","San Lucas","UNIDAD EDUCATIVA CIVITA",-64.90813,-20.00292,8,0,110,118,0,3,107,107
"Bolivia","Chuquisaca","Nor Cinti","San Lucas","UNIDAD EDUCATIVA HUAÑUMILLA",-64.74733,-19.94859,81,1,267,348,18,6,242,260
"Bolivia","Chuquisaca","Nor Cinti","San Lucas","UNIDAD EDUCATIVA JAPO",-64.77112,-20.09636,34,2,113,147,9,2,100,109
"Bolivia","Chuquisaca","Nor Cinti","San Lucas","UNIDAD EDUCATIVA KOLLPA",-64.65379,-20.03951,66,0,257,323,2,6,249,251
"Bolivia","Chuquisaca","Nor Cinti","San Lucas","UNIDAD EDUCATIVA LAJA CKASA",-64.94637,-20.19596,87,5,190,277,24,8,153,177
"Bolivia","Chuquisaca","Nor Cinti","San Lucas","UNIDAD EDUCATIVA MURIFAYA",-65.00114,-20.13484,13,3,94,107,9,4,78,87
"Bolivia","Chuquisaca","Nor Cinti","San Lucas","UNIDAD EDUCATIVA OCURI",-65.05057,-20.21683,74,21,392,466,30,7,334,364
"Bolivia","Chuquisaca","Nor Cinti","San Lucas","UNIDAD EDUCATIVA PADCOYO",-65.15222,-20.23535,186,23,665,851,96,17,529,625
"Bolivia","Chuquisaca","Nor Cinti","San Lucas","UNIDAD EDUCATIVA PALACIO TAMBO",-64.9901,-20.21117,278,36,822,1100,181,38,567,748
"Bolivia","Chuquisaca","Nor Cinti","San Lucas","UNIDAD EDUCATIVA PASLA",-64.78234,-19.94768,27,4,151,178,1,0,146,147
"Bolivia","Chuquisaca","Nor Cinti","San Lucas","UNIDAD EDUCATIVA PIRHUANI",-64.6492,-20.16914,111,4,290,401,2,4,280,282
"Bolivia","Chuquisaca","Nor Cinti","San Lucas","UNIDAD EDUCATIVA ROSENDO LA FUENTE",-65.01423,-20.3716,149,17,529,678,92,15,405,497
"Bolivia","Chuquisaca","Nor Cinti","San Lucas","UNIDAD EDUCATIVA SACAVILLQUE CHICO",-64.6198,-20.30524,112,8,204,316,13,11,172,185
"Bolivia","Chuquisaca","Nor Cinti","San Lucas","UNIDAD EDUCATIVA SAN PEDRO DE HUANAYA",-64.69353,-20.28096,16,3,91,107,1,0,87,88
"Bolivia","Chuquisaca","Nor Cinti","San Lucas","UNIDAD EDUCATIVA TAMBILLOS",-65.27066,-20.04161,102,33,284,386,18,4,229,247
"Bolivia","Chuquisaca","Nor Cinti","San Lucas","UNIDAD EDUCATIVA TAMBO CKASA",-64.7476,-20.33026,120,1,223,343,0,1,221,221
"Bolivia","Chuquisaca","Nor Cinti","San Lucas","UNIDAD EDUCATIVA TOROJCHI",-64.9986,-19.99369,32,1,122,154,13,4,104,117
"Bolivia","Chuquisaca","Nor Cinti","San Lucas","UNIDAD EDUCATIVA URUCHINI",-64.98957,-19.87956,53,3,129,182,27,7,92,119
"Bolivia","Chuquisaca","Nor Cinti","Villa Charcas","COLEGIO PADRE LANDINI SIMON BOLIVAR",-64.88494,-20.72522,756,80,2586,3342,773,151,1582,2355
"Bolivia","Chuquisaca","Nor Cinti","Villa Charcas","ESCUELA BOMBOMA",-64.69144,-20.44497,8,1,75,83,7,0,67,74
"Bolivia","Chuquisaca","Nor Cinti","Villa Charcas","ESCUELA CAIZA K",-64.74667,-20.52791,76,8,232,308,8,5,211,219
"Bolivia","Chuquisaca","Nor Cinti","Villa Charcas","ESCUELA LLUJLLAYA",-64.73945,-20.54849,45,20,255,300,12,6,217,229
"Bolivia","Chuquisaca","Nor Cinti","Villa Charcas","ESCUELA SANTA ELENA",-64.77654,-20.58304,86,5,359,445,15,9,330,345
"Bolivia","Chuquisaca","Nor Cinti","Villa Charcas","ESCUELA SUPAS",-64.77631,-20.43394,57,17,314,371,11,4,282,293
"Bolivia","Chuquisaca","Nor Cinti","Villa Charcas","U.E. MOLLINI",-64.71598,-20.45341,17,1,57,74,3,1,52,55
"Bolivia","Chuquisaca","Nor Cinti","Villa Charcas","UNIDAD EDUCATIVA JOSE ANTONIO ZAMPA",-64.85761,-20.66362,78,10,682,760,84,13,575,659
"Bolivia","Chuquisaca","Oropeza","Poroma","COLEGIOMANUEL OVANDO SAN JUAN DE ORCAS",-65.31216,-18.73248,86,10,251,337,37,16,188,225
"Bolivia","Chuquisaca","Oropeza","Poroma","COLEGIO RAFAEL CAMPOS DE LUJE",-65.21857,-18.78213,49,3,186,235,35,5,143,178
"Bolivia","Chuquisaca","Oropeza","Poroma","ESCUELA CENTRAL CHALLCHA",-65.54505,-18.44033,64,2,296,360,89,13,192,281
"Bolivia","Chuquisaca","Oropeza","Poroma","ESCUELA KAYNACAS",-65.404,-18.86573,32,4,171,203,26,3,138,164
"Bolivia","Chuquisaca","Oropeza","Poroma","ESCUELA SAN SALVADOR DE POJPO",-65.32699,-18.79455,75,14,259,334,61,10,174,235
"Bolivia","Chuquisaca","Oropeza","Poroma","POSTA SANITARIA",-65.28516,-18.49988,15,0,23,38,4,1,18,22
"Bolivia","Chuquisaca","Oropeza","Poroma","PUESTO DE SALUD VIRU VIRU",-65.651,-18.38448,21,9,124,145,26,8,81,107
"Bolivia","Chuquisaca","Oropeza","Poroma","SUB ALCALDÍA DE SAPSE",-65.27885,-18.72523,36,7,152,188,43,3,99,142
"Bolivia","Chuquisaca","Oropeza","Poroma","U. EDU. SAN ANDRES DE POROMA",-65.42594,-18.53917,368,25,941,1309,278,51,587,865
"Bolivia","Chuquisaca","Oropeza","Poroma","UNIDAD EDUCATIVA CALIZAYA",-65.33015,-18.48993,11,1,104,115,20,3,80,100
"Bolivia","Chuquisaca","Oropeza","Poroma","UNIDAD EDUCATIVA CHIJMURI",-65.39856,-18.81042,38,8,146,184,34,3,101,135
"Bolivia","Chuquisaca","Oropeza","Poroma","UNIDAD EDUCATIVA COPAVILLQUE",-65.2855,-18.62391,90,3,292,382,48,16,225,273
"Bolivia","Chuquisaca","Oropeza","Poroma","UNIDAD EDUCATIVA CUCURI",-65.30397,-18.84813,34,8,212,246,43,9,152,195
"Bolivia","Chuquisaca","Oropeza","Poroma","UNIDAD EDUCATIVA HUAÑOMA",-65.59436,-18.45855,171,4,351,522,70,38,239,309
"Bolivia","Chuquisaca","Oropeza","Poroma","UNIDAD EDUCATIVA IRU KKOTA",-65.36794,-18.6862,53,11,192,245,42,7,132,174
"Bolivia","Chuquisaca","Oropeza","Poroma","UNIDAD EDUCATIVA LOS ALAMOS",-65.34219,-18.87337,29,12,225,254,53,5,155,208
"Bolivia","Chuquisaca","Oropeza","Poroma","UNIDAD EDUCATIVA PALAJLA",-65.46515,-18.45122,43,3,178,221,19,9,147,166
"Bolivia","Chuquisaca","Oropeza","Poroma","UNIDAD EDUCATIVA  PANGORASI",-65.39965,-18.60243,23,4,105,128,11,2,88,99
"Bolivia","Chuquisaca","Oropeza","Poroma","UNIDAD EDUCATIVA PIOCERA",-65.40269,-18.74838,21,3,111,132,20,2,86,106
"Bolivia","Chuquisaca","Oropeza","Poroma","UNIDAD EDUCATIVA SANABRIA",-65.33897,-18.93845,21,3,185,206,60,3,119,179
"Bolivia","Chuquisaca","Oropeza","Poroma","UNIDAD EDUCATIVA SIJCHA ALTA",-65.30686,-18.92584,13,3,128,141,17,1,107,124
"Bolivia","Chuquisaca","Oropeza","Poroma","UNIDAD EDUCATIVA URUGUAYO",-65.35072,-18.61396,13,2,104,117,10,4,88,98
"Bolivia","Chuquisaca","Oropeza","Poroma","UNIDAD EDUCATIVA YANANI",-65.43656,-18.59779,23,2,191,214,12,2,175,187
"Bolivia","Chuquisaca","Oropeza","Sucre","AASANA",-65.29323,-19.01331,650,58,5298,5948,3156,242,1842,4998
"Bolivia","Chuquisaca","Oropeza","Sucre","CAMPO DEPORTIVO 20 DE OCTUBRE",-65.28734,-19.02233,101,19,955,1056,600,27,309,909
"Bolivia","Chuquisaca","Oropeza","Sucre","CARCEL PUBLICA",-65.26225,-19.05368,52,0,172,224,97,4,71,168
"Bolivia","Chuquisaca","Oropeza","Sucre","COL. BERNARDO MONTEAGUDO",-65.25573,-19.04699,168,8,1134,1302,897,65,164,1061
"Bolivia","Chuquisaca","Oropeza","Sucre","COL. CARDENAL MAURER",-65.26183,-19.05324,275,10,1884,2159,1529,36,309,1838
"Bolivia","Chuquisaca","Oropeza","Sucre","COL. DON BOSCO",-65.26269,-19.04767,232,6,1365,1597,1121,24,214,1335
"Bolivia","Chuquisaca","Oropeza","Sucre","COLEGIO 23 DE MARZO",-65.2681,-19.04329,236,6,1573,1809,1198,48,321,1519
"Bolivia","Chuquisaca","Oropeza","Sucre","COLEGIO 24 DE SEPTIEMBRE - MARAGUA",-65.4332,-19.05204,78,15,275,353,50,20,190,240
"Bolivia","Chuquisaca","Oropeza","Sucre","COLEGIO DOMINGO SABIO",-65.27417,-19.04843,271,24,1829,2100,1228,74,503,1731
"Bolivia","Chuquisaca","Oropeza","Sucre","COLEGIO FE Y ALEGRIA",-65.26789,-19.03673,534,25,3944,4478,2832,132,955,3787
"Bolivia","Chuquisaca","Oropeza","Sucre","COLEGIO JUEZ BALTAZAR GARZÓN",-65.21569,-19.0804,34,11,492,526,218,26,237,455
"Bolivia","Chuquisaca","Oropeza","Sucre","COLEGIO JUNIN",-65.25817,-19.04907,226,6,1139,1365,943,22,168,1111
"Bolivia","Chuquisaca","Oropeza","Sucre","COLEGIO SIMÓN RODRÍGUEZ",-65.25462,-19.05121,332,4,1292,1624,1051,47,190,1241
"Bolivia","Chuquisaca","Oropeza","Sucre","COL. EMILIO HOSCHMAN",-65.26781,-19.01751,606,76,4854,5460,2608,289,1881,4489
"Bolivia","Chuquisaca","Oropeza","Sucre","COLISEO JORGE REVILLA ALDANA",-65.25701,-19.03738,189,9,1172,1361,921,26,216,1137
"Bolivia","Chuquisaca","Oropeza","Sucre","COL.JORGE REVILLA",-65.25858,-19.02505,714,44,5101,5815,3476,197,1384,4860
"Bolivia","Chuquisaca","Oropeza","Sucre","COL.MARIANO SERRANO",-65.25015,-19.04412,480,17,3392,3872,2667,67,641,3308
"Bolivia","Chuquisaca","Oropeza","Sucre","COL. SAGRADO CORAZON",-65.26104,-19.04679,218,4,1015,1233,849,19,143,992
"Bolivia","Chuquisaca","Oropeza","Sucre","COL. VICTORINO VEGA",-65.23779,-19.04786,623,40,4119,4742,2706,153,1220,3926
"Bolivia","Chuquisaca","Oropeza","Sucre","ESC. ANGEL BASPINEIRO",-65.31149,-19.00419,100,34,985,1085,397,68,486,883
"Bolivia","Chuquisaca","Oropeza","Sucre","ESC. ANICETO ARCE",-65.27341,-19.06394,778,39,4055,4833,2485,209,1322,3807
"Bolivia","Chuquisaca","Oropeza","Sucre","ESC. BENJAMIN GUZMAN",-65.25764,-19.03901,181,8,1433,1614,1102,37,286,1388
"Bolivia","Chuquisaca","Oropeza","Sucre","ESC. GUIDO VILLAGOMEZ",-65.28304,-19.02838,465,42,3786,4251,2348,177,1219,3567
"Bolivia","Chuquisaca","Oropeza","Sucre","ESC. HORNO KHASA",-65.25737,-19.01756,528,52,3914,4442,2197,200,1465,3662
"Bolivia","Chuquisaca","Oropeza","Sucre","ESC. JOSEFINA GOYTIA",-65.26051,-19.05899,177,14,1511,1688,1069,37,391,1460
"Bolivia","Chuquisaca","Oropeza","Sucre","ESC. LA RECOLETA",-65.25409,-19.05475,484,24,3405,3889,2508,126,747,3255
"Bolivia","Chuquisaca","Oropeza","Sucre","ESC.MARISCAL DE AYACUCHO",-65.25534,-19.0489,89,1,583,672,507,9,66,573
"Bolivia","Chuquisaca","Oropeza","Sucre","ESC. OVANDO",-65.2598,-19.0377,111,1,728,839,564,18,145,709
"Bolivia","Chuquisaca","Oropeza","Sucre","ESC. ROBERTO ALVARADO",-65.24728,-19.03056,630,31,4423,5053,2964,155,1273,4237
"Bolivia","Chuquisaca","Oropeza","Sucre","ESC.SAGRADA FAMILIA",-65.24627,-19.0241,671,41,4774,5445,3109,251,1373,4482
"Bolivia","Chuquisaca","Oropeza","Sucre","ESC. SAN JAVIER",-65.24428,-19.04221,353,10,3014,3367,2448,64,492,2940
"Bolivia","Chuquisaca","Oropeza","Sucre","ESC. SAN JUANILLO",-65.2558,-19.0316,1119,50,7280,8399,5102,255,1873,6975
"Bolivia","Chuquisaca","Oropeza","Sucre","ESC.TALLER DE INTEGRACION ETI",-65.23871,-19.04204,132,8,1257,1389,1001,31,217,1218
"Bolivia","Chuquisaca","Oropeza","Sucre","ESCUELA ARABATE",-65.15241,-19.07256,67,2,92,159,16,3,71,87
"Bolivia","Chuquisaca","Oropeza","Sucre","ESCUELA DANIEL CALVO",-65.26105,-19.04571,93,2,653,746,540,15,96,636
"Bolivia","Chuquisaca","Oropeza","Sucre","ESCUELA ELIZARDO PEREZ",-65.20616,-19.1318,35,5,255,290,92,15,143,235
"Bolivia","Chuquisaca","Oropeza","Sucre","ESCUELA FALAFAYA",-65.2095,-18.94874,43,6,191,234,85,18,82,167
"Bolivia","Chuquisaca","Oropeza","Sucre","ESCUELA FRAY GABRIEL MARIA LANDINI",-65.12765,-18.77743,119,39,608,727,185,26,358,543
"Bolivia","Chuquisaca","Oropeza","Sucre","ESCUELA FRAY GABRIEL MARISCAL",-65.1773,-18.63784,47,5,192,239,37,12,138,175
"Bolivia","Chuquisaca","Oropeza","Sucre","ESCUELA JOSÉ SAMPA",-65.17965,-18.89784,37,4,210,247,83,9,114,197
"Bolivia","Chuquisaca","Oropeza","Sucre","ESCUELA LLINFI",-65.30132,-18.98218,50,18,429,479,193,9,209,402
"Bolivia","Chuquisaca","Oropeza","Sucre","ESCUELA PUNILLA",-65.37293,-18.95657,32,6,235,267,110,12,107,217
"Bolivia","Chuquisaca","Oropeza","Sucre","ESCUELA SECCIONAL DE CHAUNACA",-65.43951,-18.99047,43,1,294,337,46,10,237,283
"Bolivia","Chuquisaca","Oropeza","Sucre","ESCUELA TUCSUPAYA",-65.27917,-19.0231,355,33,2798,3153,1781,144,840,2621
"Bolivia","Chuquisaca","Oropeza","Sucre","ESTACIÓN DE BOMBEROS",-65.2486,-19.04844,242,4,1870,2112,1433,38,395,1828
"Bolivia","Chuquisaca","Oropeza","Sucre","ESTADIUM PATRIA",-65.25877,-19.03283,550,20,3385,3935,2507,115,743,3250
"Bolivia","Chuquisaca","Oropeza","Sucre","FAC. DERECHO",-65.24686,-19.04547,351,3,2494,2845,1981,40,470,2451
"Bolivia","Chuquisaca","Oropeza","Sucre","FACULTAD DE MEDICINA",-65.26635,-19.04619,867,20,3949,4816,3035,109,785,3820
"Bolivia","Chuquisaca","Oropeza","Sucre","FACULTAD DE TECNOLOGÍA",-65.25661,-19.03967,728,22,3834,4562,2905,76,831,3736
"Bolivia","Chuquisaca","Oropeza","Sucre","FED. DE CHOFERES",-65.24286,-19.03716,419,22,3382,3801,2495,79,786,3281
"Bolivia","Chuquisaca","Oropeza","Sucre","FUNDACION PACHAMAMA",-65.26746,-19.04067,136,9,1120,1256,849,21,241,1090
"Bolivia","Chuquisaca","Oropeza","Sucre","H. VIRGEN DE LA HIEDRA",-65.27728,-19.03624,166,18,1533,1699,1025,60,430,1455
"Bolivia","Chuquisaca","Oropeza","Sucre","IGLESIA SAN MATÍAS",-65.26208,-19.03669,388,22,2753,3141,2097,64,570,2667
"Bolivia","Chuquisaca","Oropeza","Sucre","IPTK-N.AGUIRRE 560 / CERPI",-65.25272,-19.03685,341,10,2395,2736,1845,58,482,2327
"Bolivia","Chuquisaca","Oropeza","Sucre","JARDÍN DE NIÑOS SAN LÁZARO",-65.24966,-19.05094,248,15,1764,2012,1325,37,387,1712
"Bolivia","Chuquisaca","Oropeza","Sucre","KINDER ECHEVERRIA",-65.25982,-19.05163,144,0,925,1069,793,21,111,904
"Bolivia","Chuquisaca","Oropeza","Sucre","KINDER GERARDO VACA GUZMAN",-65.26248,-19.04274,84,3,501,585,396,11,91,487
"Bolivia","Chuquisaca","Oropeza","Sucre","KINDER MUNICIPAL",-65.26814,-19.05075,223,9,1704,1927,1313,42,340,1653
"Bolivia","Chuquisaca","Oropeza","Sucre","KINDER SAN VICENTE DE PAUL",-65.25596,-19.04462,265,7,1731,1996,1413,23,288,1701
"Bolivia","Chuquisaca","Oropeza","Sucre","KINDER SERRANO",-65.24963,-19.04423,98,2,640,738,491,15,132,623
"Bolivia","Chuquisaca","Oropeza","Sucre","LICEO MARÍA JOSEFA MUJIA",-65.26344,-19.04962,276,6,1720,1996,1367,48,299,1666
"Bolivia","Chuquisaca","Oropeza","Sucre","MERCADO YURAC YURAC",-65.27402,-19.02921,184,17,1677,1861,1092,89,479,1571
"Bolivia","Chuquisaca","Oropeza","Sucre","PLAZUELA SAN MATÍAS",-65.26157,-19.03634,271,14,1758,2029,1332,41,371,1703
"Bolivia","Chuquisaca","Oropeza","Sucre","SAL. MULT. BARRIO NUEVOS HORIZONTES",-65.24062,-19.07006,81,6,728,809,436,42,244,680
"Bolivia","Chuquisaca","Oropeza","Sucre","SAL.MULT. PLANTA DIESEL",-65.27349,-19.05489,194,3,1343,1537,1029,32,279,1308
"Bolivia","Chuquisaca","Oropeza","Sucre","SALON MULT. ALTO LOYOLA",-65.25202,-19.02552,224,24,1415,1639,905,56,430,1335
"Bolivia","Chuquisaca","Oropeza","Sucre","SALON MULTIFUNCIONAL AMERICA",-65.26705,-19.0604,176,21,1204,1380,737,47,399,1136
"Bolivia","Chuquisaca","Oropeza","Sucre","SALON MULTIFUNCIONAL EL ABRA",-65.24494,-19.06586,331,25,2380,2711,1506,98,751,2257
"Bolivia","Chuquisaca","Oropeza","Sucre","SALON MULTIFUNCIONAL EL NIÑO",-65.28127,-19.01439,61,4,533,594,395,10,124,519
"Bolivia","Chuquisaca","Oropeza","Sucre","SALON MULTIFUNCIONAL LA HOYADA",-65.26664,-19.05572,130,8,756,886,515,18,215,730
"Bolivia","Chuquisaca","Oropeza","Sucre","SALON MULTIFUNCIONAL PEDRO MEDRANO",-65.23917,-19.02556,19,2,319,338,189,10,118,307
"Bolivia","Chuquisaca","Oropeza","Sucre","SALON MULTIFUNCIONAL SAN FRANCISCO",-65.25436,-19.05559,113,5,1082,1195,826,28,223,1049
"Bolivia","Chuquisaca","Oropeza","Sucre","SALÓN MULTIFUNCIONAL SAN JUAN CACHIMAYU",-65.30952,-19.08966,7,2,132,139,62,3,65,127
"Bolivia","Chuquisaca","Oropeza","Sucre","SEMINARIO TEOLOGICO DEL SUR",-65.25397,-19.03208,322,16,2383,2705,1665,91,611,2276
"Bolivia","Chuquisaca","Oropeza","Sucre","TERMINAL DE BUSES",-65.24707,-19.0392,569,21,3822,4391,2986,73,742,3728
"Bolivia","Chuquisaca","Oropeza","Sucre","U.ED.FRANCISCO CERMEÑO",-65.25917,-19.02858,293,13,2239,2532,1692,49,485,2177
"Bolivia","Chuquisaca","Oropeza","Sucre","U. EDU. GUALBERTO VILLARROEL",-65.53341,-19.0159,157,24,846,1003,235,58,529,764
"Bolivia","Chuquisaca","Oropeza","Sucre","U.E. GASTÓN VILAR CASSO",-65.28537,-19.01114,35,8,639,674,370,38,223,593
"Bolivia","Chuquisaca","Oropeza","Sucre","U.E. LAS AMERICAS",-65.25094,-19.01372,664,53,4428,5092,2729,209,1437,4166
"Bolivia","Chuquisaca","Oropeza","Sucre","UNIDAD EDUCATIVA 6 DE JUNIO",-65.26705,-19.02696,635,59,4275,4910,2651,193,1372,4023
"Bolivia","Chuquisaca","Oropeza","Sucre","UNIDAD EDUCATIVA ALBERTO BOHORQUEZ",-65.29878,-19.02849,97,38,987,1084,397,72,480,877
"Bolivia","Chuquisaca","Oropeza","Sucre","UNIDAD EDUCATIVA ALEGRÍA",-65.27406,-18.99063,182,36,1414,1596,604,79,695,1299
"Bolivia","Chuquisaca","Oropeza","Sucre","UNIDAD EDUCATIVA CANTU MOLINO",-65.23275,-18.86053,30,3,154,184,36,5,110,146
"Bolivia","Chuquisaca","Oropeza","Sucre","UNIDAD EDUCATIVA CHUQUI CHUQUI",-65.1201,-18.82506,77,30,472,549,149,21,272,421
"Bolivia","Chuquisaca","Oropeza","Sucre","UNIDAD EDUCATIVA LA BARRANCA",-65.31851,-18.97461,40,12,451,491,189,24,226,415
"Bolivia","Chuquisaca","Oropeza","Sucre","UNIDAD EDUCATIVA LA PALMA",-65.12672,-18.95262,105,31,554,659,166,20,337,503
"Bolivia","Chuquisaca","Oropeza","Sucre","UNIDAD EDUCATIVA LUIS ESPINAL",-65.11092,-18.89592,58,8,457,515,184,15,250,434
"Bolivia","Chuquisaca","Oropeza","Sucre","UNIDAD EDUCATIVA QUILA QUILA",-65.377,-19.11972,126,20,454,580,183,38,213,396
"Bolivia","Chuquisaca","Oropeza","Sucre","UNIDAD EDUCATIVA RUFFO",-65.2886,-19.05783,61,17,648,709,311,33,287,598
"Bolivia","Chuquisaca","Oropeza","Sucre","UNIDAD EDUCATIVA SIMÓN BOLIVAR LA PALCA",-65.24233,-18.62139,27,1,95,122,21,3,70,91
"Bolivia","Chuquisaca","Oropeza","Sucre","UNIDAD EDUCATIVA SOICO",-65.26456,-18.81216,39,5,103,142,15,4,79,94
"Bolivia","Chuquisaca","Oropeza","Sucre","UNID. ED. HUGO POPPE ENTRAMBASAGUAS",-65.23246,-19.05145,390,39,2913,3303,1971,127,776,2747
"Bolivia","Chuquisaca","Oropeza","Sucre","UNID. ED. JOSE CLEMENTE MAURER",-65.23655,-19.08533,400,62,3216,3616,1716,122,1316,3032
"Bolivia","Chuquisaca","Oropeza","Sucre","UNID.EDUCATIVA VICTORIA DIEZ",-65.30588,-19.00942,689,137,5227,5916,2478,333,2279,4757
"Bolivia","Chuquisaca","Oropeza","Sucre","U.PEDAG.MARISCAL SUCRE",-65.26093,-19.03903,155,4,920,1075,743,21,152,895
"Bolivia","Chuquisaca","Oropeza","Yotala","CASA POSADA DE HUAYLLAS",-65.32174,-19.15824,63,6,188,251,34,8,140,174
"Bolivia","Chuquisaca","Oropeza","Yotala","CENTRO EDUCATIVO SANTA ROSA",-65.26758,-19.16187,184,8,887,1071,420,55,404,824
"Bolivia","Chuquisaca","Oropeza","Yotala","COLEGIO GREGORIO PACHECO",-65.26525,-19.16197,192,25,1040,1232,415,30,570,985
"Bolivia","Chuquisaca","Oropeza","Yotala","COLEGIO SAN ISIDRO DE ANFAYA",-65.21962,-19.25604,46,5,317,363,44,11,257,301
"Bolivia","Chuquisaca","Oropeza","Yotala","COLEGIO TASA PAMPA",-65.25967,-19.30862,22,2,200,222,11,4,183,194
"Bolivia","Chuquisaca","Oropeza","Yotala","ESCUELA ANTONIO TOVAR HINOJOSA",-65.17021,-19.30317,31,4,224,255,60,7,153,213
"Bolivia","Chuquisaca","Oropeza","Yotala","ESCUELA TIPAKA",-65.3103,-19.26145,18,0,133,151,25,6,102,127
"Bolivia","Chuquisaca","Oropeza","Yotala","POSTA DE SALUD Y SALÓN DE LA COMUNIDAD",-65.1908,-19.24057,17,0,132,149,14,3,115,129
"Bolivia","Chuquisaca","Oropeza","Yotala","UNIDAD EDUCATIVA CAMPANARIO",-65.26763,-19.10636,13,2,151,164,73,7,69,142
"Bolivia","Chuquisaca","Oropeza","Yotala","UNIDAD EDUCATIVA GERMAN BUSCH",-65.28329,-19.20276,37,3,188,225,71,5,109,180
"Bolivia","Chuquisaca","Oropeza","Yotala","UNIDAD EDUCATIVA JOSÉ VILLEGAS",-65.29339,-19.1495,16,0,135,151,29,4,102,131
"Bolivia","Chuquisaca","Oropeza","Yotala","UNIDAD EDUCATIVA TUERO CHICO",-65.21132,-19.33957,11,1,96,107,17,1,77,94
"Bolivia","Chuquisaca","Oropeza","Yotala","UNIDAD EDUCATIVA VICTOR SANDI",-65.24226,-19.15815,48,3,348,396,129,18,198,327
"Bolivia","Chuquisaca","Sur Cinti","Camataqui (Villa Abecia)","U. EDU. DANIEL SANCHEZ BUSTAMANTE",-65.2789,-21.0675,17,0,86,103,29,11,46,75
"Bolivia","Chuquisaca","Sur Cinti","Camataqui (Villa Abecia)","UNIDAD EDUCATIVA 23 DE MARZO",-65.23078,-20.97539,222,23,810,1032,282,49,456,738
"Bolivia","Chuquisaca","Sur Cinti","Camataqui (Villa Abecia)","UNIDAD EDUCATIVA 2 DE AGOSTO",-65.36425,-21.02694,24,4,116,140,6,0,106,112
"Bolivia","Chuquisaca","Sur Cinti","Camataqui (Villa Abecia)","UNIDAD EDUCATIVA ACHUMA",-65.3415,-20.9139,6,2,89,95,8,6,73,81
"Bolivia","Chuquisaca","Sur Cinti","Camataqui (Villa Abecia)","UNIDAD EDUCATIVA JAILIA",-65.27052,-20.93037,16,5,120,136,33,10,72,105
"Bolivia","Chuquisaca","Sur Cinti","Camataqui (Villa Abecia)","UNIDAD EDUCATIVA TARCANA",-65.26554,-21.0909,15,0,47,62,10,3,34,44
"Bolivia","Chuquisaca","Sur Cinti","Culpina","ESCUELA CAÑON VERDE",-64.23112,-21.13576,12,0,72,84,47,2,23,70
"Bolivia","Chuquisaca","Sur Cinti","Culpina","ESCUELA EL MANZANAL",-64.4059,-21.0985,45,1,59,104,7,0,51,58
"Bolivia","Chuquisaca","Sur Cinti","Culpina","U. EDU. JOSE ANTONIO ZAMPA",-64.94446,-20.8238,768,89,2870,3638,1084,121,1576,2660
"Bolivia","Chuquisaca","Sur Cinti","Culpina","UNIDAD EDUCATIVA EL CAMPAMENTO",-64.51948,-20.90218,45,2,132,177,29,2,99,128
"Bolivia","Chuquisaca","Sur Cinti","Culpina","UNIDAD EDUCATIVA EL MONTE",-64.91585,-21.00441,59,8,291,350,75,29,179,254
"Bolivia","Chuquisaca","Sur Cinti","Culpina","UNIDAD EDUCATIVA EL PALMAR",-64.31755,-20.85209,100,14,435,535,212,35,174,386
"Bolivia","Chuquisaca","Sur Cinti","Culpina","UNIDAD EDUCATIVA HUAJLITA",-64.60419,-20.82584,45,1,141,186,14,7,119,133
"Bolivia","Chuquisaca","Sur Cinti","Culpina","UNIDAD EDUCATIVA LA CIENEGA",-64.96812,-20.9327,15,1,59,74,24,5,29,53
"Bolivia","Chuquisaca","Sur Cinti","Culpina","UNIDAD EDUCATIVA LA CUEVA",-64.88244,-20.9315,45,3,158,203,21,6,128,149
"Bolivia","Chuquisaca","Sur Cinti","Culpina","UNIDAD EDUCATIVA LA LOMA",-64.72974,-20.85919,72,4,107,179,0,7,96,96
"Bolivia","Chuquisaca","Sur Cinti","Culpina","UNIDAD EDUCATIVA PILAYA",-64.689,-20.94015,36,7,57,93,14,2,34,48
"Bolivia","Chuquisaca","Sur Cinti","Culpina","UNIDAD EDUCATIVA PUCA LAJA",-64.64645,-20.77685,4,0,37,41,4,2,31,35
"Bolivia","Chuquisaca","Sur Cinti","Culpina","UNIDAD EDUCATIVA PUCA PAMPA",-64.5965,-20.77545,74,3,238,312,35,25,175,210
"Bolivia","Chuquisaca","Sur Cinti","Culpina","UNIDAD EDUCATIVA PUMA CKASA",-64.6648,-20.74907,64,1,87,151,12,6,68,80
"Bolivia","Chuquisaca","Sur Cinti","Culpina","UNIDAD EDUCATIVA SAJLINA",-64.99879,-20.80951,113,18,456,569,132,47,259,391
"Bolivia","Chuquisaca","Sur Cinti","Culpina","UNIDAD EDUCATIVA SALITRE",-64.90742,-20.90935,19,4,82,101,14,1,63,77
"Bolivia","Chuquisaca","Sur Cinti","Culpina","UNIDAD EDUCATIVA SAN FRANCISCO",-64.7111,-20.75573,54,7,78,132,16,4,51,67
"Bolivia","Chuquisaca","Sur Cinti","Culpina","UNIDAD EDUCATIVA SUMAYA",-64.78716,-20.75736,63,5,96,159,25,7,59,84
"Bolivia","Chuquisaca","Sur Cinti","Culpina","UNIDAD EDUCATIVA TOJLASA",-64.91499,-20.85254,91,12,367,458,103,31,221,324
"Bolivia","Chuquisaca","Sur Cinti","Las Carreras (Las carretas)","ESCUELA EL MONTE DE SANDOVAL",-65.21051,-21.16683,31,3,124,155,12,5,104,116
"Bolivia","Chuquisaca","Sur Cinti","Las Carreras (Las carretas)","ESCUELA MONTE DE TARAYA",-65.35029,-21.47675,8,0,24,32,0,0,24,24
"Bolivia","Chuquisaca","Sur Cinti","Las Carreras (Las carretas)","ESCUELA SOCPORA",-65.23065,-21.35275,3,2,47,50,16,3,26,42
"Bolivia","Chuquisaca","Sur Cinti","Las Carreras (Las carretas)","UNIDAD EDUCATIVA IMPORA",-65.27929,-21.36126,20,2,99,119,21,3,73,94
"Bolivia","Chuquisaca","Sur Cinti","Las Carreras (Las carretas)","UNIDAD EDUCATIVA JAIME MENDOZA",-65.21003,-21.2103,96,6,441,537,144,23,268,412
"Bolivia","Chuquisaca","Sur Cinti","Las Carreras (Las carretas)","UNIDAD EDUCATIVA LA TORRE",-65.2924,-21.2021,25,3,104,129,18,2,81,99
"Bolivia","Chuquisaca","Sur Cinti","Las Carreras (Las carretas)","UNIDAD EDUCATIVA LIME",-65.2624,-21.2043,42,1,160,202,18,3,138,156
"Bolivia","Chuquisaca","Sur Cinti","Las Carreras (Las carretas)","UNIDAD EDUCATIVA SAN JUAN",-65.21146,-21.21964,16,6,132,148,39,6,81,120
"Bolivia","Chuquisaca","Sur Cinti","Las Carreras (Las carretas)","UNIDAD EDUCATIVA SANTA ROSA",-65.22454,-21.32046,13,1,75,88,18,4,52,70
"Bolivia","Chuquisaca","Sur Cinti","Las Carreras (Las carretas)","UNIDAD EDUCATIVA TARAYA",-65.24155,-21.42857,8,0,95,103,32,5,58,90
"Bolivia","Chuquisaca","Tomina","El Villar","COLEGIO EDUARDO ABAROA",-64.31137,-19.6299,199,24,734,933,203,34,473,676
"Bolivia","Chuquisaca","Tomina","El Villar","ESCUELA SECCIONAL LA REVUELTA",-64.19889,-19.82226,65,8,435,500,106,19,302,408
"Bolivia","Chuquisaca","Tomina","El Villar","U.E. BARBECHOS",-64.29641,-19.5529,6,3,100,106,19,0,78,97
"Bolivia","Chuquisaca","Tomina","El Villar","UNIDAD EDUCATIVA EL DORADO",-64.3289,-19.79042,35,8,220,255,16,8,188,204
"Bolivia","Chuquisaca","Tomina","El Villar","UNIDAD EDUCATIVA SAN BLAS",-64.39065,-19.63341,38,0,135,173,7,5,123,130
"Bolivia","Chuquisaca","Tomina","Padilla","COLEGIO SAN PIO X",-64.3012,-19.30634,275,29,1520,1795,571,43,877,1448
"Bolivia","Chuquisaca","Tomina","Padilla","ESCUELA MANUEL A. PADILLA",-64.30116,-19.30746,292,35,1627,1919,606,59,927,1533
"Bolivia","Chuquisaca","Tomina","Padilla","NUCLEO ESCOLAR ADRIÁN MOYA TAPIA",-64.14172,-19.33275,103,2,235,338,47,4,182,229
"Bolivia","Chuquisaca","Tomina","Padilla","NUCLEO ESCOLAR HUMBERTO DELGADILLO",-64.1024,-19.56468,66,12,385,451,68,25,280,348
"Bolivia","Chuquisaca","Tomina","Padilla","U.E. CACIANO RODAS CARDENAS",-64.0046,-19.2876,19,0,90,109,15,2,73,88
"Bolivia","Chuquisaca","Tomina","Padilla","U.E. FRANZ TAMAYO",-64.23646,-19.50273,17,0,70,87,4,2,64,68
"Bolivia","Chuquisaca","Tomina","Padilla","U.E. MARISCAL SUCRE",-64.2164,-19.37816,15,1,75,90,18,7,49,67
"Bolivia","Chuquisaca","Tomina","Padilla","UNIDAD EDUCATIVA 29 DE MARZO",-64.21652,-19.24916,10,1,39,49,7,3,28,35
"Bolivia","Chuquisaca","Tomina","Padilla","UNIDAD EDUCATIVA 2 DE ABRIL LA CIENEGA",-64.29996,-19.21987,51,5,233,284,29,12,187,216
"Bolivia","Chuquisaca","Tomina","Padilla","UNIDAD EDUCATIVA SUSANA DURAN",-64.00618,-19.42285,16,4,85,101,17,3,61,78
"Bolivia","Chuquisaca","Tomina","Padilla","UNIDAD EDUCATIVA TELEMINA BARJA",-64.175,-19.4771,51,8,206,257,29,8,161,190
"Bolivia","Chuquisaca","Tomina","Sopachuy","COLEGIO 25 DE MAYO",-64.47521,-19.48693,125,12,529,654,169,20,328,497
"Bolivia","Chuquisaca","Tomina","Sopachuy","ESCUELA JUAN BOSING",-64.47478,-19.48648,155,18,740,895,228,44,450,678
"Bolivia","Chuquisaca","Tomina","Sopachuy","ESCUELA SIPICANI",-64.57142,-19.43305,28,1,230,258,13,3,213,226
"Bolivia","Chuquisaca","Tomina","Sopachuy","INTERNADO SANTA ROSA DE AMANCAYA",-64.55762,-19.32515,88,6,451,539,25,7,413,438
"Bolivia","Chuquisaca","Tomina","Sopachuy","U.E. PAMPAS PUNTA",-64.4611,-19.41523,9,0,143,152,23,6,114,137
"Bolivia","Chuquisaca","Tomina","Sopachuy","U.E. PASLAPAYA",-64.51927,-19.42884,3,1,109,112,2,5,101,103
"Bolivia","Chuquisaca","Tomina","Sopachuy","U.E. SAN JUAN DE HORCAS",-64.51885,-19.46673,8,1,123,131,5,3,114,119
"Bolivia","Chuquisaca","Tomina","Sopachuy","UNIDAD EDUCATIVA MAMA HUASI",-64.62706,-19.33403,2,0,176,178,1,1,174,175
"Bolivia","Chuquisaca","Tomina","Sopachuy","UNIDAD EDUCATIVA PAMPAS DEL CARMEN",-64.4129,-19.54599,30,1,108,138,7,3,97,104
"Bolivia","Chuquisaca","Tomina","Sopachuy","UNIDAD EDUCATIVA SECCIONAL MILANES",-64.47321,-19.5312,9,0,70,79,9,3,58,67
"Bolivia","Chuquisaca","Tomina","Tomina","ESCUELA LORENZO CATALA",-64.58754,-19.05812,36,4,288,324,35,13,236,271
"Bolivia","Chuquisaca","Tomina","Tomina","ESCUELA SIMÓN RODRIGUEZ",-64.47535,-19.35414,110,10,526,636,98,36,382,480
"Bolivia","Chuquisaca","Tomina","Tomina","U.E. ANTOFAGASTA",-64.44697,-19.25202,12,10,272,284,42,15,205,247
"Bolivia","Chuquisaca","Tomina","Tomina","U. E. SECCIONAL FAUSTINO SUAREZ",-64.56383,-19.18622,73,1,256,329,11,6,238,249
"Bolivia","Chuquisaca","Tomina","Tomina","UNIDAD EDUCATIVA EDUARDO AVAROA",-64.46201,-19.18713,294,35,1314,1608,393,58,828,1221
"Bolivia","Chuquisaca","Tomina","Tomina","UNIDAD EDUCATIVA KAWASIRI",-64.41315,-19.14396,12,2,74,86,11,3,58,69
"Bolivia","Chuquisaca","Tomina","Tomina","UNIDAD EDUCATIVA SECCIONAL FUERTE RUA",-64.49466,-19.24193,26,1,211,237,3,5,202,205
"Bolivia","Chuquisaca","Tomina","Tomina","UNIDAD EDUCATIVA VILLA FLORES",-64.55251,-19.30332,9,1,101,110,11,3,86,97
"Bolivia","Chuquisaca","Tomina","Tomina","UNIDA EDUCATIVA PUCARA",-64.5126,-19.05801,14,3,149,163,24,5,117,141
"Bolivia","Chuquisaca","Tomina","Villa Alcalá","ESCUELA OSCAR ALFARO",-64.33492,-19.5059,208,3,309,517,47,16,243,290
"Bolivia","Chuquisaca","Tomina","Villa Alcalá","UNIDAD EDUCATIVA ALCALA",-64.38977,-19.36522,167,22,880,1047,283,35,540,823
"Bolivia","Chuquisaca","Yamparaez","Tarabuco","COLEGIO ANICETO ARCE",-64.91212,-19.18131,337,49,1413,1750,469,95,800,1269
"Bolivia","Chuquisaca","Yamparaez","Tarabuco","COLEGIO NACIONAL MIXTO BOLIVIA",-64.90345,-19.06883,129,8,490,619,167,25,290,457
"Bolivia","Chuquisaca","Yamparaez","Tarabuco","COLEGIO PAMPA LUPIARA",-64.78364,-19.25895,131,10,523,654,170,14,329,499
"Bolivia","Chuquisaca","Yamparaez","Tarabuco","ESCUELA ALFREDO MARTINEZ RODAS",-64.86771,-19.02727,25,2,207,232,26,7,172,198
"Bolivia","Chuquisaca","Yamparaez","Tarabuco","ESCUELA COLLACAMANI",-64.90224,-19.25274,85,8,217,302,43,6,160,203
"Bolivia","Chuquisaca","Yamparaez","Tarabuco","ESCUELA GUSTAVO VALDIVIA DE PAJCHA",-65.03048,-18.97762,113,11,380,493,73,14,282,355
"Bolivia","Chuquisaca","Yamparaez","Tarabuco","ESCUELA TUNAS CHILLCA",-64.95135,-19.17794,42,4,164,206,9,3,148,157
"Bolivia","Chuquisaca","Yamparaez","Tarabuco","U. ED. SAN ANTONIO DE TOCA",-64.93372,-19.00779,9,1,119,128,23,5,90,113
"Bolivia","Chuquisaca","Yamparaez","Tarabuco","U. EDU. JAIME VILLA ZAMORA",-64.91453,-19.05788,46,18,312,358,74,8,212,286
"Bolivia","Chuquisaca","Yamparaez","Tarabuco","U. EDU. ROSALIA VDA. DE ANTEZANA",-64.91234,-19.18218,327,57,1488,1815,435,70,926,1361
"Bolivia","Chuquisaca","Yamparaez","Tarabuco","U. EDU. SALVADOR GÓMEZ RODRIGUEZ",-64.76074,-19.27787,46,7,166,212,21,10,128,149
"Bolivia","Chuquisaca","Yamparaez","Tarabuco","U. EDU. SAN JOSÉ DEL PAREDON",-64.83658,-19.25209,80,10,318,398,39,12,257,296
"Bolivia","Chuquisaca","Yamparaez","Tarabuco","UNIDAD EDUCATIVA CAYAMBUCO",-64.86732,-19.09398,22,1,162,184,12,10,139,151
"Bolivia","Chuquisaca","Yamparaez","Tarabuco","UNIDAD EDUCATIVA EL CARMEN",-64.99706,-19.06575,34,2,194,228,14,3,175,189
"Bolivia","Chuquisaca","Yamparaez","Tarabuco","UNIDAD EDUCATIVA LA CIENEGA",-64.99545,-19.15368,112,11,323,435,57,15,240,297
"Bolivia","Chuquisaca","Yamparaez","Tarabuco","UNIDAD EDUCATIVA SARUFAYA",-64.80127,-19.1101,56,10,254,310,32,5,207,239
"Bolivia","Chuquisaca","Yamparaez","Yamparez","COLEGIO ANA LEON DE HUASA CANCHA",-65.04116,-19.17783,72,3,319,391,45,15,256,301
"Bolivia","Chuquisaca","Yamparaez","Yamparez","COLEGIO GERARDO RIOS",-65.07349,-19.25555,77,9,360,437,89,12,250,339
"Bolivia","Chuquisaca","Yamparaez","Yamparez","ESCUELA EDUARDO SEMPERTEGUI",-65.11996,-19.18805,228,38,895,1123,329,58,470,799
"Bolivia","Chuquisaca","Yamparaez","Yamparez","ESCUELA JATUN CKAKA",-65.00366,-19.28829,39,7,213,252,8,4,194,202
"Bolivia","Chuquisaca","Yamparaez","Yamparez","U.E. PATA LLAJTA",-65.07769,-19.11113,4,2,103,107,13,4,84,97
"Bolivia","Chuquisaca","Yamparaez","Yamparez","UNIDAD EDUCATIVA CARAMA",-65.05508,-19.33958,17,1,147,164,10,4,132,142
"Bolivia","Chuquisaca","Yamparaez","Yamparez","UNIDAD EDUCATIVA PULKI AVAROA",-65.12865,-19.24094,124,16,473,597,92,20,345,437
"Bolivia","Chuquisaca","Yamparaez","Yamparez","UNIDAD EDUCATIVA SAJPAYA",-65.12679,-19.15392,21,10,372,393,32,21,309,341
"Bolivia","Chuquisaca","Yamparaez","Yamparez","UNIDAD EDUCATIVA SOTOMAYOR",-64.99535,-19.3425,106,5,620,726,146,21,448,594
"Bolivia","Chuquisaca","Zudáñez","Icla (Ricardo Mujia)","COLEGIO ANTONIO JOSÉ DE SUCRE",-64.79297,-19.36361,153,14,586,739,155,23,394,549
"Bolivia","Chuquisaca","Zudáñez","Icla (Ricardo Mujia)","COLEGIO ELIZARDO PEREZ",-64.78985,-19.29836,93,11,380,473,121,13,235,356
"Bolivia","Chuquisaca","Zudáñez","Icla (Ricardo Mujia)","COLEGIO ROSENDO LA FUENTE",-64.8336,-19.44706,192,0,66,258,10,0,56,66
"Bolivia","Chuquisaca","Zudáñez","Icla (Ricardo Mujia)","ESCUELA CANTAR GALLO",-64.69359,-19.51735,37,3,125,162,20,2,100,120
"Bolivia","Chuquisaca","Zudáñez","Icla (Ricardo Mujia)","ESCUELA JATUN MAYU",-64.72372,-19.40604,27,3,213,240,30,1,179,209
"Bolivia","Chuquisaca","Zudáñez","Icla (Ricardo Mujia)","ESCUELA RODEO",-64.73968,-19.44641,18,0,198,216,10,1,187,197
"Bolivia","Chuquisaca","Zudáñez","Icla (Ricardo Mujia)","ESCUELA SAN JACINTO",-64.7461,-19.32193,31,2,331,362,45,6,278,323
"Bolivia","Chuquisaca","Zudáñez","Icla (Ricardo Mujia)","ESCUELA SANTA LUCIA",-64.72717,-19.56465,27,0,69,96,11,0,58,69
"Bolivia","Chuquisaca","Zudáñez","Icla (Ricardo Mujia)","ESCUELA SUMALA",-64.78291,-19.63519,33,1,93,126,8,1,83,91
"Bolivia","Chuquisaca","Zudáñez","Icla (Ricardo Mujia)","ESCUELA THACO PAMPA",-64.7289,-19.38551,37,2,253,290,19,5,227,246
"Bolivia","Chuquisaca","Zudáñez","Icla (Ricardo Mujia)","U. EDU. SECCIONAL CHUNCA CANCHA BAJA",-64.69682,-19.58073,70,7,299,369,23,10,259,282
"Bolivia","Chuquisaca","Zudáñez","Icla (Ricardo Mujia)","UNIDAD EDUCATIVA SOROMA",-64.82072,-19.50851,18,0,140,158,3,2,135,138
"Bolivia","Chuquisaca","Zudáñez","Presto","ESCUELA ELISARDO PEREZ",-64.94286,-18.77106,85,13,304,389,88,13,190,278
"Bolivia","Chuquisaca","Zudáñez","Presto","ESCUELA JOSÉ MARÍA MARTÍNEZ",-64.87681,-18.74306,220,10,560,780,110,50,390,500
"Bolivia","Chuquisaca","Zudáñez","Presto","PUESTO DE SALUD PUNO KHASA",-64.80189,-18.89501,37,4,146,183,51,7,84,135
"Bolivia","Chuquisaca","Zudáñez","Presto","UNIDAD EDUCATIVA EL PALMAR",-64.9127,-18.6944,10,5,137,147,14,17,101,115
"Bolivia","Chuquisaca","Zudáñez","Presto","UNIDAD EDUCATIVA RICARDO MUJIA",-64.93723,-18.92988,316,35,1108,1424,340,52,681,1021
"Bolivia","Chuquisaca","Zudáñez","Presto","UNIDAD EDUCATIVA TOMOROCO",-64.88657,-18.97326,95,15,351,446,121,15,200,321
"Bolivia","Chuquisaca","Zudáñez","Villa Mojocoya","COLEGIO FRANZ TAMAYO",-64.61874,-18.83001,397,40,1850,2247,610,54,1146,1756
"Bolivia","Chuquisaca","Zudáñez","Villa Mojocoya","ESCUELA GUADALUPE",-64.56116,-18.9363,46,5,238,284,49,5,179,228
"Bolivia","Chuquisaca","Zudáñez","Villa Mojocoya","ESCUELA HILARION VIDES CHOQUE",-64.73502,-18.61781,39,4,237,276,26,2,205,231
"Bolivia","Chuquisaca","Zudáñez","Villa Mojocoya","ESCUELA JAIME MENDOZA",-64.51095,-18.87217,28,2,116,144,25,2,87,112
"Bolivia","Chuquisaca","Zudáñez","Villa Mojocoya","ESCUELA JORGE ANIBARRO ZAPATA",-64.62067,-18.91616,18,4,116,134,21,3,88,109
"Bolivia","Chuquisaca","Zudáñez","Villa Mojocoya","UNIDAD EDUCATIVA EDUARDO AVAROA",-64.61971,-18.76382,59,3,195,254,76,8,108,184
"Bolivia","Chuquisaca","Zudáñez","Villa Zudañez (Tacopaya)","COL. IGNACIO PRUDENCIO BUSTILLOS",-64.70309,-19.11358,254,40,1389,1643,280,46,1023,1303
"Bolivia","Chuquisaca","Zudáñez","Villa Zudañez (Tacopaya)","COL. JAIME DE ZUDAÑEZ",-64.70162,-19.11868,183,21,944,1127,244,41,638,882
"Bolivia","Chuquisaca","Zudáñez","Villa Zudañez (Tacopaya)","ESCUELA MANDINGA",-64.69581,-19.25081,25,4,142,167,11,9,118,129
"Bolivia","Chuquisaca","Zudáñez","Villa Zudañez (Tacopaya)","ESCUELA SAYAN CHACA",-64.63419,-19.24422,41,5,224,265,18,8,193,211
"Bolivia","Chuquisaca","Zudáñez","Villa Zudañez (Tacopaya)","UNIDAD EDUCATIVA CAPILLA LLAVE",-64.70795,-18.98042,36,0,69,105,1,1,67,68
"Bolivia","Chuquisaca","Zudáñez","Villa Zudañez (Tacopaya)","UNIDAD EDUCATIVA HUACA HUASI",-64.78075,-18.98111,14,2,141,155,14,1,124,138
"Bolivia","Cochabamba","Arani","Arani","ESCUELA GUALBERTO VILLARROEL",-65.77542,-17.57345,361,59,2584,2945,907,108,1510,2417
"Bolivia","Cochabamba","Arani","Arani","ESCUELA MIXTA POCOATA",-65.72654,-17.60998,82,16,385,467,86,21,262,348
"Bolivia","Cochabamba","Arani","Arani","LICEO DE SEÑORITAS ARANI",-65.77344,-17.57311,374,52,2410,2784,1009,80,1269,2278
"Bolivia","Cochabamba","Arani","Arani","UNIDAD EDUCATIVA COLLPACIACO",-65.76109,-17.60128,103,18,505,608,116,26,345,461
"Bolivia","Cochabamba","Arani","Vacas","ESCUELA EXPERIMENTAL VACAS",-65.58172,-17.57544,371,73,2590,2961,349,95,2073,2422
"Bolivia","Cochabamba","Arani","Vacas","ESCUELA SECCIONAL RODEO A",-65.63733,-17.6298,111,68,926,1037,90,26,742,832
"Bolivia","Cochabamba","Arani","Vacas","U.E. DAVID MORATO CAÑADAS",-65.64141,-17.53415,30,26,517,547,56,21,414,470
"Bolivia","Cochabamba","Arani","Vacas","UNIDAD EDUCATIVA TOTORAPAMPA",-65.55066,-17.67862,16,5,210,226,14,1,190,204
"Bolivia","Cochabamba","Arque","Arque","ESCUELA E INTERNADO DARIO ANTEZANA V.",-66.29219,-17.94894,98,1,548,646,7,22,518,525
"Bolivia","Cochabamba","Arque","Arque","ESCUELA JUANA AZURDUY - PONGO K'ASA",-66.55169,-17.71174,84,21,375,459,45,25,284,329
"Bolivia","Cochabamba","Arque","Arque","ESCUELA MARCELO QUIROGA SANTA CRUZ",-66.39861,-17.90448,172,11,638,810,65,54,508,573
"Bolivia","Cochabamba","Arque","Arque","ESCUELA NATANIEL AGUIRRE",-66.40426,-17.8204,145,24,746,891,82,32,608,690
"Bolivia","Cochabamba","Arque","Arque","U.E. SAN PEDRO",-66.41895,-17.85651,54,11,193,247,14,3,165,179
"Bolivia","Cochabamba","Arque","Arque","UNIDAD EDUCATIVA CHANGOLLA",-66.46826,-17.77408,26,4,298,324,11,6,277,288
"Bolivia","Cochabamba","Arque","Arque","UNIDAD EDUCATIVA HUAYCHA",-66.32418,-17.89401,24,2,321,345,9,12,298,307
"Bolivia","Cochabamba","Arque","Arque","UNIDAD ESCOLAR TUPAC KATARI - TARUJAYÑA",-66.47985,-17.69246,32,7,445,477,38,13,387,425
"Bolivia","Cochabamba","Arque","Tacopaya","ESCUELA ADOLFO MERCADO",-66.53604,-17.83581,114,22,1030,1144,120,40,848,968
"Bolivia","Cochabamba","Arque","Tacopaya","ESCUELA ELIZARDO PEREZ (TOTORAPAMPA)",-66.61689,-17.88263,66,11,713,779,67,50,585,652
"Bolivia","Cochabamba","Arque","Tacopaya","ESCUELA MARTIN CARDENAS (TUJUTA)",-66.73995,-17.71179,55,3,277,332,25,11,238,263
"Bolivia","Cochabamba","Arque","Tacopaya","ESCUELA SECCIONAL RENE BARRIENTOS",-66.67029,-17.79752,95,15,473,568,61,29,368,429
"Bolivia","Cochabamba","Arque","Tacopaya","ESCUELA VICENTE DONOSO (AGUAS CALIENTES)",-66.6131,-17.82217,35,5,327,362,29,11,282,311
"Bolivia","Cochabamba","Arque","Tacopaya","UNIDAD EDUCATIVA ANICETO ARCE",-66.5975,-17.76939,68,4,290,358,29,21,236,265
"Bolivia","Cochabamba","Arque","Tacopaya","UNIDAD EDUCATIVA AUQUIPAMPA",-66.53737,-17.78284,48,1,523,571,33,17,472,505
"Bolivia","Cochabamba","Arque","Tacopaya","UNIDAD EDUCATIVA MICHAYANI GRANDE",-66.70185,-17.86216,47,0,225,272,12,12,201,213
"Bolivia","Cochabamba","Ayopaya","Ayopaya (Villa de Independencia)","COLEGIO CHAMACOMA",-66.70333,-17.40771,95,6,474,569,67,24,377,444
"Bolivia","Cochabamba","Ayopaya","Ayopaya (Villa de Independencia)","COLEGIO SIMON BOLIVAR FE Y ALEGRIA",-66.81453,-17.38495,230,39,2038,2268,502,89,1408,1910
"Bolivia","Cochabamba","Ayopaya","Ayopaya (Villa de Independencia)","ESCUELA MARIANO BAPTISTA (CALCHANI)",-66.69013,-17.32464,101,19,641,742,33,51,538,571
"Bolivia","Cochabamba","Ayopaya","Ayopaya (Villa de Independencia)","U.E. JOSE MIGUEL LANZA",-66.82125,-17.08193,508,67,2313,2821,498,138,1610,2108
"Bolivia","Cochabamba","Ayopaya","Ayopaya (Villa de Independencia)","UNIDAD EDUCATIVA CHAPISUYO A",-66.62987,-17.35943,100,13,619,719,42,24,540,582
"Bolivia","Cochabamba","Ayopaya","Ayopaya (Villa de Independencia)","UNIDAD EDUCATIVA CHARAHUAYTU",-66.79765,-17.26413,161,45,1018,1179,167,52,754,921
"Bolivia","Cochabamba","Ayopaya","Ayopaya (Villa de Independencia)","UNIDAD EDUCATIVA MACHACA",-66.86737,-17.12325,42,5,225,267,34,9,177,211
"Bolivia","Cochabamba","Ayopaya","Ayopaya (Villa de Independencia)","UNIDAD EDUCATIVA POCANCHE",-66.83318,-16.93553,70,7,399,469,17,24,351,368
"Bolivia","Cochabamba","Ayopaya","Ayopaya (Villa de Independencia)","UNIDAD EDUCATIVA SABINO WALLKU",-66.73064,-17.11669,54,13,393,447,34,14,332,366
"Bolivia","Cochabamba","Ayopaya","Ayopaya (Villa de Independencia)","UNIDAD EDUCATIVA SISI PALERMO",-66.83698,-17.20461,42,5,335,377,34,50,246,280
"Bolivia","Cochabamba","Ayopaya","Ayopaya (Villa de Independencia)","UNIDAD EDUCATIVA TAPAZA",-66.74503,-17.17871,11,3,136,147,15,4,114,129
"Bolivia","Cochabamba","Ayopaya","Ayopaya (Villa de Independencia)","UNIDAD EDUCATIVA VILLA PUCARA",-66.96396,-16.99085,123,27,507,630,74,20,386,460
"Bolivia","Cochabamba","Ayopaya","Cocapata","COLEGIO SECUNDARIO COCAPATA",-66.67577,-16.79244,71,10,258,329,53,19,176,229
"Bolivia","Cochabamba","Ayopaya","Cocapata","ESCUELA 15 DE FEBRERO (EL CHORO)",-66.65108,-16.79413,109,3,605,714,134,23,445,579
"Bolivia","Cochabamba","Ayopaya","Cocapata","ESCUELA CHOQUECAMATA (FALSURI)",-66.63028,-16.83837,27,7,611,638,217,32,355,572
"Bolivia","Cochabamba","Ayopaya","Cocapata","ESCUELA OSCAR ALFARO - VILLA VINTO",-66.46751,-16.84676,189,7,873,1062,170,58,638,808
"Bolivia","Cochabamba","Ayopaya","Cocapata","ESCUELA PEDRO DOMINGO MURILLO -CALIENTES",-66.55274,-17.01225,91,8,471,562,80,30,353,433
"Bolivia","Cochabamba","Ayopaya","Cocapata","ESCUELA SECCIONAL MACHACAYMA",-66.40887,-16.89995,117,6,674,791,112,63,493,605
"Bolivia","Cochabamba","Ayopaya","Cocapata","NUCLEO ESCOLAR PEDRO LAIME CHUSPI",-66.66877,-16.86044,64,0,237,301,47,25,165,212
"Bolivia","Cochabamba","Ayopaya","Cocapata","NUCLEO GERMAN BUSCH (CHILLAVI)",-66.59884,-16.8523,21,5,166,187,31,7,123,154
"Bolivia","Cochabamba","Ayopaya","Cocapata","SEDE SUB - CENTRAL VISCACHAS",-66.45755,-17.10735,26,2,33,59,11,0,20,31
"Bolivia","Cochabamba","Ayopaya","Cocapata","UNIDAD EDUCATIVA CHIARAJE",-66.38669,-17.05231,16,2,225,241,41,18,164,205
"Bolivia","Cochabamba","Ayopaya","Cocapata","UNIDAD EDUCATIVA COLORADO",-66.87921,-15.88327,37,2,197,234,33,4,158,191
"Bolivia","Cochabamba","Ayopaya","Cocapata","UNIDAD EDUCATIVA EL CHORITO",-66.60498,-16.94332,18,3,208,226,58,9,138,196
"Bolivia","Cochabamba","Ayopaya","Cocapata","UNIDAD EDUCATIVA ICARI",-66.3419,-17.02058,52,2,313,365,77,10,224,301
"Bolivia","Cochabamba","Ayopaya","Cocapata","UNIDAD EDUCATIVA MARAVILLAS",-66.71464,-16.60081,67,9,366,433,43,17,297,340
"Bolivia","Cochabamba","Ayopaya","Cocapata","UNIDAD EDUCATIVA TOTORANI",-66.39165,-17.01361,45,2,349,394,38,3,306,344
"Bolivia","Cochabamba","Ayopaya","Cocapata","UNIDAD EDUCATIVA TUNARI (PUCARITA)",-66.73937,-16.93249,98,10,460,558,27,18,405,432
"Bolivia","Cochabamba","Ayopaya","Morochata","COLEGIO RENE BARRIENTOS ORTUÑO -PIUSILLA",-66.49365,-17.23084,91,18,575,666,121,24,412,533
"Bolivia","Cochabamba","Ayopaya","Morochata","ESCUELA 26 DE MAYO - CHAUPISUYO B",-66.55013,-17.30591,84,11,723,807,116,46,550,666
"Bolivia","Cochabamba","Ayopaya","Morochata","ESCUELA GILDARO ANTEZANA ROJAS",-66.60968,-17.18441,130,37,893,1023,88,47,721,809
"Bolivia","Cochabamba","Ayopaya","Morochata","ESCUELA HILARION GRAGEDA - YAYANI",-66.65623,-17.21181,121,30,707,828,118,53,506,624
"Bolivia","Cochabamba","Ayopaya","Morochata","ESCUELA JULIO ESPINOZA CANELAS-PUNACACHI",-66.61133,-17.25125,134,46,714,848,112,59,497,609
"Bolivia","Cochabamba","Ayopaya","Morochata","ESCUELA MARIANO BAPTISTA- MOROCHATA",-66.53392,-17.23173,151,27,1561,1712,177,94,1263,1440
"Bolivia","Cochabamba","Ayopaya","Morochata","UNIDAD EDUCATIVA HUMAMARCA",-66.5562,-17.10199,16,8,235,251,31,14,182,213
"Bolivia","Cochabamba","Ayopaya","Morochata","UNIDAD EDUCATIVA IGLESIANI",-66.50184,-17.31038,17,0,175,192,39,2,134,173
"Bolivia","Cochabamba","Ayopaya","Morochata","UNIDAD EDUCATIVA PUCARANI GRANDE",-66.66244,-17.08579,29,0,118,147,7,3,108,115
"Bolivia","Cochabamba","Bolívar","Bolívar","ESCUELA COYUMA",-66.74062,-18.08522,23,3,86,109,31,7,45,76
"Bolivia","Cochabamba","Bolívar","Bolívar","ESCUELA JORENKO VILLA VERDE",-66.66763,-17.98483,8,5,404,412,79,16,304,383
"Bolivia","Cochabamba","Bolívar","Bolívar","ESCUELA MEJILLONES",-66.68706,-18.08409,92,3,352,444,71,18,260,331
"Bolivia","Cochabamba","Bolívar","Bolívar","ESCUELA SAN JUAN DE LA COMUNA",-66.46785,-17.9682,29,4,137,166,25,9,99,124
"Bolivia","Cochabamba","Bolívar","Bolívar","ESCUELA SIMON BOLIVAR",-66.53779,-17.9682,147,14,641,788,161,35,431,592
"Bolivia","Cochabamba","Bolívar","Bolívar","ESCUELA TANGALIQUE",-66.5484,-18.02263,22,3,224,246,43,9,169,212
"Bolivia","Cochabamba","Bolívar","Bolívar","ESCUELA VILACAYMA",-66.57627,-17.96971,24,14,308,332,76,15,203,279
"Bolivia","Cochabamba","Bolívar","Bolívar","ESCUELA YARVICOYA",-66.51677,-18.01299,65,5,260,325,14,6,235,249
"Bolivia","Cochabamba","Bolívar","Bolívar","NUCLEO ESCOLAR CARPANI",-66.61453,-17.93365,20,3,467,487,68,20,376,444
"Bolivia","Cochabamba","Bolívar","Bolívar","UNIDAD EDUCATIVA CHALLOMA",-66.54604,-17.89978,24,3,185,209,46,13,123,169
"Bolivia","Cochabamba","Bolívar","Bolívar","UNIDAD EDUCATIVA VILAPAMPA",-66.69617,-18.049,4,0,198,202,54,9,135,189
"Bolivia","Cochabamba","Campero","Aiquile","ESCUELA 20 DE DICIEMBRE",-65.17914,-18.20377,436,56,2234,2670,970,111,1097,2067
"Bolivia","Cochabamba","Campero","Aiquile","ESCUELA MANUEL DE UGARTE",-65.18247,-18.20012,405,33,2026,2431,849,62,1082,1931
"Bolivia","Cochabamba","Campero","Aiquile","ESCUELA SIMON RODRIGUEZ",-65.18458,-18.20073,417,54,2337,2754,972,87,1224,2196
"Bolivia","Cochabamba","Campero","Aiquile","NUCLEO EDUCATIVO TIPAJARA",-65.27975,-18.13377,30,6,274,304,45,8,215,260
"Bolivia","Cochabamba","Campero","Aiquile","NUCLEO ESCOLAR EL CERCADO",-65.17767,-18.10226,78,13,326,404,36,8,269,305
"Bolivia","Cochabamba","Campero","Aiquile","NUCLEO ESCOLAR VILLA GRANADO",-65.03775,-18.20921,175,22,907,1082,143,32,710,853
"Bolivia","Cochabamba","Campero","Aiquile","UNIDAD EDUCATIVA CHAQUI MAYU",-65.28205,-18.26553,20,4,158,178,9,4,141,150
"Bolivia","Cochabamba","Campero","Aiquile","UNIDAD EDUCATIVA EJE PAMPA",-65.1711,-18.5389,52,11,284,336,31,17,225,256
"Bolivia","Cochabamba","Campero","Aiquile","UNIDAD EDUCATIVA ESTANZUELA",-64.8748,-18.33058,54,2,228,282,21,4,201,222
"Bolivia","Cochabamba","Campero","Aiquile","UNIDAD EDUCATIVA KEWIÑAL",-65.3177,-18.37376,27,11,188,215,50,15,112,162
"Bolivia","Cochabamba","Campero","Aiquile","UNIDAD EDUCATIVA LAGARPAMPA",-64.98984,-18.45282,71,3,214,285,13,4,194,207
"Bolivia","Cochabamba","Campero","Aiquile","UNIDAD EDUCATIVA LAIME",-65.09598,-18.45015,23,5,175,198,8,9,153,161
"Bolivia","Cochabamba","Campero","Aiquile","UNIDAD EDUCATIVA NOVILLERO",-65.23428,-18.30105,103,11,532,635,130,20,371,501
"Bolivia","Cochabamba","Campero","Aiquile","UNIDAD EDUCATIVA PANAMA",-65.10865,-18.30899,36,3,256,292,44,5,204,248
"Bolivia","Cochabamba","Campero","Aiquile","UNIDAD EDUCATIVA QUIROGA",-65.21684,-18.42329,165,24,849,1014,106,33,686,792
"Bolivia","Cochabamba","Campero","Omereque","ESCUELA CENTRAL PEÑA COLORADA",-64.87029,-18.17198,52,5,342,394,63,13,261,324
"Bolivia","Cochabamba","Campero","Omereque","ESCUELA SECCIONAL CHARI CHARI",-65.01819,-18.02485,12,3,67,79,23,5,36,59
"Bolivia","Cochabamba","Campero","Omereque","ESCUELA SECCIONAL PEREZ",-64.76694,-18.11378,21,2,167,188,32,6,127,159
"Bolivia","Cochabamba","Campero","Omereque","UNIDAD EDUCATIVA HUANACUNI GRANDE",-64.98838,-17.92877,22,2,162,184,22,2,136,158
"Bolivia","Cochabamba","Campero","Omereque","UNIDAD EDUCATIVA OMEREQUE",-64.90799,-18.1062,303,37,1547,1850,467,34,1009,1476
"Bolivia","Cochabamba","Campero","Omereque","UNIDAD EDUCATIVA PERERETA",-64.82058,-18.1318,28,5,178,206,42,9,122,164
"Bolivia","Cochabamba","Campero","Pasorapa","COLEGIO TTE.CNEL. NATANIEL VERDUGUEZ",-64.67598,-18.31635,181,11,748,929,404,26,307,711
"Bolivia","Cochabamba","Campero","Pasorapa","ESCUELA CENTRAL QUINORI",-64.39658,-18.50312,63,1,228,291,35,4,188,223
"Bolivia","Cochabamba","Campero","Pasorapa","SEDE SINDICAL YAJO PAMPA",-64.55951,-18.13656,2,0,37,39,14,0,23,37
"Bolivia","Cochabamba","Campero","Pasorapa","U.E. REDONDO",-64.31445,-18.50069,3,2,69,72,8,4,55,63
"Bolivia","Cochabamba","Campero","Pasorapa","UNIDAD EDUCATIVA PAMPAS",-64.51284,-18.40247,11,0,112,123,21,0,91,112
"Bolivia","Cochabamba","Campero","Pasorapa","UNIDAD EDUCATIVA SEIBAS",-64.57413,-18.49377,36,5,141,177,24,2,110,134
"Bolivia","Cochabamba","Capinota","Capinota","ESCUELA APILLAPAMPA",-66.2554,-17.8624,55,16,662,717,38,24,584,622
"Bolivia","Cochabamba","Capinota","Capinota","ESCUELA CENTRAL MARCAVI",-66.19489,-17.68572,38,14,320,358,20,10,276,296
"Bolivia","Cochabamba","Capinota","Capinota","ESCUELA VICTOR BARRIENTOS",-66.26445,-17.71407,716,109,4531,5247,1681,208,2533,4214
"Bolivia","Cochabamba","Capinota","Capinota","NUCLEO CENTRAL HORNOMA",-66.20175,-17.88647,38,19,363,401,9,8,327,336
"Bolivia","Cochabamba","Capinota","Capinota","UNIDAD EDUCATIVA CUSTODIO AYAVIRI",-66.28507,-17.72167,346,52,2853,3199,1223,93,1485,2708
"Bolivia","Cochabamba","Capinota","Capinota","UNIDAD EDUCATIVA GUSTAVO GARCIA (CHARAMO",-66.29135,-17.61348,91,23,719,810,229,29,438,667
"Bolivia","Cochabamba","Capinota","Capinota","UNIDAD EDUCATIVA JUANA AZURDUY DE PADILLA",-66.26445,-17.71408,103,5,421,524,116,18,282,398
"Bolivia","Cochabamba","Capinota","Capinota","UNIDAD EDUCATIVA TOCOHALLA",-66.13054,-17.86209,20,0,81,101,1,4,76,77
"Bolivia","Cochabamba","Capinota","Capinota","UNIDAD EDUCATIVA YATAMOCO",-66.27116,-17.73293,40,5,475,515,122,13,335,457
"Bolivia","Cochabamba","Capinota","Santivañez","DOMICILIO PARTICULAR",-66.26903,-17.55104,24,4,189,213,44,6,135,179
"Bolivia","Cochabamba","Capinota","Santivañez","ESCUELA PRUDENCIO ARAUCO (SANTIVAÑEZ)",-66.24799,-17.54894,249,24,1618,1867,434,45,1115,1549
"Bolivia","Cochabamba","Capinota","Santivañez","SUB CENTRAL ENRIQUE ENCINAS (EX CALERA)",-66.21689,-17.57849,73,5,509,582,61,13,430,491
"Bolivia","Cochabamba","Capinota","Santivañez","U. E. CASTOR ZAMBRANA HUAYÑACOTA",-66.20436,-17.53515,75,4,419,494,65,6,344,409
"Bolivia","Cochabamba","Capinota","Santivañez","UNIDAD EDUCATIVA CAPORAYA",-66.2821,-17.50345,31,9,247,278,25,5,208,233
"Bolivia","Cochabamba","Capinota","Santivañez","UNIDAD EDUCATIVA JOSE RIVERA",-66.26288,-17.61516,34,2,183,217,54,4,123,177
"Bolivia","Cochabamba","Capinota","Santivañez","UNIDAD EDUCATIVA PAMPA CHURIHUA",-66.14667,-17.61767,18,4,141,159,5,4,128,133
"Bolivia","Cochabamba","Capinota","Santivañez","UNIDAD EDUCATIVA ROCHA RANCHO",-66.18881,-17.54504,83,9,460,543,74,15,362,436
"Bolivia","Cochabamba","Capinota","Sicaya","ESCUELA GERMAN BUSCH",-66.35415,-17.74645,74,23,535,609,81,25,406,487
"Bolivia","Cochabamba","Capinota","Sicaya","NUCLEO HUMANISTICO SICAYA",-66.33362,-17.80072,110,24,817,927,69,42,682,751
"Bolivia","Cochabamba","Carrasco","Chimoré","ESCUELA GERÓNIMO UZEDA FE Y ALEGRIA",-65.15494,-16.99398,1485,117,7075,8560,1647,222,5089,6736
"Bolivia","Cochabamba","Carrasco","Chimoré","ESCUELA LA MISION",-65.14838,-16.71407,39,3,348,387,98,9,238,336
"Bolivia","Cochabamba","Carrasco","Chimoré","NUCLEO EDUCATIVO ENTRE RIOS TACUARAL",-65.20777,-17.08086,60,2,570,630,43,7,518,561
"Bolivia","Cochabamba","Carrasco","Chimoré","NUCLEO ESCOLAR PUERTO AURORA",-65.18625,-16.8472,62,18,475,537,56,11,390,446
"Bolivia","Cochabamba","Carrasco","Chimoré","UNIDAD EDUCATIVA CESAR ZAMA (CHIMORE)",-65.07787,-16.99658,162,21,1626,1788,154,32,1419,1573
"Bolivia","Cochabamba","Carrasco","Chimoré","UNIDAD EDUCATIVA EL CARMEN",-64.90653,-16.16878,32,1,98,130,23,5,69,92
"Bolivia","Cochabamba","Carrasco","Chimoré","UNIDAD EDUCATIVA PUERTO LAS FLORES",-64.67742,-16.40432,12,3,65,77,24,3,35,59
"Bolivia","Cochabamba","Carrasco","Chimoré","UNIDAD EDUCATIVA SAN ANDRÉS",-65.10363,-17.0901,59,5,543,602,25,12,501,526
"Bolivia","Cochabamba","Carrasco","Chimoré","UNIDAD EDUCATIVA SANTA ANITA",-64.82532,-16.11419,42,2,89,131,19,5,63,82
"Bolivia","Cochabamba","Carrasco","Chimoré","UNIDAD EDUCATIVA SANTA ISABEL",-64.72911,-16.50484,19,1,51,70,13,1,36,49
"Bolivia","Cochabamba","Carrasco","Chimoré","UNIDAD EDUCATIVA TRES ISLAS",-64.8566,-16.75232,30,5,170,200,27,3,135,162
"Bolivia","Cochabamba","Carrasco","Chimoré","UNIDAD EDUCATIVA TRINIDADCITO",-64.94166,-16.44957,8,0,61,69,31,0,30,61
"Bolivia","Cochabamba","Carrasco","Entre Ríos (Bulo Bulo)","COLEGIO FRANZ TAMAYO",-64.53572,-17.1993,1086,104,7861,8947,1358,224,6175,7533
"Bolivia","Cochabamba","Carrasco","Entre Ríos (Bulo Bulo)","COLEGIO NACIONAL SAN MARCOS",-64.35905,-17.25389,390,53,3533,3923,441,72,2967,3408
"Bolivia","Cochabamba","Carrasco","Entre Ríos (Bulo Bulo)","ESCUELA EDUARDO AVAROA (ISARZAMA)",-64.68122,-17.13931,202,12,2085,2287,130,27,1916,2046
"Bolivia","Cochabamba","Carrasco","Entre Ríos (Bulo Bulo)","U.E. ESTEBAN ARCE",-64.61887,-17.26742,9,4,254,263,7,8,235,242
"Bolivia","Cochabamba","Carrasco","Entre Ríos (Bulo Bulo)","U. E. JOSÉ CARRASCO (MANCO KAPAC)",-64.56224,-17.18527,270,33,2874,3144,243,48,2550,2793
"Bolivia","Cochabamba","Carrasco","Entre Ríos (Bulo Bulo)","U.E. NACIONAL AYACUCHO",-64.54228,-17.20041,7,0,66,73,10,0,56,66
"Bolivia","Cochabamba","Carrasco","Entre Ríos (Bulo Bulo)","UNIDAD EDUCATIVA RIO BLANCO",-64.45576,-17.22547,260,18,1278,1538,170,42,1048,1218
"Bolivia","Cochabamba","Carrasco","Pocona","CENTRO DE ATENCION AL TURISTA",-65.40996,-17.6073,12,5,369,381,34,9,321,355
"Bolivia","Cochabamba","Carrasco","Pocona","ESCUELA LADISLAO CABRERA",-65.34206,-17.66848,68,11,418,486,61,12,334,395
"Bolivia","Cochabamba","Carrasco","Pocona","NUCLEO ESCOLAR ISMAEL MONTES",-65.38327,-17.72318,80,14,821,901,104,26,677,781
"Bolivia","Cochabamba","Carrasco","Pocona","UNIDAD EDUCATIVA 6 DE AGOSTO",-65.37962,-17.52965,165,22,936,1101,139,44,731,870
"Bolivia","Cochabamba","Carrasco","Pocona","UNIDAD EDUCATIVA CHIMBOATA",-65.28564,-17.66047,24,3,402,426,46,12,341,387
"Bolivia","Cochabamba","Carrasco","Pocona","UNIDAD EDUCATIVA HUAYAPACHA",-65.40794,-17.55243,85,30,837,922,98,35,674,772
"Bolivia","Cochabamba","Carrasco","Pocona","UNIDAD EDUCATIVA JAVIER GONZALES",-65.50449,-17.61416,3,0,61,64,1,1,59,60
"Bolivia","Cochabamba","Carrasco","Pocona","UNIDAD EDUCATIVA LA TRANCA",-65.45638,-17.73257,10,4,109,119,8,0,97,105
"Bolivia","Cochabamba","Carrasco","Pocona","UNIDAD EDUCATIVA MONTE PUNCU",-65.30296,-17.58503,55,13,394,449,46,17,318,364
"Bolivia","Cochabamba","Carrasco","Pocona","UNIDAD EDUCATIVA POCONA",-65.41882,-17.67324,106,18,389,495,72,18,281,353
"Bolivia","Cochabamba","Carrasco","Pojo","COLEGIO VENANCIO LOSS",-64.86312,-17.75708,225,31,1448,1673,246,38,1133,1379
"Bolivia","Cochabamba","Carrasco","Pojo","NUCLEO ESCOLAR DURAZNILLO",-65.01938,-17.78679,39,3,142,181,14,2,123,137
"Bolivia","Cochabamba","Carrasco","Pojo","UNIDAD EDUCATIVA CHALLHUANI",-64.89679,-17.84557,73,0,648,721,13,34,601,614
"Bolivia","Cochabamba","Carrasco","Pojo","UNIDAD EDUCATIVA DIAN PAMPA",-64.70919,-17.71177,31,3,322,353,26,12,281,307
"Bolivia","Cochabamba","Carrasco","Pojo","UNIDAD EDUCATIVA JAIME LAREDO",-64.98014,-17.84581,5,1,104,109,5,3,95,100
"Bolivia","Cochabamba","Carrasco","Pojo","UNIDAD EDUCATIVA KARA HUASI - POJO",-64.74367,-17.73957,23,2,246,269,20,10,214,234
"Bolivia","Cochabamba","Carrasco","Pojo","UNIDAD EDUCATIVA LA HABANA",-64.92303,-17.7378,29,2,289,318,17,2,268,285
"Bolivia","Cochabamba","Carrasco","Pojo","UNIDAD EDUCATIVA PALCA C",-64.97747,-17.70329,20,2,511,531,17,4,488,505
"Bolivia","Cochabamba","Carrasco","Pojo","UNIDAD EDUCATIVA RODEO C",-64.78306,-17.83571,52,1,341,393,4,24,312,316
"Bolivia","Cochabamba","Carrasco","Pojo","UNIDAD EDUCATIVA THAGO LAGUNA",-64.86137,-17.95306,0,0,61,61,0,4,57,57
"Bolivia","Cochabamba","Carrasco","Pojo","UNIDAD EDUCATIVA YUTHUPAMPA",-64.99229,-17.74813,59,7,532,591,25,11,489,514
"Bolivia","Cochabamba","Carrasco","Puerto Villarroel","COLEGIO EDUARDO AVAROA (P.VILLARROEL)",-64.79533,-16.83211,297,17,1057,1354,336,18,686,1022
"Bolivia","Cochabamba","Carrasco","Puerto Villarroel","COLEGIO JUAN PABLO II (SACTA)",-64.76898,-17.11968,408,40,3634,4042,344,74,3176,3520
"Bolivia","Cochabamba","Carrasco","Puerto Villarroel","COLEGIO LIBERTAD",-64.84208,-17.07051,75,6,849,924,64,17,762,826
"Bolivia","Cochabamba","Carrasco","Puerto Villarroel","COLEGIO MARCELO QUIROGA SANTA CRUZ",-65.04104,-17.0115,245,17,2028,2273,215,41,1755,1970
"Bolivia","Cochabamba","Carrasco","Puerto Villarroel","ESCUELA AYOPAYA (P.VILLAROEL)",-65.00072,-16.90683,77,8,900,977,49,15,828,877
"Bolivia","Cochabamba","Carrasco","Puerto Villarroel","ESCUELA BUENAS NUEVAS (VALLE IVIRZA)",-64.91539,-17.11546,182,23,1235,1417,134,22,1056,1190
"Bolivia","Cochabamba","Carrasco","Puerto Villarroel","ESCUELA CENTRAL VILLA NUEVA",-65.00124,-17.11282,71,6,722,793,40,9,667,707
"Bolivia","Cochabamba","Carrasco","Puerto Villarroel","ESCUELA SENDA 6",-64.95086,-17.01844,130,18,1312,1442,84,25,1185,1269
"Bolivia","Cochabamba","Carrasco","Puerto Villarroel","ESCUELA TORIBIO CLAURE (V. HERMOSO)",-64.96452,-17.15555,204,14,1538,1742,156,26,1342,1498
"Bolivia","Cochabamba","Carrasco","Puerto Villarroel","UNIDAD EDUCATIVA 2 DE MARZO",-64.92152,-17.21806,56,4,670,726,30,9,627,657
"Bolivia","Cochabamba","Carrasco","Puerto Villarroel","UNIDAD EDUCATIVA BIARECUATÉ",-64.94436,-16.78322,31,0,59,90,5,0,54,59
"Bolivia","Cochabamba","Carrasco","Puerto Villarroel","UNIDAD EDUCATIVA CESAR ZAMA (P. VILLARRO",-65.07753,-16.99568,20,2,177,197,14,6,155,169
"Bolivia","Cochabamba","Carrasco","Puerto Villarroel","UNIDAD EDUCATIVA ISRAEL",-64.83989,-17.22177,38,7,536,574,45,8,476,521
"Bolivia","Cochabamba","Carrasco","Puerto Villarroel","UNIDAD EDUCATIVA JUANA AZURDUY DE PADILLA",-64.85532,-17.04719,90,3,527,617,79,10,435,514
"Bolivia","Cochabamba","Carrasco","Puerto Villarroel","UNIDAD EDUCATIVA SAN FRANCISCO DE ASIS",-64.85681,-17.03161,1395,123,9073,10468,1583,289,7078,8661
"Bolivia","Cochabamba","Carrasco","Puerto Villarroel","UNIDAD EDUCATIVA VALLE TUNARI",-64.69701,-17.26063,175,17,1599,1774,101,28,1453,1554
"Bolivia","Cochabamba","Carrasco","Totora","COLEGIO 8 DE SEPTIEMBRE",-65.08691,-17.71779,44,9,554,598,51,16,478,529
"Bolivia","Cochabamba","Carrasco","Totora","SEDE DE LA JUNTA VECINAL DE EPIZANA",-65.22901,-17.63718,72,12,785,857,95,28,650,745
"Bolivia","Cochabamba","Carrasco","Totora","SEDE SOCIAL YUNGAS DE VANDIOLA",-65.23582,-17.42609,74,8,477,551,130,12,327,457
"Bolivia","Cochabamba","Carrasco","Totora","UNIDAD EDUCATIVA ANTAQAWA",-65.13827,-17.87289,8,0,131,139,9,1,121,130
"Bolivia","Cochabamba","Carrasco","Totora","UNIDAD EDUCATIVA LAIME TORO",-65.05975,-17.66721,42,8,572,614,46,18,500,546
"Bolivia","Cochabamba","Carrasco","Totora","UNIDAD EDUCATIVA POTRERO",-65.04145,-17.88901,14,1,119,133,5,0,113,118
"Bolivia","Cochabamba","Carrasco","Totora","UNIDAD EDUCATIVA RODEO GRANDE",-65.13137,-17.66049,59,10,861,920,43,12,796,839
"Bolivia","Cochabamba","Carrasco","Totora","UNIDAD EDUCATIVA TIKA PAMPA",-65.25523,-17.7844,17,4,125,142,4,4,113,117
"Bolivia","Cochabamba","Carrasco","Totora","UNIDAD EDUCATIVA TIRAQUE C",-65.09571,-17.67045,14,4,305,319,16,4,281,297
"Bolivia","Cochabamba","Carrasco","Totora","UNIDA EDUCATIVA LA PAZ",-65.19115,-17.74041,425,48,2708,3133,516,83,2061,2577
"Bolivia","Cochabamba","Cercado","Cochabamba","CAMPO FERIAL",-66.12955,-17.41828,634,33,4556,5190,2374,149,2000,4374
"Bolivia","Cochabamba","Cercado","Cochabamba","(CÁRCEL) PENITENCIARIA SAN ANTONIO",-66.15704,-17.40325,92,2,151,243,70,6,73,143
"Bolivia","Cochabamba","Cercado","Cochabamba","(CÁRCEL) PENITENCIARIA SAN SEBASTIAN MUJERES",-66.16058,-17.39862,48,0,77,125,29,0,48,77
"Bolivia","Cochabamba","Cercado","Cochabamba","(CÁRCEL) PENITENCIARIA SAN SEBASTIAN  VARONES",-66.15989,-17.39794,84,1,192,276,61,10,120,181
"Bolivia","Cochabamba","Cercado","Cochabamba","CEMA CENTRO FRUTILLITAS",-66.20207,-17.38553,39,1,481,520,347,14,119,466
"Bolivia","Cochabamba","Cercado","Cochabamba","CENTRO EDUCATIVO P.  MARIA AUXILIADORA",-66.15949,-17.43581,703,41,5203,5906,2680,191,2291,4971
"Bolivia","Cochabamba","Cercado","Cochabamba","CENTRO EDUCATIVO SAN FRANCISCO DE ASIS",-66.16775,-17.41353,185,6,1313,1498,861,18,428,1289
"Bolivia","Cochabamba","Cercado","Cochabamba","CENTRO INMACULADA CONCEPCION",-66.15766,-17.37703,394,9,2504,2898,2142,37,316,2458
"Bolivia","Cochabamba","Cercado","Cochabamba","CENTRO INTEGRADO EL SALVADOR S-VERA CRUZ",-66.1243,-17.46039,436,26,2949,3385,1227,102,1594,2821
"Bolivia","Cochabamba","Cercado","Cochabamba","CENTRO KANATA",-66.15925,-17.41386,145,2,879,1024,560,25,292,852
"Bolivia","Cochabamba","Cercado","Cochabamba","CENTRO PARTICULAR GERONIMO DE OSORIO",-66.1866,-17.397,883,24,5680,6563,3767,147,1742,5509
"Bolivia","Cochabamba","Cercado","Cochabamba","COLEGIO ABAROA",-66.1585,-17.39535,540,12,3076,3616,2308,56,700,3008
"Bolivia","Cochabamba","Cercado","Cochabamba","COLEGIO ALBERT EINSTEIN",-66.17524,-17.38465,368,13,3155,3523,2474,98,570,3044
"Bolivia","Cochabamba","Cercado","Cochabamba","COLEGIO ALEMAN SANTA MARIA",-66.15275,-17.39123,351,8,2029,2380,1666,34,321,1987
"Bolivia","Cochabamba","Cercado","Cochabamba","COLEGIO AMOR DE DIOS",-66.15005,-17.40731,1164,33,6625,7789,4045,135,2412,6457
"Bolivia","Cochabamba","Cercado","Cochabamba","COLEGIO BOLIVAR",-66.1534,-17.39354,297,11,1610,1907,1191,20,388,1579
"Bolivia","Cochabamba","Cercado","Cochabamba","COLEGIO BOLIVIANO ARGENTINO",-66.15808,-17.39156,151,5,713,864,551,10,147,698
"Bolivia","Cochabamba","Cercado","Cochabamba","COLEGIO BRANCO PETRICEVIC",-66.18783,-17.37372,837,32,6224,7061,4425,146,1621,6046
"Bolivia","Cochabamba","Cercado","Cochabamba","COLEGIO BUENAS NUEVAS C",-66.14614,-17.41905,730,42,4605,5335,2290,140,2133,4423
"Bolivia","Cochabamba","Cercado","Cochabamba","COLEGIO CRISTO REY",-66.17203,-17.39057,590,9,4395,4985,3349,88,949,4298
"Bolivia","Cochabamba","Cercado","Cochabamba","COLEGIO DON BOSCO",-66.15103,-17.38246,694,15,4015,4709,3327,58,615,3942
"Bolivia","Cochabamba","Cercado","Cochabamba","COLEGIO FEDERICO FROEBEL",-66.14729,-17.36183,428,14,3451,3879,2475,76,886,3361
"Bolivia","Cochabamba","Cercado","Cochabamba","COLEGIO HISPANO BOLIVIANO",-66.15182,-17.39768,479,14,2579,3058,1866,66,633,2499
"Bolivia","Cochabamba","Cercado","Cochabamba","COLEGIO IRLANDES",-66.13731,-17.37605,71,1,536,607,447,8,80,527
"Bolivia","Cochabamba","Cercado","Cochabamba","COLEGIO ISMAEL MONTES O LUIS ESPINAL",-66.14464,-17.4156,562,33,3962,4524,1912,124,1893,3805
"Bolivia","Cochabamba","Cercado","Cochabamba","COLEGIO JAIME ESCALANTE",-66.15813,-17.368,188,9,1369,1557,1122,21,217,1339
"Bolivia","Cochabamba","Cercado","Cochabamba","COLEGIO LA SALLE",-66.1608,-17.38936,736,11,3643,4379,3037,45,550,3587
"Bolivia","Cochabamba","Cercado","Cochabamba","COLEGIO LA SALLE FISCAL",-66.16738,-17.40489,700,22,4983,5683,3548,98,1315,4863
"Bolivia","Cochabamba","Cercado","Cochabamba","COLEGIO LAURA VICUÑA",-66.19179,-17.4425,129,15,1094,1223,419,33,627,1046
"Bolivia","Cochabamba","Cercado","Cochabamba","COLEGIO LOYOLA",-66.14664,-17.38733,321,4,1795,2116,1486,28,277,1763
"Bolivia","Cochabamba","Cercado","Cochabamba","COLEGIO LUIS QUINTIN VILA",-66.1864,-17.37541,788,21,6106,6894,4295,189,1601,5896
"Bolivia","Cochabamba","Cercado","Cochabamba","COLEGIO MARISTA",-66.16205,-17.36185,580,16,4753,5333,3384,87,1266,4650
"Bolivia","Cochabamba","Cercado","Cochabamba","COLEGIO MARISTA NUESTRA SEÑORA DEL PILAR",-66.16751,-17.35473,778,26,5557,6335,3331,161,2039,5370
"Bolivia","Cochabamba","Cercado","Cochabamba","COLEGIO MARTIN CARDENAS",-66.13716,-17.41997,489,20,4069,4558,2209,94,1746,3955
"Bolivia","Cochabamba","Cercado","Cochabamba","COLEGIO MARYKNOLL",-66.16751,-17.37765,779,8,4947,5726,4183,64,692,4875
"Bolivia","Cochabamba","Cercado","Cochabamba","COLEGIO NACIONAL MIXTO COCHABAMBA",-66.17643,-17.36379,701,29,5441,6142,3787,92,1533,5320
"Bolivia","Cochabamba","Cercado","Cochabamba","COLEGIO PAULO VI",-66.16972,-17.3896,369,8,2610,2979,2079,52,471,2550
"Bolivia","Cochabamba","Cercado","Cochabamba","COLEGIO PIO XII",-66.15453,-17.40197,233,7,1454,1687,1045,21,381,1426
"Bolivia","Cochabamba","Cercado","Cochabamba","COLEGIO RICHARD VON WEIZACKER",-66.18177,-17.37842,305,10,2765,3070,2173,38,544,2717
"Bolivia","Cochabamba","Cercado","Cochabamba","COLEGIO SAN ANTONIO DE PUCARA",-66.1666,-17.45451,1458,92,8964,10422,3375,324,5173,8548
"Bolivia","Cochabamba","Cercado","Cochabamba","COLEGIO SAN FRANCISCO DE ASIS",-66.15719,-17.43316,813,34,5774,6587,3177,138,2425,5602
"Bolivia","Cochabamba","Cercado","Cochabamba","COLEGIO SAN FRANCISCO (VILLA PAGADOR)",-66.11565,-17.43498,820,66,5571,6391,1769,211,3525,5294
"Bolivia","Cochabamba","Cercado","Cochabamba","COLEGIO SAN RAFAEL",-66.13949,-17.39816,653,16,4393,5046,3310,49,1018,4328
"Bolivia","Cochabamba","Cercado","Cochabamba","COLEGIO SANTA LUISA MARILLAC",-66.12972,-17.42876,730,49,5518,6248,2277,172,3020,5297
"Bolivia","Cochabamba","Cercado","Cochabamba","COLEGIO SANTO DOMINGO SAVIO",-66.15925,-17.42091,297,16,2234,2531,1401,60,757,2158
"Bolivia","Cochabamba","Cercado","Cochabamba","COLEGIO SEBASTIAN PAGADOR",-66.11807,-17.4396,1528,101,11230,12758,3900,353,6876,10776
"Bolivia","Cochabamba","Cercado","Cochabamba","COLEGIO SERGIO ALMARAZ PAZ",-66.15983,-17.42155,766,23,5259,6025,3325,143,1768,5093
"Bolivia","Cochabamba","Cercado","Cochabamba","COLEGIO TECNICO HUMANISTICO ABAROA",-66.18008,-17.39791,147,6,1098,1245,738,23,331,1069
"Bolivia","Cochabamba","Cercado","Cochabamba","COLEGIO VENEZUELA",-66.17432,-17.38003,420,16,2985,3405,2348,52,569,2917
"Bolivia","Cochabamba","Cercado","Cochabamba","COLEGIO VENJAMNIN",-66.12346,-17.42547,264,29,2102,2366,892,70,1111,2003
"Bolivia","Cochabamba","Cercado","Cochabamba","COLEGIO YUGOSLAVIA ( EX MARISCAL SANTA CRUZ)",-66.15756,-17.4142,355,11,2438,2793,1665,53,709,2374
"Bolivia","Cochabamba","Cercado","Cochabamba","ESC. FISCAL JUAN XXIII A – JUANCITO PINTO",-66.20342,-17.3892,214,5,1650,1864,1081,31,533,1614
"Bolivia","Cochabamba","Cercado","Cochabamba","ESC. REPUBLICA DEL PERU O I. VASQUEZ",-66.16631,-17.41514,1100,29,6962,8062,4546,136,2251,6797
"Bolivia","Cochabamba","Cercado","Cochabamba","ESCUELA 6 DE AGOSTO",-66.17321,-17.48531,604,71,4681,5285,1408,160,3042,4450
"Bolivia","Cochabamba","Cercado","Cochabamba","ESCUELA ANTOFAGASTA",-66.18551,-17.38673,721,45,5926,6647,4016,133,1732,5748
"Bolivia","Cochabamba","Cercado","Cochabamba","ESCUELA BOLIVAR",-66.15719,-17.40203,239,5,1240,1479,857,19,359,1216
"Bolivia","Cochabamba","Cercado","Cochabamba","ESCUELA BUENAS NUEVAS A",-66.14575,-17.41985,411,25,2759,3170,1307,81,1346,2653
"Bolivia","Cochabamba","Cercado","Cochabamba","ESCUELA CAMARA JUNIOR",-66.15968,-17.42823,346,17,2088,2434,1166,78,827,1993
"Bolivia","Cochabamba","Cercado","Cochabamba","ESCUELA CARLOS MEDINACELI",-66.14594,-17.44799,765,40,5459,6224,2177,157,3085,5262
"Bolivia","Cochabamba","Cercado","Cochabamba","ESCUELA CEFERINO NAMUNCURA",-66.22959,-17.44222,181,8,1063,1244,381,34,640,1021
"Bolivia","Cochabamba","Cercado","Cochabamba","ESCUELA CENTRAL TAQUIÑA A",-66.17831,-17.34379,706,52,5677,6383,2965,161,2499,5464
"Bolivia","Cochabamba","Cercado","Cochabamba","ESCUELA CENTRAL TAQUIÑA C",-66.17863,-17.3427,686,30,5223,5909,2725,147,2321,5046
"Bolivia","Cochabamba","Cercado","Cochabamba","ESCUELA EUSEBIO TUDELA",-66.21059,-17.44574,450,48,3770,4220,1177,135,2410,3587
"Bolivia","Cochabamba","Cercado","Cochabamba","ESCUELA FISCAL JUAN XXIII A",-66.20212,-17.38982,540,14,4012,4552,2580,66,1352,3932
"Bolivia","Cochabamba","Cercado","Cochabamba","ESCUELA GERARDO VARGAS",-66.12848,-17.43969,872,64,5519,6391,1967,190,3298,5265
"Bolivia","Cochabamba","Cercado","Cochabamba","ESCUELA GUALBERTO VILLARROEL",-66.14348,-17.38926,292,4,1962,2254,1557,24,377,1934
"Bolivia","Cochabamba","Cercado","Cochabamba","ESCUELA GUTIERREZ MARISCAL",-66.19385,-17.39756,652,46,5679,6331,3301,162,2170,5471
"Bolivia","Cochabamba","Cercado","Cochabamba","ESCUELA HUMBERTO PORTOCARRERO",-66.14091,-17.45442,592,23,4078,4670,1757,127,2171,3928
"Bolivia","Cochabamba","Cercado","Cochabamba","ESCUELA IV CENTENARIO",-66.18991,-17.35495,698,33,5144,5842,3146,117,1848,4994
"Bolivia","Cochabamba","Cercado","Cochabamba","ESCUELA JOSE GABRIEL DE GUMUCIO",-66.16722,-17.38438,246,3,1779,2025,1468,32,276,1744
"Bolivia","Cochabamba","Cercado","Cochabamba","ESCUELA JOSE MARIA SANTIVAÑEZ",-66.17485,-17.36938,604,10,4205,4809,3397,48,750,4147
"Bolivia","Cochabamba","Cercado","Cochabamba","ESCUELA MARYKNOLL",-66.16147,-17.37132,172,1,1224,1396,1064,15,144,1208
"Bolivia","Cochabamba","Cercado","Cochabamba","ESCUELA MIXTA FISCAL TEMPORAL A",-66.15884,-17.36139,656,29,5205,5861,3175,152,1849,5024
"Bolivia","Cochabamba","Cercado","Cochabamba","ESCUELA OTTO FELIPE BRAWN",-66.18926,-17.36244,555,19,4174,4729,2655,97,1403,4058
"Bolivia","Cochabamba","Cercado","Cochabamba","ESCUELA RICARDO PRUDENCIO",-66.14006,-17.42105,449,22,2988,3437,1337,95,1534,2871
"Bolivia","Cochabamba","Cercado","Cochabamba","ESCUELA WALTER VALLEJO",-66.14645,-17.40012,240,3,1370,1610,861,30,476,1337
"Bolivia","Cochabamba","Cercado","Cochabamba","ESCUELA WILGE RODRIGUEZ",-66.15132,-17.39204,163,6,900,1063,676,22,196,872
"Bolivia","Cochabamba","Cercado","Cochabamba","INSTITUTO AMERICANO",-66.15434,-17.36889,933,22,5993,6926,4669,95,1207,5876
"Bolivia","Cochabamba","Cercado","Cochabamba","INSTITUTO EDUARDO LAREDO",-66.1526,-17.38101,454,2,2164,2618,1825,21,316,2141
"Bolivia","Cochabamba","Cercado","Cochabamba","LICEO ADELA ZAMUDIO",-66.16859,-17.39639,546,8,2869,3415,2130,77,654,2784
"Bolivia","Cochabamba","Cercado","Cochabamba","LICEO ELENA ARZE DE ARZE",-66.16439,-17.37035,568,11,3531,4099,2871,59,590,3461
"Bolivia","Cochabamba","Cercado","Cochabamba","LICEO GUINDALINA LOAYZA",-66.16626,-17.38111,153,7,1293,1446,1083,15,188,1271
"Bolivia","Cochabamba","Cercado","Cochabamba","LICEO  MERCEDES CANDIA DE OVANDO",-66.13917,-17.39435,551,19,3684,4235,2701,90,874,3575
"Bolivia","Cochabamba","Cercado","Cochabamba","SEMINARIO SAN JOSE",-66.19784,-17.38371,361,9,2916,3277,2014,69,824,2838
"Bolivia","Cochabamba","Cercado","Cochabamba","U.E. MADRE DE LA DIVINA PROVIDENCIA",-66.14977,-17.43951,31,4,443,474,186,17,236,422
"Bolivia","Cochabamba","Cercado","Cochabamba","U.E. NACIONAL SAN ISIDRO",-66.15123,-17.46888,545,57,4004,4549,1009,162,2776,3785
"Bolivia","Cochabamba","Cercado","Cochabamba","U. E. SAN NICOLAS CLUB DE LEONES",-66.15354,-17.4825,180,33,1796,1976,381,75,1307,1688
"Bolivia","Cochabamba","Cercado","Cochabamba","UNIDAD EDUCATIVA 14 DE SEPTIEMBRE",-66.18018,-17.36749,87,1,933,1020,708,15,209,917
"Bolivia","Cochabamba","Cercado","Cochabamba","UNIDAD EDUCATIVA 26 DE OCTUBRE",-66.12116,-17.42092,39,0,545,584,269,15,261,530
"Bolivia","Cochabamba","Cercado","Cochabamba","UNIDAD EDUCATIVA 9 DE MARZO",-66.10553,-17.44673,76,15,1007,1083,263,32,697,960
"Bolivia","Cochabamba","Cercado","Cochabamba","UNIDAD EDUCATIVA ALTO COCHABAMBA",-66.14483,-17.42332,48,4,422,470,132,13,273,405
"Bolivia","Cochabamba","Cercado","Cochabamba","UNIDAD EDUCATIVA AMERICA DEL SUR - MEJILLONES A",-66.13793,-17.42199,39,7,342,381,158,11,166,324
"Bolivia","Cochabamba","Cercado","Cochabamba","UNIDAD EDUCATIVA ANDRES BELLO",-66.15125,-17.4158,596,25,3737,4333,1845,91,1776,3621
"Bolivia","Cochabamba","Cercado","Cochabamba","UNIDAD EDUCATIVA ANTONIO DIEZ",-66.17933,-17.47178,93,14,1553,1646,522,57,960,1482
"Bolivia","Cochabamba","Cercado","Cochabamba","UNIDAD EDUCATIVA ATIY",-66.15207,-17.46361,124,12,1138,1262,378,26,722,1100
"Bolivia","Cochabamba","Cercado","Cochabamba","UNIDAD EDUCATIVA BARBARA LAMAS",-66.10529,-17.46267,469,55,3502,3971,796,151,2500,3296
"Bolivia","Cochabamba","Cercado","Cochabamba","UNIDAD EDUCATIVA BOLIVIA (LA MAICA)",-66.21881,-17.41461,145,9,1277,1422,351,42,875,1226
"Bolivia","Cochabamba","Cercado","Cochabamba","UNIDAD EDUCATIVA CATOLICO GUADALUPANO (EX CALIFORNIA AMERICAN SCHOOL)",-66.1447,-17.36928,367,11,2791,3158,2054,50,676,2730
"Bolivia","Cochabamba","Cercado","Cochabamba","UNIDAD EDUCATIVA CLUB DE LEONES",-66.16528,-17.36456,502,19,3494,3996,2514,73,888,3402
"Bolivia","Cochabamba","Cercado","Cochabamba","UNIDAD EDUCATIVA DANIEL SALAMANCA (EX COLEGIO NAL. MIXTO 6 DE AGOSTO)",-66.16353,-17.39569,82,3,583,665,448,10,122,570
"Bolivia","Cochabamba","Cercado","Cochabamba","UNIDAD EDUCATIVA DE LA FUERZA AEREA",-66.16742,-17.42138,196,3,658,854,397,19,239,636
"Bolivia","Cochabamba","Cercado","Cochabamba","UNIDAD EDUCATIVA DEMETRIO CANELAS",-66.20225,-17.42305,217,24,1874,2091,627,56,1167,1794
"Bolivia","Cochabamba","Cercado","Cochabamba","UNIDAD EDUCATIVA DIONISIO MORALES CHOQUE",-66.12429,-17.46519,929,91,7321,8250,1596,285,5349,6945
"Bolivia","Cochabamba","Cercado","Cochabamba","UNIDAD EDUCATIVA DOMINGO SAVIO (EX LORENZO FILHO)",-66.14401,-17.38117,218,1,1194,1412,939,26,228,1167
"Bolivia","Cochabamba","Cercado","Cochabamba","UNIDAD EDUCATIVA EL SALVADOR SAN JAVIER",-66.12055,-17.44695,584,38,3769,4353,1520,85,2126,3646
"Bolivia","Cochabamba","Cercado","Cochabamba","UNIDAD EDUCATIVA ESTADOS UNIDOS",-66.16256,-17.41906,219,11,1660,1879,1034,42,573,1607
"Bolivia","Cochabamba","Cercado","Cochabamba","UNIDAD EDUCATIVA ESTEBAN ARZE",-66.18428,-17.39833,431,8,3409,3840,2256,104,1041,3297
"Bolivia","Cochabamba","Cercado","Cochabamba","UNIDAD EDUCATIVA FACUNDO QUIROGA",-66.18948,-17.37427,47,3,366,413,274,8,81,355
"Bolivia","Cochabamba","Cercado","Cochabamba","UNIDAD EDUCATIVA FELIX CAPRILES",-66.18253,-17.40841,73,4,784,857,534,19,227,761
"Bolivia","Cochabamba","Cercado","Cochabamba","UNIDAD EDUCATIVA GARIBALDI",-66.19059,-17.35455,222,13,1744,1966,1027,25,679,1706
"Bolivia","Cochabamba","Cercado","Cochabamba","UNIDAD EDUCATIVA HNO PACIFICO FELETTI",-66.20975,-17.46777,98,13,905,1003,205,33,654,859
"Bolivia","Cochabamba","Cercado","Cochabamba","UNIDAD EDUCATIVA JOSE IGNACIO SANJINES",-66.20641,-17.38527,95,7,1050,1145,661,27,355,1016
"Bolivia","Cochabamba","Cercado","Cochabamba","UNIDAD EDUCATIVA JUAN JOSE TORREZ",-66.11476,-17.44767,149,17,1415,1564,442,40,916,1358
"Bolivia","Cochabamba","Cercado","Cochabamba","UNIDAD EDUCATIVA MARIA EMILIA RIQUELME (EX MARIA CRISTINA)",-66.20455,-17.39834,479,20,3711,4190,2143,117,1431,3574
"Bolivia","Cochabamba","Cercado","Cochabamba","UNIDAD EDUCATIVA MARIA JOSEFA MUJIA",-66.14333,-17.42708,325,42,2969,3294,862,119,1946,2808
"Bolivia","Cochabamba","Cercado","Cochabamba","UNIDAD EDUCATIVA NATANIEL AGUIRRE",-66.16888,-17.39892,22,1,332,354,237,8,86,323
"Bolivia","Cochabamba","Cercado","Cochabamba","UNIDAD EDUCATIVA NUEVA ESPERANZA",-66.17866,-17.48736,628,77,5669,6297,1543,230,3819,5362
"Bolivia","Cochabamba","Cercado","Cochabamba","UNIDAD EDUCATIVA NUEVA VERA CRUZ",-66.11756,-17.46273,420,21,2889,3309,1009,97,1762,2771
"Bolivia","Cochabamba","Cercado","Cochabamba","UNIDAD EDUCATIVA OBISPO ANAYA",-66.12938,-17.45243,340,21,2445,2785,1038,64,1322,2360
"Bolivia","Cochabamba","Cercado","Cochabamba","UNIDAD EDUCATIVA PRIMERO DE MAYO",-66.20525,-17.46752,798,74,5989,6787,1676,212,4027,5703
"Bolivia","Cochabamba","Cercado","Cochabamba","UNIDAD EDUCATIVA PROF. OSCAR ROJAS CABALLERO",-66.15136,-17.43501,34,2,318,352,157,6,153,310
"Bolivia","Cochabamba","Cercado","Cochabamba","UNIDAD EDUCATIVA RENE BARRIENTOS ORTUÑO",-66.11013,-17.47701,993,89,6018,7011,1732,243,3954,5686
"Bolivia","Cochabamba","Cercado","Cochabamba","UNIDAD EDUCATIVA RENE CRESPO",-66.151,-17.42624,95,6,823,918,275,33,509,784
"Bolivia","Cochabamba","Cercado","Cochabamba","UNIDAD EDUCATIVA ROSENDO PEÑA",-66.19244,-17.37992,45,1,481,526,361,12,107,468
"Bolivia","Cochabamba","Cercado","Cochabamba","UNIDAD EDUCATIVA SAN MIGUEL",-66.14757,-17.40514,471,22,2432,2903,1105,67,1238,2343
"Bolivia","Cochabamba","Cercado","Cochabamba","UNIDAD EDUCATIVA SAN MIGUEL ALTA TENSION",-66.13224,-17.43877,79,16,649,728,215,13,405,620
"Bolivia","Cochabamba","Cercado","Cochabamba","UNIDAD EDUCATIVA SANTA CRUZ - EDUARDO OCAMPO MOSCOSO",-66.15053,-17.41479,20,1,132,152,51,2,78,129
"Bolivia","Cochabamba","Cercado","Cochabamba","UNIDAD EDUCATIVA SANTA MARIA MICAELA",-66.17656,-17.40725,717,16,5180,5897,3518,125,1521,5039
"Bolivia","Cochabamba","Cercado","Cochabamba","UNIDAD EDUCATIVA SANTIAGO",-66.1651,-17.3495,383,23,3641,4024,1680,131,1807,3487
"Bolivia","Cochabamba","Cercado","Cochabamba","UNIDAD EDUCATIVA SIGLO XX - GABRIELA MISTRAL",-66.12198,-17.43334,140,16,1338,1478,485,38,799,1284
"Bolivia","Cochabamba","Cercado","Cochabamba","UNIDAD EDUCATIVA STEFANO HOTELLIER",-66.13995,-17.46966,184,24,1891,2075,487,75,1305,1792
"Bolivia","Cochabamba","Cercado","Cochabamba","UNIDAD EDUCATIVA VERDAD Y VIDA",-66.10658,-17.47467,235,33,2227,2462,598,80,1516,2114
"Bolivia","Cochabamba","Cercado","Cochabamba","UNIDAD EDUCATIVA VISION MUNDIAL",-66.1441,-17.43991,692,39,4831,5523,2164,146,2482,4646
"Bolivia","Cochabamba","Cercado","Cochabamba","UNIDAD EDUCATIVA VOCES LIBRES",-66.13216,-17.47402,23,7,329,352,66,9,247,313
"Bolivia","Cochabamba","Cercado","Cochabamba","UNIDAD EDU. EDUARDO LOPEZ O E.DON BOSCO",-66.17724,-17.4273,373,29,2362,2735,1017,57,1259,2276
"Bolivia","Cochabamba","Cercado","Cochabamba","UNIVERSIDAD CATOLICA",-66.14394,-17.37205,863,26,5636,6499,4383,97,1130,5513
"Bolivia","Cochabamba","Cercado","Cochabamba","UNIVERSIDAD UCATEC (EX CEIVO)",-66.13677,-17.37113,253,8,2127,2380,1606,38,475,2081
"Bolivia","Cochabamba","Chapare","Colomi","NUCLEO ESCOLAR CANDELARIA",-65.92474,-17.27441,156,31,1832,1988,331,88,1382,1713
"Bolivia","Cochabamba","Chapare","Colomi","NUCLEO ESCOLAR TABLAS MONTE",-65.99883,-17.0847,83,16,568,651,48,10,494,542
"Bolivia","Cochabamba","Chapare","Colomi","U.E. ROSARIO",-65.88084,-17.3183,3,3,87,90,36,1,47,83
"Bolivia","Cochabamba","Chapare","Colomi","UNIDAD EDUCATIVA CORANI PAMPA",-65.93583,-17.13022,106,19,1142,1248,205,41,877,1082
"Bolivia","Cochabamba","Chapare","Colomi","UNIDAD EDUCATIVA EL PALMAR",-65.74912,-17.18198,45,4,260,305,55,5,196,251
"Bolivia","Cochabamba","Chapare","Colomi","UNIDAD EDUCATIVA PARACTI (COLOMI)",-65.82558,-17.20783,60,5,516,576,172,25,314,486
"Bolivia","Cochabamba","Chapare","Colomi","UNIDAD EDUCATIVA PUCA MAYU (COLOMI)",-65.90272,-17.01873,1,0,8,9,0,0,8,8
"Bolivia","Cochabamba","Chapare","Colomi","UNIDAD EDUCATIVA SAMUEL FINA SAVIO",-65.8636,-17.34076,914,144,5977,6891,1880,370,3583,5463
"Bolivia","Cochabamba","Chapare","Sacaba","(CÁRCEL) PENITENCIARIA EL ABRA",-66.11572,-17.40493,65,1,223,288,56,4,162,218
"Bolivia","Cochabamba","Chapare","Sacaba","(CÁRCEL) PENITENCIARIA SAN PEDRO (SACABA)",-66.0414,-17.40583,51,2,105,156,21,3,79,100
"Bolivia","Cochabamba","Chapare","Sacaba","COLEGIO BOLIVIANO JAPONES",-66.09353,-17.37924,1004,54,7211,8215,4531,203,2423,6954
"Bolivia","Cochabamba","Chapare","Sacaba","COLEGIO FRANZ TAMAYO (CHIÑATA)",-65.98093,-17.43051,525,41,3978,4503,1427,154,2356,3783
"Bolivia","Cochabamba","Chapare","Sacaba","COLEGIO NATANIEL AGUIRRE",-65.83003,-17.37266,148,8,1266,1414,208,52,998,1206
"Bolivia","Cochabamba","Chapare","Sacaba","COLEGIO PUERTO MEJILLONES",-66.1301,-17.37218,576,26,4465,5041,2823,87,1529,4352
"Bolivia","Cochabamba","Chapare","Sacaba","COLEGIO QUINTANILLA",-66.10987,-17.3848,1591,97,10227,11818,5854,343,3933,9787
"Bolivia","Cochabamba","Chapare","Sacaba","COLEGIO RENE FERNANDEZ BECERRA",-65.91483,-17.42616,124,13,1040,1164,158,16,853,1011
"Bolivia","Cochabamba","Chapare","Sacaba","COLEGIO SEÑOR DE MAYO",-66.11799,-17.37354,919,33,6076,6995,4052,119,1872,5924
"Bolivia","Cochabamba","Chapare","Sacaba","ESCUELA 6 DE JUNIO - TACOPOCA",-66.02658,-17.41193,437,63,3749,4186,1461,150,2075,3536
"Bolivia","Cochabamba","Chapare","Sacaba","ESCUELA CARLOS PEREDO SANDOVAL",-66.05909,-17.3939,1065,98,7387,8452,3470,306,3513,6983
"Bolivia","Cochabamba","Chapare","Sacaba","ESCUELA COPACABANA",-66.10087,-17.39216,460,36,3588,4048,2090,106,1356,3446
"Bolivia","Cochabamba","Chapare","Sacaba","ESCUELA GERMAN BUSCH",-66.0383,-17.40434,745,56,4774,5519,2474,200,2044,4518
"Bolivia","Cochabamba","Chapare","Sacaba","ESCUELA GUADALUPE",-66.07703,-17.38369,843,31,5983,6826,3471,189,2292,5763
"Bolivia","Cochabamba","Chapare","Sacaba","ESCUELA JESUS TERCEROS",-66.12031,-17.38594,438,6,3210,3648,2324,71,809,3133
"Bolivia","Cochabamba","Chapare","Sacaba","ESCUELA MAN CESPED",-66.03825,-17.40714,911,69,6361,7272,3261,258,2773,6034
"Bolivia","Cochabamba","Chapare","Sacaba","ESCUELA NATALIO ARAUCO",-66.04586,-17.40147,675,49,4489,5164,2353,148,1939,4292
"Bolivia","Cochabamba","Chapare","Sacaba","ESCUELA RENE BARRIENTOS ORTUÑO (UCUCHI)",-65.92544,-17.4195,90,8,574,664,139,19,408,547
"Bolivia","Cochabamba","Chapare","Sacaba","INSTITUTO TECNICO SACABA (ITSA)",-66.04596,-17.40543,16,2,126,142,58,5,61,119
"Bolivia","Cochabamba","Chapare","Sacaba","LICEO DE SEÑORITAS SACABA",-66.04489,-17.40398,928,66,6075,7003,3243,194,2572,5815
"Bolivia","Cochabamba","Chapare","Sacaba","U.E. MARCELO QUIROGA SANTA CRUZ (PACATA)",-66.1184,-17.3762,15,1,161,176,104,2,54,158
"Bolivia","Cochabamba","Chapare","Sacaba","U.E. NUEVO AMANECER",-66.03468,-17.45286,29,11,603,632,130,48,414,544
"Bolivia","Cochabamba","Chapare","Sacaba","U.E. TUTIMAYU",-65.95177,-17.41679,49,16,878,927,269,27,566,835
"Bolivia","Cochabamba","Chapare","Sacaba","UNIDAD EDUCATIVA 27 DE AGOSTO",-66.05526,-17.41448,17,4,390,407,115,11,260,375
"Bolivia","Cochabamba","Chapare","Sacaba","UNIDAD EDUCATIVA BOLIVIANO BRITÁNICO",-66.02322,-17.40267,395,42,3050,3445,1205,108,1695,2900
"Bolivia","Cochabamba","Chapare","Sacaba","UNIDAD EDUCATIVA CEILAB",-66.073,-17.38945,14,2,167,181,110,7,48,158
"Bolivia","Cochabamba","Chapare","Sacaba","UNIDAD EDUCATIVA DEL VALLE",-66.1094,-17.38272,203,13,1838,2041,1097,42,686,1783
"Bolivia","Cochabamba","Chapare","Sacaba","UNIDAD EDUCATIVA EDMUNDO BOJANOWSKI",-66.12388,-17.37073,35,1,397,432,249,9,138,387
"Bolivia","Cochabamba","Chapare","Sacaba","UNIDAD EDUCATIVA ENTRE RIOS",-66.06012,-17.40147,9,3,167,176,50,10,104,154
"Bolivia","Cochabamba","Chapare","Sacaba","UNIDAD EDUCATIVA HERNÁN RIVERO FIORILO",-66.07921,-17.40404,177,17,1925,2102,859,57,992,1851
"Bolivia","Cochabamba","Chapare","Sacaba","UNIDAD EDUCATIVA ISRAELÍ EL ABRA",-66.10103,-17.40372,627,66,5585,6212,2018,217,3284,5302
"Bolivia","Cochabamba","Chapare","Sacaba","UNIDAD EDUCATIVA KANATA",-66.10153,-17.38585,89,3,708,797,560,16,129,689
"Bolivia","Cochabamba","Chapare","Sacaba","UNIDAD EDUCATIVA LARATI",-66.01265,-17.34382,30,6,773,803,93,11,663,756
"Bolivia","Cochabamba","Chapare","Sacaba","UNIDAD EDUCATIVA PAMPILLA",-66.0752,-17.18917,195,49,2082,2277,498,128,1407,1905
"Bolivia","Cochabamba","Chapare","Sacaba","UNIDAD EDUCATIVA RENÉ BARRIENTOS ORTUÑO",-66.11898,-17.37671,135,5,1137,1272,714,27,391,1105
"Bolivia","Cochabamba","Chapare","Sacaba","UNIDAD EDUCATIVA REPUBLICA DE ITALIA",-66.04491,-17.40258,156,15,1465,1621,637,34,779,1416
"Bolivia","Cochabamba","Chapare","Sacaba","UNIDAD EDUCATIVA ULINCATE",-65.98841,-17.4069,109,14,1042,1151,384,40,604,988
"Bolivia","Cochabamba","Chapare","Sacaba","UNIDAD EDUCATIVA VILLA GRACIELA",-66.13087,-17.37237,288,15,2428,2716,1496,43,874,2370
"Bolivia","Cochabamba","Chapare","Villa Tunari","COLEGIO FE Y ALEGRIA",-65.40147,-16.91353,164,18,1661,1825,199,43,1401,1600
"Bolivia","Cochabamba","Chapare","Villa Tunari","COLEGIO FRANCISCO VIGNAUD",-65.42472,-16.97513,119,5,521,640,170,7,339,509
"Bolivia","Cochabamba","Chapare","Villa Tunari","COLEGIO MIXTO TECNICO HUM. VILLA BOLIVAR",-65.74024,-16.62949,54,6,496,550,40,6,444,484
"Bolivia","Cochabamba","Chapare","Villa Tunari","COLEGIO NUEVA TACOPAYA",-65.67545,-16.56796,102,7,1124,1226,117,33,967,1084
"Bolivia","Cochabamba","Chapare","Villa Tunari","ESCUELA 27 DE MAYO",-65.30819,-16.74821,115,13,533,648,90,25,405,495
"Bolivia","Cochabamba","Chapare","Villa Tunari","ESCUELA CRISTAL MAYU",-65.64395,-17.00619,193,18,1595,1788,138,31,1408,1546
"Bolivia","Cochabamba","Chapare","Villa Tunari","ESCUELA ELIZARDO PEREZ",-65.64406,-16.73144,242,25,1966,2208,236,45,1660,1896
"Bolivia","Cochabamba","Chapare","Villa Tunari","ESCUELA LA ESTRELLA",-65.49522,-16.72417,47,3,573,620,49,17,504,553
"Bolivia","Cochabamba","Chapare","Villa Tunari","ESCUELA LA ESTRELLA (SAN GABRIEL)",-65.62708,-16.6753,281,4,2075,2356,163,37,1871,2034
"Bolivia","Cochabamba","Chapare","Villa Tunari","ESCUELA SAMUZABETI",-65.57269,-16.81616,201,12,2121,2322,133,49,1927,2060
"Bolivia","Cochabamba","Chapare","Villa Tunari","ESCUELA SAN ANTONIO DE VILLA TUNARI",-65.4173,-16.97306,359,17,1849,2208,607,44,1181,1788
"Bolivia","Cochabamba","Chapare","Villa Tunari","ESCUELA SAN JOSE (V.TUNARI)",-65.46657,-16.81087,152,5,1283,1435,69,17,1192,1261
"Bolivia","Cochabamba","Chapare","Villa Tunari","ESCUELA VILLA 14 DE SEPTIEMBRE",-65.34883,-16.84459,677,73,4890,5567,597,121,4099,4696
"Bolivia","Cochabamba","Chapare","Villa Tunari","NUCLEO ESCOLAR NUEVA AROMA",-65.82585,-16.56242,86,14,917,1003,60,4,839,899
"Bolivia","Cochabamba","Chapare","Villa Tunari","U. E. INDEPENDENCIA (VILLA TUNARI)",-65.79965,-16.4638,88,14,975,1063,41,13,907,948
"Bolivia","Cochabamba","Chapare","Villa Tunari","U.E. SAN BENITO",-65.5032,-16.53337,18,2,56,74,5,1,48,53
"Bolivia","Cochabamba","Chapare","Villa Tunari","U. E. SANTA ROSA DE LA BOCA",-64.7546,-15.93035,28,0,25,53,24,0,1,25
"Bolivia","Cochabamba","Chapare","Villa Tunari","UNIDAD EDUCATIVA 1RO DE MAYO",-65.42921,-16.64719,50,2,591,641,52,16,521,573
"Bolivia","Cochabamba","Chapare","Villa Tunari","UNIDAD EDUCATIVA 27 DE MAYO",-65.46113,-17.0208,18,1,326,344,12,2,311,323
"Bolivia","Cochabamba","Chapare","Villa Tunari","UNIDAD EDUCATIVA JATUN PAMPA",-65.5677,-17.00337,115,14,1017,1132,160,28,815,975
"Bolivia","Cochabamba","Chapare","Villa Tunari","UNIDAD EDUCATIVA MIXTA ETERAZAMA",-65.52284,-16.83394,535,52,4318,4853,672,112,3482,4154
"Bolivia","Cochabamba","Chapare","Villa Tunari","UNIDAD EDUCATIVA MOLETO ICOYA (V.TUNARI)",-65.8701,-16.4744,43,6,645,688,25,14,600,625
"Bolivia","Cochabamba","Chapare","Villa Tunari","UNIDAD EDUCATIVA PARACTITO",-65.46431,-17.03166,228,19,1648,1876,289,54,1286,1575
"Bolivia","Cochabamba","Chapare","Villa Tunari","UNIDAD EDUCATIVA PARACTI (VILLA TUNARI)",-65.82552,-17.20792,65,6,326,391,46,7,267,313
"Bolivia","Cochabamba","Chapare","Villa Tunari","UNIDAD EDUCATIVA PARAISO-TODO SANTOS",-65.29498,-16.90554,149,20,1507,1656,182,41,1264,1446
"Bolivia","Cochabamba","Chapare","Villa Tunari","UNIDAD EDUCATIVA SAN FRANCISCO KM 21",-65.33453,-16.76798,31,7,603,634,32,15,549,581
"Bolivia","Cochabamba","Chapare","Villa Tunari","UNIDAD EDUCATIVA SAN JOSE DE ANGOSTA",-65.90482,-16.42696,75,5,207,282,20,20,162,182
"Bolivia","Cochabamba","Chapare","Villa Tunari","UNIDAD EDUCATIVA SIMON RODRIGUEZ (EX PUCA MAYU (V. TUNARI))",-65.90272,-17.01873,65,9,501,566,44,12,436,480
"Bolivia","Cochabamba","Chapare","Villa Tunari","UNIDAD EDUCATIVA TOCOPILLA",-65.26644,-16.81101,33,7,378,411,22,10,339,361
"Bolivia","Cochabamba","Chapare","Villa Tunari","UNIDAD EDUCATIVA UNCIA",-65.73511,-16.52453,42,10,573,615,26,18,519,545
"Bolivia","Cochabamba","Chapare","Villa Tunari","UNIDAD EDUCATIVA VILLA NUEVA",-65.33994,-16.65689,21,1,314,335,27,10,276,303
"Bolivia","Cochabamba","Esteban Arce","Anzaldo","ESC. ESTEBAN ANDIA ESCOBAR - PACCHA PATA",-65.94566,-17.70326,29,6,157,186,29,7,115,144
"Bolivia","Cochabamba","Esteban Arce","Anzaldo","NUCLEO EDUCATIVO LA VIÑA",-65.85647,-17.96978,46,4,194,240,42,6,142,184
"Bolivia","Cochabamba","Esteban Arce","Anzaldo","U. E. SAN JOSE DE CALAZANS-LITORAL",-65.93351,-17.78299,405,93,2084,2489,570,102,1319,1889
"Bolivia","Cochabamba","Esteban Arce","Anzaldo","UNIDAD EDUCATIVA ALFAMAYU",-65.93799,-17.86563,9,1,68,77,2,2,63,65
"Bolivia","Cochabamba","Esteban Arce","Anzaldo","UNIDAD EDUCATIVA ARTURO SARMIENTO",-65.94575,-17.90018,47,3,252,299,31,16,202,233
"Bolivia","Cochabamba","Esteban Arce","Anzaldo","UNIDAD EDUCATIVA THAGO KASA",-65.82888,-17.89126,13,2,120,133,11,2,105,116
"Bolivia","Cochabamba","Esteban Arce","Arbieto","CENTRO EDUCATIVO GERMAN BUSCH - ARBIETO",-66.01723,-17.58551,372,33,1648,2020,467,62,1086,1553
"Bolivia","Cochabamba","Esteban Arce","Arbieto","ESCUELA SECCIONAL ARPITA",-66.07514,-17.56822,196,20,1007,1203,160,39,788,948
"Bolivia","Cochabamba","Esteban Arce","Arbieto","UNIDAD EDUCATIVA 6 DE JUNIO - MAMANACA",-66.05242,-17.58441,131,13,547,678,138,17,379,517
"Bolivia","Cochabamba","Esteban Arce","Arbieto","UNIDAD EDUCATIVA ANTONIO ARNEZ -ARANJUEZ",-65.97636,-17.5959,56,4,340,396,101,10,225,326
"Bolivia","Cochabamba","Esteban Arce","Arbieto","UNIDAD EDUCATIVA CARLOS CANELAS",-66.09542,-17.49024,262,40,2833,3095,515,128,2150,2665
"Bolivia","Cochabamba","Esteban Arce","Arbieto","UNIDAD ESCOLAR CASIMIRO LOPEZ T.",-66.08762,-17.51215,66,7,354,420,128,6,213,341
"Bolivia","Cochabamba","Esteban Arce","Sacabamba","ESCUELA ELISEO TORRICO - SACABAMBA",-65.77574,-17.81699,112,22,664,776,176,37,429,605
"Bolivia","Cochabamba","Esteban Arce","Sacabamba","ESCUELA SECCIONAL CHALLAQUE",-65.75699,-17.83179,32,5,228,260,57,14,152,209
"Bolivia","Cochabamba","Esteban Arce","Sacabamba","NUCLEO ESCOLAR QUEKOMA",-65.8235,-17.70307,46,10,263,309,22,8,223,245
"Bolivia","Cochabamba","Esteban Arce","Sacabamba","NUCLEO MATARANI",-65.80145,-17.80308,97,12,592,689,103,24,453,556
"Bolivia","Cochabamba","Esteban Arce","Sacabamba","UNIDAD EDUCATIVA APILLAPA",-65.85152,-17.76226,12,3,172,184,20,6,143,163
"Bolivia","Cochabamba","Esteban Arce","Tarata","COLEGIO MY. VICTOR USTARIZ",-66.02438,-17.60891,498,23,1636,2134,548,58,1007,1555
"Bolivia","Cochabamba","Esteban Arce","Tarata","ESCUELA ESTEBAN ARZE",-66.02402,-17.61324,206,25,1195,1401,327,46,797,1124
"Bolivia","Cochabamba","Esteban Arce","Tarata","ESCUELA LUIS TERRAZAS",-66.07424,-17.75421,36,3,182,218,7,6,166,173
"Bolivia","Cochabamba","Esteban Arce","Tarata","ESCUELA RENE BARRIENTOS O.",-66.02374,-17.61071,322,22,1254,1576,383,37,812,1195
"Bolivia","Cochabamba","Esteban Arce","Tarata","UNIDAD EDUCATIVA HUASA RANCHO",-65.96735,-17.61409,31,6,141,172,38,3,94,132
"Bolivia","Cochabamba","Esteban Arce","Tarata","UNIDAD EDUCATIVA HUAYCULI",-65.97934,-17.6437,87,8,537,624,59,14,456,515
"Bolivia","Cochabamba","Esteban Arce","Tarata","UNIDAD EDUCATIVA HUERTA MAYU",-66.11383,-17.63796,42,3,351,393,8,6,334,342
"Bolivia","Cochabamba","Germán Jordán","Cliza","COLEGIO JUAN DE DIOS BALDERRAMA",-65.93368,-17.59121,762,62,4482,5244,1702,131,2587,4289
"Bolivia","Cochabamba","Germán Jordán","Cliza","COLEGIO NACIONAL MIXTO UCUREÑA",-65.90669,-17.58086,264,29,2045,2309,630,42,1344,1974
"Bolivia","Cochabamba","Germán Jordán","Cliza","ESCUELA SUCRE",-65.9311,-17.59395,819,45,3548,4367,1273,112,2118,3391
"Bolivia","Cochabamba","Germán Jordán","Cliza","UNIDAD EDUCATIVA CHULLPAS",-65.94772,-17.60734,134,11,628,762,146,27,444,590
"Bolivia","Cochabamba","Germán Jordán","Cliza","UNIDAD EDUCATIVA HUASACALLE",-65.90952,-17.5931,75,13,537,612,151,11,362,513
"Bolivia","Cochabamba","Germán Jordán","Cliza","UNIDAD EDUCATIVA SANTA LUCIA",-65.9581,-17.58606,94,7,409,503,126,18,258,384
"Bolivia","Cochabamba","Germán Jordán","Toko","COLEGIO AMBROSINI",-65.92783,-17.62949,517,52,2421,2938,476,65,1828,2304
"Bolivia","Cochabamba","Germán Jordán","Toko","UNIDAD EDUCATIVA SICHES",-65.94588,-17.66759,37,8,206,243,29,8,161,190
"Bolivia","Cochabamba","Germán Jordán","Tolata","COLEGIO VICTOR ROSALES",-65.96407,-17.53315,426,35,1615,2041,526,66,988,1514
"Bolivia","Cochabamba","Germán Jordán","Tolata","ESCUELA SAN ISIDRO",-65.97154,-17.56319,110,14,348,458,82,14,238,320
"Bolivia","Cochabamba","Germán Jordán","Tolata","ESCUELA SANTA MARIA (CARCAJE)",-66.0082,-17.54546,427,25,1648,2075,692,64,867,1559
"Bolivia","Cochabamba","Mizque","Alalay","ESCUELA DR. DEMETRIO CANELAS",-65.60884,-17.76655,47,10,382,429,88,14,270,358
"Bolivia","Cochabamba","Mizque","Alalay","U. E. ABRAHAM FLORES VELASQUEZ",-65.69196,-17.72072,73,4,334,407,30,7,293,323
"Bolivia","Cochabamba","Mizque","Alalay","UNIDAD EDUCATIVA QUTURI",-65.5355,-17.7629,26,6,185,211,18,4,157,175
"Bolivia","Cochabamba","Mizque","Alalay","UNIDAD EDUCATIVA YANA KHAKHA",-65.60854,-17.85578,52,1,207,259,11,6,189,200
"Bolivia","Cochabamba","Mizque","Mizque","COLEGIO PEDRO IGNACIO RIVERO",-65.35332,-17.94529,629,74,4377,5006,1495,205,2603,4098
"Bolivia","Cochabamba","Mizque","Mizque","ESCUELA AGUADA",-65.30665,-18.00293,124,14,586,710,74,22,476,550
"Bolivia","Cochabamba","Mizque","Mizque","ESCUELA GUILLERMO VISCARRA",-65.30976,-17.91031,74,6,511,585,41,13,451,492
"Bolivia","Cochabamba","Mizque","Mizque","ESCUELA MIXTA DR. MARTIN CARDENAS",-65.54247,-18.22179,134,26,854,988,239,43,546,785
"Bolivia","Cochabamba","Mizque","Mizque","NUCLEO CENTRO SALVIA",-65.33526,-18.14982,22,4,248,270,16,9,219,235
"Bolivia","Cochabamba","Mizque","Mizque","NUCLEO ESCOLAR BETA RAQAY PAMPA",-65.38233,-18.19124,153,18,1127,1280,27,36,1046,1073
"Bolivia","Cochabamba","Mizque","Mizque","NUCLEO ESCOLAR LAGUNA GRANDE",-65.37489,-18.30198,104,19,827,931,40,18,750,790
"Bolivia","Cochabamba","Mizque","Mizque","NUCLEO JOSÉ CLAURE (U. E. SAN VICENTE)",-65.53803,-18.16495,61,3,353,414,23,8,319,342
"Bolivia","Cochabamba","Mizque","Mizque","SEDE CENTRAL CAMPESINA (KURI)",-65.45872,-17.83207,21,6,295,316,30,14,245,275
"Bolivia","Cochabamba","Mizque","Mizque","SEDE SINDICAL DE CHAHUARANI CHICO",-65.52352,-18.05988,7,8,211,218,13,10,180,193
"Bolivia","Cochabamba","Mizque","Mizque","SEDE SOCIAL DE TIPA TIPA",-65.26866,-18.09922,69,28,479,548,114,16,321,435
"Bolivia","Cochabamba","Mizque","Mizque","UNIDAD EDUCATIVA CAUTA",-65.43818,-18.09074,24,3,175,199,21,9,142,163
"Bolivia","Cochabamba","Mizque","Mizque","UNIDAD EDUCATIVA MOLINERO",-65.38817,-18.26225,56,9,299,355,17,14,259,276
"Bolivia","Cochabamba","Mizque","Mizque","UNIDAD EDUCATIVA SANTIAGO",-65.32516,-18.20377,20,8,313,333,14,10,281,295
"Bolivia","Cochabamba","Mizque","Mizque","UNIDAD EDUCATIVA THAGO THAGO",-65.3672,-17.9808,35,14,447,482,69,27,337,406
"Bolivia","Cochabamba","Mizque","Mizque","UNIDAD EDUCATIVA TIN TIN",-65.45436,-18.0311,114,18,699,813,135,23,523,658
"Bolivia","Cochabamba","Mizque","Mizque","UNIDAD EDUCATIVA UCHHAMA ALTA",-65.50367,-17.95332,9,0,139,148,5,1,133,138
"Bolivia","Cochabamba","Mizque","Vila Vila","ESCUELA HUMBERTO NOGALES",-65.62921,-17.98482,123,16,674,797,51,11,596,647
"Bolivia","Cochabamba","Mizque","Vila Vila","NUCLEO ESCOLAR SIQUIMIRA",-65.73359,-18.01842,37,3,386,423,12,4,367,379
"Bolivia","Cochabamba","Mizque","Vila Vila","NUCLEO ESCOLAR SIVINGANI",-65.68718,-17.91458,60,15,290,350,37,17,221,258
"Bolivia","Cochabamba","Mizque","Vila Vila","UNIDAD EDUCATIVA POCOTAICA",-65.78678,-17.93137,10,1,71,81,4,2,64,68
"Bolivia","Cochabamba","Punata","Cuchumuela (Villa Gualberto Villarroel)","ESCUELA CUCHU MUELA",-65.7948,-17.65219,64,9,578,642,225,20,324,549
"Bolivia","Cochabamba","Punata","Cuchumuela (Villa Gualberto Villarroel)","NUCLEO ESCOLAR YANA RUMI",-65.74833,-17.70206,36,8,256,292,26,7,215,241
"Bolivia","Cochabamba","Punata","Punata","ESCUELA ADELA ZAMUDIO",-65.83555,-17.54252,855,54,4243,5098,1989,207,1993,3982
"Bolivia","Cochabamba","Punata","Punata","ESCUELA ANDRES MARIA TORRICO",-65.8345,-17.54389,632,57,3452,4084,1480,160,1755,3235
"Bolivia","Cochabamba","Punata","Punata","LICEO JOSEFA M. GANDARILLAS (EX SUCRE)",-65.83789,-17.54791,650,47,3300,3950,1624,155,1474,3098
"Bolivia","Cochabamba","Punata","Punata","SEDE SINDICAL THACO",-65.82087,-17.55312,66,14,552,618,147,24,367,514
"Bolivia","Cochabamba","Punata","Punata","U. E. MANUEL A. VILLARROEL (EX BOLIVAR)",-65.83459,-17.54425,640,39,3571,4211,1654,165,1713,3367
"Bolivia","Cochabamba","Punata","Punata","U. E. RENE BARRIENTOS O. - LA VILLA",-65.81705,-17.51416,113,29,506,619,101,21,355,456
"Bolivia","Cochabamba","Punata","Punata","U. E. RUBEN FERRUFINO (CAMACHO RANCHO)",-65.84141,-17.56411,126,18,747,873,222,38,469,691
"Bolivia","Cochabamba","Punata","Punata","UNIDAD EDUCATIVA MAYOR ROCHA (YACANAHUYO",-65.84713,-17.55166,96,25,771,867,308,36,402,710
"Bolivia","Cochabamba","Punata","Punata","UNIDAD EDUCATIVA MOLLE HUMA",-65.8109,-17.52157,84,19,555,639,111,19,406,517
"Bolivia","Cochabamba","Punata","Punata","UNIDAD EDUCATIVA TAJAMAR",-65.86192,-17.55713,95,22,744,839,308,39,375,683
"Bolivia","Cochabamba","Punata","Punata","UNIDAD EDUCATIVA TAMBILLO CHICO",-65.8281,-17.57144,59,8,387,446,108,24,247,355
"Bolivia","Cochabamba","Punata","San Benito (Villa José Quintín Mendoza)","COLEGIO SIMON BOLIVAR (HUARICAYA)",-65.92278,-17.52582,142,22,999,1141,294,24,659,953
"Bolivia","Cochabamba","Punata","San Benito (Villa José Quintín Mendoza)","ESCUELA EXPERIMENTAL PARACAYA",-65.85702,-17.5135,329,44,2533,2862,688,93,1708,2396
"Bolivia","Cochabamba","Punata","San Benito (Villa José Quintín Mendoza)","U. E. 27 DE MAYO (EX JOSE B. PEREIRA)",-65.89712,-17.52321,441,46,3114,3555,1004,98,1966,2970
"Bolivia","Cochabamba","Punata","San Benito (Villa José Quintín Mendoza)","UNIDAD EDUCATIVA SUNCHU PAMPA",-65.91961,-17.55873,150,20,801,951,210,28,543,753
"Bolivia","Cochabamba","Punata","San Benito (Villa José Quintín Mendoza)","UNIDAD EDUCATIVA WAÑAKAHUA",-65.8343,-17.51407,46,6,518,564,130,22,360,490
"Bolivia","Cochabamba","Punata","Tacachi","UNIDAD EDUCATIVA TACACHI",-65.80265,-17.63962,88,6,471,559,178,24,263,441
"Bolivia","Cochabamba","Punata","Villa Rivero","COL TEC IND COMUNITARIO MARCELO QUIROGA",-65.87885,-17.60502,543,36,2422,2965,385,75,1926,2311
"Bolivia","Cochabamba","Punata","Villa Rivero","ESCUELA GUALBERTO VILLARROEL (V. RIVERO)",-65.81674,-17.61485,393,42,1776,2169,719,86,929,1648
"Bolivia","Cochabamba","Punata","Villa Rivero","UNIDAD EDUCATIVA MARTÍN CÁRDENAS HERMOSO",-65.86461,-17.62572,37,5,258,295,35,6,212,247
"Bolivia","Cochabamba","Quillacollo","Colcapirhua","COLEGIO MAX FERNANDEZ",-66.23126,-17.39577,720,28,5274,5994,2955,156,2135,5090
"Bolivia","Cochabamba","Quillacollo","Colcapirhua","ESCUELA JESUS LARA",-66.22623,-17.39318,575,25,4805,5380,2928,110,1742,4670
"Bolivia","Cochabamba","Quillacollo","Colcapirhua","INSTITUTO MARÍA CRISTINA",-66.21936,-17.39718,263,6,1638,1901,968,40,624,1592
"Bolivia","Cochabamba","Quillacollo","Colcapirhua","SEDE SOCIAL CALLAJ CHULLPA (COLCAPIRHUA)",-66.24318,-17.35337,57,8,449,506,213,22,206,419
"Bolivia","Cochabamba","Quillacollo","Colcapirhua","SEDE SOCIAL DE LA OTB MARTIN CARDENAS (EX COMPLEJO EL CARMEN)",-66.21273,-17.3792,36,3,223,259,118,5,97,215
"Bolivia","Cochabamba","Quillacollo","Colcapirhua","U. E. PROF. BENEDICTO DURÁN ORTÍZ",-66.22591,-17.38681,85,1,708,793,385,23,299,684
"Bolivia","Cochabamba","Quillacollo","Colcapirhua","UNIDAD EDUCATIVA DANIEL SALAMANCA",-66.24152,-17.38778,843,58,6585,7428,3511,198,2818,6329
"Bolivia","Cochabamba","Quillacollo","Colcapirhua","UNIDAD EDUCATIVA EL SAUSALITO",-66.21352,-17.38681,645,28,5005,5650,2809,167,2001,4810
"Bolivia","Cochabamba","Quillacollo","Colcapirhua","UNIDAD EDUCATIVA LA SAGRADA FAMILIA",-66.22238,-17.38265,120,14,1624,1744,904,36,670,1574
"Bolivia","Cochabamba","Quillacollo","Colcapirhua","UNIDAD EDUCATIVA SAN JOSÉ DE KAMI",-66.23543,-17.36735,574,43,4339,4913,1944,168,2184,4128
"Bolivia","Cochabamba","Quillacollo","Colcapirhua","UNIDAD EDUCATIVA SAN LORENZO",-66.24113,-17.38883,71,6,718,789,373,15,324,697
"Bolivia","Cochabamba","Quillacollo","Colcapirhua","UNIDAD EDUCATIVA SIMON BOLIVAR (SUMUNPAYA)",-66.23511,-17.40263,15,2,144,159,48,7,87,135
"Bolivia","Cochabamba","Quillacollo","Quillacollo","(CÁRCEL) PENAL SAN PABLO",-66.28239,-17.40005,34,1,107,141,40,1,65,105
"Bolivia","Cochabamba","Quillacollo","Quillacollo","CENTRO INTEGRAL NIÑO JESUS FE Y ALEGRIA",-66.25516,-17.38777,128,10,1113,1241,581,32,490,1071
"Bolivia","Cochabamba","Quillacollo","Quillacollo","CENTRO INTERNADO MISICUNI",-66.32189,-17.1263,21,7,289,310,76,12,194,270
"Bolivia","Cochabamba","Quillacollo","Quillacollo","COLEGIO CRISTINA PRADA",-66.27902,-17.39269,299,8,2508,2807,1593,68,839,2432
"Bolivia","Cochabamba","Quillacollo","Quillacollo","COLEGIO FRANZ TAMAYO",-66.28081,-17.38829,700,32,5075,5775,3034,106,1903,4937
"Bolivia","Cochabamba","Quillacollo","Quillacollo","COLEGIO NACIONAL CALAMA (NUEVA INFRAESTRUCTURA)",-66.27234,-17.41193,23,2,105,128,51,3,49,100
"Bolivia","Cochabamba","Quillacollo","Quillacollo","ESCUELA 12 DE SEPTIEMBRE",-66.27923,-17.41147,676,43,4621,5297,2097,118,2363,4460
"Bolivia","Cochabamba","Quillacollo","Quillacollo","ESCUELA ARTURO QUITÓN",-66.27569,-17.36401,446,34,3281,3727,1260,115,1872,3132
"Bolivia","Cochabamba","Quillacollo","Quillacollo","ESCUELA FELIX MARTINEZ",-66.2527,-17.38772,1055,244,9354,10409,4711,319,4080,8791
"Bolivia","Cochabamba","Quillacollo","Quillacollo","ESCUELA FIDELIA C. DE SANCHEZ",-66.28062,-17.39867,212,10,2271,2483,1508,45,708,2216
"Bolivia","Cochabamba","Quillacollo","Quillacollo","ESCUELA SIMÓN BOLIVAR",-66.27937,-17.3954,498,23,3673,4171,2084,107,1459,3543
"Bolivia","Cochabamba","Quillacollo","Quillacollo","ESCUELA TOMAS BATA",-66.28063,-17.40219,423,33,3703,4126,2039,113,1518,3557
"Bolivia","Cochabamba","Quillacollo","Quillacollo","INSTITUTO PARTICULAR QUILLACOLLO",-66.28365,-17.39573,410,21,3415,3825,2173,94,1127,3300
"Bolivia","Cochabamba","Quillacollo","Quillacollo","INSTITUTO TECNOLOGICO EL PASO",-66.2566,-17.34972,110,12,999,1109,376,28,583,959
"Bolivia","Cochabamba","Quillacollo","Quillacollo","KINDER MARISCAL JOSE BALLIVIAN",-66.26795,-17.40211,523,27,2359,2882,1182,62,1088,2270
"Bolivia","Cochabamba","Quillacollo","Quillacollo","LICEO AMÉRICA",-66.28165,-17.39895,617,25,4759,5376,3114,116,1504,4618
"Bolivia","Cochabamba","Quillacollo","Quillacollo","NORMAL SIMÓN RODRÍGUEZ (EX NUCLEO ESCOLAR PAUCARPATA)",-66.297,-17.36322,388,19,2532,2920,1087,96,1330,2417
"Bolivia","Cochabamba","Quillacollo","Quillacollo","TEOFILO VARGAS CANDIA B",-66.27607,-17.38605,493,23,4126,4619,2284,116,1703,3987
"Bolivia","Cochabamba","Quillacollo","Quillacollo","U. E. JOSE MIGUEL LANZA (ILLATACO)",-66.29857,-17.3701,149,17,1435,1584,441,45,932,1373
"Bolivia","Cochabamba","Quillacollo","Quillacollo","U. E. MILIVOY ETEROVIC MATENDA",-66.26927,-17.39382,272,13,1861,2133,1012,47,789,1801
"Bolivia","Cochabamba","Quillacollo","Quillacollo","U. E. RENE BARRIENOS ORTUÑO (MISICUNI)",-66.32351,-17.11721,45,14,504,549,141,30,319,460
"Bolivia","Cochabamba","Quillacollo","Quillacollo","UNIDAD EDUCATIVA BELLA VISTA",-66.28169,-17.32156,636,70,3889,4525,1131,194,2494,3625
"Bolivia","Cochabamba","Quillacollo","Quillacollo","UNIDAD EDUCATIVA EL PASO",-66.26698,-17.33861,973,78,6333,7306,2231,217,3807,6038
"Bolivia","Cochabamba","Quillacollo","Quillacollo","UNIDAD EDUCATIVA FLORA SALINAS HINOJOSA - AMALIA ECHALAR DE",-66.27919,-17.39159,0,0,16,16,10,0,6,16
"Bolivia","Cochabamba","Quillacollo","Quillacollo","UNIDAD EDUCATIVA HEROINAS",-66.27933,-17.40064,334,18,2434,2768,1302,77,1037,2339
"Bolivia","Cochabamba","Quillacollo","Quillacollo","UNIDAD EDUCATIVA IRONCOLLO",-66.28701,-17.36173,552,61,4171,4723,1610,151,2349,3959
"Bolivia","Cochabamba","Quillacollo","Quillacollo","UNIDAD EDUCATIVA LIRIUNI",-66.29985,-17.28487,10,3,188,198,29,9,147,176
"Bolivia","Cochabamba","Quillacollo","Quillacollo","UNIDAD EDUCATIVA MARIA AUXILIADORA",-66.24287,-17.32961,77,11,760,837,304,36,409,713
"Bolivia","Cochabamba","Quillacollo","Quillacollo","UNIDAD EDUCATIVA MARQUINA",-66.28875,-17.33999,365,39,2802,3167,907,135,1721,2628
"Bolivia","Cochabamba","Quillacollo","Quillacollo","UNIDAD EDUCATIVA MARTIN CARDENAS",-66.29568,-17.38804,153,9,1253,1406,565,63,616,1181
"Bolivia","Cochabamba","Quillacollo","Quillacollo","UNIDAD EDUCATIVA NESTOR ADRIAZOLA (EX COLEGIO NACIONAL CALAMA)",-66.28477,-17.39367,948,52,6841,7789,3587,252,2950,6537
"Bolivia","Cochabamba","Quillacollo","Quillacollo","UNIDAD EDUCATIVA VILLA DE URKUPIÑA",-66.28946,-17.4192,302,28,2780,3082,795,88,1869,2664
"Bolivia","Cochabamba","Quillacollo","Quillacollo","UNIDAD EDUCATIVA VILLA MODERNA",-66.2822,-17.3884,303,13,2050,2353,1045,43,949,1994
"Bolivia","Cochabamba","Quillacollo","Sipe Sipe","ESC. RENE BARRIENTOS ORTUÑO (ITAPAYA)",-66.32016,-17.58389,181,19,1139,1320,312,49,759,1071
"Bolivia","Cochabamba","Quillacollo","Sipe Sipe","ESCUELA BOLVIANA AMERICANA",-66.36395,-17.41975,293,40,2375,2668,635,90,1610,2245
"Bolivia","Cochabamba","Quillacollo","Sipe Sipe","ESCUELA SUCRE (SIPE SIPE)",-66.35757,-17.45498,881,88,6828,7709,2186,297,4257,6443
"Bolivia","Cochabamba","Quillacollo","Sipe Sipe","UNIDAD EDUCATIVA 3 DE ABRIL",-66.33532,-17.4215,112,16,1405,1517,447,54,888,1335
"Bolivia","Cochabamba","Quillacollo","Sipe Sipe","UNIDAD EDUCATIVA ANDRES UZEDA OCAMPO",-66.35824,-17.45489,65,7,469,534,146,11,305,451
"Bolivia","Cochabamba","Quillacollo","Sipe Sipe","UNIDAD EDUCATIVA CARAMARCA COLLPA",-66.305,-17.45254,68,28,586,654,176,21,361,537
"Bolivia","Cochabamba","Quillacollo","Sipe Sipe","UNIDAD EDUCATIVA  CAVILOMA",-66.34575,-17.43804,22,15,549,571,158,27,349,507
"Bolivia","Cochabamba","Quillacollo","Sipe Sipe","UNIDAD EDUCATIVA EDUARDO ABAROA",-66.34507,-17.56399,394,75,2474,2868,645,111,1643,2288
"Bolivia","Cochabamba","Quillacollo","Sipe Sipe","UNIDAD EDUCATIVA SAUCE RANCHO",-66.32941,-17.42615,735,72,4872,5607,1711,205,2884,4595
"Bolivia","Cochabamba","Quillacollo","Sipe Sipe","UNIDAD EDUCATIVA SUTICOLLO",-66.33573,-17.46679,417,25,2313,2730,1040,95,1153,2193
"Bolivia","Cochabamba","Quillacollo","Sipe Sipe","UNIDAD EDUCATIVA TORIBIO CLAURE",-66.37673,-17.44035,12,4,353,365,36,9,304,340
"Bolivia","Cochabamba","Quillacollo","Sipe Sipe","UNIDAD EDUCATIVA UCHU UCHU",-66.47109,-17.37553,14,0,440,454,4,21,415,419
"Bolivia","Cochabamba","Quillacollo","Sipe Sipe","UNIDAD EDUCATIVA VILOMA",-66.37477,-17.41203,225,26,1574,1799,283,54,1211,1494
"Bolivia","Cochabamba","Quillacollo","Tiquipaya","ALDEAS S.O.S",-66.19316,-17.35118,340,19,2682,3022,1473,101,1089,2562
"Bolivia","Cochabamba","Quillacollo","Tiquipaya","COLEGIO CRISTO NACIÓN (UE BOLIVIA JAPÓN)",-66.19818,-17.34682,21,0,94,115,71,0,23,94
"Bolivia","Cochabamba","Quillacollo","Tiquipaya","COLEGIO SAN MIGUEL (TIQUIPAYA)",-66.2195,-17.33651,688,45,4701,5389,2299,146,2211,4510
"Bolivia","Cochabamba","Quillacollo","Tiquipaya","COLEGIO SIMON BOLIVAR (TIQUIPAYA)",-66.22029,-17.33622,844,65,5884,6728,2635,209,2975,5610
"Bolivia","Cochabamba","Quillacollo","Tiquipaya","ESCUELA EUGENIA RAVASCO",-66.20742,-17.36253,152,16,1392,1544,776,26,574,1350
"Bolivia","Cochabamba","Quillacollo","Tiquipaya","ESCUELA ISAAC ATTIE",-66.1954,-17.36948,236,12,2034,2270,1278,47,697,1975
"Bolivia","Cochabamba","Quillacollo","Tiquipaya","ESCUELA SECCIONAL WARIPUCARA",-66.2721,-17.02783,16,0,101,117,4,2,95,99
"Bolivia","Cochabamba","Quillacollo","Tiquipaya","ESCUELA TORIBIO CLAURE",-66.20433,-17.34466,847,55,6649,7496,3403,202,2989,6392
"Bolivia","Cochabamba","Quillacollo","Tiquipaya","NUCLEO EDUCATIVO CHAPISIRCA",-66.14425,-17.14807,111,24,1001,1112,93,31,853,946
"Bolivia","Cochabamba","Quillacollo","Tiquipaya","UNIDAD EDUCATIVA CUATRO ESQUINAS",-66.23293,-17.35942,144,13,1279,1423,669,39,558,1227
"Bolivia","Cochabamba","Quillacollo","Tiquipaya","UNIDAD EDUCATIVA JESUS MAESTRO",-66.19382,-17.333,68,14,988,1056,412,35,527,939
"Bolivia","Cochabamba","Quillacollo","Tiquipaya","UNIDAD EDUCATIVA LIBERTAD",-66.19286,-17.34593,615,33,4959,5574,2443,159,2324,4767
"Bolivia","Cochabamba","Quillacollo","Tiquipaya","UNIDAD EDUCATIVA MONTECILLO",-66.34388,-16.97306,22,1,240,262,8,4,227,235
"Bolivia","Cochabamba","Quillacollo","Tiquipaya","UNIDAD EDUCATIVA NUESTRA SRA. DE ALTAGRACIA",-66.24353,-17.35297,47,5,335,382,156,15,159,315
"Bolivia","Cochabamba","Quillacollo","Vinto","ESCUELA ISMAEL MONTES",-66.32672,-17.3703,394,34,2914,3308,1177,162,1541,2718
"Bolivia","Cochabamba","Quillacollo","Vinto","ESCUELA MARTÍN CARDENAS",-66.31405,-17.40174,924,66,6104,7028,2607,210,3221,5828
"Bolivia","Cochabamba","Quillacollo","Vinto","ESCUELA MELCHOR CUADROS",-66.31646,-17.39582,1244,76,9163,10407,4501,378,4208,8709
"Bolivia","Cochabamba","Quillacollo","Vinto","NUCLEO ESCOLAR SIMON BOLIVAR (THIOMOKO)",-66.34605,-17.39735,86,21,839,925,136,44,638,774
"Bolivia","Cochabamba","Quillacollo","Vinto","UNIDAD EDUCATIVA ANOCARAIRE",-66.31851,-17.38117,411,55,3719,4130,1396,154,2114,3510
"Bolivia","Cochabamba","Quillacollo","Vinto","UNIDAD EDUCATIVA DAVID ARZABE",-66.31459,-17.39948,95,14,968,1063,359,45,550,909
"Bolivia","Cochabamba","Quillacollo","Vinto","UNIDAD EDUCATIVA KERAYA",-66.45165,-17.29583,30,3,286,316,13,5,265,278
"Bolivia","Cochabamba","Quillacollo","Vinto","UNIDAD EDUCATIVA REINO UNIDO",-66.33875,-17.38365,495,77,4437,4932,1328,227,2805,4133
"Bolivia","Cochabamba","Quillacollo","Vinto","UNIDAD EDUCATIVA SAGRADA FAMILIA",-66.31983,-17.39161,318,28,1980,2298,892,91,969,1861
"Bolivia","Cochabamba","Tapacarí","Tapacarí","ESCUELA  CHALLA GRANDE",-66.64311,-17.70757,43,17,344,387,107,30,190,297
"Bolivia","Cochabamba","Tapacarí","Tapacarí","ESCUELA CHUÑU CHUÑINI",-66.59262,-17.69916,7,2,420,427,28,6,384,412
"Bolivia","Cochabamba","Tapacarí","Tapacarí","ESCUELA MONSEÑOR ANGEL GELMI",-66.55774,-17.61193,80,12,464,544,17,13,422,439
"Bolivia","Cochabamba","Tapacarí","Tapacarí","NUCLEO ESCOLAR CHARAPAYA",-66.75413,-17.36775,41,1,233,274,8,4,220,228
"Bolivia","Cochabamba","Tapacarí","Tapacarí","NUCLEO ESCOLAR CONFITAL",-66.73165,-17.67827,43,10,397,440,37,20,330,367
"Bolivia","Cochabamba","Tapacarí","Tapacarí","U.E. ARASAYA",-66.59817,-17.4361,2,2,152,154,3,3,144,147
"Bolivia","Cochabamba","Tapacarí","Tapacarí","U.E. CHILLCA GRANDE",-66.63358,-17.59493,1,1,170,171,7,1,161,168
"Bolivia","Cochabamba","Tapacarí","Tapacarí","U.E. LACOLACONI",-66.83026,-17.65938,3,5,273,276,21,15,232,253
"Bolivia","Cochabamba","Tapacarí","Tapacarí","U.E. LACUYO",-66.68685,-17.63514,69,12,554,623,46,25,471,517
"Bolivia","Cochabamba","Tapacarí","Tapacarí","UNIDAD EDUCATIVA APHARUMIRI",-66.54695,-17.53054,17,0,184,201,0,9,175,175
"Bolivia","Cochabamba","Tapacarí","Tapacarí","UNIDAD EDUCATIVA CALLIRI",-66.48114,-17.53546,5,0,53,58,0,1,52,52
"Bolivia","Cochabamba","Tapacarí","Tapacarí","UNIDAD EDUCATIVA CENTRAL VILLA PEREIRA",-66.7868,-17.44669,80,20,532,612,43,24,445,488
"Bolivia","Cochabamba","Tapacarí","Tapacarí","UNIDAD EDUCATIVA CHULLPA K'ASA",-66.43821,-17.62975,23,0,184,207,13,6,165,178
"Bolivia","Cochabamba","Tapacarí","Tapacarí","UNIDAD EDUCATIVA JAPO K'ASA",-66.7634,-17.6955,84,9,749,833,60,24,656,716
"Bolivia","Cochabamba","Tapacarí","Tapacarí","UNIDAD EDUCATIVA KATARIRI",-66.51272,-17.63324,27,9,423,450,24,12,378,402
"Bolivia","Cochabamba","Tapacarí","Tapacarí","UNIDAD EDUCATIVA KJARKAS",-66.521,-17.69701,33,11,356,389,46,23,276,322
"Bolivia","Cochabamba","Tapacarí","Tapacarí","UNIDAD EDUCATIVA LLAVINI",-66.41062,-17.66616,20,1,327,347,47,11,268,315
"Bolivia","Cochabamba","Tapacarí","Tapacarí","UNIDAD EDUCATIVA NORBERTO JIMENEZ",-66.81584,-17.50673,119,17,391,510,42,23,309,351
"Bolivia","Cochabamba","Tapacarí","Tapacarí","UNIDAD EDUCATIVA RAMADAS",-66.47381,-17.55251,114,7,741,855,85,24,625,710
"Bolivia","Cochabamba","Tapacarí","Tapacarí","UNIDAD EDUCATIVA SAN ANTONIO",-66.83088,-17.54268,33,2,258,291,30,5,221,251
"Bolivia","Cochabamba","Tapacarí","Tapacarí","UNIDAD EDUCATIVA SUCRE",-66.62051,-17.5165,226,18,1465,1691,36,127,1284,1320
"Bolivia","Cochabamba","Tapacarí","Tapacarí","UNIDAD EDUCATIVA TUNAS VINTO-APHARUMIRI",-66.54695,-17.53053,75,6,514,589,10,25,473,483
"Bolivia","Cochabamba","Tapacarí","Tapacarí","UNIDAD EDUCATIVA WACA PLAYA",-66.48648,-17.45753,149,22,864,1013,55,23,764,819
"Bolivia","Cochabamba","Tiraque","Shinahota","ESCUELA GERMAN BUSCH",-65.24871,-16.99495,1092,99,6453,7545,1798,231,4325,6123
"Bolivia","Cochabamba","Tiraque","Shinahota","U.E. DEMETRIO CANELAS",-65.22605,-16.99467,10,3,249,259,23,3,220,243
"Bolivia","Cochabamba","Tiraque","Shinahota","U. E. MARCELO QUIROGA SANTA CRUZ",-65.22232,-17.07844,62,9,707,769,91,24,583,674
"Bolivia","Cochabamba","Tiraque","Shinahota","U.E. MARISCAL SUCRE",-65.2549,-16.99571,18,5,195,213,24,9,157,181
"Bolivia","Cochabamba","Tiraque","Shinahota","U.E. SAN LUIS",-65.28136,-16.95968,19,4,475,494,29,5,437,466
"Bolivia","Cochabamba","Tiraque","Shinahota","UNIDAD EDUCATIVA 4 DE ABRIL",-65.27142,-17.03861,15,1,326,341,16,8,301,317
"Bolivia","Cochabamba","Tiraque","Shinahota","UNIDAD EDUCATIVA CHURO GRANDE",-65.33322,-17.05208,12,1,222,234,11,4,206,217
"Bolivia","Cochabamba","Tiraque","Shinahota","UNIDAD EDUCATIVA IBUELO",-65.33987,-16.96962,400,29,1247,1647,203,24,991,1194
"Bolivia","Cochabamba","Tiraque","Shinahota","UNIDAD EDUCATIVA IVIRIZU VANDIOLA",-65.46212,-17.06077,61,9,388,449,55,11,313,368
"Bolivia","Cochabamba","Tiraque","Shinahota","UNIDAD EDUCATIVA MAJO PAMPA A",-65.36292,-17.03242,14,2,281,295,11,2,266,277
"Bolivia","Cochabamba","Tiraque","Shinahota","UNIDAD EDUCATIVA PUERTO AROMA",-65.17721,-17.12901,5,1,72,77,12,1,58,70
"Bolivia","Cochabamba","Tiraque","Shinahota","UNIDAD EDUCATIVA SAN ISIDRO",-65.32017,-16.99914,29,11,826,855,42,10,763,805
"Bolivia","Cochabamba","Tiraque","Tiraque","COLEGIO JUAN JOSE CARRASCO",-65.72145,-17.42393,833,150,5741,6574,1161,271,4159,5320
"Bolivia","Cochabamba","Tiraque","Tiraque","ESCUELA COTANI BAJO",-65.78638,-17.38104,64,13,802,866,119,80,590,709
"Bolivia","Cochabamba","Tiraque","Tiraque","ESCUELA KOARI (NUCLEO ESC. S. BOLIVAR)",-65.57632,-17.47923,174,19,1153,1327,119,62,953,1072
"Bolivia","Cochabamba","Tiraque","Tiraque","ESCUELA SECCIONAL PAIRUMANI",-65.48745,-17.4773,87,9,709,796,69,20,611,680
"Bolivia","Cochabamba","Tiraque","Tiraque","ESCUELA SECCIONAL SACABAMBILLA",-65.76513,-17.4795,40,7,367,407,54,25,281,335
"Bolivia","Cochabamba","Tiraque","Tiraque","NUCLEO ESCOLAR ILURI GRANDE",-65.82572,-17.39656,0,16,662,662,80,40,526,606
"Bolivia","Cochabamba","Tiraque","Tiraque","UNIDAD EDUCATIVA 3 DE AGOSTO",-65.46495,-17.54261,24,4,344,368,38,19,283,321
"Bolivia","Cochabamba","Tiraque","Tiraque","UNIDAD EDUCATIVA PALCA T",-65.77904,-17.41067,14,4,125,139,29,4,88,117
"Bolivia","Cochabamba","Tiraque","Tiraque","UNIDAD EDUCATIVA RODEO",-65.76229,-17.3932,26,17,307,333,40,21,229,269
"Bolivia","La Paz","Abel Iturralde","Ixiamas","ESC. ESPERANZA DEL MADIDI",-67.17106,-12.61393,46,4,130,176,58,0,68,126
"Bolivia","La Paz","Abel Iturralde","Ixiamas","ESC. GERMAN BUSCH",-68.12748,-13.76644,695,27,2273,2968,993,78,1175,2168
"Bolivia","La Paz","Abel Iturralde","Ixiamas","ESCUELA NUEVA IDIAMAS",-68.44615,-13.64052,7,0,10,17,2,0,8,10
"Bolivia","La Paz","Abel Iturralde","Ixiamas","ESCUELA PUERTO ARAONA",-67.77129,-12.52156,34,0,14,48,1,0,13,14
"Bolivia","La Paz","Abel Iturralde","Ixiamas","ESCUELA PUERTO PEREZ",-68.55753,-12.44095,85,0,134,219,111,2,21,132
"Bolivia","La Paz","Abel Iturralde","Ixiamas","ESCUELA TOMAS CATARI",-68.5165,-13.60102,16,1,110,126,11,1,97,108
"Bolivia","La Paz","Abel Iturralde","Ixiamas","ESCUELA VILLA FATIMA",-67.51065,-13.81614,4,0,25,29,16,0,9,25
"Bolivia","La Paz","Abel Iturralde","Ixiamas","ESC. UNIDAD EDUCATIVA DE TAHUA",-67.90891,-13.86159,19,0,107,126,50,1,56,106
"Bolivia","La Paz","Abel Iturralde","Ixiamas","SEDE DEL CARMEN DEL EMERO",-67.37585,-13.38387,10,0,65,75,61,0,4,65
"Bolivia","La Paz","Abel Iturralde","Ixiamas","U.E. MANURIMI",-67.69769,-12.04555,67,2,107,174,41,0,64,105
"Bolivia","La Paz","Abel Iturralde","Ixiamas","UNIDAD EDUCATIVA 10 DE ABRIL",-68.06606,-13.78335,3,2,72,75,39,2,29,68
"Bolivia","La Paz","Abel Iturralde","Ixiamas","UNIDAD EDUCATIVA EL TIGRE",-68.05921,-11.99998,23,0,53,76,31,1,21,52
"Bolivia","La Paz","Abel Iturralde","San Buenaventura","COL. TUMUPASA B",-67.88744,-14.14472,157,13,986,1143,414,22,537,951
"Bolivia","La Paz","Abel Iturralde","San Buenaventura","ESC. CHAUPY YACHAY HUASI",-68.05549,-14.21644,30,2,120,150,67,5,46,113
"Bolivia","La Paz","Abel Iturralde","San Buenaventura","ESCUELA JOSE MANUEL PANDO",-67.53542,-14.43845,580,38,2262,2842,941,71,1212,2153
"Bolivia","La Paz","Abel Iturralde","San Buenaventura","UNIDAD EDUCATIVA CENTRAL BUENA VISTA",-67.58383,-14.37968,32,4,157,189,52,3,98,150
"Bolivia","La Paz","Abel Iturralde","San Buenaventura","UNIDAD EDUCATIVA SAN MIGUEL",-67.52943,-14.4718,10,1,88,98,32,1,54,86
"Bolivia","La Paz","Aroma","Ayo Ayo","CASA DE GOBIERNO",-68.014,-17.18632,5,4,115,120,17,3,91,108
"Bolivia","La Paz","Aroma","Ayo Ayo","COL. AYO AYO",-68.00532,-17.09241,163,30,1714,1877,426,62,1196,1622
"Bolivia","La Paz","Aroma","Ayo Ayo","COLEGIO JOSÉ BALLIVIÁN",-68.08076,-17.17401,11,0,141,152,40,8,93,133
"Bolivia","La Paz","Aroma","Ayo Ayo","ESC. CALACACHI",-68.14827,-17.06024,45,10,492,537,194,13,275,469
"Bolivia","La Paz","Aroma","Ayo Ayo","ESC. FRANZ TAMAYO",-68.06002,-17.01099,73,15,789,862,230,22,522,752
"Bolivia","La Paz","Aroma","Ayo Ayo","ESC. STA. ROSA DE LIMA",-68.06953,-17.13371,46,6,282,328,75,7,194,269
"Bolivia","La Paz","Aroma","Calamarca","CASA DE GOBIERNO",-68.1799,-16.90021,80,6,1022,1102,295,65,656,951
"Bolivia","La Paz","Aroma","Calamarca","CASA DE GOBIERNO",-68.08315,-16.96971,80,6,1022,1102,295,65,656,951
"Bolivia","La Paz","Aroma","Calamarca","ESC. CENTRAL CHORITOTORA",-68.08884,-16.84568,47,18,404,451,52,18,316,368
"Bolivia","La Paz","Aroma","Calamarca","ESCUELA EDUARDO AVAROA",-68.16341,-16.85044,63,6,540,603,122,14,398,520
"Bolivia","La Paz","Aroma","Calamarca","PLAZA 14 DE SEPTIEMBRE",-68.11526,-16.90584,131,25,1422,1553,612,49,736,1348
"Bolivia","La Paz","Aroma","Calamarca","PLAZA 16 DE JULIO",-68.13773,-16.78787,43,5,470,513,120,30,315,435
"Bolivia","La Paz","Aroma","Calamarca","PLAZA 6 DE AGOSTO",-68.17797,-16.79795,70,22,1143,1213,325,50,746,1071
"Bolivia","La Paz","Aroma","Calamarca","PLAZA PRINCIPAL",-68.14911,-16.99117,49,9,497,546,150,22,316,466
"Bolivia","La Paz","Aroma","Calamarca","PLAZA TOTORANI",-68.17602,-16.96187,71,4,406,477,107,11,284,391
"Bolivia","La Paz","Aroma","Calamarca","U.E. JUAN JOSÉ TORREZ",-68.08725,-16.75592,32,16,439,471,109,20,294,403
"Bolivia","La Paz","Aroma","Calamarca","UNIDAD EDUCATIVA FRANZ TAMAYO",-68.1254,-16.85869,19,6,361,380,68,11,276,344
"Bolivia","La Paz","Aroma","Calamarca","UNIDAD EDUCATIVA SUCANAVI",-68.07444,-16.93009,5,3,139,144,46,6,84,130
"Bolivia","La Paz","Aroma","Collana","CASA SOCIAL",-68.23739,-16.84444,9,0,188,197,31,4,153,184
"Bolivia","La Paz","Aroma","Collana","SEDE SOCIAL",-68.28757,-16.88153,164,24,1652,1816,594,60,974,1568
"Bolivia","La Paz","Aroma","Collana","SEDE SOCIAL",-68.28442,-16.90426,164,24,1652,1816,594,60,974,1568
"Bolivia","La Paz","Aroma","Colquencha","ESC. LADISLAO CABRERA",-68.20877,-16.87736,80,13,743,823,172,32,526,698
"Bolivia","La Paz","Aroma","Colquencha","ESCUELA LITORAL",-68.22531,-16.95084,14,0,184,198,40,5,139,179
"Bolivia","La Paz","Aroma","Colquencha","PLAZA 15 DE AGOSTO",-68.24931,-16.93275,132,25,1862,1994,575,84,1178,1753
"Bolivia","La Paz","Aroma","Colquencha","SEDE SOCIAL",-68.27126,-16.91852,61,20,907,968,286,24,577,863
"Bolivia","La Paz","Aroma","Patacamaya","CASA DE GOBIERNO",-67.87502,-17.19816,27,2,300,327,48,8,242,290
"Bolivia","La Paz","Aroma","Patacamaya","COLEGIO 23 DE MARZO",-67.95469,-17.27477,20,0,487,507,90,11,386,476
"Bolivia","La Paz","Aroma","Patacamaya","COLEGIO FRANZ TAMAYO",-68.02139,-17.22715,53,16,546,599,109,17,404,513
"Bolivia","La Paz","Aroma","Patacamaya","ESC. ROBERTO PABON",-67.91753,-17.24177,967,89,6002,6969,1989,171,3753,5742
"Bolivia","La Paz","Aroma","Patacamaya","ESC. SECCIONAL JATUQUIRA",-67.85796,-17.26879,3,2,64,67,16,2,44,60
"Bolivia","La Paz","Aroma","Patacamaya","ESC. TAYPILLANGA",-67.90216,-17.30549,20,5,395,415,78,9,303,381
"Bolivia","La Paz","Aroma","Patacamaya","ESCUELA COLCHANI",-67.85081,-17.23891,3,15,432,435,85,21,311,396
"Bolivia","La Paz","Aroma","Patacamaya","NUCLEO EDUCATIVO BELEN IQUIACA",-67.94446,-17.1978,23,4,333,356,66,9,254,320
"Bolivia","La Paz","Aroma","Patacamaya","PLAZA 16 DE JULIO",-67.87547,-17.18134,28,3,398,426,80,12,303,383
"Bolivia","La Paz","Aroma","Patacamaya","SEDE MUNICIPAL",-67.82513,-17.22678,2,0,138,140,42,2,94,136
"Bolivia","La Paz","Aroma","Patacamaya","SEDE SOCIAL",-67.92398,-17.28475,43,11,434,477,94,15,314,408
"Bolivia","La Paz","Aroma","Patacamaya","SEDE SOCIAL",-67.9968,-17.24903,43,11,434,477,94,15,314,408
"Bolivia","La Paz","Aroma","Patacamaya","U.E. GERMAN BUSCH",-67.91753,-17.24177,40,5,484,524,210,11,258,468
"Bolivia","La Paz","Aroma","Patacamaya","UNIDAD EDUCATIVA MURUCHAPI",-67.82782,-17.13052,7,0,49,56,7,1,41,48
"Bolivia","La Paz","Aroma","Patacamaya","UNIDAD EDUCATIVA VISCACHANI",-67.9495,-17.17933,61,19,682,743,123,8,532,655
"Bolivia","La Paz","Aroma","Sica Sica (Villa Aroma)","CASA DE GOBIERNO",-67.8598,-17.34229,5,2,361,366,75,17,267,342
"Bolivia","La Paz","Aroma","Sica Sica (Villa Aroma)","COL. 6 DE JUNIO",-67.46742,-17.23661,2,0,151,153,0,0,151,151
"Bolivia","La Paz","Aroma","Sica Sica (Villa Aroma)","COLEGIO TAWANTINSUYO",-67.63738,-17.38684,11,2,371,382,79,8,282,361
"Bolivia","La Paz","Aroma","Sica Sica (Villa Aroma)","COL. NAL. SICA SICA",-67.7421,-17.33211,161,26,1285,1446,530,42,687,1217
"Bolivia","La Paz","Aroma","Sica Sica (Villa Aroma)","COL. TOMAS KATARI",-67.58031,-17.22041,2,3,305,307,21,7,274,295
"Bolivia","La Paz","Aroma","Sica Sica (Villa Aroma)","ESC. JOSE M. PANDO",-67.44505,-17.49286,61,3,447,508,87,4,353,440
"Bolivia","La Paz","Aroma","Sica Sica (Villa Aroma)","ESCUELA EDEN",-67.67335,-17.37538,276,32,2399,2675,700,96,1571,2271
"Bolivia","La Paz","Aroma","Sica Sica (Villa Aroma)","ESCUELA SIMON BOLIVAR",-67.5736,-17.39699,50,7,522,572,90,18,407,497
"Bolivia","La Paz","Aroma","Sica Sica (Villa Aroma)","PLAZA CANTON MACHACAMARCA",-67.59753,-17.45224,49,8,427,476,116,22,281,397
"Bolivia","La Paz","Aroma","Sica Sica (Villa Aroma)","PLAZA PRINCIPAL JARUMA",-67.57709,-17.26054,100,2,640,740,125,16,497,622
"Bolivia","La Paz","Aroma","Sica Sica (Villa Aroma)","PLAZA SAN FRANCISCO",-67.79234,-17.38375,27,1,222,249,40,1,180,220
"Bolivia","La Paz","Aroma","Sica Sica (Villa Aroma)","SEDE SOCIAL AYAMAYA",-67.7303,-17.3847,10,2,253,263,69,4,178,247
"Bolivia","La Paz","Aroma","Sica Sica (Villa Aroma)","UNIDAD EDUCATIVA BARTOLINA SISA A",-67.82572,-17.38552,17,1,191,208,34,1,155,189
"Bolivia","La Paz","Aroma","Sica Sica (Villa Aroma)","UNIDAD EDUCATIVA CHUACOLLO GRANDE",-67.6738,-17.2105,7,3,161,168,12,1,145,157
"Bolivia","La Paz","Aroma","Sica Sica (Villa Aroma)","UNIDAD EDUCATIVA CONANI",-67.52164,-17.43539,169,35,1726,1895,480,64,1147,1627
"Bolivia","La Paz","Aroma","Sica Sica (Villa Aroma)","UNIDAD EDUCATIVA PEDRO DOMINGO MURILLO",-67.51456,-17.48516,17,13,662,679,163,17,469,632
"Bolivia","La Paz","Aroma","Umala","CASA DE GOBIERNO",-67.9584,-17.4303,96,23,788,884,231,40,494,725
"Bolivia","La Paz","Aroma","Umala","CASA DE GOBIERNO",-68.03399,-17.33216,96,23,788,884,231,40,494,725
"Bolivia","La Paz","Aroma","Umala","COL. DE VENTILLA",-68.10613,-17.29234,21,5,312,333,68,9,230,298
"Bolivia","La Paz","Aroma","Umala","COL. NAL. MIXTO SAN JOSE",-67.93179,-17.39158,28,3,337,365,89,13,232,321
"Bolivia","La Paz","Aroma","Umala","ESCUELA SAN MIGUEL DE COPANI",-68.06709,-17.33392,32,8,248,280,45,14,181,226
"Bolivia","La Paz","Aroma","Umala","PLAZA 16 DE JULIO",-68.02159,-17.37343,77,9,478,555,133,18,318,451
"Bolivia","La Paz","Aroma","Umala","PLAZA HUARI BELEN 6 DE AGOSTO",-68.00945,-17.46336,69,2,428,497,79,6,341,420
"Bolivia","La Paz","Aroma","Umala","PLAZA VITUY VINTO",-68.17715,-17.36859,23,1,231,254,70,4,156,226
"Bolivia","La Paz","Aroma","Umala","SEDE SOCIAL",-68.11279,-17.35408,51,1,321,372,78,13,229,307
"Bolivia","La Paz","Aroma","Umala","U.E. KELLHUIRI",-68.15555,-17.32532,8,5,200,208,32,7,156,188
"Bolivia","La Paz","Aroma","Umala","UNIDAD EDUCATIVA LLANGA BELEN",-67.90632,-17.3479,35,4,238,273,89,8,137,226
"Bolivia","La Paz","Bautista Saavedra","Curva","CASA DE GOBIERNO",-69.03347,-15.10095,34,2,118,152,26,11,79,105
"Bolivia","La Paz","Bautista Saavedra","Curva","ESCUELA KAPNA",-68.90353,-14.95543,9,1,43,52,5,5,32,37
"Bolivia","La Paz","Bautista Saavedra","Curva","NUCLEO ESCOLAR UPINUAYA",-69.02789,-15.13118,18,4,86,104,13,2,67,80
"Bolivia","La Paz","Bautista Saavedra","Curva","RECINTO TAIPI CANUMA",-69.13345,-15.03614,0,0,189,189,18,2,169,187
"Bolivia","La Paz","Bautista Saavedra","Curva","SEDE COMUNAL",-68.87193,-14.87294,3,0,25,28,8,0,17,25
"Bolivia","La Paz","Bautista Saavedra","Curva","SEDE SOCIAL",-69.00313,-15.12604,65,8,255,320,52,25,170,222
"Bolivia","La Paz","Bautista Saavedra","Curva","SEDE SOCIAL",-69.00817,-15.12213,65,8,255,320,52,25,170,222
"Bolivia","La Paz","Bautista Saavedra","Curva","SEDE SOCIAL",-69.00968,-15.0953,65,8,255,320,52,25,170,222
"Bolivia","La Paz","Bautista Saavedra","General Juan José Pérez (Charazani)","CALLINSANI",-68.89539,-15.22253,22,8,153,175,21,4,120,141
"Bolivia","La Paz","Bautista Saavedra","General Juan José Pérez (Charazani)","CASA DE GOBIERNO",-68.94041,-15.13295,27,6,197,224,31,13,147,178
"Bolivia","La Paz","Bautista Saavedra","General Juan José Pérez (Charazani)","ESCUELA ATIQUE",-68.93712,-15.19225,7,3,64,71,7,1,53,60
"Bolivia","La Paz","Bautista Saavedra","General Juan José Pérez (Charazani)","ESCUELA CENTRAL MOYAPAMPA",-69.00706,-15.26653,22,2,132,154,28,11,91,119
"Bolivia","La Paz","Bautista Saavedra","General Juan José Pérez (Charazani)","ESCUELA CHARAZANI",-68.98535,-15.17054,116,31,590,706,130,41,388,518
"Bolivia","La Paz","Bautista Saavedra","General Juan José Pérez (Charazani)","ESCUELA GENERAL RAMON GONZALES",-69.0027,-15.19276,22,4,117,139,14,3,96,110
"Bolivia","La Paz","Bautista Saavedra","General Juan José Pérez (Charazani)","ESCUELA PAUJE YUYO",-68.45623,-15.05983,29,0,122,151,18,3,101,119
"Bolivia","La Paz","Bautista Saavedra","General Juan José Pérez (Charazani)","ESCUELA SECCIONAL CHARI",-69.041,-15.17468,0,4,141,141,13,8,116,129
"Bolivia","La Paz","Bautista Saavedra","General Juan José Pérez (Charazani)","ESCUELA SECCIONAL SIATHA",-68.68688,-15.20615,16,2,105,121,18,4,81,99
"Bolivia","La Paz","Bautista Saavedra","General Juan José Pérez (Charazani)","PLAZA 26 DE JULIO",-68.75932,-15.22727,16,3,91,107,15,9,64,79
"Bolivia","La Paz","Bautista Saavedra","General Juan José Pérez (Charazani)","PLAZA AMARKA",-69.05107,-15.22568,44,3,228,272,51,8,166,217
"Bolivia","La Paz","Bautista Saavedra","General Juan José Pérez (Charazani)","PLAZA PRINCIPAL AMARETE",-68.98066,-15.22867,121,26,1016,1137,156,49,785,941
"Bolivia","La Paz","Bautista Saavedra","General Juan José Pérez (Charazani)","SEDE SOCIAL",-69.00725,-15.14073,88,14,476,564,59,18,385,444
"Bolivia","La Paz","Bautista Saavedra","General Juan José Pérez (Charazani)","SEDE SOCIAL",-68.453,-15.13352,88,14,476,564,59,18,385,444
"Bolivia","La Paz","Bautista Saavedra","General Juan José Pérez (Charazani)","UNIDAD EDUCATIVA APACHETA",-69.12223,-15.14201,26,2,181,207,45,12,122,167
"Bolivia","La Paz","Bautista Saavedra","General Juan José Pérez (Charazani)","UNIDAD EDUCATIVA KALLURHUAYA",-68.84801,-15.1727,11,7,170,181,14,6,143,157
"Bolivia","La Paz","Camacho","Escoma","COLEGIO DON BOSCO",-69.1245,-15.64438,317,67,2520,2837,603,141,1709,2312
"Bolivia","La Paz","Camacho","Escoma","PLAZA 26 DE OCTUBRE",-69.15398,-15.6867,41,2,262,303,49,17,194,243
"Bolivia","La Paz","Camacho","Escoma","PLAZA PRINCIPAL",-69.16642,-15.65046,21,5,271,292,94,16,156,250
"Bolivia","La Paz","Camacho","Escoma","PLAZA PRINCIPAL DE COLLASUYO",-69.13799,-15.6649,1,2,121,122,30,0,89,119
"Bolivia","La Paz","Camacho","Humanata","COL. SAN FRANCISCO DE PADUA",-69.11379,-15.45604,246,62,1646,1892,381,165,1038,1419
"Bolivia","La Paz","Camacho","Humanata","COL. SANTA ANA DE CUTUCUTU",-69.18256,-15.43143,32,5,192,224,41,13,133,174
"Bolivia","La Paz","Camacho","Humanata","ESC. S.J. DE PACOLLO",-69.19728,-15.42445,13,1,220,233,58,7,154,212
"Bolivia","La Paz","Camacho","Mocomoco","COLEGIO CARIQUINA CHICO",-69.0692,-15.5392,21,3,133,154,24,9,97,121
"Bolivia","La Paz","Camacho","Mocomoco","COLEGIO TECNICO YOCARGUAYA",-69.0155,-15.58194,51,4,180,231,12,6,158,170
"Bolivia","La Paz","Camacho","Mocomoco","COL. SAN JOSE",-69.06486,-15.39754,19,7,352,371,84,15,246,330
"Bolivia","La Paz","Camacho","Mocomoco","COL. SAN LUIS WILA CALA",-69.04415,-15.35719,92,15,573,665,100,28,430,530
"Bolivia","La Paz","Camacho","Mocomoco","COL. TAJANI",-69.0649,-15.61726,37,14,438,475,105,30,289,394
"Bolivia","La Paz","Camacho","Mocomoco","ESC. QUILLIMA",-69.02345,-15.62034,14,0,363,377,73,14,276,349
"Bolivia","La Paz","Camacho","Mocomoco","ESC. SECCIONAL V. JACHATIRA",-69.03743,-15.53999,0,1,65,65,18,1,45,63
"Bolivia","La Paz","Camacho","Mocomoco","ESC. TUNTUNANI",-68.9683,-15.50293,24,3,102,126,18,2,79,97
"Bolivia","La Paz","Camacho","Mocomoco","ESC. UNIDAD EDUCATIVA PACAURES",-69.0611,-15.5844,67,25,528,595,83,21,399,482
"Bolivia","La Paz","Camacho","Mocomoco","NUCLEO ESCOLAR PUMANA",-69.02091,-15.51972,39,2,222,261,25,12,183,208
"Bolivia","La Paz","Camacho","Mocomoco","NÚCLEO ESCOLAR TAYPI AYCA",-69.08912,-15.5147,5,2,169,174,10,3,154,164
"Bolivia","La Paz","Camacho","Mocomoco","PLAZA MOCO MOCO",-68.99878,-15.45637,211,46,967,1178,262,78,581,843
"Bolivia","La Paz","Camacho","Mocomoco","PLAZA SANTIAGO DE ILAVE",-69.01241,-15.36129,79,19,464,543,75,23,347,422
"Bolivia","La Paz","Camacho","Mocomoco","SEDE SOCIAL",-69.08668,-15.61018,0,1,60,60,21,2,36,57
"Bolivia","La Paz","Camacho","Mocomoco","UNIDAD EDUCATIVA CAJCACHI",-69.0796,-15.59127,12,2,149,161,34,13,100,134
"Bolivia","La Paz","Camacho","Mocomoco","UNIDAD EDUCATIVA ITALAQUE",-69.04504,-15.47639,101,19,432,533,49,37,327,376
"Bolivia","La Paz","Camacho","Mocomoco","UNIDAD EDUCATIVA QUEÑI",-68.97206,-15.43503,56,8,199,255,60,15,116,176
"Bolivia","La Paz","Camacho","Puerto Acosta","COLEGIO NACIONAL MIXTO CHIÑAYA",-69.11092,-15.52736,89,24,447,536,102,29,292,394
"Bolivia","La Paz","Camacho","Puerto Acosta","COLEGIO NACIONAL SALLACUCHO",-69.20315,-15.49551,36,9,328,364,51,21,247,298
"Bolivia","La Paz","Camacho","Puerto Acosta","COL. NICOLAS ACOSTA",-69.25303,-15.53491,222,42,1690,1912,581,86,981,1562
"Bolivia","La Paz","Camacho","Puerto Acosta","ESC. COTA PATA",-69.21085,-15.61913,16,10,211,227,46,12,143,189
"Bolivia","La Paz","Camacho","Puerto Acosta","ESC. JUPANI",-69.25771,-15.49459,33,6,309,342,126,20,157,283
"Bolivia","La Paz","Camacho","Puerto Acosta","ESC. PUERTO BELEN",-69.28316,-15.59171,17,4,361,378,78,1,278,356
"Bolivia","La Paz","Camacho","Puerto Acosta","ESC. SECCIONAL CANCANANI",-69.10598,-15.479,9,2,56,65,4,0,50,54
"Bolivia","La Paz","Camacho","Puerto Acosta","ESCUELA CENTRO BELEN",-69.11071,-15.60047,19,6,232,251,68,10,148,216
"Bolivia","La Paz","Camacho","Puerto Acosta","ESCUELA CHACAHUARA",-69.31122,-15.49251,9,0,53,62,14,7,32,46
"Bolivia","La Paz","Camacho","Puerto Acosta","PLAZA PUERTO PARAJACHI",-69.20171,-15.62851,42,6,700,742,236,10,448,684
"Bolivia","La Paz","Camacho","Puerto Acosta","U.E. PARAJACHI II",-69.21049,-15.64598,12,0,147,159,41,6,100,141
"Bolivia","La Paz","Camacho","Puerto Acosta","UNIDAD EDUCATIVA CENTRO CALANGACHI",-69.25439,-15.63603,28,2,165,193,52,0,111,163
"Bolivia","La Paz","Camacho","Puerto Acosta","UNIDAD EDUCATIVA ORURILLO",-69.31892,-15.53868,9,2,144,153,58,8,76,134
"Bolivia","La Paz","Camacho","Puerto Carabuco","COLEGIO COTAÑANI",-68.96169,-15.61601,16,3,131,147,24,2,102,126
"Bolivia","La Paz","Camacho","Puerto Carabuco","COLEGIO MARTIN CARDENAS",-69.03745,-15.78911,215,25,1074,1289,355,64,630,985
"Bolivia","La Paz","Camacho","Puerto Carabuco","COLEGIO NACIONAL MIXTO CHUANI",-68.98556,-15.64204,33,7,347,380,75,23,242,317
"Bolivia","La Paz","Camacho","Puerto Carabuco","COLEGIO PASARANI",-68.9835,-15.57729,104,15,468,572,97,19,337,434
"Bolivia","La Paz","Camacho","Puerto Carabuco","ESC. MCAL. SUCRE",-68.96303,-15.6083,89,10,495,584,65,32,388,453
"Bolivia","La Paz","Camacho","Puerto Carabuco","ESC. S. M. DE YARICOA",-69.08703,-15.67951,28,8,232,260,50,22,152,202
"Bolivia","La Paz","Camacho","Puerto Carabuco","ESCUELA HUILACUNCA",-68.94692,-15.56903,62,19,296,358,53,13,211,264
"Bolivia","La Paz","Camacho","Puerto Carabuco","PLAZA PRINCIPAL COPUSQUIA",-68.95209,-15.66244,66,9,476,542,56,19,392,448
"Bolivia","La Paz","Camacho","Puerto Carabuco","PLAZA SISASANI",-68.98576,-15.81754,53,7,351,404,75,17,252,327
"Bolivia","La Paz","Camacho","Puerto Carabuco","UNID.EDU. URSULA GOYZUETA",-69.0638,-15.75902,216,37,1524,1740,381,83,1023,1404
"Bolivia","La Paz","Caranavi","Alto Beni","ESC. C. BELLA VISTA",-67.42459,-15.62154,67,6,483,550,130,30,317,447
"Bolivia","La Paz","Caranavi","Alto Beni","ESC. N. SARARIA",-67.51301,-15.39834,90,4,481,571,114,35,328,442
"Bolivia","La Paz","Caranavi","Alto Beni","ESCUELA CASERIO NUEVE",-67.39796,-15.59869,56,0,316,372,66,8,242,308
"Bolivia","La Paz","Caranavi","Alto Beni","ESCUELA PIQUENDO",-67.38728,-15.59628,95,6,638,733,128,28,476,604
"Bolivia","La Paz","Caranavi","Alto Beni","LOCAL AMAS DE CASA",-67.44894,-15.54566,31,7,227,258,60,3,157,217
"Bolivia","La Paz","Caranavi","Alto Beni","N. ESC. SAN ANTONIO",-67.17532,-15.6578,167,13,929,1096,154,21,741,895
"Bolivia","La Paz","Caranavi","Alto Beni","SEDE SOCIAL",-67.44275,-15.55506,107,14,577,684,138,15,410,548
"Bolivia","La Paz","Caranavi","Alto Beni","SEDE SOCIAL",-67.46413,-15.481,107,14,577,684,138,15,410,548
"Bolivia","La Paz","Caranavi","Alto Beni","UNIDAD EDUCATIVA PUENTE ALTO BENI",-67.3764,-15.56314,13,5,146,159,24,4,113,137
"Bolivia","La Paz","Caranavi","Alto Beni","UNIDAD EDUCATIVA VILLA EL PORVENIR",-67.24788,-15.60961,26,1,313,339,35,7,270,305
"Bolivia","La Paz","Caranavi","Alto Beni","UNIDAD EDUCATIVA VILLA LITORAL",-67.24664,-15.60868,20,4,266,286,22,11,229,251
"Bolivia","La Paz","Caranavi","Caranavi","COL. GUILLERMO MOLINA",-67.44241,-15.77615,204,14,911,1115,133,27,737,870
"Bolivia","La Paz","Caranavi","Caranavi","COL. JHON F. KENEDDY",-67.56451,-15.83448,1199,55,4839,6038,1946,141,2697,4643
"Bolivia","La Paz","Caranavi","Caranavi","COL. LOS ANDES",-67.57357,-15.75793,59,7,519,578,86,6,420,506
"Bolivia","La Paz","Caranavi","Caranavi","COL. MADRE MARIA FEDERICA",-67.56628,-15.83424,728,47,3533,4261,1531,105,1850,3381
"Bolivia","La Paz","Caranavi","Caranavi","COL. SAN LORENZO",-67.50715,-15.79369,95,5,903,998,129,23,746,875
"Bolivia","La Paz","Caranavi","Caranavi","ESC. CARRASCO LA RESERVA",-67.51271,-15.73402,199,20,1453,1652,153,38,1242,1395
"Bolivia","La Paz","Caranavi","Caranavi","ESC. C. DE CHOJNA",-67.56999,-15.95466,14,1,259,273,55,4,199,254
"Bolivia","La Paz","Caranavi","Caranavi","ESC. F. INCAHUARA",-67.59956,-15.97782,16,0,55,71,3,1,51,54
"Bolivia","La Paz","Caranavi","Caranavi","ESC. MSCAL. SANTA CRUZ",-67.4963,-15.74751,69,9,397,466,35,7,346,381
"Bolivia","La Paz","Caranavi","Caranavi","ESC. N. CHORO",-67.63139,-16.03343,23,2,133,156,36,4,91,127
"Bolivia","La Paz","Caranavi","Caranavi","ESC. P. DOMINGO MURILLO",-67.47856,-15.93649,263,19,1631,1894,334,55,1223,1557
"Bolivia","La Paz","Caranavi","Caranavi","ESC. SAN PEDRO",-67.61211,-16.00981,19,1,102,121,4,7,90,94
"Bolivia","La Paz","Caranavi","Caranavi","ESC. SECCIONAL SANTA ANA",-67.54862,-15.89038,73,9,367,440,57,10,291,348
"Bolivia","La Paz","Caranavi","Caranavi","ESC. SIMON BOLIVAR",-67.59677,-15.62007,162,19,770,932,136,33,582,718
"Bolivia","La Paz","Caranavi","Caranavi","ESC. TUPAC KATARI",-67.4232,-15.8093,84,8,484,568,66,13,397,463
"Bolivia","La Paz","Caranavi","Caranavi","ESCUELA CENTRAL VILLAMONTES",-67.31539,-15.8295,44,2,262,306,34,4,222,256
"Bolivia","La Paz","Caranavi","Caranavi","ESCUELA SIMON BOLIVAR DE SANTA FE",-67.62475,-15.80753,84,4,524,608,143,16,361,504
"Bolivia","La Paz","Caranavi","Caranavi","ESC. UYUNENSE",-67.58036,-15.86842,53,10,419,472,68,19,322,390
"Bolivia","La Paz","Caranavi","Caranavi","INSTITUTO AMERICANO",-67.56655,-15.8344,19,0,69,88,31,2,36,67
"Bolivia","La Paz","Caranavi","Caranavi","SEDE SOCIAL",-67.60384,-15.68305,170,6,1140,1310,137,75,922,1059
"Bolivia","La Paz","Caranavi","Caranavi","SEDE SOCIAL",-67.67484,-15.74946,170,6,1140,1310,137,75,922,1059
"Bolivia","La Paz","Caranavi","Caranavi","SEDE SOCIAL",-67.62841,-15.68759,170,6,1140,1310,137,75,922,1059
"Bolivia","La Paz","Caranavi","Caranavi","U. E. RENE ZENON PORTILLO CHAVARRIA",-67.54003,-15.77183,34,1,279,313,66,7,205,271
"Bolivia","La Paz","Caranavi","Caranavi","U.E. SUAZO",-67.56655,-15.8344,17,1,86,103,34,4,47,81
"Bolivia","La Paz","Caranavi","Caranavi","U.E. VENEZUELA",-67.56655,-15.8344,22,1,87,109,24,3,59,83
"Bolivia","La Paz","Caranavi","Caranavi","UNIDAD EDUCATIVA MANCHEGO",-67.60762,-15.852,15,1,163,178,60,2,100,160
"Bolivia","La Paz","Caranavi","Caranavi","UNIDAD EDUCATIVA NUEVA LLUSTA 2DA",-67.39731,-15.85297,51,3,317,368,38,7,269,307
"Bolivia","La Paz","Caranavi","Caranavi","UNIDAD EDUCATIVA SIMON BOLIVAR",-67.55769,-15.83356,647,26,2798,3445,1060,84,1628,2688
"Bolivia","La Paz","Franz Tamayo","Apolo","ESC. CENTRAL ATEN",-68.33105,-14.93176,44,8,245,289,139,17,81,220
"Bolivia","La Paz","Franz Tamayo","Apolo","ESC. CENTRAL INCA",-68.43272,-14.81314,49,6,240,289,75,11,148,223
"Bolivia","La Paz","Franz Tamayo","Apolo","ESC. MACHUA",-68.41223,-14.66684,25,7,162,187,56,13,86,142
"Bolivia","La Paz","Franz Tamayo","Apolo","ESC. MOJOS",-68.89278,-14.56084,2,2,25,27,5,1,17,22
"Bolivia","La Paz","Franz Tamayo","Apolo","ESC. NAZARIO PARDO VALLE",-68.51307,-14.63398,1132,137,4104,5236,2147,188,1632,3779
"Bolivia","La Paz","Franz Tamayo","Apolo","ESC. NAZARIO PARDO VALLE",-68.41825,-14.71928,1132,137,4104,5236,2147,188,1632,3779
"Bolivia","La Paz","Franz Tamayo","Apolo","ESC. PATA SAN ANTONIO",-68.65208,-14.56562,0,2,102,102,34,19,47,81
"Bolivia","La Paz","Franz Tamayo","Apolo","ESC. PUCHAHUI",-68.44442,-14.86157,75,6,378,453,168,16,188,356
"Bolivia","La Paz","Franz Tamayo","Apolo","ESC. SANTA CATALINA",-68.49142,-14.74016,99,15,363,462,130,23,195,325
"Bolivia","La Paz","Franz Tamayo","Apolo","ESCUELA CORREO",-68.44034,-14.95642,21,2,164,185,12,1,149,161
"Bolivia","La Paz","Franz Tamayo","Apolo","ESCUELA MUNAYPATA",-68.30943,-15.0214,50,5,222,272,78,4,135,213
"Bolivia","La Paz","Franz Tamayo","Apolo","UNIDADA EDUCATIVA TOREWA",-67.5419,-14.5968,45,0,21,66,8,1,12,20
"Bolivia","La Paz","Franz Tamayo","Apolo","UNIDAD EDUCATIVA INDIGENA TOREWA",-67.60982,-14.71774,15,0,18,33,3,1,14,17
"Bolivia","La Paz","Franz Tamayo","Pelechuco","ESC. CANTON SUCHES",-69.33424,-14.81951,38,3,173,211,78,7,85,163
"Bolivia","La Paz","Franz Tamayo","Pelechuco","ESC. COL. FRANZ TAMAYO",-69.27006,-15.06253,54,11,433,487,172,26,224,396
"Bolivia","La Paz","Franz Tamayo","Pelechuco","ESC. NAZARIO PARDO VALLE",-69.06972,-14.82036,100,13,606,706,249,34,310,559
"Bolivia","La Paz","Franz Tamayo","Pelechuco","ESC. PUINA",-69.13412,-14.61019,14,0,90,104,22,4,64,86
"Bolivia","La Paz","Franz Tamayo","Pelechuco","ESCUELA AGUA BLANCA",-69.10895,-14.8218,16,3,163,179,64,5,91,155
"Bolivia","La Paz","Franz Tamayo","Pelechuco","ESCUELA DE PUYO PUYO",-69.17246,-14.99942,13,2,171,184,106,3,60,166
"Bolivia","La Paz","Franz Tamayo","Pelechuco","ESCUELA SAN MIGUEL DE THAPI",-68.93021,-14.77682,19,0,103,122,63,4,36,99
"Bolivia","La Paz","Franz Tamayo","Pelechuco","ESCUELA SORAPATA",-68.97952,-14.79948,19,2,110,129,53,9,46,99
"Bolivia","La Paz","Franz Tamayo","Pelechuco","IGLESIA COPACABANA DE ANTIQUILLA",-69.28759,-14.88028,36,9,281,317,68,9,195,263
"Bolivia","La Paz","Franz Tamayo","Pelechuco","NUCLEO  EDUCATIVO HICHOCOLLO",-69.29661,-14.95523,12,2,220,232,70,14,134,204
"Bolivia","La Paz","Franz Tamayo","Pelechuco","SEDE DEL SINDICATO",-69.02939,-14.9247,73,2,278,351,81,27,168,249
"Bolivia","La Paz","General Jose Manuel","Catacora","ESC. THOLA COLLO",-69.55451,-17.23441,14,0,78,92,16,2,60,76
"Bolivia","La Paz","General Jose Manuel","Catacora","NUCLEO ESCOLAR CATACORA",-69.48728,-17.16064,40,0,187,227,37,6,144,181
"Bolivia","La Paz","General Jose Manuel","Catacora","NUCLEO ESCOLAR PAIRUMANI GRANDE",-69.4282,-17.32692,9,1,85,94,19,3,62,81
"Bolivia","La Paz","General Jose Manuel","Catacora","PLAZA 6 DE AGOSTO",-69.46824,-17.29597,7,1,84,91,6,0,77,83
"Bolivia","La Paz","General Jose Manuel","Santiago de Machaca","COLEGIO BAUTISTA SAAVEDRA",-69.25512,-17.206,42,0,100,142,10,1,89,99
"Bolivia","La Paz","General Jose Manuel","Santiago de Machaca","COLEGIO PEDRO KRAMER",-69.21403,-17.28709,14,0,49,63,13,1,35,48
"Bolivia","La Paz","General Jose Manuel","Santiago de Machaca","ESCUELA ATACUNI",-69.15105,-17.17518,5,0,54,59,2,0,52,54
"Bolivia","La Paz","General Jose Manuel","Santiago de Machaca","ESCUELA CENTRAL HUARI PHUJO",-69.04736,-17.13798,6,0,82,88,7,1,74,81
"Bolivia","La Paz","General Jose Manuel","Santiago de Machaca","ESCUELA SANTIAGO DE MACHACA",-69.19207,-17.06675,244,25,1208,1452,220,32,931,1151
"Bolivia","La Paz","General Jose Manuel","Santiago de Machaca","PLAZA VILLA EXALTACION",-69.27541,-17.24455,4,0,125,129,18,0,107,125
"Bolivia","La Paz","Gualberto Villarroel","Chacarilla","ESC. PUERTO AROMA",-68.16104,-17.46223,8,3,204,212,42,6,153,195
"Bolivia","La Paz","Gualberto Villarroel","Chacarilla","PLAZA CHACARILLA",-68.20435,-17.58085,53,1,279,332,47,10,221,268
"Bolivia","La Paz","Gualberto Villarroel","Chacarilla","PLAZA ROSAPATA",-68.10223,-17.49878,25,2,262,287,43,8,209,252
"Bolivia","La Paz","Gualberto Villarroel","Papel Pampa","CASA DE GOBIERNO",-67.82444,-17.66832,94,16,772,866,170,18,568,738
"Bolivia","La Paz","Gualberto Villarroel","Papel Pampa","CASA DE GOBIERNO",-67.76893,-17.81909,94,16,772,866,170,18,568,738
"Bolivia","La Paz","Gualberto Villarroel","Papel Pampa","ESC. TITUZA",-67.57115,-17.60931,9,2,88,97,17,3,66,83
"Bolivia","La Paz","Gualberto Villarroel","Papel Pampa","ESCUELA CIRCA CRUZANI",-67.62467,-17.71481,2,0,65,67,7,1,57,64
"Bolivia","La Paz","Gualberto Villarroel","Papel Pampa","ESCUELA COLQUE AMAYA ALTA",-67.78625,-17.57081,14,4,266,280,51,8,203,254
"Bolivia","La Paz","Gualberto Villarroel","Papel Pampa","PLAZA MOLLEBAMBA",-67.82986,-17.73928,55,7,622,677,123,15,477,600
"Bolivia","La Paz","Gualberto Villarroel","Papel Pampa","PLAZA PRINCIPAL UNO PATA",-67.71118,-17.69406,54,4,417,471,88,16,309,397
"Bolivia","La Paz","Gualberto Villarroel","Papel Pampa","PLAZA RIVERA ALTA",-67.66396,-17.59161,15,2,271,286,98,8,163,261
"Bolivia","La Paz","Gualberto Villarroel","Papel Pampa","SEDE SINDICAL",-67.6296,-17.74787,3,0,72,75,10,0,62,72
"Bolivia","La Paz","Gualberto Villarroel","Papel Pampa","SEDE SOCIAL CAYLLA CHURO",-67.56867,-17.6794,4,0,50,54,8,0,42,50
"Bolivia","La Paz","Gualberto Villarroel","Papel Pampa","UNIDAD EDUCATIVA PACOLLO",-67.8727,-17.78063,3,0,129,132,9,2,118,127
"Bolivia","La Paz","Gualberto Villarroel","Papel Pampa","UNIDAD EDUCATIVA SAN JOSE",-67.75399,-17.72414,25,4,183,208,53,2,124,177
"Bolivia","La Paz","Gualberto Villarroel","San Pedro de Curahuara","CASA COMUNAL",-68.05531,-17.53329,3,3,87,90,23,1,60,83
"Bolivia","La Paz","Gualberto Villarroel","San Pedro de Curahuara","CASA DE GOBIERNO",-68.04781,-17.65329,75,4,516,591,52,16,444,496
"Bolivia","La Paz","Gualberto Villarroel","San Pedro de Curahuara","COLEGIO HERNANDO SILES",-67.91642,-17.5809,79,6,530,609,52,21,451,503
"Bolivia","La Paz","Gualberto Villarroel","San Pedro de Curahuara","COLEGIO LUIS ESPINAL",-67.98427,-17.54257,46,1,377,423,30,2,344,374
"Bolivia","La Paz","Gualberto Villarroel","San Pedro de Curahuara","COLEGIO WISCO KARI",-67.96583,-17.72286,6,0,425,431,121,9,295,416
"Bolivia","La Paz","Gualberto Villarroel","San Pedro de Curahuara","ESC. CHILAGUALA",-68.01054,-17.47809,10,0,89,99,9,2,78,87
"Bolivia","La Paz","Gualberto Villarroel","San Pedro de Curahuara","ESC. JUAN CANCIO COLQUE",-68.10113,-17.65724,4,0,38,42,11,2,25,36
"Bolivia","La Paz","Gualberto Villarroel","San Pedro de Curahuara","PLAZA JANKO MARCA",-67.87048,-17.66836,0,0,397,397,0,4,393,393
"Bolivia","La Paz","Gualberto Villarroel","San Pedro de Curahuara","PLAZA PEDRO DOMINGO MURILLO",-67.87997,-17.63544,9,0,368,377,86,3,279,365
"Bolivia","La Paz","Gualberto Villarroel","San Pedro de Curahuara","PLAZA ROSARIO",-67.8949,-17.73604,4,0,313,317,5,20,288,293
"Bolivia","La Paz","Gualberto Villarroel","San Pedro de Curahuara","SEDE SINDICAL",-67.83096,-17.56285,0,2,88,88,5,3,78,83
"Bolivia","La Paz","Ingaví","Desaguadero","COL. BATALLON COLORADOS",-69.03388,-16.56696,310,26,2535,2845,1635,66,808,2443
"Bolivia","La Paz","Ingaví","Desaguadero","ESC. AZAFRANAL",-68.99149,-16.58226,27,3,289,316,90,6,190,280
"Bolivia","La Paz","Ingaví","Desaguadero","ESC. MCAL. ANDRES DE SANTA CRUZ",-68.95457,-16.58847,57,12,463,520,112,29,310,422
"Bolivia","La Paz","Ingaví","Desaguadero","UNIDAD EDUCATIVA SIMÓN BOLÍVAR",-68.93962,-16.63942,19,5,143,162,54,11,73,127
"Bolivia","La Paz","Ingaví","Guaqui","COLEGIO DANIEL SANCHEZ BUSTAMANTE",-68.83635,-16.59753,162,19,780,942,234,43,484,718
"Bolivia","La Paz","Ingaví","Guaqui","COL. TOMAS KATARI",-68.79683,-16.58405,165,47,1601,1766,335,59,1160,1495
"Bolivia","La Paz","Ingaví","Guaqui","ESC. ISMAEL MONTES",-68.85074,-16.59324,223,17,873,1096,281,41,534,815
"Bolivia","La Paz","Ingaví","Guaqui","UNIDAD EDUCATIVA WILACOLLO",-68.91432,-16.59871,17,4,168,185,38,9,117,155
"Bolivia","La Paz","Ingaví","Jesús de Machaca","COLEGIO CHAMA",-68.57966,-16.79505,17,6,292,309,78,10,198,276
"Bolivia","La Paz","Ingaví","Jesús de Machaca","COL. HOLANDA",-68.89614,-16.80193,38,7,415,453,110,18,280,390
"Bolivia","La Paz","Ingaví","Jesús de Machaca","COL. MEJILLONES",-68.80325,-16.82421,16,6,304,320,81,7,210,291
"Bolivia","La Paz","Ingaví","Jesús de Machaca","COL. REP. DE NORUEGA",-68.74157,-16.77844,31,15,376,407,98,8,255,353
"Bolivia","La Paz","Ingaví","Jesús de Machaca","ESC. FRANZ TAMAYO",-68.61249,-16.78762,0,2,107,107,22,3,80,102
"Bolivia","La Paz","Ingaví","Jesús de Machaca","ESC. NUCLEO CUIPA ESPANA DE MACHACA",-68.63845,-16.79134,4,6,273,277,27,9,231,258
"Bolivia","La Paz","Ingaví","Jesús de Machaca","ESC. SAN FELIPE DE CORPA",-68.8671,-16.67783,73,4,955,1028,135,36,780,915
"Bolivia","La Paz","Ingaví","Jesús de Machaca","ESC. SECC. KHONKHO",-68.67211,-16.7936,21,2,140,161,30,4,104,134
"Bolivia","La Paz","Ingaví","Jesús de Machaca","ESCUELA GERMAN BUSCH",-68.70154,-16.77555,22,4,334,356,62,9,259,321
"Bolivia","La Paz","Ingaví","Jesús de Machaca","PLAZA DEL PUEBLO",-68.76755,-16.77356,29,4,331,360,61,6,260,321
"Bolivia","La Paz","Ingaví","Jesús de Machaca","PLAZA PRINCIPAL",-68.80595,-16.74199,77,18,635,712,164,15,438,602
"Bolivia","La Paz","Ingaví","Jesús de Machaca","PLAZA VILLA ASUNCION DE MACHACA",-68.85337,-16.69936,27,2,378,405,95,6,275,370
"Bolivia","La Paz","Ingaví","Jesús de Machaca","POSTA SANITARIA",-68.63844,-16.84721,33,10,168,201,35,5,118,153
"Bolivia","La Paz","Ingaví","Jesús de Machaca","SEDE SOCIAL",-68.83674,-16.71817,33,7,428,461,93,24,304,397
"Bolivia","La Paz","Ingaví","Jesús de Machaca","SEDE SOCIAL",-68.5472,-16.81992,33,7,428,461,93,24,304,397
"Bolivia","La Paz","Ingaví","San Andrés de Machaca","COLEGIO BOLIVIANO JAPONES",-68.95058,-17.02766,46,3,171,217,17,3,148,165
"Bolivia","La Paz","Ingaví","San Andrés de Machaca","COLEGIO TUPAK KATARI DE CONCHACOLLO",-68.99821,-16.7345,10,1,257,267,59,5,192,251
"Bolivia","La Paz","Ingaví","San Andrés de Machaca","COL. VILLA PUSUMA ALTO MACHACA",-69.16449,-16.80326,23,3,153,176,17,2,131,148
"Bolivia","La Paz","Ingaví","San Andrés de Machaca","ESC. FRANZ TAMAYO",-69.09547,-16.73553,23,1,96,119,7,1,87,94
"Bolivia","La Paz","Ingaví","San Andrés de Machaca","ESC. LITORAL CHUNCARCOTA",-69.02103,-16.79199,9,3,127,136,23,6,95,118
"Bolivia","La Paz","Ingaví","San Andrés de Machaca","ESC. NUCLEO LAQUINAMAYA",-69.19246,-16.94843,43,3,238,281,47,3,185,232
"Bolivia","La Paz","Ingaví","San Andrés de Machaca","ESCUELA DE SAN ANDRES DE MACHACA",-68.96825,-16.95646,100,9,355,455,69,17,260,329
"Bolivia","La Paz","Ingaví","San Andrés de Machaca","PLAZA PRINCIPAL",-68.76829,-16.93683,21,8,169,190,51,4,106,157
"Bolivia","La Paz","Ingaví","San Andrés de Machaca","SEDE SOCIAL(COMUNIDAD MAURI)",-69.13435,-16.83909,10,1,110,120,16,0,93,109
"Bolivia","La Paz","Ingaví","San Andrés de Machaca","UNIDAD EDUCATIVA ANTAQUIRANI",-69.07945,-16.8683,4,1,79,83,20,1,57,77
"Bolivia","La Paz","Ingaví","San Andrés de Machaca","UNIDAD EDUCATIVA ROSA PATA ERBEN KALLA",-68.91935,-16.83392,9,1,143,152,27,7,108,135
"Bolivia","La Paz","Ingaví","Taraco","COL. NUCLEO FRAY JOSE ZAMPA",-68.82944,-16.43332,24,6,212,236,37,4,165,202
"Bolivia","La Paz","Ingaví","Taraco","COL. OVANDO CANDIA",-68.94234,-16.44834,40,16,562,602,90,30,426,516
"Bolivia","La Paz","Ingaví","Taraco","ESC. TARACO",-68.8576,-16.45572,158,24,1348,1506,269,60,995,1264
"Bolivia","La Paz","Ingaví","Taraco","SEDE SOCIAL",-68.79443,-16.43522,6,6,229,235,47,9,167,214
"Bolivia","La Paz","Ingaví","Tiahuanacu","COLEGIO JOSE BALLIVIAN",-68.74157,-16.44234,90,17,1170,1260,212,55,886,1098
"Bolivia","La Paz","Ingaví","Tiahuanacu","COLEGIO NACIONAL ARTURO POSNANSKI",-68.67873,-16.55647,311,56,3225,3536,900,175,2094,2994
"Bolivia","La Paz","Ingaví","Tiahuanacu","ESC. CENTRAL PILLAPI",-68.7683,-16.5035,57,13,957,1014,225,31,688,913
"Bolivia","La Paz","Ingaví","Viacha","CASA DE GOBIERNO",-68.25248,-16.80821,19,5,177,196,41,12,119,160
"Bolivia","La Paz","Ingaví","Viacha","COLEGIO BALLIVIAN",-68.29795,-16.65053,1101,111,8727,9828,3309,320,4987,8296
"Bolivia","La Paz","Ingaví","Viacha","COLEGIO JHONN F. KENNEDI",-68.17124,-16.77349,53,16,692,745,183,30,463,646
"Bolivia","La Paz","Ingaví","Viacha","COL. HACIA EL MAR",-68.24142,-16.75815,55,16,601,656,101,37,447,548
"Bolivia","La Paz","Ingaví","Viacha","COL. NAL. MIXTO CALAMA",-68.30962,-16.82777,32,14,398,430,93,17,274,367
"Bolivia","La Paz","Ingaví","Viacha","ESC. 18 DE NOVIEMBRE",-68.2989,-16.64955,463,43,3785,4248,1450,129,2163,3613
"Bolivia","La Paz","Ingaví","Viacha","ESC. ACHICA ARRIBA",-68.18732,-16.71439,48,6,767,815,179,47,535,714
"Bolivia","La Paz","Ingaví","Viacha","ESC. CENTRO TILATA",-68.23033,-16.58882,888,115,10123,11011,2890,388,6730,9620
"Bolivia","La Paz","Ingaví","Viacha","ESC. EVARISTO VALLE",-68.29871,-16.65074,563,69,5014,5577,1890,189,2866,4756
"Bolivia","La Paz","Ingaví","Viacha","ESC. SAN LUIS",-68.29977,-16.65029,379,32,3724,4103,1550,114,2028,3578
"Bolivia","La Paz","Ingaví","Viacha","ESC. VILIROCO",-68.24899,-16.61097,246,33,3367,3613,817,195,2322,3139
"Bolivia","La Paz","Ingaví","Viacha","PLAZA JOSE BALLIVIAN",-68.23183,-16.8031,20,5,309,329,87,11,206,293
"Bolivia","La Paz","Ingaví","Viacha","PLAZA PRINCIPAL",-68.42336,-16.81759,51,2,256,307,57,7,190,247
"Bolivia","La Paz","Ingaví","Viacha","SAN PEDRO DE CHONCHOCORO",-68.29809,-16.65042,18,0,111,129,62,1,48,110
"Bolivia","La Paz","Ingaví","Viacha","SEDE SOCIAL",-68.37337,-16.87176,4,4,160,164,37,6,113,150
"Bolivia","La Paz","Ingaví","Viacha","UNIDAD EDUCATIVA BATALLA DE INGAVI",-68.24085,-16.63196,15,3,58,73,20,1,34,54
"Bolivia","La Paz","Ingaví","Viacha","UNIDAD EDUCATIVA LITORAL",-68.29734,-16.85302,31,5,262,293,54,7,196,250
"Bolivia","La Paz","Ingaví","Viacha","UNIDAD EDUCATIVA TONCOPUJIO",-68.29401,-16.8719,6,4,160,166,18,4,134,152
"Bolivia","La Paz","Inquisivi","Cajuata","CASA DE GOBIERNO",-67.1912,-16.74741,128,24,1066,1194,132,26,884,1016
"Bolivia","La Paz","Inquisivi","Cajuata","CASA DE GOBIERNO",-67.26615,-16.62763,128,24,1066,1194,132,26,884,1016
"Bolivia","La Paz","Inquisivi","Cajuata","ESCUELA",-67.28862,-16.5991,62,11,374,436,60,10,293,353
"Bolivia","La Paz","Inquisivi","Cajuata","ESCUELA HUARITOLO",-67.20372,-16.72687,51,15,364,415,59,14,276,335
"Bolivia","La Paz","Inquisivi","Cajuata","UNIDAD EDUCATIVA CIRCUATA",-67.23114,-16.64647,97,18,808,905,155,35,600,755
"Bolivia","La Paz","Inquisivi","Cajuata","UNIDAD EDUCATIVA MIGUILLAS",-67.33664,-16.55579,55,5,357,412,25,1,326,351
"Bolivia","La Paz","Inquisivi","Cajuata","UNIDA EDUCATIVA CAJUATA",-67.17103,-16.69801,262,62,1722,1984,366,64,1230,1596
"Bolivia","La Paz","Inquisivi","Colquiri","CASA DE GOBIERNO",-66.98113,-17.55202,98,51,737,835,156,45,485,641
"Bolivia","La Paz","Inquisivi","Colquiri","CASA DE GOBIERNO",-66.90228,-17.38338,98,51,737,835,156,45,485,641
"Bolivia","La Paz","Inquisivi","Colquiri","CASA DE GOBIERNO",-66.93718,-17.58477,98,51,737,835,156,45,485,641
"Bolivia","La Paz","Inquisivi","Colquiri","COLEGIO ALTO DE LA ALIANZA",-66.8511,-17.5196,23,4,259,282,57,41,157,214
"Bolivia","La Paz","Inquisivi","Colquiri","COLEGIO SIMON BOLIVAR",-66.99767,-17.44226,62,12,553,615,114,31,396,510
"Bolivia","La Paz","Inquisivi","Colquiri","ESC. SIMON BOLIVAR",-66.9579,-17.54244,19,3,161,180,39,9,110,149
"Bolivia","La Paz","Inquisivi","Colquiri","ESCUELA ANICETO ARCE",-66.87982,-17.35054,24,9,205,229,37,7,152,189
"Bolivia","La Paz","Inquisivi","Colquiri","ESCUELA CAQUENA ENTRE RIOS",-67.00492,-17.32234,21,0,222,243,12,2,208,220
"Bolivia","La Paz","Inquisivi","Colquiri","ESCUELA CENTRAL UYUNI",-66.91545,-17.44477,39,37,280,319,68,20,155,223
"Bolivia","La Paz","Inquisivi","Colquiri","ESCUELA JOSE MIGUEL LANZA",-66.94537,-17.36096,80,19,618,698,119,13,467,586
"Bolivia","La Paz","Inquisivi","Colquiri","ESCUELA PIPINI",-66.92647,-17.48633,25,3,191,216,45,11,132,177
"Bolivia","La Paz","Inquisivi","Colquiri","ESCUELA SECCIONAL CHUALLA",-66.86385,-17.45984,11,0,157,168,31,4,122,153
"Bolivia","La Paz","Inquisivi","Colquiri","ESCUELA SECCIONAL CORIRI",-66.86787,-17.39233,15,3,92,107,14,4,71,85
"Bolivia","La Paz","Inquisivi","Colquiri","LADISLAO CABRERA",-67.13279,-17.38032,344,57,2869,3213,1250,153,1409,2659
"Bolivia","La Paz","Inquisivi","Colquiri","U.E. MARISCAL DE ZEPITA",-67.12341,-17.3896,174,29,1489,1663,602,68,790,1392
"Bolivia","La Paz","Inquisivi","Colquiri","UNIDAD EDUCATIVA MARQUIRIVI",-66.84624,-17.48428,16,0,205,221,37,3,165,202
"Bolivia","La Paz","Inquisivi","Ichoca","CASA DE GOBIERNO",-67.28601,-17.123,4,6,107,111,30,3,68,98
"Bolivia","La Paz","Inquisivi","Ichoca","ESC. CENTRAL LURUTA",-67.12575,-17.23102,29,3,156,185,43,3,107,150
"Bolivia","La Paz","Inquisivi","Ichoca","ESCUELA JOSE ANTONIO DE SUCRE",-67.30527,-17.25527,13,6,321,334,38,8,269,307
"Bolivia","La Paz","Inquisivi","Ichoca","ESCUELA PEDRO DOMINGO MURILLO",-67.25848,-17.18484,19,6,209,228,22,6,175,197
"Bolivia","La Paz","Inquisivi","Ichoca","ESCUELA REPUBLICA DE VENEZUELA",-67.08401,-17.15735,25,8,130,155,19,6,97,116
"Bolivia","La Paz","Inquisivi","Ichoca","UNIDAD EDUCATIVA",-67.18003,-17.14062,141,15,569,710,91,19,444,535
"Bolivia","La Paz","Inquisivi","Ichoca","UNIDAD EDUCATIVA GERMAN BUSCH",-67.17284,-17.24399,1,5,173,174,62,4,102,164
"Bolivia","La Paz","Inquisivi","Inquisivi","ESC. CENTRAL CAVARI",-66.99092,-17.07948,81,14,373,454,53,21,285,338
"Bolivia","La Paz","Inquisivi","Inquisivi","ESC. EDUARDO AVAROA",-66.922,-16.79497,77,8,374,451,24,12,330,354
"Bolivia","La Paz","Inquisivi","Inquisivi","ESC. PEDRO DOMINGO MURILLO",-67.13365,-16.87514,52,5,334,386,50,16,263,313
"Bolivia","La Paz","Inquisivi","Inquisivi","ESCUELA ELIODORO CAMACHO",-67.13739,-16.90743,149,13,777,926,244,39,481,725
"Bolivia","La Paz","Inquisivi","Inquisivi","ESCUELA SIMON BOLIVAR",-66.91412,-17.25326,67,37,245,312,39,15,154,193
"Bolivia","La Paz","Inquisivi","Inquisivi","PLAZA DE LA FERIA DE VILLA VICTORIA",-67.01423,-17.23652,15,0,86,101,10,1,75,85
"Bolivia","La Paz","Inquisivi","Inquisivi","PLAZA PRINCIPAL",-66.86905,-16.60352,126,5,576,702,50,8,513,563
"Bolivia","La Paz","Inquisivi","Inquisivi","PLAZA PRINCIPAL 16 DE JULIO",-66.94501,-16.51898,201,12,654,855,125,12,505,630
"Bolivia","La Paz","Inquisivi","Inquisivi","SEDE SOCIAL",-67.09277,-16.88889,26,2,80,106,28,1,49,77
"Bolivia","La Paz","Inquisivi","Inquisivi","SEDE SOCIAL",-67.08649,-16.69044,26,2,80,106,28,1,49,77
"Bolivia","La Paz","Inquisivi","Inquisivi","UNIDAD EDUCATIVA ESCOLA",-67.01402,-16.88219,79,8,446,525,57,11,370,427
"Bolivia","La Paz","Inquisivi","Inquisivi","UNIDAD EDUCATIVA KANAMARCA",-67.07207,-16.34529,44,3,212,256,25,4,180,205
"Bolivia","La Paz","Inquisivi","Inquisivi","UNIDAD EDUCATIVA MARISCAL SUCRE",-67.08443,-16.78866,13,2,140,153,22,3,113,135
"Bolivia","La Paz","Inquisivi","Inquisivi","UNIDAD EDUCATIVA SIGUAS",-66.93951,-17.17848,31,20,283,314,49,24,190,239
"Bolivia","La Paz","Inquisivi","Inquisivi","UNIDAD EDUCATIVA TUPAK KATARI",-67.07355,-16.99531,83,24,470,553,83,67,296,379
"Bolivia","La Paz","Inquisivi","Licoma Pampa","ESCUELA ELIODORO CAMACHO",-67.20383,-16.80501,149,25,821,970,134,37,625,759
"Bolivia","La Paz","Inquisivi","Licoma Pampa","ESCUELA MIXTA CHARAPAXI",-67.1801,-16.84146,29,1,175,204,16,4,154,170
"Bolivia","La Paz","Inquisivi","Quime","ESC. PONGO B2",-67.27655,-16.98723,18,7,192,210,34,9,142,176
"Bolivia","La Paz","Inquisivi","Quime","ESC. TEODOMIRO URQUIOLA",-67.21542,-16.97982,292,70,2265,2557,758,137,1300,2058
"Bolivia","La Paz","Inquisivi","Quime","ESCUELA HUAYNACOTA",-67.28345,-17.03332,0,1,26,26,10,0,15,25
"Bolivia","La Paz","Inquisivi","Quime","ESCUELA SIMON BOLIVAR",-67.33048,-16.93823,119,14,492,611,255,13,210,465
"Bolivia","La Paz","Inquisivi","Quime","ESCUELA U.E. TITIAMAYA",-67.1907,-16.92141,4,0,110,114,21,4,85,106
"Bolivia","La Paz","Inquisivi","Quime","UNIDAD EDUCATIVA CHOQUETANGA",-67.31809,-16.8389,49,16,412,461,116,16,264,380
"Bolivia","La Paz","Larecaja","Combaya","ESC. CENTRAL SOREJAYA",-68.76491,-15.8242,22,5,333,355,61,21,246,307
"Bolivia","La Paz","Larecaja","Combaya","ESC. NUCLEO TICAMBLAYA",-68.73175,-15.83537,23,18,186,209,46,8,114,160
"Bolivia","La Paz","Larecaja","Combaya","UNIDAD EDUCATIVA EDUARDO AVAROA",-68.7542,-15.80447,52,29,293,345,67,19,178,245
"Bolivia","La Paz","Larecaja","Combaya","UNIDAD EDUCATIVA HUAYCHO",-68.73401,-15.81383,17,6,170,187,7,10,147,154
"Bolivia","La Paz","Larecaja","Guanay","ESC. C. CRESPO",-67.8819,-15.50123,409,21,1763,2172,783,46,913,1696
"Bolivia","La Paz","Larecaja","Guanay","ESC. CENTRAL CARURA",-67.96386,-15.42661,72,9,465,537,127,8,321,448
"Bolivia","La Paz","Larecaja","Guanay","ESC. MARIAPU",-68.05544,-15.40095,5,1,72,77,54,2,15,69
"Bolivia","La Paz","Larecaja","Guanay","ESC. SAN JUAN DE CHALLANA",-67.86722,-15.50406,7,0,60,67,49,1,10,59
"Bolivia","La Paz","Larecaja","Guanay","ESC. SECC. DE POROMA",-67.876,-15.66636,33,3,156,189,32,1,120,152
"Bolivia","La Paz","Larecaja","Guanay","ESC. SECC. MIXTA LA FABULOSA",-68.24464,-16.07889,3,0,42,45,3,0,39,42
"Bolivia","La Paz","Larecaja","Guanay","ESC. SECC. TRAPICHEPONTE",-67.74178,-15.64004,42,3,182,224,36,3,140,176
"Bolivia","La Paz","Larecaja","Guanay","ESCUELA PABLO AMAYA",-68.21191,-15.97806,11,0,79,90,21,8,50,71
"Bolivia","La Paz","Larecaja","Guanay","ESCUELA PAJONAL VILAQUE",-68.05408,-15.41886,22,3,146,168,89,2,52,141
"Bolivia","La Paz","Larecaja","Guanay","LA AGUADA",-67.92878,-15.49115,25,0,181,206,108,1,72,180
"Bolivia","La Paz","Larecaja","Guanay","NUCLEO ESCOLAR DE AMAGUAYA",-68.25602,-15.95273,15,0,80,95,30,1,49,79
"Bolivia","La Paz","Larecaja","Guanay","SEDE SOCIAL",-67.85902,-15.60936,1,2,45,46,15,0,28,43
"Bolivia","La Paz","Larecaja","Guanay","SINDICATO",-68.22674,-16.06047,1,0,59,60,9,7,43,52
"Bolivia","La Paz","Larecaja","Guanay","UNIDAD EDUCATIVA ALTO CHIJINI",-67.88482,-15.41975,5,0,37,42,9,0,28,37
"Bolivia","La Paz","Larecaja","Guanay","UNIDAD EDUCATIVA BUENOS AIRES",-67.68906,-15.70198,32,3,222,254,67,3,149,216
"Bolivia","La Paz","Larecaja","Guanay","UNIDAD EDUCATIVA CANDELARIA",-67.94775,-15.4421,32,4,465,497,110,3,348,458
"Bolivia","La Paz","Larecaja","Guanay","UNIDAD EDUCATIVA NACIONAL GUANAY",-67.88155,-15.49581,457,27,1864,2321,823,65,949,1772
"Bolivia","La Paz","Larecaja","Guanay","UNIDAD EDUCATIVA YOLOSANI",-67.79774,-15.57438,14,1,82,96,20,2,59,79
"Bolivia","La Paz","Larecaja","Mapiri","COLEGIO 1º DE MAYO",-68.20412,-15.28964,95,6,534,629,195,12,321,516
"Bolivia","La Paz","Larecaja","Mapiri","ESC. 16 DE JULIO",-68.21772,-15.31103,466,39,1816,2282,756,63,958,1714
"Bolivia","La Paz","Larecaja","Mapiri","ESC. CENTRAL DE SANTA ROSA",-68.32465,-15.31801,497,19,1423,1920,510,44,850,1360
"Bolivia","La Paz","Larecaja","Mapiri","ESC. DE SARAMPIUNI",-68.22166,-15.3938,19,0,118,137,27,2,89,116
"Bolivia","La Paz","Larecaja","Mapiri","ESC. MONJE ZAPATA",-68.26091,-15.20526,98,6,419,517,112,17,284,396
"Bolivia","La Paz","Larecaja","Mapiri","ESCUELA CHIMATE",-68.1562,-15.3971,33,1,153,186,36,5,111,147
"Bolivia","La Paz","Larecaja","Mapiri","ESC. UNIDAD EDUCATIVA VILAQUE GRANDE",-68.1724,-15.3626,26,3,189,215,49,4,133,182
"Bolivia","La Paz","Larecaja","Quiabaya","ESC. MIXTA JULIO CORDERO",-68.70292,-15.63772,182,34,1025,1207,291,64,636,927
"Bolivia","La Paz","Larecaja","Sorata","COL. JUAN XXIII",-68.65056,-15.77354,235,59,1651,1886,550,74,968,1518
"Bolivia","La Paz","Larecaja","Sorata","ESC. CENTRAL CARAZANI",-68.76967,-15.73627,18,2,197,215,35,20,140,175
"Bolivia","La Paz","Larecaja","Sorata","ESC. CENTRAL CHEJE",-68.6847,-15.79368,39,1,292,331,23,5,263,286
"Bolivia","La Paz","Larecaja","Sorata","ESC. CENTRAL CHOJLLA",-68.35152,-15.8526,28,2,76,104,16,1,57,73
"Bolivia","La Paz","Larecaja","Sorata","ESC. CENTRAL DE YANI",-68.53834,-15.63402,96,12,601,697,382,36,171,553
"Bolivia","La Paz","Larecaja","Sorata","ESC. FERNANDO ELOY GUACHALLA",-68.65588,-15.80826,99,54,809,908,147,48,560,707
"Bolivia","La Paz","Larecaja","Sorata","ESC. NEMECIO AYALA",-68.7309,-15.713,31,8,181,212,35,8,130,165
"Bolivia","La Paz","Larecaja","Sorata","ESC. NUCLEO ABISPAYA",-68.69788,-15.7081,41,12,314,355,77,21,204,281
"Bolivia","La Paz","Larecaja","Sorata","ESC. NUCLEO COCOY",-68.44633,-15.78752,1,0,292,293,152,19,121,273
"Bolivia","La Paz","Larecaja","Sorata","ESC. NUCLEO LARIPATA",-68.66778,-15.75021,91,25,807,898,226,39,517,743
"Bolivia","La Paz","Larecaja","Sorata","ESC. NUCLEO SAN ANTONIO DE MILLIPA",-68.61856,-15.87464,15,7,790,805,229,22,532,761
"Bolivia","La Paz","Larecaja","Sorata","ESC. SECC. DE ANKOMA SUR",-68.5121,-15.74682,17,8,162,179,87,7,60,147
"Bolivia","La Paz","Larecaja","Sorata","ESC. SECCIONAL CHUSSI",-68.2317,-15.6224,2,1,166,168,28,1,136,164
"Bolivia","La Paz","Larecaja","Sorata","ESCUELA COMBILILI",-68.7889,-15.75265,8,0,83,91,33,6,44,77
"Bolivia","La Paz","Larecaja","Sorata","ESCUELA MACHACAMARCA",-68.78627,-15.72192,24,0,154,178,14,1,139,153
"Bolivia","La Paz","Larecaja","Sorata","ESCUELA PACOLLO",-68.64767,-15.85605,5,0,200,205,58,8,134,192
"Bolivia","La Paz","Larecaja","Sorata","ESCUELA SANTA MARIA",-68.21433,-15.58872,54,4,115,169,26,4,81,107
"Bolivia","La Paz","Larecaja","Sorata","ESC. UNIDAD EDUCATIVA OKARA",-68.3903,-15.67581,11,4,50,61,16,2,28,44
"Bolivia","La Paz","Larecaja","Sorata","H.A.M. DE SORATA",-68.64867,-15.77538,290,53,1733,2023,547,94,1039,1586
"Bolivia","La Paz","Larecaja","Tacacoma","COL. CENTRAL SAN AGUSTIN",-68.50902,-15.37926,75,11,346,421,77,18,240,317
"Bolivia","La Paz","Larecaja","Tacacoma","ESC. ANANEA",-68.6505,-15.5341,28,1,192,220,93,6,92,185
"Bolivia","La Paz","Larecaja","Tacacoma","ESC. CENTRAL CHUMISA",-68.65643,-15.58669,56,6,464,520,114,14,330,444
"Bolivia","La Paz","Larecaja","Tacacoma","ESCUELA PALLAYUNGA",-68.60498,-15.46068,60,1,212,272,48,10,153,201
"Bolivia","La Paz","Larecaja","Tacacoma","ESCUELA XVI DE JULIO",-68.64725,-15.59322,140,16,967,1107,467,54,430,897
"Bolivia","La Paz","Larecaja","Tacacoma","ESC. UNIDAD EDUCATIVA CAMILLAYA",-68.57066,-15.43699,17,3,81,98,24,1,53,77
"Bolivia","La Paz","Larecaja","Tacacoma","NUCLEO ESCOLAR INCACHACA",-68.47215,-15.32096,70,2,213,283,124,2,85,209
"Bolivia","La Paz","Larecaja","Tacacoma","PLAZA COLLABAMBA",-68.64456,-15.51472,19,2,111,130,67,7,35,102
"Bolivia","La Paz","Larecaja","Teoponte","COL. NAL. MIXTO TEOPONTE",-67.81804,-15.49505,263,23,1142,1405,404,22,693,1097
"Bolivia","La Paz","Larecaja","Teoponte","COL. NUCLEO TAJLIHUI",-67.70219,-15.67721,20,1,143,163,21,8,113,134
"Bolivia","La Paz","Larecaja","Teoponte","ESC.EDUARDO AVAROA",-67.64935,-15.67183,15,4,127,142,15,6,102,117
"Bolivia","La Paz","Larecaja","Teoponte","ESC. MIXTA TOMACHI",-67.73718,-15.47837,86,2,316,402,104,10,200,304
"Bolivia","La Paz","Larecaja","Teoponte","ESC.NUCLEO VILLA AROMA",-67.7086,-15.59438,33,4,371,404,56,10,301,357
"Bolivia","La Paz","Larecaja","Teoponte","NUCLEO RED UNO",-67.6581,-15.5712,12,1,59,71,4,2,52,56
"Bolivia","La Paz","Larecaja","Teoponte","SEDE SOCIAL",-67.60563,-15.41431,228,13,1044,1272,240,22,769,1009
"Bolivia","La Paz","Larecaja","Tipuani","ESC. 16 DE JULIO",-68.04258,-15.5816,225,7,651,876,204,10,430,634
"Bolivia","La Paz","Larecaja","Tipuani","ESC. EDUARDO AVAROA",-68.01199,-15.56615,478,18,1581,2059,646,37,880,1526
"Bolivia","La Paz","Larecaja","Tipuani","ESC. MIXTA GERMAN BUSCH",-68.00401,-15.56263,40,2,192,232,77,6,107,184
"Bolivia","La Paz","Larecaja","Tipuani","ESC. NESTOR PAZ ZAMORA",-68.0163,-15.51995,11,0,56,67,4,2,50,54
"Bolivia","La Paz","Larecaja","Tipuani","ESCUELA CHUQUINI",-68.08243,-15.61108,281,9,787,1068,198,15,565,763
"Bolivia","La Paz","Larecaja","Tipuani","UNIDAD EDUCATIVA PEDRO DOMINGO MURILLO",-68.10115,-15.59577,97,5,388,485,150,9,224,374
"Bolivia","La Paz","Loayza","Cairoma","COLEGIO GERMAN BUSCH",-67.54138,-16.90495,136,27,1065,1201,246,55,737,983
"Bolivia","La Paz","Loayza","Cairoma","COLEGIO LUIS ESPINAL",-67.57736,-16.92918,29,10,325,354,92,2,221,313
"Bolivia","La Paz","Loayza","Cairoma","ESCUELA DE SAYA",-67.54543,-16.71021,8,2,105,113,40,5,58,98
"Bolivia","La Paz","Loayza","Cairoma","ESCUELA TIENDA PATA",-67.50883,-16.886,14,1,126,140,38,5,82,120
"Bolivia","La Paz","Loayza","Cairoma","PLAZA LLOJA",-67.57372,-16.74774,22,1,184,206,10,1,172,182
"Bolivia","La Paz","Loayza","Cairoma","PLAZA TORRE PAMPA",-67.58032,-16.83131,63,8,346,409,67,10,261,328
"Bolivia","La Paz","Loayza","Cairoma","UNIDAD EDUCATIVA BARTOLINA SISA",-67.4908,-16.65928,23,0,118,141,13,8,97,110
"Bolivia","La Paz","Loayza","Cairoma","UNIDAD EDUCATIVA BOLIVAR",-67.54518,-16.87182,69,19,489,558,68,16,386,454
"Bolivia","La Paz","Loayza","Cairoma","UNIDAD EDUCATIVA BOLIVIA-VILOCO",-67.49796,-16.87398,159,5,706,865,165,22,514,679
"Bolivia","La Paz","Loayza","Cairoma","UNIDAD EDUCATIVA LIBERTAD",-67.56012,-16.81969,55,9,341,396,54,14,264,318
"Bolivia","La Paz","Loayza","Cairoma","UNIDAD EDUCATIVA SACANI",-67.61375,-16.94436,16,3,365,381,57,8,297,354
"Bolivia","La Paz","Loayza","Luribay","COLEGIO AZAMBO",-67.63184,-17.00489,29,4,371,400,66,13,288,354
"Bolivia","La Paz","Loayza","Luribay","COLEGIO VILLA LITORAL",-67.6229,-17.08772,37,2,383,420,47,8,326,373
"Bolivia","La Paz","Loayza","Luribay","COL. RVDO. VICTOR ARUAZO-PLAZA PRINCIPAL",-67.6609,-17.06249,88,10,630,718,135,19,466,601
"Bolivia","La Paz","Loayza","Luribay","ESCUELA ANQUIMOA",-67.66051,-16.99854,49,6,587,636,60,11,510,570
"Bolivia","La Paz","Loayza","Luribay","ESCUELA EL PORVENIR",-67.55268,-17.03213,44,3,617,661,107,12,495,602
"Bolivia","La Paz","Loayza","Luribay","ESCUELA MURMUNTANI",-67.5434,-17.08703,20,1,171,191,13,4,153,166
"Bolivia","La Paz","Loayza","Luribay","ESC. UNIDAD EDUCATIVA BRAVO",-67.68433,-16.95887,17,3,198,215,19,3,173,192
"Bolivia","La Paz","Loayza","Luribay","PLAZA 5 DE AGOSTO",-67.60162,-17.11526,64,5,422,486,57,11,349,406
"Bolivia","La Paz","Loayza","Luribay","PLAZA 6 DE AGOSTO",-67.68541,-17.13404,60,4,349,409,33,24,288,321
"Bolivia","La Paz","Loayza","Luribay","PLAZA TOTORA",-67.68784,-17.09565,5,0,90,95,11,0,79,90
"Bolivia","La Paz","Loayza","Luribay","UNIDAD EDUCATIVA COLLIRI",-67.7193,-17.04746,32,1,225,257,31,8,185,216
"Bolivia","La Paz","Loayza","Luribay","UNIDAD EDUCATIVA PEDRO DOMINGO MURILLO",-67.57441,-17.14605,88,8,596,684,94,3,491,585
"Bolivia","La Paz","Loayza","Luribay","UNIDAD EDUCATIVA POROMA",-67.54092,-17.17032,23,1,299,322,37,1,260,297
"Bolivia","La Paz","Loayza","Malla","ESCUELA SIMON BOLIVAR",-67.42189,-17.06216,3,0,99,102,3,2,94,97
"Bolivia","La Paz","Loayza","Malla","PLAZA 14 DE SEPTIEMBRE",-67.45062,-17.03962,13,2,408,421,55,5,346,401
"Bolivia","La Paz","Loayza","Malla","UNIDAD EDUCATIVA FRANZ TAMAYO",-67.49815,-16.9908,38,2,254,292,55,9,188,243
"Bolivia","La Paz","Loayza","Sapahaqui","ESCUELA EDUARDO AVAROA",-67.71152,-16.88625,43,2,413,456,44,5,362,406
"Bolivia","La Paz","Loayza","Sapahaqui","ESCUELA SIXILLA BAJA",-67.79269,-17.05937,0,1,325,325,42,2,280,322
"Bolivia","La Paz","Loayza","Sapahaqui","MURUHUTA",-67.83468,-17.10299,43,2,373,416,66,16,289,355
"Bolivia","La Paz","Loayza","Sapahaqui","PLAZA PRINCIPAL HUANCANE",-67.92168,-16.96859,13,2,321,334,52,5,262,314
"Bolivia","La Paz","Loayza","Sapahaqui","UNIDAD EDUCATIVA CHIVISIVI",-67.87543,-16.95139,49,7,565,614,86,4,468,554
"Bolivia","La Paz","Loayza","Sapahaqui","UNIDAD EDUCATIVA OCUIRI",-67.75996,-17.09802,21,0,228,249,20,6,202,222
"Bolivia","La Paz","Loayza","Sapahaqui","UNIDAD EDUCATIVA SAN MARCOS",-67.81051,-16.99369,192,11,1391,1583,215,51,1114,1329
"Bolivia","La Paz","Loayza","Sapahaqui","UNIDAD EDUCATIVA SAPAHAQUI",-67.95024,-16.88832,204,31,1625,1829,323,69,1202,1525
"Bolivia","La Paz","Loayza","Sapahaqui","UNIDAD EDUCATIVA TACOBAMBA",-67.93534,-16.89507,63,3,616,679,93,17,503,596
"Bolivia","La Paz","Loayza","Sapahaqui","UNIDAD EDUCATIVA URUPAYA",-67.86726,-16.83526,12,0,94,106,16,2,76,92
"Bolivia","La Paz","Loayza","Yaco","COLEGIO REPUBLICA VENEZUELA",-67.33579,-17.27501,43,5,589,632,169,21,394,563
"Bolivia","La Paz","Loayza","Yaco","ESCUELA CHALLOMA",-67.48557,-17.17411,22,2,235,257,12,5,216,228
"Bolivia","La Paz","Loayza","Yaco","ESCUELA UMALACO",-67.44422,-17.08424,4,1,74,78,8,1,64,72
"Bolivia","La Paz","Loayza","Yaco","PLAZA 14 DE SEPTIEMBRE",-67.37626,-17.18333,9,2,116,125,23,7,84,107
"Bolivia","La Paz","Loayza","Yaco","PLAZA CENTRAL",-67.33892,-17.17855,27,11,431,458,98,46,276,374
"Bolivia","La Paz","Loayza","Yaco","UNIDAD EDUCATIVA CHUCAMARCA",-67.45103,-17.09326,34,4,238,272,34,10,190,224
"Bolivia","La Paz","Loayza","Yaco","UNIDAD EDUCATIVA DANIEL GOMEZ GARCIA",-67.44017,-17.25055,36,7,284,320,50,20,207,257
"Bolivia","La Paz","Loayza","Yaco","UNIDAD EDUCATIVA GERMAN BUSCH",-67.34483,-17.1474,18,0,119,137,25,5,89,114
"Bolivia","La Paz","Loayza","Yaco","UNIDAD EDUCATIVA HURNUNI",-67.40517,-17.3487,12,1,240,252,87,5,147,234
"Bolivia","La Paz","Loayza","Yaco","UNIDAD EDUCATIVA SIMON BOLIVAR",-67.35043,-17.13314,0,7,137,137,38,5,87,125
"Bolivia","La Paz","Loayza","Yaco","UNIDAD EDUCATIVA YACO",-67.41138,-17.1584,84,13,368,452,78,25,252,330
"Bolivia","La Paz","Los Andes","Batallas","COLEGIO DON BOSCO",-68.46431,-16.31361,60,18,729,789,166,29,516,682
"Bolivia","La Paz","Los Andes","Batallas","COLEGIO TÉCNICO HUMANÍSTICO CHIRAPACA",-68.49313,-16.29834,21,4,406,427,136,16,250,386
"Bolivia","La Paz","Los Andes","Batallas","COL. FISCAL BOLIVIANO CUBANO",-68.52594,-16.30013,64,13,724,788,224,26,461,685
"Bolivia","La Paz","Los Andes","Batallas","COL. PEDRO DOMINGO MURILLO",-68.50931,-16.1562,62,11,535,597,213,23,288,501
"Bolivia","La Paz","Los Andes","Batallas","ESCUELA GENOVEVA RIOS",-68.53124,-16.30003,339,47,2937,3276,953,124,1813,2766
"Bolivia","La Paz","Los Andes","Batallas","PLAZA LA PAZ",-68.51289,-16.34104,36,4,566,602,193,19,350,543
"Bolivia","La Paz","Los Andes","Batallas","PLAZA PRINCIPAL",-68.54729,-16.10482,112,16,1192,1304,434,57,685,1119
"Bolivia","La Paz","Los Andes","Batallas","PLAZA PRINCIPAL",-68.46272,-16.2592,112,16,1192,1304,434,57,685,1119
"Bolivia","La Paz","Los Andes","Batallas","PLAZA TUPAC KATARI",-68.50398,-16.23213,75,17,642,717,150,35,440,590
"Bolivia","La Paz","Los Andes","Batallas","PLAZA TUQUIA",-68.46532,-16.21404,67,13,684,751,186,44,441,627
"Bolivia","La Paz","Los Andes","Batallas","PLAZA V. ASUNCION DE CALUYO",-68.51057,-16.32793,15,0,198,213,34,4,160,194
"Bolivia","La Paz","Los Andes","Batallas","SEDE SOCIAL",-68.56298,-16.25858,16,3,250,266,77,9,161,238
"Bolivia","La Paz","Los Andes","Laja","COL. PEDRO DOMINGO MURILLO",-68.38843,-16.53407,294,57,3397,3691,824,159,2357,3181
"Bolivia","La Paz","Los Andes","Laja","COL. TEC. HUMANISTICO TAMBILLO",-68.50755,-16.57151,56,13,515,571,151,28,323,474
"Bolivia","La Paz","Los Andes","Laja","ESC. QUINTUPATA",-68.50268,-16.62749,3,3,135,138,30,1,101,131
"Bolivia","La Paz","Los Andes","Laja","ESCUELA REPUBLICA DE IRAN",-68.30653,-16.52587,113,16,1084,1197,287,47,734,1021
"Bolivia","La Paz","Los Andes","Laja","MERCADO SAN JUAN",-68.46218,-16.69142,36,13,460,496,56,24,367,423
"Bolivia","La Paz","Los Andes","Laja","PLAZA CURVA PUCARA",-68.57091,-16.59581,22,12,579,601,99,21,447,546
"Bolivia","La Paz","Los Andes","Laja","PLAZA PRINCIPAL",-68.55198,-16.5294,38,22,1018,1056,176,53,767,943
"Bolivia","La Paz","Los Andes","Laja","PLAZA PRINCIPAL",-68.55477,-16.65492,38,22,1018,1056,176,53,767,943
"Bolivia","La Paz","Los Andes","Laja","PLAZA PRINCIPAL",-68.56635,-16.57367,38,22,1018,1056,176,53,767,943
"Bolivia","La Paz","Los Andes","Laja","U.E. CALLAMARCA",-68.57652,-16.6364,2,3,380,382,73,19,285,358
"Bolivia","La Paz","Los Andes","Laja","U.E. GUALBERTO VILLARROEL DE SACACANI",-68.50606,-16.68419,0,0,216,216,48,8,160,208
"Bolivia","La Paz","Los Andes","Laja","UNIDAD EDUCATIVA COPAJIRA",-68.44736,-16.59749,38,10,617,655,118,33,456,574
"Bolivia","La Paz","Los Andes","Pucarani","COLEGIO CHIARPATA",-68.52587,-16.35778,30,20,480,510,148,25,287,435
"Bolivia","La Paz","Los Andes","Pucarani","COLEGIO COHANA",-68.65945,-16.37055,25,16,685,710,136,25,508,644
"Bolivia","La Paz","Los Andes","Pucarani","COLEGIO MARIO GUTIERREZ",-68.5423,-16.40942,80,43,1028,1108,366,92,527,893
"Bolivia","La Paz","Los Andes","Pucarani","COLEGIO SAN SALVADOR",-68.37844,-16.37475,133,40,1707,1840,473,103,1091,1564
"Bolivia","La Paz","Los Andes","Pucarani","COL.NAL.CHOJÑA COLLO",-68.42926,-16.44215,17,9,393,410,128,35,221,349
"Bolivia","La Paz","Los Andes","Pucarani","ESC. CENTRAL CHIPAMAYA",-68.42702,-16.38573,34,7,457,491,140,21,289,429
"Bolivia","La Paz","Los Andes","Pucarani","ESC. JOSE SALMON BALLIVIAN",-68.47432,-16.39758,294,81,3005,3299,1094,162,1668,2762
"Bolivia","La Paz","Los Andes","Pucarani","ESCUELA ANTOFAGASTA",-68.33107,-16.42799,88,53,1728,1816,627,161,887,1514
"Bolivia","La Paz","Los Andes","Pucarani","ESCUELA CATAVI",-68.58923,-16.48189,61,22,675,736,193,30,430,623
"Bolivia","La Paz","Los Andes","Pucarani","ESCUELA CHOJASIVI",-68.69275,-16.44042,10,10,676,686,231,26,409,640
"Bolivia","La Paz","Los Andes","Pucarani","PLAZA 6 DE AGOSTO",-68.41537,-16.33457,120,31,1482,1602,323,63,1065,1388
"Bolivia","La Paz","Los Andes","Pucarani","PLAZA PRINCIPAL",-68.66112,-16.44403,67,16,725,792,110,11,588,698
"Bolivia","La Paz","Los Andes","Pucarani","PLAZA VILLA ROSARIO DE CORAPATA",-68.37347,-16.4377,72,22,920,992,390,47,461,851
"Bolivia","La Paz","Los Andes","Puerto Pérez","ESC. GUALBERTO VILLARROEL",-68.59356,-16.35726,65,6,453,518,151,26,270,421
"Bolivia","La Paz","Los Andes","Puerto Pérez","ESC. MIXTO 16 DE JULIO",-68.76075,-16.30686,62,27,874,936,173,36,638,811
"Bolivia","La Paz","Los Andes","Puerto Pérez","ESCUELA CENTRAL CASCACHI",-68.67452,-16.3437,37,13,518,555,91,35,379,470
"Bolivia","La Paz","Los Andes","Puerto Pérez","ESCUELA PUERTO PEREZ",-68.60112,-16.28587,90,20,1047,1137,243,26,758,1001
"Bolivia","La Paz","Los Andes","Puerto Pérez","ESCUELAS POPULARES DON BOSCO",-68.58698,-16.34699,28,2,314,342,91,9,212,303
"Bolivia","La Paz","Los Andes","Puerto Pérez","UNIDAD EDUCATIVA CUMANA",-68.63633,-16.34833,20,4,257,277,42,5,206,248
"Bolivia","La Paz","Manco Kapac","Copacabana","CENTRO DE SALUD SIRIPACA",-69.06173,-16.09907,39,7,243,282,25,3,208,233
"Bolivia","La Paz","Manco Kapac","Copacabana","COLEGIO CHALLA",-69.18937,-15.98997,64,12,938,1002,47,15,864,911
"Bolivia","La Paz","Manco Kapac","Copacabana","COL. NACIONAL MIXTO COPACABANA",-69.08396,-16.1632,569,57,3967,4536,1210,144,2556,3766
"Bolivia","La Paz","Manco Kapac","Copacabana","ESC. 16 DE JULIO",-69.0842,-16.20929,110,16,881,991,288,36,541,829
"Bolivia","La Paz","Manco Kapac","Copacabana","ESC. COL. TEC. HUMANISTICO HUACUYO",-69.03305,-16.17805,71,3,409,480,81,16,309,390
"Bolivia","La Paz","Manco Kapac","Copacabana","ESCUELA SECCIONAL SAMPAYA",-69.1012,-16.08231,44,7,321,365,47,15,252,299
"Bolivia","La Paz","Manco Kapac","Copacabana","ESCUELA VILLA ROSARIO",-68.98846,-16.14534,37,9,328,365,68,11,240,308
"Bolivia","La Paz","Manco Kapac","San Pedro de Tiquina","COLEGIO VILLA AMACARI",-68.86105,-16.25432,14,8,184,198,48,5,123,171
"Bolivia","La Paz","Manco Kapac","San Pedro de Tiquina","COL. SIMON BOLIVAR",-68.85252,-16.22503,260,19,1043,1303,306,53,665,971
"Bolivia","La Paz","Manco Kapac","San Pedro de Tiquina","ESC. MIXTA SAN PABLO DE TIQUINA",-68.84653,-16.21544,75,20,651,726,249,30,352,601
"Bolivia","La Paz","Manco Kapac","San Pedro de Tiquina","PLAZA 25 DE JUNIO",-68.88103,-16.26364,31,2,212,243,62,4,144,206
"Bolivia","La Paz","Manco Kapac","San Pedro de Tiquina","SEDE SOCIAL",-68.89336,-16.22142,52,8,303,355,55,7,233,288
"Bolivia","La Paz","Manco Kapac","Tito Yupanqui","COLEGIO NACIONAL MIXTO TITO YUPANQUI",-68.95449,-16.19247,122,25,653,775,215,21,392,607
"Bolivia","La Paz","Manco Kapac","Tito Yupanqui","ESCUELA HUATAPAMPA",-68.95433,-16.17676,14,1,165,179,39,8,117,156
"Bolivia","La Paz","Muñecas","Aucapata","COLEGIO 2 DE AGOSTO",-68.76146,-15.4182,101,10,391,492,52,22,307,359
"Bolivia","La Paz","Muñecas","Aucapata","ESCUELA DR. ANGEL GEMIO ERGUETA",-68.72099,-15.48481,66,2,169,235,51,16,100,151
"Bolivia","La Paz","Muñecas","Aucapata","IGLESIA SANTO DOMINGO",-68.72872,-15.4539,72,10,195,267,34,13,138,172
"Bolivia","La Paz","Muñecas","Aucapata","NUCLEO ESCOLAR YANAHUAYA",-68.6969,-15.45401,110,22,384,494,83,22,257,340
"Bolivia","La Paz","Muñecas","Aucapata","UNIDAD EDUCATIVA ROSARIO",-68.6216,-15.4223,168,12,489,657,91,20,366,457
"Bolivia","La Paz","Muñecas","Ayata","COL. NEMESIO ALIAGA BENAVENTE",-68.8305,-15.45652,245,60,811,1056,118,57,576,694
"Bolivia","La Paz","Muñecas","Ayata","ESC. SAN JUANITO",-68.75811,-15.3747,58,3,367,425,44,19,301,345
"Bolivia","La Paz","Muñecas","Ayata","ESCUELA CAMATA",-68.74616,-15.23502,79,17,385,464,72,18,278,350
"Bolivia","La Paz","Muñecas","Ayata","ESCUELA NUCLEO ELIZARDO PEREZ DE M.",-68.80567,-15.50827,81,30,444,525,97,28,289,386
"Bolivia","La Paz","Muñecas","Ayata","ESCUELA SAIHUANI",-68.77344,-15.44397,102,15,420,522,32,17,356,388
"Bolivia","La Paz","Muñecas","Ayata","ESCUELA SECCIONAL MULTIGRADO UPANI",-68.80933,-15.49444,52,5,276,328,7,29,235,242
"Bolivia","La Paz","Muñecas","Ayata","UNIDAD EDUCATIVA VILLA ROSARIO",-68.62227,-15.22997,0,3,87,87,13,3,68,81
"Bolivia","La Paz","Muñecas","Chuma","COLEGIO HUMANISTICO SOCOCONI",-68.87901,-15.7106,67,11,508,575,57,13,427,484
"Bolivia","La Paz","Muñecas","Chuma","COLEGIO POCOAYA",-68.91715,-15.4475,16,1,118,134,26,8,83,109
"Bolivia","La Paz","Muñecas","Chuma","CUSAHUAYA",-68.84715,-15.66148,7,3,206,213,14,3,186,200
"Bolivia","La Paz","Muñecas","Chuma","ESC. TIMUSI",-68.86244,-15.66374,31,1,266,297,35,7,223,258
"Bolivia","La Paz","Muñecas","Chuma","ESCUELA CENTRAL TITICACHI",-68.81434,-15.50673,63,10,409,472,88,21,290,378
"Bolivia","La Paz","Muñecas","Chuma","ESCUELA CHAJLAYA",-68.90194,-15.68445,57,5,535,592,104,20,406,510
"Bolivia","La Paz","Muñecas","Chuma","ESCUELA DE LUQUISANI",-68.81457,-15.51897,24,6,269,293,93,17,153,246
"Bolivia","La Paz","Muñecas","Chuma","ESCUELA DE TUILUNI",-68.92104,-15.48239,27,9,258,285,68,25,156,224
"Bolivia","La Paz","Muñecas","Chuma","ESCUELA MAXIMILIANO ORTIZ",-68.89848,-15.4816,252,37,830,1082,184,54,555,739
"Bolivia","La Paz","Muñecas","Chuma","ESCUELA PALOHUAYA",-68.8721,-15.63676,14,1,124,138,28,4,91,119
"Bolivia","La Paz","Muñecas","Chuma","PLAZA CAPAYQUE",-68.80988,-15.69481,13,4,212,225,18,9,181,199
"Bolivia","La Paz","Muñecas","Chuma","PLAZA JICHUHUAYA",-68.8353,-15.69286,13,0,104,117,20,1,83,103
"Bolivia","La Paz","Murillo","Achocalla","COLEGIO 16 DE AGOSTO",-68.17045,-16.55337,114,6,1115,1229,320,26,763,1083
"Bolivia","La Paz","Murillo","Achocalla","ESCUELA ASUNTA QUILLVIRI",-68.11919,-16.72616,81,18,1012,1093,238,67,689,927
"Bolivia","La Paz","Murillo","Achocalla","ESCUELA CHAÑOCAHUA",-68.14516,-16.63919,347,30,3694,4041,1028,129,2507,3535
"Bolivia","La Paz","Murillo","Achocalla","ESCUELA MARQUIRIVI",-68.15418,-16.5915,278,37,2011,2289,498,51,1425,1923
"Bolivia","La Paz","Murillo","Achocalla","ESCUELA VILLA CONCEPCION",-68.13874,-16.60526,28,9,522,550,101,27,385,486
"Bolivia","La Paz","Murillo","Achocalla","U. E.  ANTONIO DIAZ VILLAMIL",-68.16837,-16.57798,148,34,1803,1951,514,52,1203,1717
"Bolivia","La Paz","Murillo","Achocalla","U. E. RENE BARRIENTOS ORTUÑO",-68.1705,-16.56838,143,13,1235,1378,410,29,783,1193
"Bolivia","La Paz","Murillo","Achocalla","UNIDAD EDUCATIVA TUNI",-68.13835,-16.67672,26,2,348,374,69,7,270,339
"Bolivia","La Paz","Murillo","El Alto de La Paz","CENTRO EDUCATIVO CATOLICO MERCEDES",-68.2159,-16.56526,214,28,2435,2649,824,121,1462,2286
"Bolivia","La Paz","Murillo","El Alto de La Paz","COL 18 DE DICIEMBRE",-68.17837,-16.58624,338,27,3263,3601,1006,144,2086,3092
"Bolivia","La Paz","Murillo","El Alto de La Paz","COL 1RO DE MAYO",-68.19975,-16.53636,657,49,7853,8510,3644,396,3764,7408
"Bolivia","La Paz","Murillo","El Alto de La Paz","COL 25 DE JULIO",-68.18322,-16.58162,838,75,6599,7437,2202,295,4027,6229
"Bolivia","La Paz","Murillo","El Alto de La Paz","COL ATIPIRIS",-68.17815,-16.59096,321,40,2932,3253,866,149,1877,2743
"Bolivia","La Paz","Murillo","El Alto de La Paz","COL BASILL MILLER",-68.17461,-16.48812,230,19,2919,3149,1330,130,1440,2770
"Bolivia","La Paz","Murillo","El Alto de La Paz","COL BOLIVIA",-68.17217,-16.5416,467,46,4155,4622,1592,215,2302,3894
"Bolivia","La Paz","Murillo","El Alto de La Paz","COL CALAMA",-68.19262,-16.53144,626,52,7137,7763,2855,316,3914,6769
"Bolivia","La Paz","Murillo","El Alto de La Paz","COL EDUARDO AVAROA",-68.18268,-16.52774,319,22,2726,3045,1119,115,1470,2589
"Bolivia","La Paz","Murillo","El Alto de La Paz","COLEGIO 23 DE MARZO",-68.1777,-16.61965,770,87,6619,7389,1738,305,4489,6227
"Bolivia","La Paz","Murillo","El Alto de La Paz","COLEGIO 27 DE MAYO",-68.18954,-16.59973,595,88,5668,6263,1618,298,3664,5282
"Bolivia","La Paz","Murillo","El Alto de La Paz","COLEGIO 6 DE JUNIO",-68.20706,-16.55554,516,40,4530,5046,1597,147,2746,4343
"Bolivia","La Paz","Murillo","El Alto de La Paz","COLEGIO ADRIAN CASTILLO NAVA",-68.18089,-16.47932,842,92,8873,9715,3409,395,4977,8386
"Bolivia","La Paz","Murillo","El Alto de La Paz","COLEGIO ANDRES DE STA CRUZ",-68.21678,-16.48222,623,80,6837,7460,2609,386,3762,6371
"Bolivia","La Paz","Murillo","El Alto de La Paz","COLEGIO ANTONIO PAREDES CANDIA",-68.21078,-16.47959,918,144,10853,11771,3838,538,6333,10171
"Bolivia","La Paz","Murillo","El Alto de La Paz","COLEGIO BOLIVIA MAR",-68.19718,-16.58017,264,24,2518,2782,660,107,1727,2387
"Bolivia","La Paz","Murillo","El Alto de La Paz","COLEGIO DON BOSCO",-68.22162,-16.56328,746,78,7399,8145,2631,249,4441,7072
"Bolivia","La Paz","Murillo","El Alto de La Paz","COLEGIO FERNANDO NOGALES CASTRO",-68.23376,-16.52565,289,37,3484,3773,1511,133,1803,3314
"Bolivia","La Paz","Murillo","El Alto de La Paz","COLEGIO HUAYNA POTOSI",-68.18628,-16.47742,666,114,8029,8695,2771,410,4734,7505
"Bolivia","La Paz","Murillo","El Alto de La Paz","COLEGIO ILLIMANI",-68.20894,-16.54332,694,71,7226,7920,2297,267,4591,6888
"Bolivia","La Paz","Murillo","El Alto de La Paz","COLEGIO LUIS ESPINAL CAMPS",-68.22268,-16.52322,980,111,9286,10266,3175,314,5686,8861
"Bolivia","La Paz","Murillo","El Alto de La Paz","COLEGIO LUIS ESPINAL CAMPS (AEROPUERTO)",-68.19802,-16.51796,352,33,2977,3329,1046,156,1742,2788
"Bolivia","La Paz","Murillo","El Alto de La Paz","COLEGIO MARISCAL ANDRES DE SANTA CRUZ",-68.14963,-16.53367,133,16,1349,1482,748,42,543,1291
"Bolivia","La Paz","Murillo","El Alto de La Paz","COLEGIO MARTIN CARDENAS",-68.20902,-16.5227,1058,70,9815,10873,4851,385,4509,9360
"Bolivia","La Paz","Murillo","El Alto de La Paz","COLEGIO M QUIROGA SANTA CRUZ",-68.20879,-16.48692,295,158,4768,5063,1919,264,2427,4346
"Bolivia","La Paz","Murillo","El Alto de La Paz","COLEGIO NESTOR PAZ",-68.23247,-16.54344,495,45,4940,5435,1684,272,2939,4623
"Bolivia","La Paz","Murillo","El Alto de La Paz","COLEGIO PARTICULAR SAN MIGUEL",-68.21574,-16.49355,224,15,2154,2378,1059,100,980,2039
"Bolivia","La Paz","Murillo","El Alto de La Paz","COLEGIO PUERTO DEL ROSARIO",-68.19044,-16.54459,1107,83,10673,11780,4517,402,5671,10188
"Bolivia","La Paz","Murillo","El Alto de La Paz","COLEGIO PUERTO DEL ROSARIO",-68.19044,-16.54459,1107,83,10673,11780,4517,402,5671,10188
"Bolivia","La Paz","Murillo","El Alto de La Paz","COLEGIO SAN JOSE",-68.17645,-16.48123,876,111,10039,10915,4092,467,5369,9461
"Bolivia","La Paz","Murillo","El Alto de La Paz","COLEGIO WALTER ALPIRE 1ER PATIO",-68.21351,-16.49505,515,36,4904,5419,2435,204,2229,4664
"Bolivia","La Paz","Murillo","El Alto de La Paz","COLEGIO WALTER ALPIRE 2DO PATIO",-68.21351,-16.49505,233,30,3092,3325,1664,90,1308,2972
"Bolivia","La Paz","Murillo","El Alto de La Paz","COL ESPAÑA",-68.19041,-16.58716,1083,87,9120,10203,2893,393,5747,8640
"Bolivia","La Paz","Murillo","El Alto de La Paz","COL GRAN BRETAÑA",-68.18764,-16.49338,490,42,5632,6122,2556,229,2805,5361
"Bolivia","La Paz","Murillo","El Alto de La Paz","COL HEROES DEL PACIFICO",-68.15602,-16.52656,396,13,4315,4711,2896,119,1287,4183
"Bolivia","La Paz","Murillo","El Alto de La Paz","COL LIBERTADOR S. BOLIVAR",-68.17521,-16.52682,462,34,4467,4929,1991,177,2265,4256
"Bolivia","La Paz","Murillo","El Alto de La Paz","COL MUTUAL LA PAZ",-68.19092,-16.55765,361,43,4042,4403,1871,136,1992,3863
"Bolivia","La Paz","Murillo","El Alto de La Paz","COL PUERTO MEJILLONES",-68.15205,-16.52655,788,41,7782,8570,5150,204,2387,7537
"Bolivia","La Paz","Murillo","El Alto de La Paz","COL RAFAEL MENDOZA",-68.19506,-16.49104,492,48,4903,5395,2342,267,2246,4588
"Bolivia","La Paz","Murillo","El Alto de La Paz","COL. REPUBLICA DE ITALIA",-68.1873,-16.5898,215,25,2000,2215,636,91,1248,1884
"Bolivia","La Paz","Murillo","El Alto de La Paz","COL ROTARY CHUQUIAGO MARCA",-68.16711,-16.53573,1011,81,8411,9422,3437,350,4543,7980
"Bolivia","La Paz","Murillo","El Alto de La Paz","COL SANTA MARIA DE LOS ANGELES",-68.17751,-16.49472,613,57,6809,7422,3221,351,3180,6401
"Bolivia","La Paz","Murillo","El Alto de La Paz","COL SAN VICENTE DE PAUL",-68.20663,-16.50516,720,71,7407,8127,2690,299,4347,7037
"Bolivia","La Paz","Murillo","El Alto de La Paz","COL. TEC. HUMANISTICO JOSE BALLIVIAN",-68.1784,-16.48976,313,42,3459,3772,1487,184,1746,3233
"Bolivia","La Paz","Murillo","El Alto de La Paz","COL TOPATER",-68.19929,-16.5635,482,35,5105,5587,1886,196,2988,4874
"Bolivia","La Paz","Murillo","El Alto de La Paz","COL TUNARI",-68.19628,-16.49841,1276,134,13812,15088,5846,623,7209,13055
"Bolivia","La Paz","Murillo","El Alto de La Paz","COL VICENTE TEJADA",-68.15522,-16.51924,558,55,5652,6210,2603,228,2766,5369
"Bolivia","La Paz","Murillo","El Alto de La Paz","ESC BALLIVIAN",-68.17644,-16.49026,328,44,3921,4249,1573,201,2103,3676
"Bolivia","La Paz","Murillo","El Alto de La Paz","ESC BOLIVAR MUNICIPAL",-68.18821,-16.53657,303,36,3647,3950,1409,147,2055,3464
"Bolivia","La Paz","Murillo","El Alto de La Paz","ESC ELIZARDO PEREZ",-68.1898,-16.48761,428,43,4525,4953,1912,218,2352,4264
"Bolivia","La Paz","Murillo","El Alto de La Paz","ESC JUVENAL MARIACA",-68.17067,-16.49689,715,55,7081,7796,3574,293,3159,6733
"Bolivia","La Paz","Murillo","El Alto de La Paz","ESC LIBERTAD EN LAS AMERICAS",-68.15623,-16.53351,767,73,7221,7988,3007,258,3883,6890
"Bolivia","La Paz","Murillo","El Alto de La Paz","ESC LOS ANDES",-68.18398,-16.49493,304,34,3283,3587,1507,147,1595,3102
"Bolivia","La Paz","Murillo","El Alto de La Paz","ESC LUIS ESPINAL CAMPS",-68.16608,-16.4796,245,31,2568,2813,916,116,1505,2421
"Bolivia","La Paz","Murillo","El Alto de La Paz","ESC PRIMAVERA",-68.1945,-16.53725,174,13,1555,1729,685,64,793,1478
"Bolivia","La Paz","Murillo","El Alto de La Paz","ESC TARAPACA",-68.18806,-16.60872,554,71,5829,6383,1548,243,3967,5515
"Bolivia","La Paz","Murillo","El Alto de La Paz","ESCUELA 16 DE FEBRERO",-68.22742,-16.50302,661,95,7448,8109,2757,268,4328,7085
"Bolivia","La Paz","Murillo","El Alto de La Paz","ESCUELA BRASIL",-68.20975,-16.49082,456,38,5008,5464,2223,211,2536,4759
"Bolivia","La Paz","Murillo","El Alto de La Paz","ESCUELA GUAQUI",-68.17409,-16.47567,563,74,6164,6727,2203,301,3586,5789
"Bolivia","La Paz","Murillo","El Alto de La Paz","ESCUELA JUAN CARLOS FLORES BEDREGAL",-68.22012,-16.50096,693,95,7769,8462,3069,266,4339,7408
"Bolivia","La Paz","Murillo","El Alto de La Paz","ESCUELA JUAN CARLOS FLORES BEDREGAL",-68.22012,-16.50096,693,95,7769,8462,3069,266,4339,7408
"Bolivia","La Paz","Murillo","El Alto de La Paz","ESCUELA JUAN JOSE TORREZ",-68.17109,-16.47051,363,55,4053,4416,1349,196,2453,3802
"Bolivia","La Paz","Murillo","El Alto de La Paz","ESCUELA RAFAEL PABON",-68.17429,-16.46312,305,75,4175,4480,1240,279,2581,3821
"Bolivia","La Paz","Murillo","El Alto de La Paz","ESCUELA RAUL SALMON DE LA BARRA",-68.21005,-16.49883,282,31,3411,3693,1445,154,1781,3226
"Bolivia","La Paz","Murillo","El Alto de La Paz","ESCUELA REPUBLICA DE CHINA POPULAR",-68.23643,-16.50772,422,72,4824,5246,1516,168,3068,4584
"Bolivia","La Paz","Murillo","El Alto de La Paz","ESCUELA TEJADA TRIANGULAR",-68.15996,-16.52431,273,22,2802,3075,1340,107,1333,2673
"Bolivia","La Paz","Murillo","El Alto de La Paz","ESCUELA TUPAC KATARI",-68.19848,-16.48532,330,45,3613,3943,1557,150,1861,3418
"Bolivia","La Paz","Murillo","El Alto de La Paz","INSTITUTO EDUCATIVO JESUS DE NAZARETH",-68.21307,-16.52458,459,45,4099,4558,1855,130,2069,3924
"Bolivia","La Paz","Murillo","El Alto de La Paz","SEDE SOCIAL JUNTA VECINAL",-68.19644,-16.54614,155,21,1394,1549,521,34,818,1339
"Bolivia","La Paz","Murillo","El Alto de La Paz","SEDE VECINAL",-68.1711,-16.51802,39,3,471,510,281,18,169,450
"Bolivia","La Paz","Murillo","El Alto de La Paz","U.E. AMIGOS DEL CHACO",-68.20364,-16.52415,86,11,1048,1134,424,31,582,1006
"Bolivia","La Paz","Murillo","El Alto de La Paz","U.E. CRISTAL",-68.20247,-16.59457,68,12,1343,1411,390,32,909,1299
"Bolivia","La Paz","Murillo","El Alto de La Paz","U.E. FUERZA AEREA ARGENTINA",-68.25346,-16.49715,66,16,934,1000,283,46,589,872
"Bolivia","La Paz","Murillo","El Alto de La Paz","U.E. GRAL. ARMANDO ESCOBAR URIA",-68.15063,-16.52961,145,3,1622,1767,1077,52,490,1567
"Bolivia","La Paz","Murillo","El Alto de La Paz","U.E. OSCAR ALFARO",-68.23621,-16.48713,444,61,4838,5282,1745,229,2803,4548
"Bolivia","La Paz","Murillo","El Alto de La Paz","UE PARTICULAR INTERANDINO BOLIVIANO",-68.18138,-16.49701,34,2,196,230,99,8,87,186
"Bolivia","La Paz","Murillo","El Alto de La Paz","U.E. SAN ANDRES",-68.15803,-16.53902,165,13,1751,1916,724,56,958,1682
"Bolivia","La Paz","Murillo","El Alto de La Paz","U.E. TOKIO",-68.17825,-16.47219,254,22,2749,3003,901,195,1631,2532
"Bolivia","La Paz","Murillo","El Alto de La Paz","U. E. VILLA ADELA YUNGUYO",-68.21577,-16.52021,380,45,3453,3833,1447,167,1794,3241
"Bolivia","La Paz","Murillo","El Alto de La Paz","U. E. VILLA ADELA YUNGUYO",-68.21643,-16.51679,380,45,3453,3833,1447,167,1794,3241
"Bolivia","La Paz","Murillo","El Alto de La Paz","UNIDAD EDUCATIVA 12 DE OCTUBRE",-68.1631,-16.51261,455,32,4604,5059,2562,138,1872,4434
"Bolivia","La Paz","Murillo","El Alto de La Paz","UNIDAD EDUCATIVA 25 DE JULIO",-68.21799,-16.50818,450,53,4141,4591,1412,204,2472,3884
"Bolivia","La Paz","Murillo","El Alto de La Paz","UNIDAD EDUCATIVA 3 DE MAYO",-68.21262,-16.54766,509,72,5791,6300,1877,199,3643,5520
"Bolivia","La Paz","Murillo","El Alto de La Paz","UNIDAD EDUCATIVA 6 DE JUNIO",-68.22369,-16.53518,476,42,4617,5093,1571,163,2841,4412
"Bolivia","La Paz","Murillo","El Alto de La Paz","UNIDAD EDUCATIVA ADELA ZAMUDIO",-68.19314,-16.52711,174,19,2157,2331,883,87,1168,2051
"Bolivia","La Paz","Murillo","El Alto de La Paz","UNIDAD EDUCATIVA  ALTO DE LA ALIANZA",-68.18938,-16.52214,340,31,3555,3895,1476,146,1902,3378
"Bolivia","La Paz","Murillo","El Alto de La Paz","UNIDAD EDUCATIVA ANDRES BELLO",-68.16715,-16.51139,109,16,1031,1140,577,26,412,989
"Bolivia","La Paz","Murillo","El Alto de La Paz","UNIDAD EDUCATIVA ANDRES BELLO (U. E. 16 DE JULIO)",-68.16715,-16.51139,72,3,577,649,357,16,201,558
"Bolivia","La Paz","Murillo","El Alto de La Paz","UNIDAD EDUCATIVA ANICETO ARCE",-68.18877,-16.55329,177,30,1945,2122,776,62,1077,1853
"Bolivia","La Paz","Murillo","El Alto de La Paz","UNIDAD EDUCATIVA BAUTISTA SAAVEDRA",-68.23381,-16.48594,839,109,8195,9034,3042,352,4692,7734
"Bolivia","La Paz","Murillo","El Alto de La Paz","UNIDAD EDUCATIVA BRASILIA",-68.15981,-16.51867,424,31,4386,4810,2189,148,2018,4207
"Bolivia","La Paz","Murillo","El Alto de La Paz","UNIDAD EDUCATIVA CARLOS PALENQUE",-68.18768,-16.52626,334,21,3284,3618,1331,154,1778,3109
"Bolivia","La Paz","Murillo","El Alto de La Paz","UNIDAD EDUCATIVA DONOZO TORRES",-68.15047,-16.52236,360,20,3654,4014,2192,105,1337,3529
"Bolivia","La Paz","Murillo","El Alto de La Paz","UNIDAD EDUCATIVA ECOLOGICO LOS PINOS",-68.17538,-16.5999,506,47,4661,5167,1207,202,3205,4412
"Bolivia","La Paz","Murillo","El Alto de La Paz","UNIDAD EDUCATIVA EDUARDO AVAROA I",-68.29729,-16.49421,45,17,638,683,201,27,393,594
"Bolivia","La Paz","Murillo","El Alto de La Paz","UNIDAD EDUCATIVA EVA PERON",-68.15955,-16.50945,437,35,4267,4704,2171,150,1911,4082
"Bolivia","La Paz","Murillo","El Alto de La Paz","UNIDAD EDUCATIVA FRANZ TAMAYO",-68.25333,-16.50809,484,54,5632,6116,1700,232,3646,5346
"Bolivia","La Paz","Murillo","El Alto de La Paz","UNIDAD EDUCATIVA GRAN PODER",-68.19362,-16.55863,261,18,2224,2485,850,91,1265,2115
"Bolivia","La Paz","Murillo","El Alto de La Paz","UNIDAD EDUCATIVA ILLIMANI",-68.18507,-16.46561,441,56,4632,5073,1563,258,2755,4318
"Bolivia","La Paz","Murillo","El Alto de La Paz","UNIDAD EDUCATIVA INGAVI",-68.1793,-16.46868,421,55,4620,5041,1480,261,2824,4304
"Bolivia","La Paz","Murillo","El Alto de La Paz","UNIDAD EDUCATIVA INTEGRACION",-68.16405,-16.50175,310,25,2597,2907,1405,84,1083,2488
"Bolivia","La Paz","Murillo","El Alto de La Paz","UNIDAD EDUCATIVA JUAN CAPRILES",-68.15948,-16.5062,357,36,3402,3759,1632,96,1638,3270
"Bolivia","La Paz","Murillo","El Alto de La Paz","UNIDAD EDUCATIVA JUAN JOSE TORRES",-68.2122,-16.53901,522,59,5218,5740,1935,197,3027,4962
"Bolivia","La Paz","Murillo","El Alto de La Paz","UNIDAD EDUCATIVA LA PAZ",-68.20005,-16.52881,340,34,2798,3138,1226,106,1432,2658
"Bolivia","La Paz","Murillo","El Alto de La Paz","UNIDAD EDUCATIVA MARISCAL ANTONIO JOSE E",-68.22196,-16.47654,638,73,6087,6725,1994,312,3708,5702
"Bolivia","La Paz","Murillo","El Alto de La Paz","UNIDAD EDUCATIVA MERCEDES ELIO DE RIVERO",-68.23167,-16.55686,300,46,3477,3777,973,116,2342,3315
"Bolivia","La Paz","Murillo","El Alto de La Paz","UNIDAD EDUCATIVA NORUEGA",-68.19359,-16.4826,559,75,5561,6120,2065,300,3121,5186
"Bolivia","La Paz","Murillo","El Alto de La Paz","UNIDAD EDUCATIVA PABLO ZARATE VILLCA",-68.19443,-16.47187,23,4,403,426,126,22,251,377
"Bolivia","La Paz","Murillo","El Alto de La Paz","UNIDAD EDUCATIVA PROGRESO",-68.25311,-16.47828,449,97,5662,6111,1942,284,3339,5281
"Bolivia","La Paz","Murillo","El Alto de La Paz","UNIDAD EDUCATIVA REP. DEL URUGUAY",-68.27645,-16.51882,40,8,550,590,228,17,297,525
"Bolivia","La Paz","Murillo","El Alto de La Paz","UNIDAD EDUCATIVA REPUBLICA DE CUBA",-68.18736,-16.52857,425,64,5159,5584,1716,234,3145,4861
"Bolivia","La Paz","Murillo","El Alto de La Paz","UNIDAD EDUCATIVA REPUBLICA DE CUBA",-68.20181,-16.47474,425,64,5159,5584,1716,234,3145,4861
"Bolivia","La Paz","Murillo","El Alto de La Paz","UNIDAD EDUCATIVA REPUBLICA DE FRANCIA",-68.19515,-16.5501,686,64,6429,7115,2256,285,3824,6080
"Bolivia","La Paz","Murillo","El Alto de La Paz","UNIDAD EDUCATIVA SAN JUAN DE CALAMA",-68.19692,-16.52204,346,42,3643,3989,1473,121,2007,3480
"Bolivia","La Paz","Murillo","El Alto de La Paz","UNIDAD EDUCATIVA SAN LUIS",-68.20049,-16.54089,468,45,4851,5319,1876,169,2761,4637
"Bolivia","La Paz","Murillo","El Alto de La Paz","UNIDAD EDUCATIVA SAN ROQUE",-68.27818,-16.47489,1063,189,11300,12363,3640,629,6842,10482
"Bolivia","La Paz","Murillo","El Alto de La Paz","UNIDAD EDUCATIVA SANTA ROSA DE LIMA",-68.1677,-16.45551,179,21,1769,1948,504,121,1123,1627
"Bolivia","La Paz","Murillo","El Alto de La Paz","UNIDAD EDUCATIVA SANTIAGO I",-68.16467,-16.52485,481,31,4108,4589,1971,154,1952,3923
"Bolivia","La Paz","Murillo","El Alto de La Paz","UNIDAD EDUCATIVA TECNICA YUNGUYO",-68.22483,-16.49496,393,59,4853,5246,1809,184,2801,4610
"Bolivia","La Paz","Murillo","El Alto de La Paz","UNIDAD EDUCATIVA THE STRONGEST",-68.19981,-16.47943,191,23,2072,2263,743,113,1193,1936
"Bolivia","La Paz","Murillo","El Alto de La Paz","UNIDAD EDUCATIVA TUPAC AMARU",-68.20243,-16.57245,208,15,2137,2345,642,88,1392,2034
"Bolivia","La Paz","Murillo","El Alto de La Paz","UNIDAD EDUCATIVA UNION EUROPEA",-68.17921,-16.53997,1265,109,12979,14244,6059,474,6337,12396
"Bolivia","La Paz","Murillo","El Alto de La Paz","UNIDAD EDUCATIVA VILLA ALEMANIA",-68.20655,-16.51637,345,28,3017,3362,1348,116,1525,2873
"Bolivia","La Paz","Murillo","El Alto de La Paz","UNIDAD EDUCATIVA VILLA COOPERATIVA",-68.22495,-16.47322,415,83,4399,4814,1389,197,2730,4119
"Bolivia","La Paz","Murillo","El Alto de La Paz","UNID. EDUC.  M. QUIROGA SANTA CRUZ",-68.17841,-16.5187,242,32,2762,3004,1151,116,1463,2614
"Bolivia","La Paz","Murillo","Mecapaca","COLEGIO 6 DE JUNIO",-67.93151,-16.8046,5,0,270,275,38,1,231,269
"Bolivia","La Paz","Murillo","Mecapaca","COL. SAN SIMON DE AYACUCHO",-67.98664,-16.8034,67,9,353,420,77,13,254,331
"Bolivia","La Paz","Murillo","Mecapaca","ESCUELA EL PALOMAR",-68.00471,-16.7009,76,18,1072,1148,237,33,784,1021
"Bolivia","La Paz","Murillo","Mecapaca","ESCUELA HUARICANA ALTO",-67.93894,-16.73059,45,9,794,839,130,14,641,771
"Bolivia","La Paz","Murillo","Mecapaca","ESCUELA JANKOSUNI",-67.87069,-16.79541,8,0,252,260,29,1,222,251
"Bolivia","La Paz","Murillo","Mecapaca","ESCUELA SANTIAGO DE COLLANA",-67.96983,-16.66847,40,5,599,639,97,12,485,582
"Bolivia","La Paz","Murillo","Mecapaca","ESCUELA SIMONA MANZANEDA",-68.01966,-16.66984,204,17,1878,2082,571,49,1241,1812
"Bolivia","La Paz","Murillo","Mecapaca","PLAZA PRINCIPAL HUAJCHILLA",-68.05293,-16.62848,128,7,1429,1557,477,40,905,1382
"Bolivia","La Paz","Murillo","Mecapaca","UNIDAD EDUCATIVA LLUTO",-68.02113,-16.59331,20,11,267,287,35,21,200,235
"Bolivia","La Paz","Murillo","Mecapaca","UNIDAD EDUCATIVA MILLOCATO",-67.9091,-16.73255,19,2,315,334,37,5,271,308
"Bolivia","La Paz","Murillo","Mecapaca","UNID. EDUC. CONDOR DE LOS ANDES",-68.06098,-16.73627,14,4,336,350,38,9,285,323
"Bolivia","La Paz","Murillo","Nuestra Señora de La Paz","CANCHA DEPORTIVA",-68.108,-16.50108,488,31,4394,4882,2337,98,1928,4265
"Bolivia","La Paz","Murillo","Nuestra Señora de La Paz","CANCHA DEPORTIVA",-68.09735,-16.52828,488,31,4394,4882,2337,98,1928,4265
"Bolivia","La Paz","Murillo","Nuestra Señora de La Paz","(CÁRCEL) COF MIRAFLORES",-68.11906,-16.50092,19,1,37,56,24,0,12,36
"Bolivia","La Paz","Murillo","Nuestra Señora de La Paz","(CÁRCEL) COF OBRAJES",-68.10977,-16.52685,49,0,91,140,55,3,33,88
"Bolivia","La Paz","Murillo","Nuestra Señora de La Paz","(CÁRCEL) PANOPTICO",-68.13491,-16.50283,288,4,491,779,238,16,233,471
"Bolivia","La Paz","Murillo","Nuestra Señora de La Paz","C. E. ADVENTISTA BELLO HORIZONTE",-68.14233,-16.50962,49,3,276,325,170,4,99,269
"Bolivia","La Paz","Murillo","Nuestra Señora de La Paz","CENTRO DE CAPACITACION INTI PAXSI",-68.09966,-16.56521,147,20,1528,1675,906,25,577,1483
"Bolivia","La Paz","Murillo","Nuestra Señora de La Paz","COL. AMERICAN SCHOOL",-68.13224,-16.49319,174,5,1645,1819,1132,28,480,1612
"Bolivia","La Paz","Murillo","Nuestra Señora de La Paz","COL. AMOR DE DIOS",-68.11962,-16.51487,492,14,3097,3589,2449,48,586,3035
"Bolivia","La Paz","Murillo","Nuestra Señora de La Paz","COL. CANADA",-68.14336,-16.50653,338,23,3090,3428,1674,84,1309,2983
"Bolivia","La Paz","Murillo","Nuestra Señora de La Paz","COL. CARACAS",-68.10925,-16.49185,164,19,2109,2273,854,71,1165,2019
"Bolivia","La Paz","Murillo","Nuestra Señora de La Paz","COL. CERVANTES",-68.12268,-16.49229,241,5,2333,2574,1925,28,375,2300
"Bolivia","La Paz","Murillo","Nuestra Señora de La Paz","COL. COPACABANA",-68.116,-16.49115,615,41,6023,6638,3634,164,2184,5818
"Bolivia","La Paz","Murillo","Nuestra Señora de La Paz","COL. CRISTO REY",-68.11716,-16.49006,472,38,5029,5501,2771,162,2058,4829
"Bolivia","La Paz","Murillo","Nuestra Señora de La Paz","COL DANIEL SANCHEZ BUSTAMANTE",-68.14701,-16.50356,951,63,7627,8578,3660,200,3704,7364
"Bolivia","La Paz","Murillo","Nuestra Señora de La Paz","COL DANIEL SANCHEZ BUSTAMANTE",-68.14701,-16.50356,951,63,7627,8578,3660,200,3704,7364
"Bolivia","La Paz","Murillo","Nuestra Señora de La Paz","COLEGIO 6 DE JUNIO",-68.10533,-16.52268,749,37,7987,8736,5501,162,2287,7788
"Bolivia","La Paz","Murillo","Nuestra Señora de La Paz","COLEGIO  ADOLFO  COSTA DU RELS",-68.12815,-16.47907,937,107,9552,10489,3476,413,5556,9032
"Bolivia","La Paz","Murillo","Nuestra Señora de La Paz","COLEGIO AMORETTI",-68.12887,-16.51681,359,35,2687,3046,1965,62,625,2590
"Bolivia","La Paz","Murillo","Nuestra Señora de La Paz","COLEGIO ANTONIO DIAZ VILLAMIL",-68.13431,-16.49114,416,9,3298,3714,2229,59,1001,3230
"Bolivia","La Paz","Murillo","Nuestra Señora de La Paz","COLEGIO AVE MARIA",-68.11795,-16.47431,999,85,8459,9458,5018,223,3133,8151
"Bolivia","La Paz","Murillo","Nuestra Señora de La Paz","COLEGIO AVE MARIA",-68.11795,-16.47431,999,85,8459,9458,5018,223,3133,8151
"Bolivia","La Paz","Murillo","Nuestra Señora de La Paz","COLEGIO BOLIVAR",-68.13287,-16.50506,219,4,1926,2145,1410,37,475,1885
"Bolivia","La Paz","Murillo","Nuestra Señora de La Paz","COLEGIO CANADIENSE",-68.1338,-16.50349,138,5,1267,1405,932,10,320,1252
"Bolivia","La Paz","Murillo","Nuestra Señora de La Paz","COLEGIO DELIA GAMBARTE",-68.10197,-16.50602,214,14,1670,1884,661,96,899,1560
"Bolivia","La Paz","Murillo","Nuestra Señora de La Paz","COLEGIO DON BOSCO",-68.10194,-16.50008,480,37,4722,5202,2385,178,2122,4507
"Bolivia","La Paz","Murillo","Nuestra Señora de La Paz","COLEGIO FRANCIA",-68.1449,-16.48456,167,10,1655,1822,966,63,616,1582
"Bolivia","La Paz","Murillo","Nuestra Señora de La Paz","COLEGIO FRANCO BOLIVIANO",-68.07697,-16.53309,1454,27,9591,11045,7542,152,1870,9412
"Bolivia","La Paz","Murillo","Nuestra Señora de La Paz","COLEGIO GERMAN BUSCH",-68.14012,-16.4923,301,12,2679,2980,1835,71,761,2596
"Bolivia","La Paz","Murillo","Nuestra Señora de La Paz","COLEGIO HOLANDA",-68.15083,-16.49805,1282,103,11070,12352,5057,312,5598,10655
"Bolivia","La Paz","Murillo","Nuestra Señora de La Paz","COLEGIO HOLANDA",-68.15083,-16.49805,1282,103,11070,12352,5057,312,5598,10655
"Bolivia","La Paz","Murillo","Nuestra Señora de La Paz","COLEGIO IGNACIO CALDERON",-68.14203,-16.51064,448,30,4516,4964,2644,88,1754,4398
"Bolivia","La Paz","Murillo","Nuestra Señora de La Paz","COLEGIO IRENE NAVA",-68.11196,-16.46699,777,50,6498,7275,3348,174,2926,6274
"Bolivia","La Paz","Murillo","Nuestra Señora de La Paz","COLEGIO ITALIA",-68.16149,-16.49363,477,40,4954,5431,2332,142,2440,4772
"Bolivia","La Paz","Murillo","Nuestra Señora de La Paz","COLEGIO ITALIA",-68.16149,-16.49363,477,40,4954,5431,2332,142,2440,4772
"Bolivia","La Paz","Murillo","Nuestra Señora de La Paz","COLEGIO JERUSALEM",-68.10326,-16.50195,347,31,3295,3642,1462,119,1683,3145
"Bolivia","La Paz","Murillo","Nuestra Señora de La Paz","COLEGIO LUIS ALBERTO PABON",-68.13418,-16.49122,164,5,1608,1772,1018,58,527,1545
"Bolivia","La Paz","Murillo","Nuestra Señora de La Paz","COLEGIO MAX TOLEDO",-68.15351,-16.49414,694,62,6847,7541,3709,171,2905,6614
"Bolivia","La Paz","Murillo","Nuestra Señora de La Paz","COLEGIO MAX TOLEDO",-68.15351,-16.49414,694,62,6847,7541,3709,171,2905,6614
"Bolivia","La Paz","Murillo","Nuestra Señora de La Paz","COLEGIO NUESTRA SEÑORA DE FATIMA",-68.12103,-16.47554,260,12,2429,2689,1246,104,1067,2313
"Bolivia","La Paz","Murillo","Nuestra Señora de La Paz","COLEGIO RENE BARRIENTOS",-68.07787,-16.53858,404,10,2490,2894,2055,34,391,2446
"Bolivia","La Paz","Murillo","Nuestra Señora de La Paz","COLEGIO SAINT PETERS",-68.13634,-16.50428,171,36,1737,1908,1289,23,389,1678
"Bolivia","La Paz","Murillo","Nuestra Señora de La Paz","COLEGIO SAN IGNACIO",-68.09715,-16.53659,826,10,2927,3753,2340,40,537,2877
"Bolivia","La Paz","Murillo","Nuestra Señora de La Paz","COLEGIO SAN LUIS",-68.13464,-16.51359,570,27,6069,6639,3939,105,1998,5937
"Bolivia","La Paz","Murillo","Nuestra Señora de La Paz","COLEGIO SERGIO VILLEGAS",-68.09919,-16.51187,512,46,4716,5228,2035,165,2470,4505
"Bolivia","La Paz","Murillo","Nuestra Señora de La Paz","COLEGIO SIMON RODRIGUEZ",-68.12112,-16.47591,493,28,3834,4327,2054,80,1672,3726
"Bolivia","La Paz","Murillo","Nuestra Señora de La Paz","COLEGIO TOPATER",-68.10408,-16.49198,320,28,3267,3587,1508,93,1638,3146
"Bolivia","La Paz","Murillo","Nuestra Señora de La Paz","COLEGIO VILLARROEL",-68.14117,-16.49612,378,19,3172,3550,1967,79,1107,3074
"Bolivia","La Paz","Murillo","Nuestra Señora de La Paz","COLEGIO VILLARROEL",-68.14117,-16.4961,378,19,3172,3550,1967,79,1107,3074
"Bolivia","La Paz","Murillo","Nuestra Señora de La Paz","COL. EXPERIMENTAL HUGO DAVILA",-68.11927,-16.49929,531,19,4620,5151,3472,84,1045,4517
"Bolivia","La Paz","Murillo","Nuestra Señora de La Paz","COL. FELIPE 2DO. GUZMAN",-68.12112,-16.50593,420,4,2238,2658,1689,44,501,2190
"Bolivia","La Paz","Murillo","Nuestra Señora de La Paz","COL. FRANZ TAMAYO",-68.15231,-16.49047,621,43,6283,6904,3522,133,2585,6107
"Bolivia","La Paz","Murillo","Nuestra Señora de La Paz","COL. GREGORIO REYNOLDS",-68.13242,-16.51624,403,12,3564,3967,2513,106,933,3446
"Bolivia","La Paz","Murillo","Nuestra Señora de La Paz","COL. GUILLEN PINTO",-68.15572,-16.487,440,59,4970,5410,2167,111,2633,4800
"Bolivia","La Paz","Murillo","Nuestra Señora de La Paz","COL. HERSCHELL",-68.10605,-16.52725,639,23,4356,4995,3064,89,1180,4244
"Bolivia","La Paz","Murillo","Nuestra Señora de La Paz","COL. LORETTO",-68.07858,-16.5454,368,7,2531,2899,2168,35,321,2489
"Bolivia","La Paz","Murillo","Nuestra Señora de La Paz","COL. LUIS ESPINAL CAMPS",-68.14557,-16.52328,759,79,7471,8230,2797,297,4298,7095
"Bolivia","La Paz","Murillo","Nuestra Señora de La Paz","COL. LUIS VELASCO FLORES",-68.15797,-16.46071,80,21,1440,1520,428,37,954,1382
"Bolivia","La Paz","Murillo","Nuestra Señora de La Paz","COL. MARIA AUXILIADORA",-68.13763,-16.50292,224,14,2250,2474,1613,56,567,2180
"Bolivia","La Paz","Murillo","Nuestra Señora de La Paz","COL. MARIEN GARTEN",-68.16064,-16.49042,436,33,4756,5192,2232,115,2376,4608
"Bolivia","La Paz","Murillo","Nuestra Señora de La Paz","COL. NACIONAL AYACUCHO",-68.13404,-16.49409,257,5,1650,1907,1077,41,527,1604
"Bolivia","La Paz","Murillo","Nuestra Señora de La Paz","COL. SAN FRANCISCO",-68.13798,-16.49661,221,12,1804,2025,1268,48,476,1744
"Bolivia","La Paz","Murillo","Nuestra Señora de La Paz","COL. SAN JAVIER",-68.15145,-16.48675,205,9,2253,2458,1500,62,682,2182
"Bolivia","La Paz","Murillo","Nuestra Señora de La Paz","COL. SAN MARTIN",-68.14119,-16.49969,265,16,2143,2408,1349,50,728,2077
"Bolivia","La Paz","Murillo","Nuestra Señora de La Paz","COL. SANTA ANA",-68.13152,-16.49671,156,6,1384,1540,1065,15,298,1363
"Bolivia","La Paz","Murillo","Nuestra Señora de La Paz","COL SERGIO ALMARAZ",-68.11177,-16.49919,439,19,4025,4464,2262,126,1618,3880
"Bolivia","La Paz","Murillo","Nuestra Señora de La Paz","COMPLEJO DEPORTIVO CAMIRI",-68.11738,-16.47857,228,7,2261,2489,1551,40,663,2214
"Bolivia","La Paz","Murillo","Nuestra Señora de La Paz","COMPLEJO DEPORTIVO SAN LUIS",-68.13494,-16.5137,93,3,1118,1211,817,26,272,1089
"Bolivia","La Paz","Murillo","Nuestra Señora de La Paz","COOP. EDUCACIONAL SAN MARCOS LTDA",-68.13071,-16.49973,110,2,910,1020,639,19,250,889
"Bolivia","La Paz","Murillo","Nuestra Señora de La Paz","DIR DISTRITAL DE EDUCACION",-68.12583,-16.49939,296,13,2235,2531,1636,30,556,2192
"Bolivia","La Paz","Murillo","Nuestra Señora de La Paz","E.N.S.A.F.",-68.11926,-16.50412,249,6,2128,2377,1691,26,405,2096
"Bolivia","La Paz","Murillo","Nuestra Señora de La Paz","ESC. ABRAHAM LINCOLN",-68.14679,-16.47846,294,31,3303,3597,1529,109,1634,3163
"Bolivia","La Paz","Murillo","Nuestra Señora de La Paz","ESC. ALCIDES ARGUEDAS",-68.141,-16.50126,135,4,1163,1298,738,23,398,1136
"Bolivia","La Paz","Murillo","Nuestra Señora de La Paz","ESC. ALFREDO VARGAS",-68.12498,-16.48322,504,22,4654,5158,2764,167,1701,4465
"Bolivia","La Paz","Murillo","Nuestra Señora de La Paz","ESC. ALONZO DE MENDOZA",-68.12307,-16.50274,109,1,849,958,645,17,186,831
"Bolivia","La Paz","Murillo","Nuestra Señora de La Paz","ESC. ALONZO DE MENDOZA (U.E. BICHITO DE LUZ)",-68.12307,-16.50274,423,6,3195,3618,2488,82,619,3107
"Bolivia","La Paz","Murillo","Nuestra Señora de La Paz","ESC. ALTO TEMBLADERANI",-68.14673,-16.51458,152,13,1316,1468,444,41,818,1262
"Bolivia","La Paz","Murillo","Nuestra Señora de La Paz","ESC. CHUCURA",-68.10157,-16.27567,2,4,62,64,12,7,39,51
"Bolivia","La Paz","Murillo","Nuestra Señora de La Paz","ESC. CLUB DE LEONES",-68.15932,-16.49451,805,66,8556,9361,4139,267,4084,8223
"Bolivia","La Paz","Murillo","Nuestra Señora de La Paz","ESC. CLUB DE LEONES",-68.15932,-16.49451,805,66,8556,9361,4139,267,4084,8223
"Bolivia","La Paz","Murillo","Nuestra Señora de La Paz","ESC ECUADOR",-68.12662,-16.50871,403,12,2193,2596,1785,23,373,2158
"Bolivia","La Paz","Murillo","Nuestra Señora de La Paz","ESC. EDUARDO AVAROA",-68.14451,-16.49651,583,31,5181,5764,3038,133,1979,5017
"Bolivia","La Paz","Murillo","Nuestra Señora de La Paz","ESC. EDUCACIONAL LUIS  ERNEST",-68.15179,-16.46655,154,9,1860,2014,1069,52,730,1799
"Bolivia","La Paz","Murillo","Nuestra Señora de La Paz","ESC. FRANCISCO DE MIRANDA",-68.09369,-16.53112,429,42,4542,4971,1991,133,2376,4367
"Bolivia","La Paz","Murillo","Nuestra Señora de La Paz","ESC. GENOVEVA RIOS",-68.10799,-16.50161,561,34,5280,5841,2583,163,2500,5083
"Bolivia","La Paz","Murillo","Nuestra Señora de La Paz","ESC. GIL TAPIA RADA",-68.15082,-16.45705,358,52,4327,4685,2055,118,2102,4157
"Bolivia","La Paz","Murillo","Nuestra Señora de La Paz","ESC. GRAL. JOSE MANUEL PANDO",-68.14954,-16.50061,155,13,1820,1975,940,41,826,1766
"Bolivia","La Paz","Murillo","Nuestra Señora de La Paz","ESC IND PEDRO DOMINGO MURILLO",-68.15194,-16.47472,542,44,4544,5086,2448,135,1917,4365
"Bolivia","La Paz","Murillo","Nuestra Señora de La Paz","ESC. JOSE SANTOS",-68.14185,-16.53238,349,40,3453,3802,1248,124,2041,3289
"Bolivia","La Paz","Murillo","Nuestra Señora de La Paz","ESC. LADISLAO CABRERA",-68.14954,-16.50061,568,44,5104,5672,2501,170,2389,4890
"Bolivia","La Paz","Murillo","Nuestra Señora de La Paz","ESC LA MERCED",-68.11915,-16.46617,692,74,6376,7068,2523,180,3599,6122
"Bolivia","La Paz","Murillo","Nuestra Señora de La Paz","ESC. LIMANIPATA 10 DE JUNIO",-68.14423,-16.4425,113,14,1442,1555,421,35,972,1393
"Bolivia","La Paz","Murillo","Nuestra Señora de La Paz","ESC. MCAL SANTA CRUZ",-68.13808,-16.49557,78,3,660,738,412,12,233,645
"Bolivia","La Paz","Murillo","Nuestra Señora de La Paz","ESC. MSCAL ANDRES DE SANTA CRUZ",-67.67603,-15.76266,25,3,205,230,41,2,159,200
"Bolivia","La Paz","Murillo","Nuestra Señora de La Paz","ESC MSCAL ANTONIO JOSE DE SUCRE",-68.07882,-16.48678,57,21,722,779,183,12,506,689
"Bolivia","La Paz","Murillo","Nuestra Señora de La Paz","ESC NATALIA PALACIOS",-68.13138,-16.49431,311,20,2708,3019,1921,49,718,2639
"Bolivia","La Paz","Murillo","Nuestra Señora de La Paz","ESC. NICOLAS  FERNANDEZ NARANJO",-68.1405,-16.48321,803,90,8289,9092,3687,219,4293,7980
"Bolivia","La Paz","Murillo","Nuestra Señora de La Paz","ESC PABLO ITURRI",-68.10268,-16.45948,620,60,5124,5744,1729,178,3157,4886
"Bolivia","La Paz","Murillo","Nuestra Señora de La Paz","ESC PANAMA",-68.12434,-16.49475,450,7,3456,3906,2736,68,645,3381
"Bolivia","La Paz","Murillo","Nuestra Señora de La Paz","ESC. REMBERTO TAPIA",-68.14641,-16.50409,399,42,4556,4955,2112,146,2256,4368
"Bolivia","La Paz","Murillo","Nuestra Señora de La Paz","ESC. REPUBLICA DEL PERU",-68.12861,-16.50675,102,1,588,690,452,9,126,578
"Bolivia","La Paz","Murillo","Nuestra Señora de La Paz","ESC. RURAL CANAVIRI",-68.13701,-16.17418,26,8,187,213,54,2,123,177
"Bolivia","La Paz","Murillo","Nuestra Señora de La Paz","ESC. SAGRADO CORAZON DE JESUS",-68.14336,-16.50653,683,56,7063,7746,2748,200,4059,6807
"Bolivia","La Paz","Murillo","Nuestra Señora de La Paz","ESC. SAN JOSE",-68.12814,-16.52707,348,21,3872,4220,2099,95,1657,3756
"Bolivia","La Paz","Murillo","Nuestra Señora de La Paz","ESC. SAN MARTIN",-68.11597,-16.49783,666,42,6132,6798,3862,233,1995,5857
"Bolivia","La Paz","Murillo","Nuestra Señora de La Paz","ESC. SAN MIGUEL",-68.14462,-16.54603,51,6,488,539,115,13,354,469
"Bolivia","La Paz","Murillo","Nuestra Señora de La Paz","ESC SANTA ROSA DE LIMA",-68.03819,-16.53689,448,63,5381,5829,1329,192,3797,5126
"Bolivia","La Paz","Murillo","Nuestra Señora de La Paz","ESC. SERGIO SUAREZ",-68.13206,-16.48701,670,57,6254,6924,2747,164,3286,6033
"Bolivia","La Paz","Murillo","Nuestra Señora de La Paz","ESCUELA 13 DE JUNIO CHINCHAYA",-68.08366,-16.48442,56,18,653,709,132,19,484,616
"Bolivia","La Paz","Murillo","Nuestra Señora de La Paz","ESCUELA 6 DE AGOSTO",-68.11748,-16.49531,236,18,2365,2601,1569,49,729,2298
"Bolivia","La Paz","Murillo","Nuestra Señora de La Paz","ESCUELA AGUSTIN ASPIAZU",-68.12946,-16.50753,447,11,3167,3614,2455,62,639,3094
"Bolivia","La Paz","Murillo","Nuestra Señora de La Paz","ESCUELA ALTO ACHUMANI",-68.05845,-16.51433,618,46,6259,6877,3573,129,2511,6084
"Bolivia","La Paz","Murillo","Nuestra Señora de La Paz","ESCUELA CALLAPA (PLAZA DE CALLAPA)",-68.09043,-16.49957,140,13,1291,1431,327,55,896,1223
"Bolivia","La Paz","Murillo","Nuestra Señora de La Paz","ESCUELA CHASQUIPAMPA",-68.04555,-16.54921,1021,79,10620,11641,4104,312,6125,10229
"Bolivia","La Paz","Murillo","Nuestra Señora de La Paz","ESCUELA CIUDAD DEL NIÑO",-68.09786,-16.49375,223,18,2315,2538,1129,111,1057,2186
"Bolivia","La Paz","Murillo","Nuestra Señora de La Paz","ESCUELA ELOY ALVAREZ PLATA",-68.14813,-16.48382,157,2,1559,1716,1077,35,445,1522
"Bolivia","La Paz","Murillo","Nuestra Señora de La Paz","ESCUELA JOHN F. KENNEDY",-68.1515,-16.47704,139,5,1301,1440,764,29,503,1267
"Bolivia","La Paz","Murillo","Nuestra Señora de La Paz","ESCUELA JUAN PABLO II",-68.1031,-16.53394,318,14,2822,3140,2154,39,615,2769
"Bolivia","La Paz","Murillo","Nuestra Señora de La Paz","ESCUELA PEDRO POVEDA",-68.11266,-16.5103,408,22,3418,3826,1789,96,1511,3300
"Bolivia","La Paz","Murillo","Nuestra Señora de La Paz","ESCUELA PEDRO POVEDA",-68.11266,-16.5103,408,22,3418,3826,1789,96,1511,3300
"Bolivia","La Paz","Murillo","Nuestra Señora de La Paz","ESCUELA PILOTO NACIONES UNIDAS",-68.1187,-16.49925,132,7,1191,1323,877,20,287,1164
"Bolivia","La Paz","Murillo","Nuestra Señora de La Paz","ESCUELA REPUBLICA DE JAPON",-68.14366,-16.51144,634,47,5956,6590,2582,191,3136,5718
"Bolivia","La Paz","Murillo","Nuestra Señora de La Paz","ESCUELA REPUBLICA DE JAPON",-68.14366,-16.51144,634,47,5956,6590,2582,191,3136,5718
"Bolivia","La Paz","Murillo","Nuestra Señora de La Paz","ESCUELA REPUBLICA DEL BRASIL",-68.14114,-16.49013,263,13,2453,2716,1571,57,812,2383
"Bolivia","La Paz","Murillo","Nuestra Señora de La Paz","ESCUELA ROSEMARI DE BARRIENTOS",-68.08743,-16.52519,1191,18,7850,9041,6275,101,1456,7731
"Bolivia","La Paz","Murillo","Nuestra Señora de La Paz","ESCUELA SANTA ROSA LA FLORIDA",-68.09236,-16.54617,605,19,3640,4245,2534,57,1030,3564
"Bolivia","La Paz","Murillo","Nuestra Señora de La Paz","ESCUELA SUPERIOR DE FORMACIÓN DE MAESTROS SIMON BOLIVAR",-68.11337,-16.51854,255,16,2820,3075,1843,70,891,2734
"Bolivia","La Paz","Murillo","Nuestra Señora de La Paz","ESCUELA VICTOR PAZ ESTENSORO",-68.08412,-16.51657,324,24,2934,3258,1563,77,1270,2833
"Bolivia","La Paz","Murillo","Nuestra Señora de La Paz","ESC. WALTER STRAUB",-68.06351,-16.54204,534,13,4299,4833,2707,135,1444,4151
"Bolivia","La Paz","Murillo","Nuestra Señora de La Paz","FACULTAD DE TECNOLOGIA (U.M.S.A)",-68.12685,-16.50758,216,3,1075,1291,883,17,172,1055
"Bolivia","La Paz","Murillo","Nuestra Señora de La Paz","INSTITUTO AMERICANO",-68.13234,-16.50628,518,32,4253,4771,3290,107,824,4114
"Bolivia","La Paz","Murillo","Nuestra Señora de La Paz","INSTITUTO AMERICANO",-68.13234,-16.50628,518,32,4253,4771,3290,107,824,4114
"Bolivia","La Paz","Murillo","Nuestra Señora de La Paz","INSTITUTO AMERICANO OBRAJES",-68.10566,-16.52666,469,17,4081,4550,3137,79,848,3985
"Bolivia","La Paz","Murillo","Nuestra Señora de La Paz","INSTITUTO DOMINGO SAVIO",-68.08488,-16.53951,377,11,1687,2064,1337,26,313,1650
"Bolivia","La Paz","Murillo","Nuestra Señora de La Paz","INSTITUTO MENDEZ ARCOS",-68.13995,-16.5042,356,10,3726,4082,2767,62,887,3654
"Bolivia","La Paz","Murillo","Nuestra Señora de La Paz","KINDER. BOLIVIA",-68.14942,-16.45182,203,20,2238,2441,942,57,1219,2161
"Bolivia","La Paz","Murillo","Nuestra Señora de La Paz","KINDER FLORA PEREZ DE SAAVEDRA",-68.14472,-16.48339,137,18,1613,1750,895,50,650,1545
"Bolivia","La Paz","Murillo","Nuestra Señora de La Paz","KINDER NAZARIO PARDO",-68.12493,-16.51608,213,8,1861,2074,1047,61,745,1792
"Bolivia","La Paz","Murillo","Nuestra Señora de La Paz","LICEO BOLIVIA",-68.13096,-16.51116,181,6,1296,1477,1035,31,224,1259
"Bolivia","La Paz","Murillo","Nuestra Señora de La Paz","LICEO LA PAZ",-68.13188,-16.50126,184,2,1210,1394,881,24,303,1184
"Bolivia","La Paz","Murillo","Nuestra Señora de La Paz","LICEO TEC.H. NUESTRA SRA DE LA PAZ",-68.13543,-16.49124,220,4,1729,1949,1161,41,523,1684
"Bolivia","La Paz","Murillo","Nuestra Señora de La Paz","PARQUE MIRADOR KILLI KILLI",-68.12752,-16.49444,269,19,2437,2706,1555,89,774,2329
"Bolivia","La Paz","Murillo","Nuestra Señora de La Paz","PLAZA DANIEL RODRIGUEZ",-68.09914,-16.53118,240,9,2405,2645,1329,54,1013,2342
"Bolivia","La Paz","Murillo","Nuestra Señora de La Paz","POLIFUNCIONAL SAN ISIDRO (IGLESIA SAN ISIDRO)",-68.107,-16.51307,176,17,1566,1742,814,47,688,1502
"Bolivia","La Paz","Murillo","Nuestra Señora de La Paz","SEDE JUNTA VECINAL",-68.11436,-16.50176,47,8,587,634,247,6,326,573
"Bolivia","La Paz","Murillo","Nuestra Señora de La Paz","SEDE SOCIAL CAJA FERROVIARIA",-68.15063,-16.44667,111,11,1350,1461,414,30,895,1309
"Bolivia","La Paz","Murillo","Nuestra Señora de La Paz","SEDE SOCIAL CARPANI",-68.0458,-16.45051,42,27,491,533,34,10,420,454
"Bolivia","La Paz","Murillo","Nuestra Señora de La Paz","SEDE SOCIAL DE CUSICANCHA",-68.16608,-16.48517,113,15,1205,1318,476,49,665,1141
"Bolivia","La Paz","Murillo","Nuestra Señora de La Paz","SEDE SOCIAL PLAN AUTOPISTA",-68.14625,-16.45818,164,16,1598,1762,775,45,762,1537
"Bolivia","La Paz","Murillo","Nuestra Señora de La Paz","SEDE SOCIAL PURA PURA",-68.15314,-16.47277,222,7,2201,2423,1105,64,1025,2130
"Bolivia","La Paz","Murillo","Nuestra Señora de La Paz","SEDE SOCIAL VILLA LITORAL",-68.10748,-16.50479,91,15,1008,1099,466,22,505,971
"Bolivia","La Paz","Murillo","Nuestra Señora de La Paz","SEMINARIO NAZARENO",-68.09364,-16.55968,101,1,554,655,427,8,118,545
"Bolivia","La Paz","Murillo","Nuestra Señora de La Paz","TECNICO AYACUCHO",-68.12161,-16.48541,1357,58,11903,13260,8561,237,3047,11608
"Bolivia","La Paz","Murillo","Nuestra Señora de La Paz","TECNICO AYACUCHO",-68.12161,-16.48541,1357,58,11903,13260,8561,237,3047,11608
"Bolivia","La Paz","Murillo","Nuestra Señora de La Paz","U. E. ABRAHAM REYES (FE Y ALEGRIA)",-68.16405,-16.48898,555,58,5865,6420,2519,167,3121,5640
"Bolivia","La Paz","Murillo","Nuestra Señora de La Paz","U. E. ANDINA",-68.11532,-16.46878,252,16,1986,2238,1079,39,852,1931
"Bolivia","La Paz","Murillo","Nuestra Señora de La Paz","U.E. CARLOS SALINAS",-68.13042,-16.4982,60,2,503,563,326,14,161,487
"Bolivia","La Paz","Murillo","Nuestra Señora de La Paz","U.E. EL PEDREGAL (URB. PEDREGAL)",-68.05286,-16.54382,86,10,1091,1177,375,35,671,1046
"Bolivia","La Paz","Murillo","Nuestra Señora de La Paz","U. E. FF. AA. DE LA NACIÓN",-68.08987,-16.52197,358,17,2923,3281,1732,76,1098,2830
"Bolivia","La Paz","Murillo","Nuestra Señora de La Paz","U.E. FILADELFIA",-68.16099,-16.50017,53,11,763,816,279,36,437,716
"Bolivia","La Paz","Murillo","Nuestra Señora de La Paz","U.E. GRAN BRETAÑA",-68.10885,-16.5197,10,0,76,86,43,1,32,75
"Bolivia","La Paz","Murillo","Nuestra Señora de La Paz","U. E. KINDER CAROLA IÑIGUEZ (FE Y ALEGRIA)",-68.16422,-16.48865,188,10,1615,1803,658,32,915,1573
"Bolivia","La Paz","Murillo","Nuestra Señora de La Paz","U. E. PANTALEON DALENCE",-68.14204,-16.51047,165,10,1890,2055,1199,44,637,1836
"Bolivia","La Paz","Murillo","Nuestra Señora de La Paz","U.E. SAN ANDRÉS",-68.07038,-16.53759,348,11,2701,3049,2009,59,622,2631
"Bolivia","La Paz","Murillo","Nuestra Señora de La Paz","U.E. WALDO BALLIVIAN",-68.11192,-16.5086,461,24,5077,5538,2780,169,2104,4884
"Bolivia","La Paz","Murillo","Nuestra Señora de La Paz","UNIDAD EDUCATIVA 24 DE JUNIO",-68.10389,-16.49494,554,47,5633,6187,2554,215,2817,5371
"Bolivia","La Paz","Murillo","Nuestra Señora de La Paz","UNIDAD EDUCATIVA ARABE DE EGIPTO",-68.1409,-16.4971,150,13,1683,1833,1044,26,600,1644
"Bolivia","La Paz","Murillo","Nuestra Señora de La Paz","UNIDAD EDUCATIVA CARLOS MEDINACELLI",-68.14066,-16.51231,484,20,4452,4936,2561,134,1737,4298
"Bolivia","La Paz","Murillo","Nuestra Señora de La Paz","UNIDAD EDUCATIVA CRISTIANA VIDA NUEVA",-68.11804,-16.48913,257,13,2715,2972,1681,66,955,2636
"Bolivia","La Paz","Murillo","Nuestra Señora de La Paz","UNIDAD EDUCATIVA FABRIL 18 DE MAYO",-68.14603,-16.49241,321,14,2914,3235,1856,67,977,2833
"Bolivia","La Paz","Murillo","Nuestra Señora de La Paz","UNIDAD EDUCATIVA FABRIL 18 DE MAYO",-68.14603,-16.49241,321,14,2914,3235,1856,67,977,2833
"Bolivia","La Paz","Murillo","Nuestra Señora de La Paz","UNIDAD EDUCATIVA JUPAPINA",-68.0744,-16.58935,144,11,1176,1320,524,40,601,1125
"Bolivia","La Paz","Murillo","Nuestra Señora de La Paz","UNIDAD EDUCATIVA LITORAL A",-68.151,-16.47124,374,23,3347,3721,1673,96,1555,3228
"Bolivia","La Paz","Murillo","Nuestra Señora de La Paz","UNIDAD EDUCATIVA LOS PINOS",-68.07632,-16.54179,663,13,4322,4985,3695,100,514,4209
"Bolivia","La Paz","Murillo","Nuestra Señora de La Paz","UNIDAD EDUCATIVA MALLASA",-68.08762,-16.57032,169,17,1674,1843,775,36,846,1621
"Bolivia","La Paz","Murillo","Nuestra Señora de La Paz","UNIDAD EDUCATIVA PRIVADA LA PAZ",-68.14587,-16.4988,151,12,1459,1610,796,35,616,1412
"Bolivia","La Paz","Murillo","Nuestra Señora de La Paz","UNIDAD EDUCATIVA PRIVADA LA PAZ",-68.14587,-16.4988,151,12,1459,1610,796,35,616,1412
"Bolivia","La Paz","Murillo","Nuestra Señora de La Paz","UNIDAD EDUCATIVA PUERTO RICO",-68.13956,-16.51244,345,30,3573,3918,1885,120,1538,3423
"Bolivia","La Paz","Murillo","Nuestra Señora de La Paz","UNIDAD EDUCATIVA REPUBLICA DE CHINA",-68.1278,-16.4945,300,16,2812,3112,1704,69,1023,2727
"Bolivia","La Paz","Murillo","Nuestra Señora de La Paz","UNIDAD EDUCATIVA REPUBLICA DE CUBA",-68.13556,-16.50287,334,14,2639,2973,1903,50,672,2575
"Bolivia","La Paz","Murillo","Nuestra Señora de La Paz","UNIDAD EDUCATIVA ROSARIO (URB. EL ROSARIO)",-68.11529,-16.52871,24,1,507,531,284,11,211,495
"Bolivia","La Paz","Murillo","Nuestra Señora de La Paz","UNIDAD EDUCATIVA SAN JOSE (U. E. MANUEL B. MARIACA)",-68.15286,-16.48993,284,15,3352,3636,1943,70,1324,3267
"Bolivia","La Paz","Murillo","Nuestra Señora de La Paz","UNIDAD EDUCATIVA VALLE HERMOSO",-68.10799,-16.4883,256,23,3022,3278,1358,80,1561,2919
"Bolivia","La Paz","Murillo","Nuestra Señora de La Paz","UNIDAD EDUCATIVA VILLA HARCA",-68.04404,-16.09133,35,6,291,326,101,13,171,272
"Bolivia","La Paz","Murillo","Nuestra Señora de La Paz","UNID. EDUC. 20 DE OCTUBRE N° 1",-68.16086,-16.46114,107,21,1283,1390,354,30,878,1232
"Bolivia","La Paz","Murillo","Nuestra Señora de La Paz","UNID EDUCATIVA BETESTA",-68.04996,-16.54382,227,25,2750,2977,952,99,1674,2626
"Bolivia","La Paz","Murillo","Nuestra Señora de La Paz","UNID. EDUC. HUGO BANZER SUAREZ",-68.14326,-16.51199,178,15,1665,1843,909,28,713,1622
"Bolivia","La Paz","Murillo","Nuestra Señora de La Paz","UNID. EDUC. JAIME ESCALANTE",-68.14835,-16.51145,414,55,3784,4198,1398,106,2225,3623
"Bolivia","La Paz","Murillo","Nuestra Señora de La Paz","UNID. EDUC. JOAQUIN HERNANN",-68.02591,-16.54834,95,25,1081,1176,172,19,865,1037
"Bolivia","La Paz","Murillo","Nuestra Señora de La Paz","UNID. EDUC. JORGE VARGAS",-68.13081,-16.53269,213,11,2192,2405,1060,93,1028,2088
"Bolivia","La Paz","Murillo","Nuestra Señora de La Paz","UNID. EDUC. RAUL SALMON DE LA BARRA",-68.1396,-16.52271,293,31,2955,3248,1034,97,1793,2827
"Bolivia","La Paz","Murillo","Palca","COL PEDRO DOMINGO MURILLO",-67.95261,-16.56124,247,50,1923,2170,259,95,1519,1778
"Bolivia","La Paz","Murillo","Palca","ESCUELA CAYIMBAYA",-67.75253,-16.71384,53,15,595,648,162,31,387,549
"Bolivia","La Paz","Murillo","Palca","ESCUELA COHONI",-67.83873,-16.7112,152,46,1329,1481,147,76,1060,1207
"Bolivia","La Paz","Murillo","Palca","ESCUELA COTAÑA",-67.71759,-16.72519,50,6,542,592,76,14,446,522
"Bolivia","La Paz","Murillo","Palca","ESCUELA QUILLIHUAYA",-67.90135,-16.66606,107,17,935,1042,111,29,778,889
"Bolivia","La Paz","Murillo","Palca","ESCUELA TAHUAPALCA",-67.87465,-16.72088,39,12,498,537,54,15,417,471
"Bolivia","La Paz","Murillo","Palca","ESCUELA TIRATA",-67.78961,-16.76238,29,0,257,286,25,0,232,257
"Bolivia","La Paz","Murillo","Palca","UNIDAD EDUCATIVA UNI",-67.9979,-16.5432,46,13,755,801,73,34,635,708
"Bolivia","La Paz","Nor Yungas","Coripata","CASA CULTURAL SAN JUAN DE CORIPATA",-67.56571,-16.25786,39,7,498,537,70,9,412,482
"Bolivia","La Paz","Nor Yungas","Coripata","COLEGIO ANDRES DE SANTA CRUZ",-67.64132,-16.27026,284,34,2254,2538,856,133,1231,2087
"Bolivia","La Paz","Nor Yungas","Coripata","COLEGIO FRAZ TAMAYO FE Y ALEGRIA",-67.6668,-16.28096,146,12,1020,1166,419,58,531,950
"Bolivia","La Paz","Nor Yungas","Coripata","COLEGIO SANTIAGO TOCORONI",-67.55057,-16.26809,112,8,907,1019,193,32,674,867
"Bolivia","La Paz","Nor Yungas","Coripata","ESCUELA CAPITAN LUIS REVERO SANCHEZ",-67.60426,-16.31971,709,67,4092,4801,1462,156,2407,3869
"Bolivia","La Paz","Nor Yungas","Coripata","ESCUELA MILLUHUAYA ALTO",-67.61317,-16.37393,74,6,735,809,194,20,515,709
"Bolivia","La Paz","Nor Yungas","Coroico","CASA DE GOBIERNO",-67.7733,-16.11081,68,5,472,540,145,24,298,443
"Bolivia","La Paz","Nor Yungas","Coroico","COL. TEC. HUM. CRUZ LOMA",-67.6988,-16.19916,89,10,853,942,226,32,585,811
"Bolivia","La Paz","Nor Yungas","Coroico","ESC. FELIX REYES ORTIZ",-67.72715,-16.18757,363,35,1842,2205,754,80,973,1727
"Bolivia","La Paz","Nor Yungas","Coroico","ESCUELA FRANZ TAMAYO",-67.73856,-16.14407,84,9,487,571,133,13,332,465
"Bolivia","La Paz","Nor Yungas","Coroico","ESCUELA JHON F. KENNEDY",-67.68882,-16.07204,53,7,513,566,96,17,393,489
"Bolivia","La Paz","Nor Yungas","Coroico","ESCUELA PACOLLO",-67.79175,-16.20483,104,8,633,737,148,25,452,600
"Bolivia","La Paz","Nor Yungas","Coroico","ESCUELA SANTA ROSA DE QUILO QUILO",-67.81871,-16.03682,57,8,706,763,111,19,568,679
"Bolivia","La Paz","Nor Yungas","Coroico","ESCUELA UNDUAVI",-67.90942,-16.31096,7,1,58,65,13,4,40,53
"Bolivia","La Paz","Nor Yungas","Coroico","U.E. YOLOSA",-67.74015,-16.23356,62,6,424,486,129,9,280,409
"Bolivia","La Paz","Nor Yungas","Coroico","UNIDAD EDUCATIVA PUENTE ARMAS",-67.64138,-16.03312,78,4,441,519,77,11,349,426
"Bolivia","La Paz","Nor Yungas","Coroico","UNIDAD EDU. SAN PEDRO",-67.72571,-16.19051,361,40,2079,2440,833,77,1129,1962
"Bolivia","La Paz","Omasuyos","Achacachi","CASA DE GOBIERNO",-68.81913,-16.16913,61,26,744,805,206,33,479,685
"Bolivia","La Paz","Omasuyos","Achacachi","COLEGIO ANTOFAGASTA",-68.69424,-15.9962,48,14,695,743,198,24,459,657
"Bolivia","La Paz","Omasuyos","Achacachi","COLEGIO FRANZ TAMAYO",-68.74367,-15.92973,63,26,882,945,209,41,606,815
"Bolivia","La Paz","Omasuyos","Achacachi","COLEGIO MARISCAL SANTA CRUZ",-68.68538,-16.04263,489,72,3710,4199,1320,204,2114,3434
"Bolivia","La Paz","Omasuyos","Achacachi","COLEGIO OMASUYOS",-68.68598,-16.04657,386,76,3572,3958,1253,182,2061,3314
"Bolivia","La Paz","Omasuyos","Achacachi","COLEGIO SIMON BOLIVAR",-68.59965,-16.0757,16,3,403,419,121,33,246,367
"Bolivia","La Paz","Omasuyos","Achacachi","COLEGIO SUÑASIVI",-68.64019,-15.98684,84,14,641,725,140,49,438,578
"Bolivia","La Paz","Omasuyos","Achacachi","ESC. SIMON BOLIVIAR",-68.69108,-16.04526,299,80,2719,3018,969,141,1529,2498
"Bolivia","La Paz","Omasuyos","Achacachi","ESCUELA AJLLATA GRANDE",-68.7886,-16.02371,96,37,1289,1385,515,50,687,1202
"Bolivia","La Paz","Omasuyos","Achacachi","ESCUELA APLICACION HUARIZATA",-68.66218,-15.97352,191,40,1450,1641,508,89,813,1321
"Bolivia","La Paz","Omasuyos","Achacachi","ESCUELA APURAYA",-68.74739,-16.0668,49,18,759,808,190,33,518,708
"Bolivia","La Paz","Omasuyos","Achacachi","ESCUELA BELEN",-68.70184,-16.01776,49,11,490,539,112,22,345,457
"Bolivia","La Paz","Omasuyos","Achacachi","ESCUELA CENTRAL CASAMAYA",-68.59995,-16.04042,32,6,354,386,85,27,236,321
"Bolivia","La Paz","Omasuyos","Achacachi","ESCUELA KILLOSA",-68.70744,-15.93228,10,0,126,136,35,7,84,119
"Bolivia","La Paz","Omasuyos","Achacachi","ESCUELA VILLA LIPE",-68.75453,-16.05257,55,17,672,727,166,40,449,615
"Bolivia","La Paz","Omasuyos","Achacachi","ESCUELA WALATA CHICO",-68.65627,-15.93059,31,6,260,291,60,5,189,249
"Bolivia","La Paz","Omasuyos","Achacachi","NUCLEO ECOLAR MURUMAMANI",-68.69246,-15.90919,19,2,499,518,84,14,399,483
"Bolivia","La Paz","Omasuyos","Achacachi","NUCLEO EDUCATIVO TAHARI",-68.6852,-15.95393,8,2,421,429,138,17,264,402
"Bolivia","La Paz","Omasuyos","Achacachi","NÚCLEO ESCOLAR CHALLUYO",-68.61758,-15.99023,20,14,435,455,91,21,309,400
"Bolivia","La Paz","Omasuyos","Achacachi","NUCLEO TACAMARA",-68.61773,-16.02135,88,17,831,919,193,51,570,763
"Bolivia","La Paz","Omasuyos","Achacachi","PLAZA VILLA ASUNCION DE CORPAPUTO",-68.55613,-16.0707,65,14,503,568,115,20,354,469
"Bolivia","La Paz","Omasuyos","Ancoraimes","COLEGIO CAJIATA",-68.85471,-15.91954,4,4,324,328,32,11,277,309
"Bolivia","La Paz","Omasuyos","Ancoraimes","COLEGIO MACAMACA",-68.94691,-15.83644,37,6,663,700,116,22,519,635
"Bolivia","La Paz","Omasuyos","Ancoraimes","ESCUELA FRANZ TAMAYO",-68.90729,-15.89587,186,29,1152,1338,298,74,751,1049
"Bolivia","La Paz","Omasuyos","Ancoraimes","ESCUELA SECCIONAL CHIÑAJA",-68.83353,-15.76956,1,2,94,95,14,2,76,90
"Bolivia","La Paz","Omasuyos","Ancoraimes","ESCUELA SOTALAYA",-68.83341,-15.92723,3,8,316,319,53,8,247,300
"Bolivia","La Paz","Omasuyos","Ancoraimes","ESCUELA TURRINI",-68.89091,-15.87126,14,3,288,302,67,10,208,275
"Bolivia","La Paz","Omasuyos","Ancoraimes","MOROCOLLO PLAZA PRINCIPAL",-68.88557,-15.91232,103,23,909,1012,222,49,615,837
"Bolivia","La Paz","Omasuyos","Ancoraimes","NUCLEO ESCOLAR DE PATAPATANI",-68.82576,-15.78231,5,1,109,114,17,1,90,107
"Bolivia","La Paz","Omasuyos","Ancoraimes","PLAZA 14 DE FEBRERO",-68.81345,-15.88548,95,10,955,1050,184,37,724,908
"Bolivia","La Paz","Omasuyos","Ancoraimes","SEDE SOCIAL CHOJÑAPATA",-68.87042,-15.79118,7,0,97,104,20,1,76,96
"Bolivia","La Paz","Omasuyos","Ancoraimes","SEDE SOCIAL INKA CATURAPI",-68.82888,-15.76071,20,8,285,305,105,3,169,274
"Bolivia","La Paz","Omasuyos","Ancoraimes","TEC. HUMANISTA POCOATA GRANDE",-68.79222,-15.94282,31,13,597,628,138,24,422,560
"Bolivia","La Paz","Omasuyos","Chúa Cocani","CASA DE GOBIERNO",-68.76876,-16.1837,53,7,480,533,162,14,297,459
"Bolivia","La Paz","Omasuyos","Chúa Cocani","ESCUELA CHUA COCANI",-68.74966,-16.18941,150,11,725,875,265,31,418,683
"Bolivia","La Paz","Omasuyos","Chúa Cocani","ESCUELA CORPACHILAYA",-68.71874,-16.19794,39,5,330,369,120,10,195,315
"Bolivia","La Paz","Omasuyos","Chúa Cocani","UNIDAD EDUCATIVA COMPI",-68.7893,-16.17562,55,21,704,759,166,32,485,651
"Bolivia","La Paz","Omasuyos","Huarina","CASA DE GOBIERNO",-68.57069,-16.24477,46,2,380,426,78,6,294,372
"Bolivia","La Paz","Omasuyos","Huarina","ESCUELA APUVILLQUE MOROCOLLO",-68.64399,-16.13322,38,12,312,350,75,23,202,277
"Bolivia","La Paz","Omasuyos","Huarina","ESCUELA BERNABE LEDEZMA",-68.54478,-16.12266,57,13,574,631,182,26,353,535
"Bolivia","La Paz","Omasuyos","Huarina","ESCUELA MARISCAL DE SANTA CRUZ",-68.60149,-16.19093,305,49,2169,2474,705,103,1312,2017
"Bolivia","La Paz","Omasuyos","Huarina","ESCUELA UNIDAD EDUCATIVAO COROMATA BAJA",-68.56112,-16.15195,35,8,323,358,113,11,191,304
"Bolivia","La Paz","Omasuyos","Huatajata","COLEGIO NACIONAL MIXTO HUATAJATA",-68.70113,-16.2081,170,26,1382,1552,536,51,769,1305
"Bolivia","La Paz","Omasuyos","Huatajata","ESCUELA SANCA JAHUIRA",-68.66814,-16.21417,28,13,329,357,111,14,191,302
"Bolivia","La Paz","Omasuyos","Santiago de Huata","COLEGIO CENTRAL POREJONI",-68.83286,-16.10552,36,14,329,365,51,7,257,308
"Bolivia","La Paz","Omasuyos","Santiago de Huata","COLEGIO SANTIAGO DE HUATA",-68.81879,-16.05531,191,71,1619,1810,532,94,922,1454
"Bolivia","La Paz","Omasuyos","Santiago de Huata","ESCUELA WATARI",-68.86102,-16.07956,25,5,189,214,44,13,127,171
"Bolivia","La Paz","Omasuyos","Santiago de Huata","PLAZA WICHI WICHI",-68.87871,-16.09691,51,9,541,592,125,17,390,515
"Bolivia","La Paz","Pacajes","Calacoto","COL. ANTOFAGASTA",-69.04382,-17.42133,14,3,179,193,46,5,125,171
"Bolivia","La Paz","Pacajes","Calacoto","COL. CAMACHO",-68.75751,-17.42726,66,2,156,222,28,2,124,152
"Bolivia","La Paz","Pacajes","Calacoto","COLEGIO FRANZ TAMAYO",-68.85695,-17.30775,27,0,223,250,51,3,169,220
"Bolivia","La Paz","Pacajes","Calacoto","COLEGIO HEROES DEL PACIFICO",-68.76153,-17.86703,6,1,125,131,25,0,99,124
"Bolivia","La Paz","Pacajes","Calacoto","COLEGIO PLAYA VINTO",-68.91974,-17.76429,15,3,107,122,14,1,89,103
"Bolivia","La Paz","Pacajes","Calacoto","COL. HUARISCATA",-68.80087,-17.83315,26,0,142,168,13,1,128,141
"Bolivia","La Paz","Pacajes","Calacoto","COL. J. SARCO KRAMER",-68.81659,-17.42351,39,3,135,174,34,2,96,130
"Bolivia","La Paz","Pacajes","Calacoto","ESC. LAGUNA BLANCA",-68.61784,-17.6079,7,0,127,134,18,3,106,124
"Bolivia","La Paz","Pacajes","Calacoto","ESC. N. LERCO",-68.47871,-17.5797,32,2,205,237,42,6,155,197
"Bolivia","La Paz","Pacajes","Calacoto","ESC. PABLO LAVADENS",-68.63289,-17.28291,97,4,445,542,114,18,309,423
"Bolivia","La Paz","Pacajes","Calacoto","ESCUELA ACHAVICO",-68.92034,-17.41066,5,1,56,61,8,2,45,53
"Bolivia","La Paz","Pacajes","Calacoto","ESCUELA PLAYA VERDE",-68.56482,-17.37746,19,2,185,204,30,4,149,179
"Bolivia","La Paz","Pacajes","Calacoto","ESC. ULLOMA",-68.49041,-17.4915,10,2,181,191,50,2,127,177
"Bolivia","La Paz","Pacajes","Calacoto","PLAZA AUDIENCIA",-68.6291,-17.47268,19,3,368,387,72,2,291,363
"Bolivia","La Paz","Pacajes","Calacoto","PLAZA CHALLUYO",-69.03053,-17.35813,22,4,113,135,33,3,73,106
"Bolivia","La Paz","Pacajes","Calacoto","PLAZA PRINCIPAL",-68.91343,-17.47115,30,2,110,140,10,3,95,105
"Bolivia","La Paz","Pacajes","Calacoto","SEDE SOCIAL MAX TOLEDO",-68.68167,-17.2371,33,1,149,182,34,3,111,145
"Bolivia","La Paz","Pacajes","Caquiaviri","COL. CALLA LLALLAGUA",-68.68002,-16.92397,34,0,142,176,14,5,123,137
"Bolivia","La Paz","Pacajes","Caquiaviri","ESC. ACHIRI",-69.00089,-17.21467,226,17,874,1100,226,27,604,830
"Bolivia","La Paz","Pacajes","Caquiaviri","ESC. ANTAQUIRA VILLA BELEN",-68.66805,-17.08638,41,2,279,320,66,4,207,273
"Bolivia","La Paz","Pacajes","Caquiaviri","ESC. CALAMA QUINTAVI",-68.86324,-17.26844,5,0,32,37,12,0,20,32
"Bolivia","La Paz","Pacajes","Caquiaviri","ESC. CAQUIAVIRI",-68.60491,-17.02134,202,23,908,1110,210,31,644,854
"Bolivia","La Paz","Pacajes","Caquiaviri","ESC. CENTRAL",-68.57354,-16.90038,44,3,320,364,54,11,252,306
"Bolivia","La Paz","Pacajes","Caquiaviri","ESC. CHOJNA PAMPA DE VICHAYA",-68.71049,-17.12527,2,0,103,105,29,0,74,103
"Bolivia","La Paz","Pacajes","Caquiaviri","ESC. JIHUACUTA",-68.78035,-17.1179,46,8,336,382,62,14,252,314
"Bolivia","La Paz","Pacajes","Caquiaviri","ESC. VILLA CHOCOROSI",-68.84946,-17.14096,32,4,213,245,80,5,124,204
"Bolivia","La Paz","Pacajes","Caquiaviri","NUCLEO ESCOLAR VICHAYA",-68.66454,-16.85874,37,5,342,379,98,9,230,328
"Bolivia","La Paz","Pacajes","Caquiaviri","PLAZA 14 DE SEPTIEMBRE",-68.71069,-16.90587,18,4,262,280,37,3,218,255
"Bolivia","La Paz","Pacajes","Caquiaviri","PLAZA SAN MIGUEL",-68.7556,-17.03869,37,3,318,355,80,10,225,305
"Bolivia","La Paz","Pacajes","Caquiaviri","SEDE SOCIAL",-68.94909,-17.09862,20,2,62,82,25,1,34,59
"Bolivia","La Paz","Pacajes","Charaña","COLEGIO EDUARDO AVAROA",-69.44685,-17.59194,183,9,599,782,218,16,356,574
"Bolivia","La Paz","Pacajes","Charaña","COL. TEC. HUMANISTICO TOPATER",-69.10415,-17.43627,5,0,72,77,26,2,44,70
"Bolivia","La Paz","Pacajes","Charaña","ESC. CHINOCAVI",-69.33294,-17.72286,14,1,84,98,14,1,68,82
"Bolivia","La Paz","Pacajes","Charaña","ESC. EDUARDO AVAROA",-69.24786,-17.5377,3,0,42,45,14,2,26,40
"Bolivia","La Paz","Pacajes","Charaña","ESC. GUALBERTO VILLARROEL",-69.11758,-17.51751,5,1,51,56,8,2,40,48
"Bolivia","La Paz","Pacajes","Charaña","ESC. RIO BLANCO",-69.07213,-17.8919,25,3,136,161,61,5,67,128
"Bolivia","La Paz","Pacajes","Charaña","ESC. SICUANI CONDOROCA",-69.46599,-17.4963,26,1,123,149,19,1,102,121
"Bolivia","La Paz","Pacajes","Comanche","COLEGIO COMANCHE",-68.42522,-16.95766,138,18,938,1076,244,38,638,882
"Bolivia","La Paz","Pacajes","Comanche","COL. TOCOPILLA CANTUYO",-68.50373,-16.83876,24,3,324,348,68,10,243,311
"Bolivia","La Paz","Pacajes","Comanche","ESC. KELLA KELLA",-68.41179,-16.9197,5,2,126,131,53,3,68,121
"Bolivia","La Paz","Pacajes","Comanche","SEDE SOCIAL",-68.46437,-17.07932,37,6,289,326,84,5,194,278
"Bolivia","La Paz","Pacajes","Comanche","SEDE SOCIAL",-68.54688,-16.92686,37,6,289,326,84,5,194,278
"Bolivia","La Paz","Pacajes","Coro Coro","CASA DE  GOBIERNO",-68.49454,-17.2455,21,3,279,300,73,12,191,264
"Bolivia","La Paz","Pacajes","Coro Coro","COL. CANCASILLA",-68.60786,-17.10883,18,2,121,139,36,3,80,116
"Bolivia","La Paz","Pacajes","Coro Coro","COLEGIO JOSE MANUEL PANDO",-68.49117,-17.2136,37,8,389,426,93,17,271,364
"Bolivia","La Paz","Pacajes","Coro Coro","COL. JAYUMA LLALLAGUA",-68.48241,-17.29913,9,2,128,137,37,2,87,124
"Bolivia","La Paz","Pacajes","Coro Coro","ESC. PEDRO DOMINGO MURILLO",-68.2065,-17.1975,0,2,191,191,30,9,150,180
"Bolivia","La Paz","Pacajes","Coro Coro","ESC. SECCIONAL ANCO AQUE",-68.19199,-17.17361,1,7,331,332,91,7,226,317
"Bolivia","La Paz","Pacajes","Coro Coro","ESC. TOPOHOCO",-68.24099,-17.16903,19,14,316,335,58,18,226,284
"Bolivia","La Paz","Pacajes","Coro Coro","ESC. VICENTA JUARISTE EGUINO",-68.45507,-17.1773,244,9,1228,1472,313,58,848,1161
"Bolivia","La Paz","Pacajes","Coro Coro","NUCLEO ESC. CENTRAL ENEQUELLA",-68.15412,-17.14132,32,3,297,329,77,4,213,290
"Bolivia","La Paz","Pacajes","Coro Coro","PLAZA APOSTOL SANTIAGO",-68.13311,-17.18174,37,17,289,326,70,16,186,256
"Bolivia","La Paz","Pacajes","Coro Coro","PLAZA CANTON ROSAPATA",-68.58238,-17.21777,30,2,136,166,29,4,101,130
"Bolivia","La Paz","Pacajes","Coro Coro","PLAZA MEJILLONES",-68.50258,-17.08385,50,6,279,329,79,5,189,268
"Bolivia","La Paz","Pacajes","Coro Coro","PLAZA PRINCIPAL",-68.64835,-17.14039,33,4,194,227,34,9,147,181
"Bolivia","La Paz","Pacajes","Nazacara de Pacajes","PLAZA PRINCIPAL",-68.76462,-16.93795,56,3,275,331,49,7,216,265
"Bolivia","La Paz","Pacajes","Santiago de Callapa","COL.TECNICO HUMANISTICO TUPAC AMARU",-68.33572,-17.34924,37,5,161,198,39,6,111,150
"Bolivia","La Paz","Pacajes","Santiago de Callapa","ESC. HUAYLLAPANTA",-68.26348,-17.27865,9,3,86,95,27,3,53,80
"Bolivia","La Paz","Pacajes","Santiago de Callapa","ESC. HUICHURAYA",-68.43911,-17.33394,15,2,115,130,30,3,80,110
"Bolivia","La Paz","Pacajes","Santiago de Callapa","ESC. N. CANUHUTA",-68.47823,-17.42123,50,2,291,341,65,4,220,285
"Bolivia","La Paz","Pacajes","Santiago de Callapa","ESC. POQUEVILLQUE",-68.27715,-17.32858,17,1,118,135,23,4,90,113
"Bolivia","La Paz","Pacajes","Santiago de Callapa","ESCUELA LIBERTADOR SIMON BOLIVIAR",-68.2121,-17.43119,12,1,150,162,41,2,106,147
"Bolivia","La Paz","Pacajes","Santiago de Callapa","ESCUELA ROMERO PAMPA",-68.23565,-17.35947,23,4,231,254,75,7,145,220
"Bolivia","La Paz","Pacajes","Santiago de Callapa","PLAZA 29 DE JUNIO",-68.18311,-17.36895,17,6,273,290,67,14,186,253
"Bolivia","La Paz","Pacajes","Santiago de Callapa","PLAZA SANTIAGO DE CALLAPA",-68.35594,-17.4794,145,11,449,594,113,19,306,419
"Bolivia","La Paz","Pacajes","Santiago de Callapa","PLAZA VILLA PUCHUNI",-68.31937,-17.2838,24,4,169,193,52,5,108,160
"Bolivia","La Paz","Pacajes","Santiago de Callapa","P. S. FRANCISCO YARIBAY",-68.41264,-17.24828,54,0,225,279,44,3,178,222
"Bolivia","La Paz","Pacajes","Santiago de Callapa","UNIDAD EDUCATIVA HUAJRUMA",-68.39203,-17.57708,7,0,76,83,31,1,44,75
"Bolivia","La Paz","Pacajes","Waldo Ballivián","PATIO HISTORICO TUMARAPI",-68.18797,-17.08567,68,9,919,987,207,35,668,875
"Bolivia","La Paz","Sur Yungas","Chulumani (Villa de la Libertad)","CASA DE GOBIERNO",-67.58398,-16.3884,66,11,536,602,122,10,393,515
"Bolivia","La Paz","Sur Yungas","Chulumani (Villa de la Libertad)","COLEGIO AGUSTIN ASPIAZU",-67.52634,-16.40942,810,48,4209,5019,1510,168,2483,3993
"Bolivia","La Paz","Sur Yungas","Chulumani (Villa de la Libertad)","COLEGIO GRAL.ARMANDO ESCOBAR URIA",-67.51199,-16.43177,85,6,648,733,237,18,387,624
"Bolivia","La Paz","Sur Yungas","Chulumani (Villa de la Libertad)","COLEGIO JUAN RAMOS DE TAGMA",-67.47916,-16.37452,88,9,756,844,250,29,468,718
"Bolivia","La Paz","Sur Yungas","Chulumani (Villa de la Libertad)","ESC. COLOPAMPA",-67.53527,-16.28799,6,3,136,142,20,1,112,132
"Bolivia","La Paz","Sur Yungas","Chulumani (Villa de la Libertad)","PLAZA PRINCIPAL",-67.50503,-16.44271,29,6,445,474,80,14,345,425
"Bolivia","La Paz","Sur Yungas","Chulumani (Villa de la Libertad)","U.E. TÉCNICO HUMANÍSTICO PASTO PATA",-67.47044,-16.36745,95,11,725,820,263,24,427,690
"Bolivia","La Paz","Sur Yungas","Chulumani (Villa de la Libertad)","UNIDAD EDUCATIVA HUANCANE",-67.53661,-16.3786,238,18,1579,1817,437,64,1060,1497
"Bolivia","La Paz","Sur Yungas","Irupana (Villa de Lanza)","CANCHA DE UNION HUIRI",-67.35191,-16.30181,41,9,450,491,47,13,381,428
"Bolivia","La Paz","Sur Yungas","Irupana (Villa de Lanza)","COLEGIO TTE.CNL. RAFAEL PABON",-67.79365,-16.57078,221,27,865,1086,328,28,482,810
"Bolivia","La Paz","Sur Yungas","Irupana (Villa de Lanza)","COL. NUCLEO ROSARIO",-67.6368,-16.65357,19,3,178,197,41,5,129,170
"Bolivia","La Paz","Sur Yungas","Irupana (Villa de Lanza)","ESC. CENTRAL LA PLAZUELA",-67.40361,-16.52655,50,2,273,323,69,5,197,266
"Bolivia","La Paz","Sur Yungas","Irupana (Villa de Lanza)","ESC. T.C. RAFAEL PABON",-67.34905,-16.49079,26,2,170,196,28,5,135,163
"Bolivia","La Paz","Sur Yungas","Irupana (Villa de Lanza)","ESC. VICTOR CENTELLAS",-67.4448,-16.42614,48,15,330,378,123,8,184,307
"Bolivia","La Paz","Sur Yungas","Irupana (Villa de Lanza)","ESC. VICTORIO LANZA",-67.43213,-16.40116,62,8,553,615,134,76,335,469
"Bolivia","La Paz","Sur Yungas","Irupana (Villa de Lanza)","PLAZA 25 DE JULIO",-67.70308,-16.60368,49,15,342,391,64,9,254,318
"Bolivia","La Paz","Sur Yungas","Irupana (Villa de Lanza)","U. E. AGUSTIN ASPIAZU",-67.45403,-16.47174,471,54,2962,3433,978,111,1819,2797
"Bolivia","La Paz","Sur Yungas","Irupana (Villa de Lanza)","U.E. CHICALOMA",-67.4781,-16.4439,100,29,730,830,232,28,441,673
"Bolivia","La Paz","Sur Yungas","Irupana (Villa de Lanza)","U.E. CURIHUATI",-67.53439,-16.62459,12,1,102,114,31,1,69,100
"Bolivia","La Paz","Sur Yungas","Irupana (Villa de Lanza)","U.E. NUCLEO ALEJANDRO PEREZ",-67.39616,-16.48061,11,1,119,130,22,5,91,113
"Bolivia","La Paz","Sur Yungas","Irupana (Villa de Lanza)","U.E. SIQUILJARA",-67.43041,-16.4995,4,0,49,53,7,5,37,44
"Bolivia","La Paz","Sur Yungas","Irupana (Villa de Lanza)","UNIDAD EDUCATIVA TACA",-67.59009,-16.6741,14,23,247,261,51,9,164,215
"Bolivia","La Paz","Sur Yungas","La Asunta","CASA DE GOBIERNO",-67.16822,-16.02656,74,7,437,511,130,12,288,418
"Bolivia","La Paz","Sur Yungas","La Asunta","CASA DE GOBIERNO",-67.42729,-16.3161,74,7,437,511,130,12,288,418
"Bolivia","La Paz","Sur Yungas","La Asunta","COLEGIO LAS MERCEDES",-67.34164,-16.28541,156,24,1110,1266,239,16,831,1070
"Bolivia","La Paz","Sur Yungas","La Asunta","COLEGIO PEDRO DOMINGO MURILLO",-67.17278,-15.99563,156,30,1193,1349,296,29,838,1134
"Bolivia","La Paz","Sur Yungas","La Asunta","ESC. BATALLON COLORADOS",-67.23377,-16.24007,61,6,344,405,63,14,261,324
"Bolivia","La Paz","Sur Yungas","La Asunta","ESC. PEDRO DOMINGO MURILLO",-67.23003,-16.17662,70,18,594,664,97,20,459,556
"Bolivia","La Paz","Sur Yungas","La Asunta","ESC. RENE BARRIENTOS ORTUNO",-67.19631,-16.12306,868,75,4955,5823,1599,235,3046,4645
"Bolivia","La Paz","Sur Yungas","La Asunta","ESCUELA PUERTO RICO",-67.23912,-15.91417,169,22,904,1073,268,26,588,856
"Bolivia","La Paz","Sur Yungas","La Asunta","ESC. YANAMAYU",-67.24638,-16.25433,66,11,479,545,94,12,362,456
"Bolivia","La Paz","Sur Yungas","La Asunta","PLAZA 5 DE AGOSTO",-67.32188,-16.29534,92,8,686,778,130,23,525,655
"Bolivia","La Paz","Sur Yungas","La Asunta","PLAZA PRINCIPAL",-67.28065,-16.28432,17,10,498,515,92,19,377,469
"Bolivia","La Paz","Sur Yungas","La Asunta","PLAZA PRINCIPAL PICHARI",-67.1724,-16.03647,33,1,172,205,28,1,142,170
"Bolivia","La Paz","Sur Yungas","La Asunta","SEDE SOCIAL 16 DE JULIO",-67.21876,-15.98921,94,13,604,698,66,18,507,573
"Bolivia","La Paz","Sur Yungas","La Asunta","SEDE SOCIAL CHARIA",-67.17044,-16.06197,76,6,627,703,139,17,465,604
"Bolivia","La Paz","Sur Yungas","La Asunta","SEDE SOCIAL - ESC. FISCAL CALIZAYA",-67.17819,-16.20132,102,15,857,959,287,34,521,808
"Bolivia","La Paz","Sur Yungas","La Asunta","U.E. SANTA ROSA",-67.29982,-16.29054,34,3,420,454,42,13,362,404
"Bolivia","La Paz","Sur Yungas","La Asunta","UNIDAD EDUCATIVA CENTRAL QUINUNI",-67.12872,-16.24596,180,33,1240,1420,297,44,866,1163
"Bolivia","La Paz","Sur Yungas","La Asunta","UNIDAD EDUCATIVA NUEVOS HORIZONTES",-67.0814,-16.07017,59,9,353,412,79,9,256,335
"Bolivia","La Paz","Sur Yungas","La Asunta","UNIDAD EDUCATIVA SIGUANI GRANDE",-67.1498,-16.02148,157,12,782,939,155,15,600,755
"Bolivia","La Paz","Sur Yungas","Palos Blancos","COLEGIO GRAL.JUAN JOSE TORREZ",-67.15504,-15.43328,93,8,438,531,95,18,317,412
"Bolivia","La Paz","Sur Yungas","Palos Blancos","COLEGIO INICUA ALTO",-67.21655,-15.49705,240,26,1316,1556,198,42,1050,1248
"Bolivia","La Paz","Sur Yungas","Palos Blancos","ESC. CENTRAL SAPECHO",-67.33434,-15.55851,175,12,932,1107,202,28,690,892
"Bolivia","La Paz","Sur Yungas","Palos Blancos","ESC. FRANZ TAMAYO",-66.97848,-15.79254,129,7,568,697,93,28,440,533
"Bolivia","La Paz","Sur Yungas","Palos Blancos","ESC. MAPURICHUQUI",-67.38571,-15.53334,13,0,104,117,10,2,92,102
"Bolivia","La Paz","Sur Yungas","Palos Blancos","ESC. REMOLINOS",-67.10275,-15.70205,20,4,165,185,28,2,131,159
"Bolivia","La Paz","Sur Yungas","Palos Blancos","ESC. SAN MIGUEL DE HUACHI",-67.13039,-15.67505,117,7,556,673,148,21,380,528
"Bolivia","La Paz","Sur Yungas","Palos Blancos","ESC. SANTA ANA DE MOSETENES",-67.42593,-15.51087,61,13,519,580,101,17,388,489
"Bolivia","La Paz","Sur Yungas","Palos Blancos","ESC. SECC. PUERTO CARMEN",-67.10754,-15.72647,76,3,513,589,53,15,442,495
"Bolivia","La Paz","Sur Yungas","Palos Blancos","ESCUELA 13 DE MAYO",-67.05286,-15.7359,75,8,370,445,70,7,285,355
"Bolivia","La Paz","Sur Yungas","Palos Blancos","ESCUELA COCOCHI",-67.03598,-15.76373,76,4,517,593,46,9,458,504
"Bolivia","La Paz","Sur Yungas","Palos Blancos","ESCUELA UNIDAD EDUCATIVA POPOY",-67.16382,-15.64156,87,4,507,594,91,11,401,492
"Bolivia","La Paz","Sur Yungas","Palos Blancos","ESC. UNI. EDUCATIVA PALOS BLANCOS",-67.24989,-15.58425,754,39,3769,4523,1274,160,2296,3570
"Bolivia","La Paz","Sur Yungas","Yanacachi","AGENCIA CANTONAL",-67.67539,-16.40772,18,2,195,213,43,5,145,188
"Bolivia","La Paz","Sur Yungas","Yanacachi","ESC. EDUARDO AVAROA",-67.77512,-16.40746,84,5,727,811,161,19,542,703
"Bolivia","La Paz","Sur Yungas","Yanacachi","ESCUELA PUENTE VILLA",-67.64563,-16.40512,125,7,605,730,113,27,458,571
"Bolivia","La Paz","Sur Yungas","Yanacachi","UNIDAD ED. FELIX ERNESTO MOSCOSO",-67.73924,-16.39802,105,20,837,942,162,40,615,777
"Bolivia","Oruro","Abaroa","Challapata","CASA COMUNAL",-66.867,-18.81626,4,3,52,56,17,4,28,45
"Bolivia","Oruro","Abaroa","Challapata","COL. NEMECIO BARRIENTOS",-66.41433,-18.8165,93,52,1851,1944,183,92,1524,1707
"Bolivia","Oruro","Abaroa","Challapata","COL. SIMON BOLIVAR",-66.2065,-19.07044,133,23,724,857,184,53,464,648
"Bolivia","Oruro","Abaroa","Challapata","ESC. ELIZARDO PEREZ",-66.63439,-18.78513,35,5,201,236,65,11,120,185
"Bolivia","Oruro","Abaroa","Challapata","ESC. GUALBERTO VILLARROEL",-66.17815,-19.14781,57,6,487,544,131,30,320,451
"Bolivia","Oruro","Abaroa","Challapata","ESC. GUALBERTO VILLARROEL",-66.17815,-19.14781,57,6,487,544,131,30,320,451
"Bolivia","Oruro","Abaroa","Challapata","IGLESIA",-66.75696,-18.90541,77,27,481,558,134,26,294,428
"Bolivia","Oruro","Abaroa","Challapata","U.E. ANTOFAGASTA",-66.76142,-18.9058,156,18,984,1140,464,54,448,912
"Bolivia","Oruro","Abaroa","Challapata","U. E. CHIRITAMBO",-66.49629,-18.74333,6,0,37,43,9,8,20,29
"Bolivia","Oruro","Abaroa","Challapata","U. E. CHURACANI",-66.6879,-18.88193,17,3,190,207,94,8,85,179
"Bolivia","Oruro","Abaroa","Challapata","U. E. COCHUYO",-66.19255,-19.04616,15,6,176,191,26,12,132,158
"Bolivia","Oruro","Abaroa","Challapata","U. E. CRUCE AGUAS CALIENTES",-66.59532,-18.75354,23,16,336,359,105,23,192,297
"Bolivia","Oruro","Abaroa","Challapata","U. E. EDUARDO AVAROA",-66.77432,-18.89956,455,46,2647,3102,1299,159,1143,2442
"Bolivia","Oruro","Abaroa","Challapata","U.E. GERMAN BUSCH",-66.64656,-18.83978,15,3,175,190,77,13,82,159
"Bolivia","Oruro","Abaroa","Challapata","U.E. HUANCANE",-66.87584,-18.70498,33,7,353,386,153,32,161,314
"Bolivia","Oruro","Abaroa","Challapata","U.E. MONS. RICARDO BENI MORO",-66.77174,-18.89699,218,23,1153,1371,559,63,508,1067
"Bolivia","Oruro","Abaroa","Challapata","U. E. REPUBLICA ARGENTINA",-66.77376,-18.89994,480,63,2859,3339,1366,218,1212,2578
"Bolivia","Oruro","Abaroa","Challapata","U. E. SAN JUAN DE DIOS",-66.77537,-18.89861,375,36,2256,2631,1116,125,979,2095
"Bolivia","Oruro","Abaroa","Challapata","U. E. WILAÑEQUE",-66.87421,-18.79802,5,2,63,68,14,4,43,57
"Bolivia","Oruro","Abaroa","Santuario de Quillacas","COL. NAL. MIXTO SEVARUYO",-66.8639,-19.36308,91,17,762,853,194,30,521,715
"Bolivia","Oruro","Abaroa","Santuario de Quillacas","ESC. SORAGA",-66.81366,-19.37804,29,1,236,265,30,4,201,231
"Bolivia","Oruro","Abaroa","Santuario de Quillacas","U.E. SANTUARIO DE QUILLACAS",-66.9434,-19.23514,100,14,679,779,171,16,478,649
"Bolivia","Oruro","Carangas","Choque Cota","ESC. JOSE BALLIVIAN",-67.89426,-18.09751,147,10,493,640,85,13,385,470
"Bolivia","Oruro","Carangas","Choque Cota","U.E. GERMAN BUSCH",-67.9801,-18.24933,16,0,63,79,8,0,55,63
"Bolivia","Oruro","Carangas","Corque","COL.  JOSE TRIFIRO",-67.68045,-18.34875,433,22,1058,1491,262,38,736,998
"Bolivia","Oruro","Carangas","Corque","COL. QUITA QUITA",-67.59264,-18.57433,20,1,125,145,28,1,95,123
"Bolivia","Oruro","Carangas","Corque","ESC. CENTRAL ANDAPATA LUPE",-67.7664,-18.57256,23,2,134,157,41,1,90,131
"Bolivia","Oruro","Carangas","Corque","ESC. ELIZARDO PEREZ",-67.96458,-18.42258,4,0,192,196,39,1,152,191
"Bolivia","Oruro","Carangas","Corque","ESC. GERMAN BUSCH",-67.63393,-18.19181,3,0,124,127,39,2,83,122
"Bolivia","Oruro","Carangas","Corque","ESC. RAFAEL PABON",-67.86765,-18.61046,5,2,314,319,77,8,227,304
"Bolivia","Oruro","Carangas","Corque","ESC. SECCIONAL VILLA NUEVA",-67.52446,-18.50015,2,0,90,92,10,1,79,89
"Bolivia","Oruro","Carangas","Corque","ESC. SECCIONAL VILLA REMEDIOS",-67.53616,-18.34178,12,9,103,115,15,2,77,92
"Bolivia","Oruro","Carangas","Corque","NUCLEO JANCOCALA",-67.63593,-18.40875,19,3,119,138,29,4,83,112
"Bolivia","Oruro","Carangas","Corque","PROYECTO CRISTIAN CHILDRENS",-67.89956,-18.54068,37,4,348,385,73,7,264,337
"Bolivia","Oruro","Carangas","Corque","U. E. CONDORIRI",-67.87078,-18.28468,3,0,143,146,14,5,124,138
"Bolivia","Oruro","Carangas","Corque","U. E. EDUARDO AVAROA",-67.93131,-18.25961,8,2,108,116,23,2,81,104
"Bolivia","Oruro","Carangas","Corque","U.E. FRANZ TAMAYO",-67.92997,-18.34328,2,0,199,201,11,1,187,198
"Bolivia","Oruro","Carangas","Corque","U. E. FRANZ TAMAYO - VILLA ESPERANZA.-",-67.79691,-18.69382,37,2,227,264,37,2,186,223
"Bolivia","Oruro","Carangas","Corque","U.E. HUAYLLAPACHA",-67.78386,-18.20815,11,0,109,120,9,1,99,108
"Bolivia","Oruro","Carangas","Corque","U.E. HUAYLLOCO",-67.60744,-18.62654,41,3,157,198,34,4,116,150
"Bolivia","Oruro","Carangas","Corque","U.E. ISMAEL MONTES",-67.63055,-18.2567,9,0,123,132,27,2,94,121
"Bolivia","Oruro","Carangas","Corque","U.E. VILLA COPACABANA",-67.58656,-18.33602,23,1,205,228,63,4,137,200
"Bolivia","Oruro","Carangas","Corque","U.E. VILLA TARUCACHI",-67.69584,-18.17327,33,2,135,168,15,3,115,130
"Bolivia","Oruro","Cercado","Caracollo","CASA COMUNAL",-67.36098,-17.5586,27,6,232,259,52,6,168,220
"Bolivia","Oruro","Cercado","Caracollo","ESC. ARCA DE NOE",-67.14415,-17.53467,27,5,221,248,52,9,155,207
"Bolivia","Oruro","Cercado","Caracollo","ESC. CASIMIRO OLAÑETA",-67.71239,-17.75884,15,6,98,113,23,1,68,91
"Bolivia","Oruro","Cercado","Caracollo","ESC. CENTRAL HORENCO",-67.08439,-17.67966,41,13,508,549,114,30,351,465
"Bolivia","Oruro","Cercado","Caracollo","ESC. ELIZARDO PEREZ",-67.23847,-17.7678,25,6,325,350,76,20,223,299
"Bolivia","Oruro","Cercado","Caracollo","ESC. GUALBERTO VILLARROEL",-67.60866,-17.84485,2,1,156,158,48,7,100,148
"Bolivia","Oruro","Cercado","Caracollo","ESC. MARISCAL SUCRE",-67.21998,-17.63756,576,68,4543,5119,1534,200,2741,4275
"Bolivia","Oruro","Cercado","Caracollo","ESC. RENE BERNAL ESCALANTE",-67.26373,-17.41522,26,8,227,253,35,9,175,210
"Bolivia","Oruro","Cercado","Caracollo","ESC. SECCIONAL ANCOTANGA",-67.41176,-17.80681,10,3,108,118,45,1,59,104
"Bolivia","Oruro","Cercado","Caracollo","ESC. TUPAC KATARI",-67.32282,-17.67462,4,0,35,39,4,1,30,34
"Bolivia","Oruro","Cercado","Caracollo","PLAZA 21 DE SEPTIEMBRE",-67.63667,-17.79293,11,1,182,193,52,1,128,180
"Bolivia","Oruro","Cercado","Caracollo","U. E. ADELA ZAMUDIO B",-67.61005,-17.79552,0,1,66,66,14,0,51,65
"Bolivia","Oruro","Cercado","Caracollo","U.E. ALEMANIA",-67.29485,-17.58746,66,8,484,550,117,23,336,453
"Bolivia","Oruro","Cercado","Caracollo","U.E. AYACUCHO",-67.32822,-17.88792,52,11,267,319,94,12,150,244
"Bolivia","Oruro","Cercado","Caracollo","U.E. FLORENCIO ALVARADO",-67.67155,-17.89358,10,6,203,213,49,6,142,191
"Bolivia","Oruro","Cercado","Caracollo","U.E. JAIME LAREDO UNZUETA",-67.29126,-17.76572,3,5,55,58,12,0,38,50
"Bolivia","Oruro","Cercado","Caracollo","U.E. LITORAL",-67.21841,-17.63715,141,11,632,773,202,35,384,586
"Bolivia","Oruro","Cercado","Caracollo","U.E. MARISCAL SUCRE B",-67.49707,-17.77807,134,14,707,841,232,28,433,665
"Bolivia","Oruro","Cercado","Caracollo","U.E. MAX FERNANDEZ",-67.10453,-17.55754,38,3,436,474,98,9,326,424
"Bolivia","Oruro","Cercado","Caracollo","U.E. OTTO SAUCEDO RIVERA",-67.3471,-17.80727,20,2,156,176,70,8,76,146
"Bolivia","Oruro","Cercado","Caracollo","U.ESC. MARCELO QUIROGA SANTA CRUZ",-67.3585,-17.954,25,1,192,217,43,1,147,190
"Bolivia","Oruro","Cercado","Caracollo","U.E. SEBASTIAN PAGADOR",-67.32516,-17.52224,40,5,342,382,68,12,257,325
"Bolivia","Oruro","Cercado","Caracollo","U.E. SIMON BOLIVAR PRIMARIO",-67.65617,-17.79859,45,6,342,387,105,28,203,308
"Bolivia","Oruro","Cercado","Caracollo","U. E. VICTOR PAZ ESTENSORO",-67.22767,-17.52121,18,1,83,101,33,3,46,79
"Bolivia","Oruro","Cercado","El Choro","ESC. GUALBERTO VILLARROEL",-67.1244,-18.28041,30,8,229,259,83,5,133,216
"Bolivia","Oruro","Cercado","El Choro","ESC. JOSE BALLIVIAN",-67.23971,-18.07711,100,12,470,570,107,20,331,438
"Bolivia","Oruro","Cercado","El Choro","ESC. SEBASTIAN  PAGADOR",-67.11596,-18.35524,115,12,573,688,132,41,388,520
"Bolivia","Oruro","Cercado","El Choro","PLAZA PRINCIPAL",-67.16006,-18.20486,43,3,241,284,73,13,152,225
"Bolivia","Oruro","Cercado","El Choro","U. E. SAN FELIPE DE CHAITAVI",-67.19747,-18.2947,13,2,164,177,56,6,100,156
"Bolivia","Oruro","Cercado","Oruro","(CÁRCEL) PENAL SAN PEDRO.-",-67.11382,-17.94748,51,5,177,228,87,2,83,170
"Bolivia","Oruro","Cercado","Oruro","CEMEI.-",-67.10611,-17.95222,62,3,565,627,374,17,171,545
"Bolivia","Oruro","Cercado","Oruro","CENTRO DE ALFABETIZACION HUAJARA III.-",-67.09458,-17.94664,52,7,453,505,213,16,217,430
"Bolivia","Oruro","Cercado","Oruro","CENTRO DE MADRES VILLA DORINA.-  (U.ESC. GTANJA CAPACHOS)",-67.0959,-17.93653,51,2,529,580,219,21,287,506
"Bolivia","Oruro","Cercado","Oruro","CENTRO EDUCATIVO ALCIRA CARDONA.-",-67.13569,-17.98138,301,20,2236,2537,1192,72,952,2144
"Bolivia","Oruro","Cercado","Oruro","CENTRO EDUCATIVO LUIS ESPINAL.-",-67.10418,-17.97677,133,6,1049,1182,638,39,366,1004
"Bolivia","Oruro","Cercado","Oruro","COL. ANICETO ARCE.-",-67.10963,-17.95758,239,11,1749,1988,1161,39,538,1699
"Bolivia","Oruro","Cercado","Oruro","COL. DONATO VASQUEZ",-67.11268,-17.96753,167,16,1394,1561,1032,28,318,1350
"Bolivia","Oruro","Cercado","Oruro","COLEGIO JESUS MARIA FE Y ALEGRIA.-",-67.1079,-17.95973,127,4,1082,1209,843,11,224,1067
"Bolivia","Oruro","Cercado","Oruro","COL. IGNACIO LEON.-",-67.11066,-17.96957,271,9,2057,2328,1535,47,466,2001
"Bolivia","Oruro","Cercado","Oruro","COL. JORGE OBLITAS.-",-67.11667,-17.97098,218,5,1470,1688,1017,48,400,1417
"Bolivia","Oruro","Cercado","Oruro","COL. MARCOS BELTRAN AVILA.-",-67.12161,-17.98581,323,13,1753,2076,949,52,739,1688
"Bolivia","Oruro","Cercado","Oruro","COL. MIXTO SAN JOSE.-",-67.1077,-17.96691,108,5,902,1010,553,19,325,878
"Bolivia","Oruro","Cercado","Oruro","COL. NAL. ANTONIO JOSE DE SAINZ.-",-67.11235,-17.97625,296,9,1926,2222,1206,61,650,1856
"Bolivia","Oruro","Cercado","Oruro","COL. NAL. JUAN MISAEL SARACHO.-",-67.10977,-17.96565,212,7,1694,1906,1283,34,370,1653
"Bolivia","Oruro","Cercado","Oruro","COL. NAL. MIXTO BOLIVIA.-",-67.11076,-17.96816,635,27,3246,3881,1758,98,1363,3121
"Bolivia","Oruro","Cercado","Oruro","COL. NAL. MIXTO CARMEN GUZMAN DE MIER",-67.09805,-17.96961,716,42,5553,6269,2944,258,2309,5253
"Bolivia","Oruro","Cercado","Oruro","COL.NAL.MIXTO MEJILLONES (V. CHALLACOLLO)",-67.13516,-18.00865,237,14,1290,1527,473,85,718,1191
"Bolivia","Oruro","Cercado","Oruro","COL. NAL. SIMON BOLIVAR.-",-67.11548,-17.97176,308,12,2228,2536,1608,43,565,2173
"Bolivia","Oruro","Cercado","Oruro","COL. PARTICULAR ANGLO AMERICANO.-",-67.12007,-17.96936,288,12,2233,2521,1432,66,723,2155
"Bolivia","Oruro","Cercado","Oruro","COL. PARTICULAR BOLIVIA JAPON-.",-67.11596,-17.96645,200,11,1473,1673,1003,28,431,1434
"Bolivia","Oruro","Cercado","Oruro","COL. PARTICULAR LA SALLE.-",-67.12745,-17.98239,341,18,2698,3039,1614,99,967,2581
"Bolivia","Oruro","Cercado","Oruro","COL. PARTICULAR NACIONES UNIDAS.-",-67.11937,-17.9807,108,9,691,799,354,96,232,586
"Bolivia","Oruro","Cercado","Oruro","COL. PARTICULAR REEKIE.-",-67.1146,-17.97336,196,8,1654,1850,1229,34,383,1612
"Bolivia","Oruro","Cercado","Oruro","ESC. FRANZ TAMAYO (LOS PINOS).-",-67.13069,-17.9254,133,17,1159,1292,421,34,687,1108
"Bolivia","Oruro","Cercado","Oruro","ESC. JACINTO RODRIGUEZ (LA AURORA).-",-67.12757,-17.91296,359,22,3129,3488,1641,108,1358,2999
"Bolivia","Oruro","Cercado","Oruro","ESC. JUAN PABLO.-",-67.13759,-17.97069,435,34,2906,3341,1374,92,1406,2780
"Bolivia","Oruro","Cercado","Oruro","ESC. MIXTA FERROVIARIA.-",-67.1043,-17.96417,438,23,3645,4083,2496,74,1052,3548
"Bolivia","Oruro","Cercado","Oruro","FAC. DE DERECHO (ESC. 10 DE FEBRERO)",-67.10728,-17.96463,88,5,716,804,515,7,189,704
"Bolivia","Oruro","Cercado","Oruro","FACULTAD DE AGRONOMIA-.",-67.1356,-17.99495,136,3,827,963,371,25,428,799
"Bolivia","Oruro","Cercado","Oruro","FACULTAD DE MEDICINA.-",-67.11997,-17.95705,285,15,2294,2579,1257,93,929,2186
"Bolivia","Oruro","Cercado","Oruro","FACULTAD TECNICA.-",-67.10745,-17.95388,269,18,2399,2668,1640,56,685,2325
"Bolivia","Oruro","Cercado","Oruro","FUNDACION INFOCAL.-",-67.13299,-17.97652,157,9,1200,1357,648,28,515,1163
"Bolivia","Oruro","Cercado","Oruro","INICIAL CARMEN GUZMAN DE MIER-.",-67.09798,-17.96936,51,4,407,458,217,16,170,387
"Bolivia","Oruro","Cercado","Oruro","INST. DE APRENDIZAJE INDUSTRIAL - I.A.I.",-67.10339,-17.95443,432,26,3789,4221,2091,115,1557,3648
"Bolivia","Oruro","Cercado","Oruro","INST. NORMAL SUPERIOR ANGEL MENDOZA J.",-67.11544,-17.95136,279,16,2280,2559,1330,74,860,2190
"Bolivia","Oruro","Cercado","Oruro","KINDER CHIRIPUJIO-.",-67.13878,-17.97487,58,5,317,375,161,6,145,306
"Bolivia","Oruro","Cercado","Oruro","KINDER EDITH ZAMORA DE PAZ",-67.06566,-17.59109,91,7,642,733,310,10,315,625
"Bolivia","Oruro","Cercado","Oruro","KINDER JUANCITO PINTO.-",-67.1338,-17.97651,222,23,1612,1834,865,51,673,1538
"Bolivia","Oruro","Cercado","Oruro","LICEO ANTOFAGASTA.-",-67.11086,-17.95904,130,3,1109,1239,753,28,325,1078
"Bolivia","Oruro","Cercado","Oruro","LICEO TEC. HUMANISTICO ADOLFO BALLIVIAN",-67.11545,-17.97227,124,6,997,1121,697,20,274,971
"Bolivia","Oruro","Cercado","Oruro","U.E. ABY AYALA  (MAGDALENA POSTEL II)",-67.0858,-17.96687,34,1,402,436,203,13,185,388
"Bolivia","Oruro","Cercado","Oruro","U. E. ALTO ORURO-.",-67.11981,-17.97776,90,7,657,747,270,35,345,615
"Bolivia","Oruro","Cercado","Oruro","U.E. BOLIVIA VINTO.-",-67.06182,-17.97608,590,73,4246,4836,1541,406,2226,3767
"Bolivia","Oruro","Cercado","Oruro","U. E. CARMELA CERRUTO-.",-67.12911,-17.98492,75,6,423,498,206,18,193,399
"Bolivia","Oruro","Cercado","Oruro","U. E. EDUARDO AVAROA",-67.10896,-17.96172,202,10,1711,1913,1309,44,348,1657
"Bolivia","Oruro","Cercado","Oruro","U. E. EJERCITO NACIONAL.-",-67.11467,-17.94708,452,31,3461,3913,1885,105,1440,3325
"Bolivia","Oruro","Cercado","Oruro","U.E. EL CARMEN",-67.06756,-17.97467,128,12,1135,1263,479,51,593,1072
"Bolivia","Oruro","Cercado","Oruro","U. E. GUIDO VILLAGOMEZ.-",-67.12384,-17.95729,193,15,1750,1943,819,66,850,1669
"Bolivia","Oruro","Cercado","Oruro","U. E. HIJOS DEL SOL II",-67.14334,-17.97866,68,5,293,361,98,75,115,213
"Bolivia","Oruro","Cercado","Oruro","U.E. HUAJARA",-67.09364,-17.94298,389,44,3361,3750,1680,121,1516,3196
"Bolivia","Oruro","Cercado","Oruro","U. E. JESUS DE NAZARETH.-",-67.09926,-17.98237,425,41,3179,3604,1434,156,1548,2982
"Bolivia","Oruro","Cercado","Oruro","U. E. JOHN F. KENNEDY",-67.11703,-17.95129,448,28,3490,3938,1760,138,1564,3324
"Bolivia","Oruro","Cercado","Oruro","U. E. JOSE IGNACIO DE SANJINEZ.-",-67.11224,-17.97953,442,20,3127,3569,1909,88,1110,3019
"Bolivia","Oruro","Cercado","Oruro","U. E. JOSE MARIA SIERRA GALVARRO.-",-67.10973,-17.97574,491,26,3831,4322,2450,94,1261,3711
"Bolivia","Oruro","Cercado","Oruro","U. E. JUAN VELEZ DE CORDOBA (INCA POZO).",-67.12063,-17.94589,175,19,1556,1731,634,72,831,1465
"Bolivia","Oruro","Cercado","Oruro","U. E. KANTUTA II (JOSERMO MURILLO)-.",-67.10438,-17.94779,283,49,2285,2568,969,131,1136,2105
"Bolivia","Oruro","Cercado","Oruro","U.E. LOS ANGELES DE NAZARIA IGNACIA",-67.0696,-17.97254,133,9,952,1085,306,36,601,907
"Bolivia","Oruro","Cercado","Oruro","U. E. LUIS MARIO CAREAGA.-",-67.06567,-17.59111,652,57,3966,4618,1685,131,2093,3778
"Bolivia","Oruro","Cercado","Oruro","U.E. MARCELO QUIROGA SANTA CRUZ",-67.11663,-17.93236,43,5,649,692,291,15,338,629
"Bolivia","Oruro","Cercado","Oruro","U.E. MARIA  DE NAZARETH",-67.0949,-17.98389,194,22,1558,1752,566,97,873,1439
"Bolivia","Oruro","Cercado","Oruro","U. E. MCAL. ANDRES DE SANTA CRUZ.-",-67.11391,-17.95798,361,25,2527,2888,1422,83,997,2419
"Bolivia","Oruro","Cercado","Oruro","U. E. MCAL. ANTONIO JOSE DE SUCRE.-",-67.11536,-17.96788,328,16,2490,2818,1720,42,712,2432
"Bolivia","Oruro","Cercado","Oruro","U.E. MEJILLONES II(SECUNDARIO)",-67.13734,-18.00333,59,5,340,399,118,28,189,307
"Bolivia","Oruro","Cercado","Oruro","U. E. MISAEL PACHECO LOMA.-",-67.10031,-17.96391,194,6,1567,1761,932,47,582,1514
"Bolivia","Oruro","Cercado","Oruro","U. E. MOVIMIENTO SIN TECHO",-67.07934,-17.97713,507,61,3764,4271,947,165,2591,3538
"Bolivia","Oruro","Cercado","Oruro","U.E. NAL. MIXTO HUAJARA SECUNDARIO",-67.09364,-17.94298,106,13,924,1030,362,114,435,797
"Bolivia","Oruro","Cercado","Oruro","U.E. NIÑO QUIRQUINCHO FELIZ",-67.03982,-17.97784,188,23,1463,1651,551,113,776,1327
"Bolivia","Oruro","Cercado","Oruro","U. E. ORURO OTAWA (SECUNDARIA)",-67.10309,-17.97182,213,17,1686,1899,905,40,724,1629
"Bolivia","Oruro","Cercado","Oruro","U. E. OSCAR UNZAGA DE LA VEGA.-",-67.11453,-17.94222,446,43,3640,4086,1752,198,1647,3399
"Bolivia","Oruro","Cercado","Oruro","U. E. OSCAR UNZAGA DE LA VEGA II",-67.1145,-17.9421,183,15,1168,1351,558,42,553,1111
"Bolivia","Oruro","Cercado","Oruro","U.E. PARTICULAR ARRIETA",-67.11098,-17.9635,27,1,301,328,215,8,77,292
"Bolivia","Oruro","Cercado","Oruro","U.E. SAN LUIS",-67.07831,-17.93586,49,8,414,463,126,49,231,357
"Bolivia","Oruro","Cercado","Oruro","U. E. SANTA ROSA.-",-67.07967,-17.97144,339,24,2098,2437,1054,111,909,1963
"Bolivia","Oruro","Cercado","Oruro","U. ESC. BENEMERITOS DE LA PATRIA.-",-67.12161,-17.98581,230,14,1568,1798,698,61,795,1493
"Bolivia","Oruro","Cercado","Oruro","U. ESC. DIOS ES AMOR.-",-67.09901,-17.98909,99,20,887,986,317,30,520,837
"Bolivia","Oruro","Cercado","Oruro","U. ESC. EL KASSO - EL PROGRESO.-",-67.08046,-17.97144,32,7,281,313,85,10,179,264
"Bolivia","Oruro","Cercado","Oruro","U. ESC. EL PATICO.-",-67.08788,-17.93559,16,8,270,286,96,15,151,247
"Bolivia","Oruro","Cercado","Oruro","U. ESC. FRANCISCO FAJARDO.-",-67.10979,-17.95128,248,10,2030,2278,1172,75,773,1945
"Bolivia","Oruro","Cercado","Oruro","U. ESC. HIJOS DEL SOL (PLAN 500)",-67.14334,-17.97866,325,13,1820,2145,727,53,1027,1754
"Bolivia","Oruro","Cercado","Oruro","U. ESC. KANTUTA.-",-67.10198,-17.94742,586,69,4563,5149,2098,302,2094,4192
"Bolivia","Oruro","Cercado","Oruro","U. ESC. LUIS LLOSA - ESPAÑA.-",-67.10973,-17.96015,100,0,987,1087,700,20,267,967
"Bolivia","Oruro","Cercado","Oruro","U. ESC. MELVIN JONES",-67.11378,-17.94639,254,17,1955,2209,1168,79,691,1859
"Bolivia","Oruro","Cercado","Oruro","U. ESC. ORURO OTAWA (PRIMARIA)",-67.10278,-17.97236,290,24,2604,2894,1561,61,958,2519
"Bolivia","Oruro","Cercado","Oruro","U. ESC. SAN IGNACIO DE LOYOLA.-",-67.10327,-17.97707,621,33,4667,5288,2581,131,1922,4503
"Bolivia","Oruro","Cercado","Oruro","U. ESC. SAN ISIDRO",-67.08199,-17.9849,202,34,1756,1958,632,83,1007,1639
"Bolivia","Oruro","Cercado","Oruro","U. ESC. SAN JUAN DE DIOS.-",-67.0648,-17.98498,65,13,664,729,214,27,410,624
"Bolivia","Oruro","Cercado","Oruro","U. ESC. SANTA ANA I  ARENALES.-",-67.08875,-17.9662,47,4,504,551,213,16,271,484
"Bolivia","Oruro","Cercado","Oruro","U. ESC. SEBASTIAN PAGADOR(PRIMARIO)",-67.10513,-17.96682,190,15,1580,1770,1041,41,483,1524
"Bolivia","Oruro","Cercado","Oruro","U. ESC. URU URU.-",-67.13344,-17.97674,319,9,2200,2519,1130,91,970,2100
"Bolivia","Oruro","Cercado","Oruro","U.E. SOCAMANI-.",-67.04722,-17.96745,107,22,857,964,258,58,519,777
"Bolivia","Oruro","Cercado","Oruro","U.E. TOMAS BARRON.-",-67.11607,-17.93777,926,88,7014,7940,3184,304,3438,6622
"Bolivia","Oruro","Cercado","Oruro","U. E. VIRGEN DEL MAR II.-",-67.0981,-17.95885,251,26,2376,2627,1278,131,941,2219
"Bolivia","Oruro","Cercado","Oruro","U.E. VIRGEN DEL MAR III",-67.0981,-17.95885,37,1,142,179,91,2,48,139
"Bolivia","Oruro","Cercado","Soracachi","COL. EDUARDO AVAROA",-66.93476,-17.90583,31,5,480,511,160,23,292,452
"Bolivia","Oruro","Cercado","Soracachi","COL. NAL. IRUMA",-66.95744,-17.82625,34,6,354,388,112,21,215,327
"Bolivia","Oruro","Cercado","Soracachi","COL. NAL. MIXTO SORACACHI",-67.04009,-17.80021,98,19,844,942,298,59,468,766
"Bolivia","Oruro","Cercado","Soracachi","ESC. CACHI CACHI",-66.90673,-17.92398,25,14,298,323,108,14,162,270
"Bolivia","Oruro","Cercado","Soracachi","ESC. CARLOS BELTRAN MORALES",-66.74974,-17.84505,41,3,283,324,38,8,234,272
"Bolivia","Oruro","Cercado","Soracachi","ESC. CENTRAL PARIA",-67.02174,-17.82162,67,14,696,763,216,40,426,642
"Bolivia","Oruro","Cercado","Soracachi","ESC. ELIZARDO PEREZ",-66.92491,-17.94757,15,3,244,259,59,18,164,223
"Bolivia","Oruro","Cercado","Soracachi","ESC. LITORAL",-66.8653,-17.87313,10,0,189,199,20,4,165,185
"Bolivia","Oruro","Cercado","Soracachi","ESC. MULTIGRADO CULLCUPAMPA",-66.84515,-17.81123,33,5,221,254,56,24,136,192
"Bolivia","Oruro","Cercado","Soracachi","ESC. SECCIONAL CONDORCHINOCA",-66.92383,-17.81707,21,6,259,280,47,10,196,243
"Bolivia","Oruro","Cercado","Soracachi","ESC. SECCIONAL SAN JUAN PAMPA",-67.02293,-17.80466,40,5,292,332,130,11,146,276
"Bolivia","Oruro","Cercado","Soracachi","ESC. SIMON BOLIVAR",-66.95678,-17.63055,69,7,335,404,87,17,224,311
"Bolivia","Oruro","Cercado","Soracachi","ESC. SIMON BOLIVAR",-66.93806,-17.64721,69,7,335,404,87,17,224,311
"Bolivia","Oruro","Cercado","Soracachi","PLAZA DE TOLAPALCA",-66.839,-17.85507,43,8,321,364,62,17,234,296
"Bolivia","Oruro","Cercado","Soracachi","PLAZA TENIENTE BULLAIN",-67.00915,-17.9779,42,17,867,909,266,49,535,801
"Bolivia","Oruro","Cercado","Soracachi","U. E. CALAPATA",-67.07857,-17.81657,8,2,225,233,66,9,148,214
"Bolivia","Oruro","Cercado","Soracachi","U.E. EDUARDO AVAROA",-66.95867,-18.05556,45,6,486,531,120,17,343,463
"Bolivia","Oruro","Cercado","Soracachi","U.E. FRANZ TAMAYO",-67.03432,-17.68199,23,6,120,143,34,7,73,107
"Bolivia","Oruro","Cercado","Soracachi","U. E. JATITA",-67.15078,-17.74948,22,3,199,221,51,2,143,194
"Bolivia","Oruro","Cercado","Soracachi","U. E. K'ASA HUASA",-67.01914,-18.04029,16,11,232,248,90,15,116,206
"Bolivia","Oruro","Cercado","Soracachi","U. E. MCAL. ANTONIO JOSE DE SUCRE",-66.99371,-17.6637,6,0,134,140,43,9,82,125
"Bolivia","Oruro","Cercado","Soracachi","U. ESC. SIMON BOLIVAR",-66.88591,-17.77803,22,7,211,233,48,9,147,195
"Bolivia","Oruro","Ladislao Cabrera","Pampa Aullagas","ESC. FRANZ TAMAYO",-67.14696,-19.40474,3,0,140,143,47,7,86,133
"Bolivia","Oruro","Ladislao Cabrera","Pampa Aullagas","ESC. MARIA SANCHEZ FERNANDEZ",-67.06307,-19.19442,136,26,960,1096,279,42,613,892
"Bolivia","Oruro","Ladislao Cabrera","Pampa Aullagas","U.E. GUALBERTO VILLARROEL",-67.06329,-19.28214,28,2,268,296,90,7,169,259
"Bolivia","Oruro","Ladislao Cabrera","Salinas de Garcí Mendoza","COL. ANTOFAGASTA",-67.73315,-19.52218,55,6,465,520,110,17,332,442
"Bolivia","Oruro","Ladislao Cabrera","Salinas de Garcí Mendoza","COL. FRANZ TAMAYO",-67.67596,-19.63522,228,15,1143,1371,351,61,716,1067
"Bolivia","Oruro","Ladislao Cabrera","Salinas de Garcí Mendoza","ESC. AMERICA SAN MARTIN",-67.59932,-19.27503,46,3,198,244,49,7,139,188
"Bolivia","Oruro","Ladislao Cabrera","Salinas de Garcí Mendoza","ESC. CENTRAL PUQUI",-67.37225,-19.57412,45,6,349,394,54,12,277,331
"Bolivia","Oruro","Ladislao Cabrera","Salinas de Garcí Mendoza","ESC. ILDEFONSO MURGUIA",-67.94785,-19.71597,7,3,54,61,4,0,47,51
"Bolivia","Oruro","Ladislao Cabrera","Salinas de Garcí Mendoza","ESC. VILLA ESPERANZA",-67.28278,-19.39601,21,2,183,204,47,9,125,172
"Bolivia","Oruro","Ladislao Cabrera","Salinas de Garcí Mendoza","PLAZA PRINCIPAL",-67.76024,-19.25545,6,3,161,167,104,4,50,154
"Bolivia","Oruro","Ladislao Cabrera","Salinas de Garcí Mendoza","U.E. BOLIVIA LUCA",-67.8995,-19.59013,17,1,73,90,9,1,62,71
"Bolivia","Oruro","Ladislao Cabrera","Salinas de Garcí Mendoza","U. E. CONCEPCION DE BELEN",-67.88071,-19.19479,26,1,86,112,46,4,35,81
"Bolivia","Oruro","Ladislao Cabrera","Salinas de Garcí Mendoza","U.E. GERMAN BUSCH",-67.57353,-19.85675,4,0,41,45,11,2,28,39
"Bolivia","Oruro","Ladislao Cabrera","Salinas de Garcí Mendoza","U.E. OTTO SAUCEDO RIVERA",-67.42625,-19.13229,142,12,754,896,232,43,467,699
"Bolivia","Oruro","Litoral","Cruz de Machacamarca","AMB. COMITE CIVICO",-68.34784,-18.80327,1,0,78,79,18,2,58,76
"Bolivia","Oruro","Litoral","Cruz de Machacamarca","CASA COMUNAL",-68.05518,-18.69846,5,0,97,102,40,2,55,95
"Bolivia","Oruro","Litoral","Cruz de Machacamarca","ESC. CRUZ DE MACHACAMARCA",-67.75741,-18.74025,12,11,192,204,83,1,97,180
"Bolivia","Oruro","Litoral","Cruz de Machacamarca","ESC. TCNL. RAFAEL PABON.-",-68.27777,-18.77197,0,0,119,119,29,1,89,118
"Bolivia","Oruro","Litoral","Escara","CASA COMUNAL",-68.16998,-18.85891,5,2,82,87,34,2,44,78
"Bolivia","Oruro","Litoral","Escara","CASA DEL NOTARIO",-68.20262,-18.80862,0,2,155,155,54,2,97,151
"Bolivia","Oruro","Litoral","Escara","U.E. FRANZ TAMAYO",-68.16997,-18.85826,37,32,317,354,137,5,143,280
"Bolivia","Oruro","Litoral","Esmeralda","ESC. SEBASTIAN PAGADOR",-68.25356,-18.88226,8,1,185,193,77,0,107,184
"Bolivia","Oruro","Litoral","Esmeralda","IGLESIA",-67.93938,-18.92884,10,2,182,192,65,1,114,179
"Bolivia","Oruro","Litoral","Esmeralda","IGLESIA",-68.28327,-18.84608,10,2,182,192,65,1,114,179
"Bolivia","Oruro","Litoral","Esmeralda","U.E. PEDRO DOMINGO MURILLO",-68.20913,-18.91374,1,0,118,119,53,0,65,118
"Bolivia","Oruro","Litoral","Huachacalla","ESC. FE Y ALEGRIA",-68.26381,-18.79456,313,3,341,654,125,9,204,329
"Bolivia","Oruro","Litoral","Yunguyo de Litoral","ESC. JOSE BALLIVIAN",-68.31896,-18.85273,32,0,94,126,43,6,45,88
"Bolivia","Oruro","Mejillones","Carangas","ESC. ELIODORO VILLAZON",-68.62348,-18.93954,29,0,139,168,61,1,77,138
"Bolivia","Oruro","Mejillones","La Rivera","U.E. LA RIVERA",-68.63965,-19.0056,0,3,250,250,124,2,121,245
"Bolivia","Oruro","Mejillones","Todos Santos","U.E. EDUARDO AVAROA",-68.7207,-19.0161,62,5,192,254,63,3,121,184
"Bolivia","Oruro","Nor Carangas","Huayllamarca (Santiago de Huayllamarca)","COL. CHOJÑOHUMA",-67.99887,-17.75547,10,5,118,128,23,2,88,111
"Bolivia","Oruro","Nor Carangas","Huayllamarca (Santiago de Huayllamarca)","COL. LLANQUERA",-67.69202,-17.98834,75,4,423,498,106,12,301,407
"Bolivia","Oruro","Nor Carangas","Huayllamarca (Santiago de Huayllamarca)","ESC. GERMAN BUSCH",-67.63836,-18.05427,24,2,140,164,59,4,75,134
"Bolivia","Oruro","Nor Carangas","Huayllamarca (Santiago de Huayllamarca)","ESC. JESUS BELEN",-68.02042,-17.79224,4,0,119,123,34,2,83,117
"Bolivia","Oruro","Nor Carangas","Huayllamarca (Santiago de Huayllamarca)","ESC. TUNUPA",-67.88644,-17.80342,30,2,197,227,51,6,138,189
"Bolivia","Oruro","Nor Carangas","Huayllamarca (Santiago de Huayllamarca)","PLAZA PRINCIPAL",-67.9429,-17.83473,103,16,685,788,153,23,493,646
"Bolivia","Oruro","Nor Carangas","Huayllamarca (Santiago de Huayllamarca)","U. E. MEJILLONES",-67.91051,-17.86477,16,0,125,141,27,5,93,120
"Bolivia","Oruro","Nor Carangas","Huayllamarca (Santiago de Huayllamarca)","U.E. PEDRO DOMINGO MURILLO",-67.8089,-17.91016,27,7,298,325,89,3,199,288
"Bolivia","Oruro","Nor Carangas","Huayllamarca (Santiago de Huayllamarca)","U. E. SAN MIGUEL",-67.74892,-17.9582,17,7,392,409,123,12,250,373
"Bolivia","Oruro","Nor Carangas","Huayllamarca (Santiago de Huayllamarca)","U.E. SEBASTIAN PAGADOR",-67.85006,-17.99825,24,0,125,149,30,1,94,124
"Bolivia","Oruro","Pantaleón Dalence","Machacamarca","COL. P. D. MURILLO.-",-67.01683,-18.17177,247,32,1563,1810,542,53,936,1478
"Bolivia","Oruro","Pantaleón Dalence","Machacamarca","ESC. ADOLFO MIER",-67.00506,-18.10496,30,1,194,224,68,8,117,185
"Bolivia","Oruro","Pantaleón Dalence","Machacamarca","ESC. GERMAN BUSCH",-66.96426,-18.16933,89,9,398,487,130,14,245,375
"Bolivia","Oruro","Pantaleón Dalence","Villa Huanuni","COL. AYACUCHO",-66.84127,-18.28592,584,47,3859,4443,1144,193,2475,3619
"Bolivia","Oruro","Pantaleón Dalence","Villa Huanuni","ESC. DANIEL SANCHEZ BUSTAMANTE",-66.81483,-18.27406,27,2,130,157,47,9,72,119
"Bolivia","Oruro","Pantaleón Dalence","Villa Huanuni","ESC. EDUARDO AVAROA",-66.83648,-18.28687,514,57,4060,4574,1162,179,2662,3824
"Bolivia","Oruro","Pantaleón Dalence","Villa Huanuni","ESC. FRANZ TAMAYO",-66.84327,-18.28328,342,39,2940,3282,823,133,1945,2768
"Bolivia","Oruro","Pantaleón Dalence","Villa Huanuni","ESC. HUALLATIRI",-66.57692,-18.26101,29,3,189,218,31,3,152,183
"Bolivia","Oruro","Pantaleón Dalence","Villa Huanuni","ESC. OSCAR ALFARO",-66.84819,-18.07138,32,6,247,279,119,10,112,231
"Bolivia","Oruro","Pantaleón Dalence","Villa Huanuni","PLAZA PRINCIPAL",-66.74792,-18.36819,24,1,249,273,50,8,190,240
"Bolivia","Oruro","Pantaleón Dalence","Villa Huanuni","U.E. 12 DE ABRIL",-66.83877,-18.28987,121,6,358,479,134,18,200,334
"Bolivia","Oruro","Pantaleón Dalence","Villa Huanuni","U.E. MARISCAL SUCRE DE TARUCAMARCA",-66.74748,-18.27423,2,2,90,92,8,6,74,82
"Bolivia","Oruro","Pantaleón Dalence","Villa Huanuni","U.E. TAYAQUIRA",-66.68075,-18.28287,22,9,324,346,45,6,264,309
"Bolivia","Oruro","Pantaleón Dalence","Villa Huanuni","U.E. VENEZUELA",-66.83852,-18.28969,42,1,237,279,122,7,107,229
"Bolivia","Oruro","Pantaleón Dalence","Villa Huanuni","U.E. VICTOR MANUEL AYLLON",-66.79549,-18.15128,41,3,230,271,72,16,139,211
"Bolivia","Oruro","Poopó","Antequera (Bolívar)","ESC. MARISCAL ANTONIO JOSE DE SUCRE",-66.75814,-18.60952,11,2,137,148,42,5,88,130
"Bolivia","Oruro","Poopó","Antequera (Bolívar)","ESC. SEBASTIAN PAGADOR",-66.84234,-18.47896,136,19,1065,1201,557,51,438,995
"Bolivia","Oruro","Poopó","Antequera (Bolívar)","PLAZA 2 DE FEBRERO",-66.74583,-18.57221,14,5,141,155,58,8,70,128
"Bolivia","Oruro","Poopó","Paza","COL. JUAN LECHIN OQUENDO",-66.87602,-18.49693,82,7,534,616,201,17,309,510
"Bolivia","Oruro","Poopó","Paza","COL. OSCAR UNZAGA DE LA VEGA",-66.9222,-18.59495,145,16,849,994,337,42,454,791
"Bolivia","Oruro","Poopó","Paza","COL. URMIRI",-66.87689,-18.57802,15,1,117,132,68,1,47,115
"Bolivia","Oruro","Poopó","Paza","ESC. MARISCAL SUCRE.-",-66.75761,-18.69305,114,18,758,872,216,76,448,664
"Bolivia","Oruro","Poopó","Paza","U.E. GUILLERMO GUTIERREZ",-66.88187,-18.52423,23,7,261,284,100,6,148,248
"Bolivia","Oruro","Poopó","Poopó (Villa Poopó)","ESC. EDUARDO AVAROA",-66.99586,-18.28933,26,5,114,140,29,8,72,101
"Bolivia","Oruro","Poopó","Poopó (Villa Poopó)","ESC. ISMAEL MONTES",-66.96783,-18.37966,276,47,2328,2604,760,113,1408,2168
"Bolivia","Oruro","Poopó","Poopó (Villa Poopó)","ESC. MARISCAL SUCRE",-66.82631,-18.37954,13,2,111,124,22,7,80,102
"Bolivia","Oruro","Poopó","Poopó (Villa Poopó)","ESC. PUÑACA",-67.01503,-18.40687,5,0,55,60,5,3,47,52
"Bolivia","Oruro","Poopó","Poopó (Villa Poopó)","PLAZA SIMON BOLIVAR",-66.85959,-18.29434,75,10,414,489,112,20,272,384
"Bolivia","Oruro","Poopó","Poopó (Villa Poopó)","U.E. GERMAN BUSCH",-66.96021,-18.49657,0,0,49,49,11,2,36,47
"Bolivia","Oruro","Poopó","Poopó (Villa Poopó)","U.E. LIBERTADOR SIMON BOLIVAR",-66.97563,-18.45356,5,5,106,111,16,0,85,101
"Bolivia","Oruro","Sabaya","Chipaya","ESC. PUENTE TOPATER",-67.91399,-19.03246,41,1,114,155,11,5,97,108
"Bolivia","Oruro","Sabaya","Chipaya","ESC. SAN IGNACIO",-68.0725,-19.09496,20,0,70,90,6,1,63,69
"Bolivia","Oruro","Sabaya","Chipaya","U.E. SANTA ANA",-68.08934,-19.04418,227,9,411,638,129,8,265,394
"Bolivia","Oruro","Sabaya","Coipasa","U.E. COIPASA",-68.27831,-19.2763,36,3,346,382,186,4,153,339
"Bolivia","Oruro","Sabaya","Sabaya","CASA COMUNAL",-68.73852,-18.73852,1,0,167,168,118,0,49,167
"Bolivia","Oruro","Sabaya","Sabaya","CASA COMUNAL",-68.47369,-19.00466,1,0,167,168,118,0,49,167
"Bolivia","Oruro","Sabaya","Sabaya","CASA DEL NOTARIO",-68.5004,-19.06247,14,0,91,105,61,1,29,90
"Bolivia","Oruro","Sabaya","Sabaya","ESC. EDUARDO AVAROA",-68.87798,-19.03987,0,4,30,30,8,4,14,22
"Bolivia","Oruro","Sabaya","Sabaya","ESC. FELIX FERNANDEZ",-68.52093,-18.96744,4,0,97,101,67,0,30,97
"Bolivia","Oruro","Sabaya","Sabaya","ESC. FRANZ TAMAYO",-68.35445,-19.19073,0,2,298,298,183,4,109,292
"Bolivia","Oruro","Sabaya","Sabaya","ESC. FRANZ TAMAYO",-68.31431,-18.76981,0,2,298,298,183,4,109,292
"Bolivia","Oruro","Sabaya","Sabaya","ESC. GERMAN BUSCH",-68.61129,-18.82781,11,0,201,212,80,2,119,199
"Bolivia","Oruro","Sabaya","Sabaya","ESC. GUALBERTO VILLARROEL",-68.78839,-18.57318,2,3,107,109,35,2,67,102
"Bolivia","Oruro","Sabaya","Sabaya","ESC. ILDEFONSO MURGUIA",-68.89094,-18.69991,8,1,199,207,104,1,93,197
"Bolivia","Oruro","Sabaya","Sabaya","ESC. JOSE MARIA EGUES CUELLAR",-68.37302,-19.01429,145,8,404,549,192,20,184,376
"Bolivia","Oruro","Sabaya","Sabaya","ESC. JOSE MARIA MONTAÑO",-68.53316,-18.90277,2,0,113,115,92,0,21,113
"Bolivia","Oruro","Sabaya","Sabaya","ESC. JOSE MERIDA MONTAÑO",-68.64622,-18.70486,15,0,103,118,78,1,24,102
"Bolivia","Oruro","Sabaya","Sabaya","ESC. PITACOLLO",-68.59029,-19.05312,3,1,85,88,14,0,70,84
"Bolivia","Oruro","Sabaya","Sabaya","ESC. SEBASTIAN  PAGADOR",-68.37182,-19.01886,0,3,154,154,105,1,45,150
"Bolivia","Oruro","Sabaya","Sabaya","ESC. VERALINES",-68.55422,-19.20341,4,0,121,125,90,2,29,119
"Bolivia","Oruro","Sabaya","Sabaya","IGLESIA",-68.80792,-18.79146,0,0,54,54,32,0,22,54
"Bolivia","Oruro","Sabaya","Sabaya","PLAZA 25 DE JULIO MIRAFLORES",-68.54026,-18.65128,0,0,33,33,20,0,13,33
"Bolivia","Oruro","Sabaya","Sabaya","PLAZA SIMON BOLIVAR",-68.52158,-18.8665,12,0,67,79,41,0,26,67
"Bolivia","Oruro","Sabaya","Sabaya","U. E.  CONCEPCION COMUJO",-68.38916,-19.21006,2,1,104,106,67,0,36,103
"Bolivia","Oruro","Sabaya","Sabaya","U.E. JOSE ANTONIO ARCE",-68.68381,-18.44296,24,0,126,150,80,0,46,126
"Bolivia","Oruro","Sabaya","Sabaya","U.E. LIBERTADOR SIMON BOLIVAR",-68.61559,-19.27332,69,5,224,293,121,13,85,206
"Bolivia","Oruro","Sabaya","Sabaya","U.E. MARIA EVANS CUELLAR",-68.34265,-19.09297,6,0,120,126,96,1,23,119
"Bolivia","Oruro","Sabaya","Sabaya","U.E. PEDRO DOMINGO MURILLO",-68.53796,-18.92385,3,0,138,141,90,2,46,136
"Bolivia","Oruro","Sajama","Curahuara de Carangas","COL. BOLIVIA",-68.97609,-18.13643,46,4,160,206,74,7,75,149
"Bolivia","Oruro","Sajama","Curahuara de Carangas","ESC. EDUARDO SAGARNAGA",-68.41264,-17.84149,592,39,1589,2181,355,73,1122,1477
"Bolivia","Oruro","Sajama","Curahuara de Carangas","U.E. HACIA EL MAR",-68.83837,-18.00538,7,0,67,74,17,0,50,67
"Bolivia","Oruro","Sajama","Curahuara de Carangas","U.E. LITORAL B",-68.93645,-18.2223,29,1,148,177,56,6,85,141
"Bolivia","Oruro","Sajama","Turco","CASA COMUNAL",-68.94479,-18.53836,11,0,57,68,18,0,39,57
"Bolivia","Oruro","Sajama","Turco","ESC. CENTRAL TURCO",-68.19347,-18.18156,204,16,956,1160,212,23,705,917
"Bolivia","Oruro","Sajama","Turco","ESC. GUALBERTO VILLARROEL - IRUNI.-",-68.5331,-18.60372,2,0,40,42,6,0,34,40
"Bolivia","Oruro","Sajama","Turco","ESC. WALBERTO VILLARROEL",-68.62778,-18.34289,5,0,31,36,6,1,24,30
"Bolivia","Oruro","Sajama","Turco","NUCLEO ESCOLAR TITIRI",-68.33176,-18.38792,23,0,73,96,6,6,61,67
"Bolivia","Oruro","Sajama","Turco","U.E. ASUNCION DE HUAJRIRE",-68.37857,-18.21539,1,0,21,22,5,1,15,20
"Bolivia","Oruro","Sajama","Turco","U.E. EDUARDO AVAROA",-67.94069,-18.01298,21,1,96,117,16,2,77,93
"Bolivia","Oruro","Sajama","Turco","U.E. PEDRO DOMINGO MURILLO A",-68.71188,-18.17634,64,5,377,441,59,10,303,362
"Bolivia","Oruro","Sajama","Turco","U.E. PORVENIR",-68.94597,-18.35423,43,1,283,326,108,13,161,269
"Bolivia","Oruro","San Pedro De Totora","San Pedro de Totora","COL. NAL. CALAZAYA",-68.29729,-17.66094,64,7,295,359,30,6,252,282
"Bolivia","Oruro","San Pedro De Totora","San Pedro de Totora","COMEDOR ESCOLAR",-68.31258,-17.89262,17,1,100,117,29,4,66,95
"Bolivia","Oruro","San Pedro De Totora","San Pedro de Totora","ESC. CENTRAL SORA SORA",-68.10621,-17.9355,13,2,223,236,24,4,193,217
"Bolivia","Oruro","San Pedro De Totora","San Pedro de Totora","ESC. FRANZ TAMAYO",-68.09863,-17.82198,10,1,185,195,30,3,151,181
"Bolivia","Oruro","San Pedro De Totora","San Pedro de Totora","ESC. LITORAL DE CULTA.-",-68.03839,-17.97308,29,0,197,226,18,9,170,188
"Bolivia","Oruro","San Pedro De Totora","San Pedro de Totora","ESC. MARQUIRIVI",-67.9737,-17.95451,13,0,69,82,26,2,41,67
"Bolivia","Oruro","San Pedro De Totora","San Pedro de Totora","U.E. CENTRO REVITO",-68.02218,-17.91033,7,0,76,83,18,2,56,74
"Bolivia","Oruro","San Pedro De Totora","San Pedro de Totora","U.E. ROMEROCOTA",-68.25556,-17.92027,0,2,77,77,4,14,57,61
"Bolivia","Oruro","San Pedro De Totora","San Pedro de Totora","U.E. SEBASTIAN PAGADOR",-68.28579,-17.79087,14,1,127,141,13,1,112,125
"Bolivia","Oruro","San Pedro De Totora","San Pedro de Totora","U.E. TOTORA",-68.14532,-17.7922,149,17,789,938,119,46,607,726
"Bolivia","Oruro","San Pedro De Totora","San Pedro de Totora","U.E. VINO HUTA",-68.2402,-17.8328,12,1,132,144,14,2,115,129
"Bolivia","Oruro","Saucarí","Toledo","CASA COMUNAL",-67.42073,-18.08936,27,0,115,142,41,3,71,112
"Bolivia","Oruro","Saucarí","Toledo","CASA COMUNAL",-67.00774,-18.14512,27,0,115,142,41,3,71,112
"Bolivia","Oruro","Saucarí","Toledo","CASA COMUNAL CENTRAL MOLLOCO",-67.49101,-18.40378,4,4,77,81,14,1,58,72
"Bolivia","Oruro","Saucarí","Toledo","CASA DEL NOTARIO",-67.58843,-18.20439,13,0,67,80,18,1,48,66
"Bolivia","Oruro","Saucarí","Toledo","COL. NACIONAL TOLEDO",-67.4108,-18.1808,250,14,998,1248,299,37,648,947
"Bolivia","Oruro","Saucarí","Toledo","ESC. EDUARDO AVAROA",-67.58844,-18.20436,10,1,95,105,26,17,51,77
"Bolivia","Oruro","Saucarí","Toledo","ESC. ELIZARDO PEREZ 1",-67.28907,-18.29798,32,2,137,169,31,5,99,130
"Bolivia","Oruro","Saucarí","Toledo","ESC. GERMAN BUSCH 1",-67.54126,-18.26623,31,1,139,170,54,5,79,133
"Bolivia","Oruro","Saucarí","Toledo","ESC. GERMAN BUSCH II",-67.40559,-18.50244,1,0,123,124,24,5,94,118
"Bolivia","Oruro","Saucarí","Toledo","ESC. ISAC PORTO CARRERA",-67.59666,-18.02896,38,2,149,187,28,2,117,145
"Bolivia","Oruro","Saucarí","Toledo","ESC. M. M. VACA GUZMAN.-",-67.2721,-17.47592,70,5,282,352,87,9,181,268
"Bolivia","Oruro","Saucarí","Toledo","ESC. PUMASARA",-67.35503,-18.6561,21,0,120,141,19,3,98,117
"Bolivia","Oruro","Saucarí","Toledo","U.E. ANTONIO JOSE DE SUCRE",-67.51073,-18.37418,10,0,38,48,11,0,27,38
"Bolivia","Oruro","Saucarí","Toledo","U.E. BARTOLINA SISA",-67.46616,-18.43586,6,1,101,107,21,2,77,98
"Bolivia","Oruro","Saucarí","Toledo","U.E. FRANZ TAMAYO",-67.59203,-18.1406,5,0,45,50,16,2,27,43
"Bolivia","Oruro","Saucarí","Toledo","U. E. GUALBERTO VILLARROEL",-67.49483,-17.94513,17,2,121,138,27,1,91,118
"Bolivia","Oruro","Saucarí","Toledo","U.E. MARCELO QUIROGA SANTA CRUZ",-67.40546,-18.39192,20,1,61,81,9,0,51,60
"Bolivia","Oruro","Saucarí","Toledo","U.E. OTTO SAUCEDO",-67.5033,-18.48854,5,2,125,130,31,2,90,121
"Bolivia","Oruro","Saucarí","Toledo","U. ESC. TIJLLACAHUA",-67.46854,-17.94667,19,0,69,88,26,3,40,66
"Bolivia","Oruro","Sebastian Pagador","Santiago de Huari","COL. MIXTO GUALBERTO VILLARROEL",-66.77557,-19.00875,215,27,1528,1743,585,126,790,1375
"Bolivia","Oruro","Sebastian Pagador","Santiago de Huari","ESC. CAICO BOLIVAR",-66.75815,-19.25462,9,1,88,97,39,1,47,86
"Bolivia","Oruro","Sebastian Pagador","Santiago de Huari","ESC. CALACOTA",-66.46594,-19.14192,8,0,69,77,16,3,50,66
"Bolivia","Oruro","Sebastian Pagador","Santiago de Huari","ESC. CASTILLA HUMA",-66.71346,-19.14007,38,4,229,267,86,9,130,216
"Bolivia","Oruro","Sebastian Pagador","Santiago de Huari","ESC. CONDO K",-66.8055,-19.17203,14,2,140,154,67,3,68,135
"Bolivia","Oruro","Sebastian Pagador","Santiago de Huari","ESC. LLAPALLAPANI",-66.81982,-19.01081,17,2,117,134,25,6,84,109
"Bolivia","Oruro","Sebastian Pagador","Santiago de Huari","ESC. VICHAJ LUPE",-66.7529,-19.25462,42,1,245,287,68,12,164,232
"Bolivia","Oruro","Sebastian Pagador","Santiago de Huari","NUCLEO ESCOLAR BOLIVIA",-66.74451,-19.15185,14,1,284,298,50,3,230,280
"Bolivia","Oruro","Sebastian Pagador","Santiago de Huari","NUCLEO MARCA LAGUNILLAS",-66.27309,-19.23056,34,7,472,506,107,23,335,442
"Bolivia","Oruro","Sebastian Pagador","Santiago de Huari","U. E. LUCUMPAYA",-66.69658,-19.29461,8,0,57,65,10,1,46,56
"Bolivia","Oruro","Sebastian Pagador","Santiago de Huari","U.E. NAZACARA",-66.48449,-19.15744,0,3,121,121,41,7,70,111
"Bolivia","Oruro","Sebastian Pagador","Santiago de Huari","U.E. SAN PEDRO DE CONDO",-66.74747,-19.04341,105,9,553,658,205,24,315,520
"Bolivia","Oruro","Sebastian Pagador","Santiago de Huari","U. E. URMIRI DE QUILLACAS",-66.72021,-19.22743,39,3,211,250,43,4,161,204
"Bolivia","Oruro","Sebastian Pagador","Santiago de Huari","U. E. VILLA VERDE",-66.76753,-19.11843,23,3,130,153,43,2,82,125
"Bolivia","Oruro","Sur Carangas","Andamarca (Santiago de Andamarca)","ESC. SEBASTIAN PAGADOR",-67.50749,-18.77982,183,24,688,871,200,12,452,652
"Bolivia","Oruro","Sur Carangas","Andamarca (Santiago de Andamarca)","U.E. MEJILLONES",-67.50016,-18.87049,84,25,540,624,111,8,396,507
"Bolivia","Oruro","Sur Carangas","Andamarca (Santiago de Andamarca)","U.E. ORINOCA",-67.25661,-18.96682,110,3,804,914,64,11,726,790
"Bolivia","Oruro","Sur Carangas","Belén de Andamarca","COL. TEC. HUMANISTICO SIMON BOLIVAR",-67.64007,-18.8171,46,7,330,376,123,7,193,316
"Bolivia","Oruro","Sur Carangas","Belén de Andamarca","ESC. ANICETO ARCE",-67.75741,-18.74025,0,4,178,178,36,5,133,169
"Bolivia","Oruro","Sur Carangas","Belén de Andamarca","ESC. ELIZARDO PEREZ",-67.67679,-18.76107,11,0,101,112,20,3,78,98
"Bolivia","Oruro","Sur Carangas","Belén de Andamarca","U.E. BOLIVIA",-67.69051,-18.75176,16,7,183,199,38,9,129,167
"Bolivia","Oruro","Tomas Barrón","Eucaliptus","COL. NAL. EUCALIPTUS",-67.51264,-17.59574,6,1,62,68,11,0,50,61
"Bolivia","Oruro","Tomas Barrón","Eucaliptus","ESC. HUANCAROMA",-67.49158,-17.66445,18,0,121,139,18,0,103,121
"Bolivia","Oruro","Tomas Barrón","Eucaliptus","ESC. MARISCAL ANTONIO JOSE DE SUCRE",-67.39827,-17.62614,24,4,167,191,19,3,141,160
"Bolivia","Oruro","Tomas Barrón","Eucaliptus","ESC. TUPAC KATARI",-67.45214,-17.5953,4,2,200,204,36,6,156,192
"Bolivia","Oruro","Tomas Barrón","Eucaliptus","U.E. BENEDETO VINCENTI",-67.50977,-17.59444,216,21,1308,1524,381,32,874,1255
"Bolivia","Oruro","Tomas Barrón","Eucaliptus","U.E. MACHACAMARCA",-67.35824,-17.64213,10,0,105,115,11,4,90,101
"Bolivia","Oruro","Tomas Barrón","Eucaliptus","U.E. QUELCATA",-67.48569,-17.56117,56,13,325,381,55,8,249,304
"Bolivia","Pando","Abuná","Ingavi (Humaita)","U.E. DERREPENTE",-66.94105,-10.93787,0,0,68,68,37,12,19,56
"Bolivia","Pando","Abuná","Ingavi (Humaita)","U.E. HUMAITA",-66.44747,-10.82152,119,2,372,491,178,7,185,363
"Bolivia","Pando","Abuná","Ingavi (Humaita)","U.E. INGAVI",-66.82959,-10.95218,44,4,99,143,43,3,49,92
"Bolivia","Pando","Abuná","Ingavi (Humaita)","U.E. LAS AMALIAS",-66.79862,-10.97642,5,0,25,30,1,1,23,24
"Bolivia","Pando","Abuná","Santa Rosa del Abun","U.E. ABUNA",-67.45408,-10.60663,141,5,236,377,114,8,109,223
"Bolivia","Pando","Abuná","Santa Rosa del Abun","U.E. AUGUSTO GUTIERREZ BANZER",-67.35876,-10.85149,1,0,80,81,20,2,58,78
"Bolivia","Pando","Abuná","Santa Rosa del Abun","U.E. GENOVEVA RÍOS",-67.42355,-10.9903,63,5,223,286,45,2,171,216
"Bolivia","Pando","Abuná","Santa Rosa del Abun","U.E. PEDRO DOMINGO MURRILLO",-67.32189,-10.64891,16,0,100,116,8,0,92,100
"Bolivia","Pando","Abuná","Santa Rosa del Abun","U.E.  ZACARIAS MORENO",-67.48418,-10.87283,41,0,203,244,127,2,74,201
"Bolivia","Pando","Federico Román","Nuevo Manoa (Nueva Esperanza)","U.E. GRAL. FEDERICO ROMÁN",-65.50873,-10.47329,103,1,148,251,95,2,50,145
"Bolivia","Pando","Federico Román","Nuevo Manoa (Nueva Esperanza)","U.E. LA GRAN CRUZ",-65.40121,-10.36206,19,2,61,80,7,1,51,58
"Bolivia","Pando","Federico Román","Nuevo Manoa (Nueva Esperanza)","U.E.  MANUEL ESTREMADOIRO MARTINEZ",-65.34017,-10.05819,213,1,270,483,159,3,107,266
"Bolivia","Pando","Federico Román","Nuevo Manoa (Nueva Esperanza)","U.E.  MONTE SINAI",-65.31994,-10.25371,30,9,137,167,11,6,111,122
"Bolivia","Pando","Federico Román","Nuevo Manoa (Nueva Esperanza)","U.E. RUFINO CHAO",-65.59814,-10.53096,44,3,52,96,30,0,19,49
"Bolivia","Pando","Federico Román","Santos Mercado","19 DE OCTUBRE",-66.15702,-10.52243,181,2,367,548,177,6,182,359
"Bolivia","Pando","Federico Román","Santos Mercado","U.E. 11 DE SEPTIEMBRE",-66.40456,-10.258,54,1,170,224,50,2,117,167
"Bolivia","Pando","Federico Román","Santos Mercado","U.E.  23 DE MARZO",-66.30795,-10.4217,116,5,347,463,169,9,164,333
"Bolivia","Pando","Federico Román","Villa Nueva (Loma Alta)","U.E.  ANDRES IDAGUA",-65.96667,-10.79472,161,6,476,637,216,7,247,463
"Bolivia","Pando","Federico Román","Villa Nueva (Loma Alta)","U.E. ENAREVENA",-66.10579,-10.57579,9,0,51,60,28,0,23,51
"Bolivia","Pando","Federico Román","Villa Nueva (Loma Alta)","U.E. JUANA AZURDUY DE PADILLA",-66.15096,-10.79327,39,3,77,116,31,0,43,74
"Bolivia","Pando","Federico Román","Villa Nueva (Loma Alta)","U.E.  ROBERTO GONZALES",-65.88841,-10.6848,57,5,184,241,76,1,102,178
"Bolivia","Pando","Madre De Dios","El Sena","U.E.  2 DE AGOSTO",-67.05062,-11.45478,6,4,71,77,51,2,14,65
"Bolivia","Pando","Madre De Dios","El Sena","U.E. 4 DE AGOSTO",-67.01925,-12.17563,26,1,86,112,26,1,58,84
"Bolivia","Pando","Madre De Dios","El Sena","U.E. DE PEKIN",-67.65797,-12.00184,43,1,72,115,43,1,27,70
"Bolivia","Pando","Madre De Dios","El Sena","U.E. EL SENA",-67.24951,-11.48288,498,19,1417,1915,740,25,633,1373
"Bolivia","Pando","Madre De Dios","El Sena","U.E. EL TURI (RIO MANURAPE)",-67.28406,-11.69199,4,2,46,50,27,4,13,40
"Bolivia","Pando","Madre De Dios","El Sena","U.E. LAS MERCEDES",-67.27101,-11.87276,7,2,73,80,35,1,35,70
"Bolivia","Pando","Madre De Dios","El Sena","U.E. PALMA REAL",-67.72301,-11.65824,67,2,174,241,89,5,78,167
"Bolivia","Pando","Madre De Dios","El Sena","U.E. REMANSO",-67.29217,-11.76813,6,1,66,72,20,0,45,65
"Bolivia","Pando","Madre De Dios","El Sena","U.E. SAN FRANCISCO",-67.31672,-12.17345,50,5,166,216,53,6,102,155
"Bolivia","Pando","Madre De Dios","El Sena","U.E. SANTA ELENA",-67.48461,-11.78688,17,2,62,79,17,0,43,60
"Bolivia","Pando","Madre De Dios","El Sena","U.E. SANTA ROSA",-67.38081,-12.04853,30,0,54,84,25,0,29,54
"Bolivia","Pando","Madre De Dios","Puerto Gonzalo Moreno","U.E. 2 DE AGOSTO",-66.41665,-11.36894,29,1,141,170,44,4,92,136
"Bolivia","Pando","Madre De Dios","Puerto Gonzalo Moreno","U.E. AGUA DULCE",-66.20935,-11.00872,71,0,134,205,61,2,71,132
"Bolivia","Pando","Madre De Dios","Puerto Gonzalo Moreno","U.E. LUZ EN EL CAMINO",-66.17489,-11.08213,419,13,992,1411,426,29,524,950
"Bolivia","Pando","Madre De Dios","Puerto Gonzalo Moreno","U.E. MIRAFLORES",-66.40204,-11.10459,33,2,168,201,37,2,127,164
"Bolivia","Pando","Madre De Dios","Puerto Gonzalo Moreno","U.E. PEDRO HERRERA",-66.13277,-11.03917,184,5,501,685,266,7,223,489
"Bolivia","Pando","Madre De Dios","Puerto Gonzalo Moreno","U.E.  PORTACHUELO DIOS ES AMOR",-66.26447,-11.31525,108,8,329,437,50,4,267,317
"Bolivia","Pando","Madre De Dios","San Lorenzo","ESCUELA EDUARDO ABAROA",-66.95135,-11.30087,11,0,74,85,50,1,23,73
"Bolivia","Pando","Madre De Dios","San Lorenzo","U.E. 21 DE SEPTIEMBRE",-66.93037,-11.5493,9,0,60,69,24,0,36,60
"Bolivia","Pando","Madre De Dios","San Lorenzo","U.E.  24 DE SEPTIEMBRE",-66.9321,-11.72435,248,13,785,1033,256,13,503,759
"Bolivia","Pando","Madre De Dios","San Lorenzo","U.E. 27 DE MAYO",-66.81934,-11.2835,19,5,144,163,35,5,99,134
"Bolivia","Pando","Madre De Dios","San Lorenzo","U.E. 6 DE AGOSTO",-66.80107,-11.51633,0,0,118,118,0,1,117,117
"Bolivia","Pando","Madre De Dios","San Lorenzo","U.E.  6 DE JUNIO",-66.84736,-11.30354,9,1,62,71,2,0,59,61
"Bolivia","Pando","Madre De Dios","San Lorenzo","U.E.  BRUNO RACUA",-66.98441,-11.34711,12,0,81,93,38,6,37,75
"Bolivia","Pando","Madre De Dios","San Lorenzo","U.E. DE IBERIA",-66.74494,-11.69689,11,1,30,41,9,0,20,29
"Bolivia","Pando","Madre De Dios","San Lorenzo","U.E. DE ROSARIO",-66.93926,-12.29388,33,0,52,85,27,0,25,52
"Bolivia","Pando","Madre De Dios","San Lorenzo","U.E.  FEDERICO HECKER",-66.9248,-12.17911,27,0,70,97,31,1,38,69
"Bolivia","Pando","Madre De Dios","San Lorenzo","U.E. GALILEA",-66.56686,-11.41806,34,5,146,180,39,7,95,134
"Bolivia","Pando","Madre De Dios","San Lorenzo","U.E.  GENOVEVA RIOS",-66.80064,-11.27083,23,0,55,78,29,3,23,52
"Bolivia","Pando","Madre De Dios","San Lorenzo","U.E. GREGORIA DESTRE MATURANA",-66.5792,-11.1674,19,2,165,184,58,2,103,161
"Bolivia","Pando","Madre De Dios","San Lorenzo","U.E. NUEVO HORIZONTE",-66.67747,-11.44474,1,0,43,44,20,1,22,42
"Bolivia","Pando","Madre De Dios","San Lorenzo","U.E. PTO. COPACABANA",-66.68026,-11.54849,99,1,113,212,57,9,46,103
"Bolivia","Pando","Madre De Dios","San Lorenzo","U.E.  SOLEDAD",-66.9871,-11.57613,66,2,173,239,73,2,96,169
"Bolivia","Pando","Madre De Dios","San Lorenzo","U.E. VISTA ALEGRE",-66.6041,-11.3245,35,2,202,237,97,4,99,196
"Bolivia","Pando","Manuripi","Filadelfia","U.E. ALTA GRACIA",-68.25834,-11.60331,89,1,39,128,3,0,35,38
"Bolivia","Pando","Manuripi","Filadelfia","U.E. BUYUYO",-68.80491,-11.61425,14,1,127,141,33,4,89,122
"Bolivia","Pando","Manuripi","Filadelfia","U.E. CHIVE",-68.58688,-12.39163,93,9,220,313,105,8,98,203
"Bolivia","Pando","Manuripi","Filadelfia","U.E. CURICHON",-68.56036,-12.00636,24,4,101,125,48,0,49,97
"Bolivia","Pando","Manuripi","Filadelfia","U.E. DE HOLANDA",-68.71101,-11.76399,46,2,185,231,56,8,119,175
"Bolivia","Pando","Manuripi","Filadelfia","U.E. DE LA CRUZ",-68.10158,-11.98084,7,0,32,39,9,1,22,31
"Bolivia","Pando","Manuripi","Filadelfia","U.E. FILADELFIA",-68.74851,-11.32842,105,3,346,451,156,5,182,338
"Bolivia","Pando","Manuripi","Filadelfia","U.E.  FLORIDA",-68.63426,-12.19954,7,1,90,97,34,0,55,89
"Bolivia","Pando","Manuripi","Filadelfia","U.E.  JUANCITO PINTO",-68.98754,-11.87768,51,4,208,259,82,3,119,201
"Bolivia","Pando","Manuripi","Filadelfia","U.E. LUZ DE AMERICA",-68.6104,-12.12153,10,1,114,124,52,4,57,109
"Bolivia","Pando","Manuripi","Filadelfia","U.E. NUEVA ALIANZA",-68.35039,-11.37201,57,1,288,345,126,4,157,283
"Bolivia","Pando","Manuripi","Filadelfia","U.E. NUEVA EMPRESA",-68.81753,-11.49919,57,5,326,383,131,3,187,318
"Bolivia","Pando","Manuripi","Filadelfia","U.E. SAN ANTONIO",-68.58239,-12.04789,4,1,48,52,16,0,31,47
"Bolivia","Pando","Manuripi","Filadelfia","U.E. UCIA",-68.97458,-11.75343,14,5,67,81,5,0,57,62
"Bolivia","Pando","Manuripi","Filadelfia","U.E. VILLA AMERICA",-68.49368,-11.61459,14,1,93,107,44,3,45,89
"Bolivia","Pando","Manuripi","Filadelfia","U.E. VILLA BELLA",-68.72463,-11.44835,30,3,131,161,73,1,54,127
"Bolivia","Pando","Manuripi","Puerto Rico","U.E. BATRAJA",-67.32244,-11.29704,27,4,216,243,105,5,102,207
"Bolivia","Pando","Manuripi","Puerto Rico","U.E. DE LAS ARENAS",-67.69072,-11.58415,195,0,21,216,4,0,17,21
"Bolivia","Pando","Manuripi","Puerto Rico","U.E. DE PALESTINA",-67.09533,-11.03269,21,0,56,77,25,0,31,56
"Bolivia","Pando","Manuripi","Puerto Rico","U.E.  GERMAN BUSCH",-67.17651,-11.30694,0,7,396,396,151,57,181,332
"Bolivia","Pando","Manuripi","Puerto Rico","U.E. HIROSHIMA",-67.83469,-11.39288,7,0,24,31,17,1,6,23
"Bolivia","Pando","Manuripi","Puerto Rico","U.E.  LA SALLE EMETERIO RUIZ",-67.5565,-11.10394,735,18,1582,2317,735,42,787,1522
"Bolivia","Pando","Manuripi","Puerto Rico","U.E.  LOS MANDARINOS",-67.44718,-11.24423,1,2,28,29,11,2,13,24
"Bolivia","Pando","Manuripi","Puerto Rico","U.E. MANCHESTER",-67.999,-11.47539,39,0,59,98,41,0,18,59
"Bolivia","Pando","Manuripi","Puerto Rico","U.E.  SAN ANTONIO",-67.39052,-11.29652,7,0,85,92,15,3,67,82
"Bolivia","Pando","Manuripi","Puerto Rico","U.E.  SILVERIO ROJAS GONZALES",-66.75974,-11.58043,13,2,96,109,37,0,57,94
"Bolivia","Pando","Manuripi","San Pedro","U.E.  12 DE ABRIL",-66.18632,-10.82638,120,2,155,275,90,3,60,150
"Bolivia","Pando","Manuripi","San Pedro","U.E. FORTALEZA",-66.32966,-10.84701,140,0,177,317,77,1,99,176
"Bolivia","Pando","Manuripi","San Pedro","U.E.  JORGE HAENSEL",-66.44067,-10.94822,20,2,135,155,86,1,46,132
"Bolivia","Pando","Nicolás Suárez","Bella Flor","ESC. SANTA ELENA",-67.82802,-11.04349,7,0,11,18,6,0,5,11
"Bolivia","Pando","Nicolás Suárez","Bella Flor","U.E. BUENA VISTA",-67.67737,-11.09413,45,1,80,125,46,1,32,78
"Bolivia","Pando","Nicolás Suárez","Bella Flor","U.E. DE FLORIDA",-67.63081,-11.11081,5,0,18,23,1,0,17,18
"Bolivia","Pando","Nicolás Suárez","Bella Flor","U.E.  HUGO ANTEQUERA",-67.89793,-11.08514,94,4,320,414,178,9,129,307
"Bolivia","Pando","Nicolás Suárez","Bella Flor","U.E. JORGE BENITO VERA",-67.27247,-10.31881,154,2,277,431,132,7,136,268
"Bolivia","Pando","Nicolás Suárez","Bella Flor","U.E.  KM. 35 DE KARAMANU",-68.34393,-11.14225,62,5,251,313,84,6,156,240
"Bolivia","Pando","Nicolás Suárez","Bella Flor","U.E.  KM. 60 DE SAN ANTONIO",-68.09121,-11.16999,48,4,143,191,50,0,89,139
"Bolivia","Pando","Nicolás Suárez","Bella Flor","U.E. MAPAJO",-67.6199,-10.62717,30,1,69,99,32,0,36,68
"Bolivia","Pando","Nicolás Suárez","Bella Flor","U.E. SANTA LOURDES",-68.47906,-11.13931,23,0,103,126,50,2,51,101
"Bolivia","Pando","Nicolás Suárez","Bella Flor","U.E. SIMON BOLÍVAR",-67.61858,-10.90335,15,0,142,157,37,5,100,137
"Bolivia","Pando","Nicolás Suárez","Bolpebra (Mukden)","U.E. BIOCEANICA",-69.37039,-11.13272,45,1,123,168,74,1,47,121
"Bolivia","Pando","Nicolás Suárez","Bolpebra (Mukden)","U.E. DE BOLPEBRA",-69.56477,-10.94741,21,2,76,97,25,4,45,70
"Bolivia","Pando","Nicolás Suárez","Bolpebra (Mukden)","U.E. DE MUKDEN",-69.02858,-11.1877,48,3,222,270,168,6,45,213
"Bolivia","Pando","Nicolás Suárez","Bolpebra (Mukden)","U.E. DE YAMINAHUA",-69.42874,-10.93892,21,0,57,78,16,4,37,53
"Bolivia","Pando","Nicolás Suárez","Bolpebra (Mukden)","U.E.  GENOVEVA RIOS",-69.06962,-11.28025,62,3,218,280,111,3,101,212
"Bolivia","Pando","Nicolás Suárez","Bolpebra (Mukden)","U.E. NUEVA CANAÁN",-69.22169,-11.14435,49,0,74,123,26,3,45,71
"Bolivia","Pando","Nicolás Suárez","Bolpebra (Mukden)","U.E. SAN MIGUEL",-69.48006,-10.95564,4,0,12,16,0,0,12,12
"Bolivia","Pando","Nicolás Suárez","Bolpebra (Mukden)","U.E.  SANTA LUCIA",-69.01627,-11.25383,21,0,101,122,55,6,40,95
"Bolivia","Pando","Nicolás Suárez","Bolpebra (Mukden)","U.E. TRES ESTRELLAS",-69.27618,-11.33935,15,0,65,80,28,1,36,64
"Bolivia","Pando","Nicolás Suárez","Cobija","CARCEL PUBLICA (VILLA BUSCH)",-68.78143,-11.08489,37,2,131,168,61,4,64,125
"Bolivia","Pando","Nicolás Suárez","Cobija","KINDER VICTOR LEON ARUETA (VACA DIEZ MEDIO)",-68.76038,-11.02101,82,1,280,362,195,7,77,272
"Bolivia","Pando","Nicolás Suárez","Cobija","U. E. 11 DE OCTUBRE",-68.75275,-11.01869,404,10,1729,2133,1009,47,663,1672
"Bolivia","Pando","Nicolás Suárez","Cobija","U. E.  AMERICA",-68.75782,-11.01896,121,6,541,662,353,20,162,515
"Bolivia","Pando","Nicolás Suárez","Cobija","U. E. COBIJA",-68.77015,-11.03708,761,16,2513,3274,1543,61,893,2436
"Bolivia","Pando","Nicolás Suárez","Cobija","U.E. DE BELLA VISTA",-68.78143,-11.08489,184,9,920,1104,462,21,428,890
"Bolivia","Pando","Nicolás Suárez","Cobija","U.E. DEFENSORES DEL ACRE",-68.76064,-11.02505,535,21,2110,2645,1216,46,827,2043
"Bolivia","Pando","Nicolás Suárez","Cobija","U.E. GERMAN BUSCH",-67.17651,-11.30694,190,7,954,1144,543,18,386,929
"Bolivia","Pando","Nicolás Suárez","Cobija","U. E. INSTITUTO AMERICANO",-68.75738,-11.02217,161,3,694,855,454,19,218,672
"Bolivia","Pando","Nicolás Suárez","Cobija","U. E. JOSÉ MANUEL PANDO",-68.75738,-11.02217,546,28,2464,3010,1387,72,977,2364
"Bolivia","Pando","Nicolás Suárez","Cobija","U. E. JUANA AZURDUY DE PADILLA",-68.77395,-11.03823,194,1,502,696,318,8,175,493
"Bolivia","Pando","Nicolás Suárez","Cobija","U. E. MANUELA ROJAS",-68.77524,-11.03517,367,15,1822,2189,1158,57,592,1750
"Bolivia","Pando","Nicolás Suárez","Cobija","U.E. MARIANO BAPTISTA (EDIFICIO SEDUCA)",-68.7578,-11.02304,233,4,916,1149,592,44,276,868
"Bolivia","Pando","Nicolás Suárez","Cobija","U. E. MARISCAL SUCRE",-68.75624,-11.01813,615,21,2466,3081,1265,66,1114,2379
"Bolivia","Pando","Nicolás Suárez","Cobija","U.E. NUEVA ESPERANZA",-68.88235,-11.1152,16,0,84,100,53,3,28,81
"Bolivia","Pando","Nicolás Suárez","Cobija","U. E. ROGELIA MENACHO DE BALCAZAR",-68.74956,-11.01224,356,17,1672,2028,967,50,638,1605
"Bolivia","Pando","Nicolás Suárez","Cobija","U. E. SIMON BOLIVAR",-68.78709,-11.03764,170,6,1195,1365,638,33,518,1156
"Bolivia","Pando","Nicolás Suárez","Cobija","U. E. SOFIA CALPIÑEIRO",-68.75566,-11.01603,564,11,2347,2911,1518,65,753,2271
"Bolivia","Pando","Nicolás Suárez","Cobija","U. E. VACA DIEZ (INTERMEDIO)",-68.76405,-11.02211,136,156,842,978,394,19,273,667
"Bolivia","Pando","Nicolás Suárez","Cobija","U. E. VACA DIEZ (MEDIO)",-68.76039,-11.02054,166,0,576,742,379,20,177,556
"Bolivia","Pando","Nicolás Suárez","Cobija","U.E. VILLA CRUZ",-68.77383,-11.03098,595,19,2955,3550,1735,84,1117,2852
"Bolivia","Pando","Nicolás Suárez","Porvenir","U.E. BRUNO RACUA",-68.68311,-11.23532,288,9,1125,1413,462,29,625,1087
"Bolivia","Pando","Nicolás Suárez","Porvenir","U.E.  GUTEMBERT CRUZ",-68.84592,-11.22069,33,1,191,224,108,1,81,189
"Bolivia","Pando","Nicolás Suárez","Porvenir","U.E. MONS. SANTISTEBAN",-68.68311,-11.23532,264,9,953,1217,435,13,496,931
"Bolivia","Pando","Nicolás Suárez","Porvenir","U.E. VILLA BELLA",-68.724,-11.2168,95,4,584,679,245,9,326,571
"Bolivia","Potosí","Alonso de Ibáñez","Caripuyo","ESC. CATARI",-66.557,-18.152,21,0,100,121,10,5,85,95
"Bolivia","Potosí","Alonso de Ibáñez","Caripuyo","ESC. CHAICURIRI",-66.63818,-18.22252,25,1,104,129,19,1,83,102
"Bolivia","Potosí","Alonso de Ibáñez","Caripuyo","ESC. CHALVIRI",-66.51712,-18.19005,37,11,160,197,15,8,126,141
"Bolivia","Potosí","Alonso de Ibáñez","Caripuyo","ESC. CHOJLLA",-66.58522,-18.208,10,2,277,287,13,32,230,243
"Bolivia","Potosí","Alonso de Ibáñez","Caripuyo","ESC. COTANA",-66.57648,-18.09925,113,25,466,579,55,13,373,428
"Bolivia","Potosí","Alonso de Ibáñez","Caripuyo","ESC. EDUARDO AVAROA",-66.47403,-18.2329,187,65,815,1002,109,38,603,712
"Bolivia","Potosí","Alonso de Ibáñez","Caripuyo","ESC. HUANACHACA",-66.53834,-18.10201,15,3,141,156,5,2,131,136
"Bolivia","Potosí","Alonso de Ibáñez","Caripuyo","ESC. HUANACOMA",-66.49527,-18.15723,23,19,376,399,76,20,261,337
"Bolivia","Potosí","Alonso de Ibáñez","Caripuyo","ESC. JANCKO JANCKO",-66.59177,-18.17574,66,4,311,377,50,29,228,278
"Bolivia","Potosí","Alonso de Ibáñez","Caripuyo","ESC. JUNTAVI",-66.50504,-18.23312,53,7,401,454,11,11,372,383
"Bolivia","Potosí","Alonso de Ibáñez","Sacaca (Villa de Sacaca)","COL. JOSE ALONZO DE IBAÑEZ",-66.38387,-18.06966,512,52,1970,2482,779,146,993,1772
"Bolivia","Potosí","Alonso de Ibáñez","Sacaca (Villa de Sacaca)","ESC. CARCOMA",-66.31796,-17.98507,92,0,491,583,16,1,474,490
"Bolivia","Potosí","Alonso de Ibáñez","Sacaca (Villa de Sacaca)","ESC. CHARCA",-66.309,-18.29,22,3,230,252,121,6,100,221
"Bolivia","Potosí","Alonso de Ibáñez","Sacaca (Villa de Sacaca)","ESC. COLLOMA",-66.34437,-18.3256,15,3,105,120,32,5,65,97
"Bolivia","Potosí","Alonso de Ibáñez","Sacaca (Villa de Sacaca)","ESC. DE OVEJERIA",-66.23547,-18.14605,46,5,701,747,88,27,581,669
"Bolivia","Potosí","Alonso de Ibáñez","Sacaca (Villa de Sacaca)","ESC. ITURATA",-66.2449,-18.01211,27,3,260,287,18,10,229,247
"Bolivia","Potosí","Alonso de Ibáñez","Sacaca (Villa de Sacaca)","ESC. JARUMA",-66.49641,-18.05654,14,8,309,323,125,18,158,283
"Bolivia","Potosí","Alonso de Ibáñez","Sacaca (Villa de Sacaca)","ESC. LAYTOCO",-66.30727,-18.14706,21,0,276,297,4,8,264,268
"Bolivia","Potosí","Alonso de Ibáñez","Sacaca (Villa de Sacaca)","ESC. LAYUPAMPA",-66.40737,-17.99987,41,25,439,480,52,23,339,391
"Bolivia","Potosí","Alonso de Ibáñez","Sacaca (Villa de Sacaca)","ESC. SILLU SILLU",-66.46011,-18.09924,3,4,440,443,22,9,405,427
"Bolivia","Potosí","Alonso de Ibáñez","Sacaca (Villa de Sacaca)","ESC. VILA SIRCA",-66.32172,-18.34239,28,4,115,143,36,6,69,105
"Bolivia","Potosí","Alonso de Ibáñez","Sacaca (Villa de Sacaca)","ESC. VILA VILA",-66.34768,-18.15004,27,3,623,650,28,26,566,594
"Bolivia","Potosí","Alonso de Ibáñez","Sacaca (Villa de Sacaca)","SACANI",-66.18929,-18.09043,10,0,373,383,19,7,347,366
"Bolivia","Potosí","Alonso de Ibáñez","Sacaca (Villa de Sacaca)","TARHUA CHAPI",-66.40738,-18.19324,65,24,565,630,54,27,460,514
"Bolivia","Potosí","Alonso de Ibáñez","Sacaca (Villa de Sacaca)","U.E. BOLIVIA",-66.41556,-18.09067,5,2,174,179,1,9,162,163
"Bolivia","Potosí","Alonso de Ibáñez","Sacaca (Villa de Sacaca)","U.E. CAMACACHI",-66.3724,-18.11655,0,1,90,90,0,0,89,89
"Bolivia","Potosí","Alonso de Ibáñez","Sacaca (Villa de Sacaca)","U.E. JAYU JAYU",-66.37892,-18.16083,2,10,155,157,4,5,136,140
"Bolivia","Potosí","Alonso de Ibáñez","Sacaca (Villa de Sacaca)","U.E. LLAPA LLAPA",-66.3597,-18.09612,2,2,82,84,6,1,73,79
"Bolivia","Potosí","Antonio Quijarro","Porco","ESC. AGUA CASTILLA",-65.99281,-19.76802,148,16,1148,1296,844,43,245,1089
"Bolivia","Potosí","Antonio Quijarro","Porco","U.E. ANTONIO QUIJARRO DE CARMA",-65.83518,-19.78734,27,1,128,155,109,6,12,121
"Bolivia","Potosí","Antonio Quijarro","Porco","U.E. CONCEPCION DE CHAQUILLA",-66.17165,-19.915,5,0,89,94,44,1,44,88
"Bolivia","Potosí","Antonio Quijarro","Porco","U.E. GUALBERTO VILLARROEL DE CHICHUYO",-65.97169,-19.90254,22,1,113,135,62,5,45,107
"Bolivia","Potosí","Antonio Quijarro","Porco","U.E. JOSE MARIA LINARES",-65.98714,-19.79856,161,13,1042,1203,729,31,269,998
"Bolivia","Potosí","Antonio Quijarro","Porco","U.E. SAN ANTONIO DE TORCUYO",-65.79976,-19.77843,3,2,100,103,72,4,22,94
"Bolivia","Potosí","Antonio Quijarro","Porco","U.E. SAN GABRIEL DE CONDORIRI",-65.92919,-19.74775,33,1,117,150,92,1,23,115
"Bolivia","Potosí","Antonio Quijarro","Porco","U.E. SAN JOSE DE TOPALA",-65.90455,-19.80483,17,0,117,134,76,6,35,111
"Bolivia","Potosí","Antonio Quijarro","Porco","U.E. SANTA MARIA DE CHURCUITA",-65.81611,-19.84111,24,2,119,143,82,3,32,114
"Bolivia","Potosí","Antonio Quijarro","Porco","U.E. SANTA ROSA",-65.98714,-19.79856,199,23,1244,1443,841,46,334,1175
"Bolivia","Potosí","Antonio Quijarro","Tomave","COL. ELIZARDO PEREZ A",-66.31324,-20.14378,65,19,573,638,221,23,310,531
"Bolivia","Potosí","Antonio Quijarro","Tomave","COL. SIMON RODRIGUEZ CARREÑO",-66.13405,-20.04367,35,2,184,219,96,6,80,176
"Bolivia","Potosí","Antonio Quijarro","Tomave","COL. TOMAS FRIAS",-66.53149,-20.0643,129,33,438,567,224,21,160,384
"Bolivia","Potosí","Antonio Quijarro","Tomave","ESC. MARISCAL SUCRE",-66.7066,-19.74305,75,14,394,469,179,21,180,359
"Bolivia","Potosí","Antonio Quijarro","Tomave","U.E. 10 DE NOVIEMBRE",-66.5676,-20.21303,20,1,115,135,46,3,65,111
"Bolivia","Potosí","Antonio Quijarro","Tomave","U.E. 1RO. DE MAYO",-66.39316,-20.35149,27,3,142,169,60,8,71,131
"Bolivia","Potosí","Antonio Quijarro","Tomave","U.E. 31 DE OCTUBRE",-66.34953,-19.78253,14,1,128,142,77,5,45,122
"Bolivia","Potosí","Antonio Quijarro","Tomave","U.E. DANIEL CAMPOS",-66.2225,-20.26551,37,8,144,181,55,6,75,130
"Bolivia","Potosí","Antonio Quijarro","Tomave","U.E. EDUARDO ABAROA",-66.17575,-19.98652,14,3,133,147,58,5,67,125
"Bolivia","Potosí","Antonio Quijarro","Tomave","U.E. ELIZARDO PEREZ",-66.19482,-20.41101,12,1,98,110,40,4,53,93
"Bolivia","Potosí","Antonio Quijarro","Tomave","U.E. FRANZ TAMAYO",-66.16724,-20.0438,89,5,498,587,222,14,257,479
"Bolivia","Potosí","Antonio Quijarro","Tomave","U.E. FRANZ TAMAYO",-66.38166,-20.09554,89,5,498,587,222,14,257,479
"Bolivia","Potosí","Antonio Quijarro","Tomave","U.E. FRANZ TAMAYO",-66.26527,-19.82753,89,5,498,587,222,14,257,479
"Bolivia","Potosí","Antonio Quijarro","Tomave","U.E. GERMAN BUSCH",-66.04766,-20.07577,39,1,267,306,71,13,182,253
"Bolivia","Potosí","Antonio Quijarro","Tomave","U.E. GERMAN BUSCH",-66.26482,-19.89234,39,1,267,306,71,13,182,253
"Bolivia","Potosí","Antonio Quijarro","Tomave","U.E. JUANA AZURDUY DE PADILLA",-66.36832,-20.50186,7,1,35,42,14,2,18,32
"Bolivia","Potosí","Antonio Quijarro","Tomave","U.E. JULIO LAREDO",-66.17559,-20.12856,23,3,125,148,19,2,101,120
"Bolivia","Potosí","Antonio Quijarro","Tomave","U.E. MARISCAL DE AYACUCHO",-66.56905,-19.69648,43,6,115,158,63,6,40,103
"Bolivia","Potosí","Antonio Quijarro","Tomave","U.E. MARISCAL JOSE DE SUCRE",-66.12498,-20.07338,129,18,499,628,242,14,225,467
"Bolivia","Potosí","Antonio Quijarro","Tomave","U.E. RAFAEL PABON",-66.09256,-20.00132,22,4,86,108,25,5,52,77
"Bolivia","Potosí","Antonio Quijarro","Tomave","U.E. RICARDO CRUZ",-65.92126,-20.07895,67,3,164,231,47,11,103,150
"Bolivia","Potosí","Antonio Quijarro","Tomave","U.E. SIMON BOLIVAR",-66.24822,-19.90882,11,3,266,277,36,26,201,237
"Bolivia","Potosí","Antonio Quijarro","Tomave","U.E. SIMON BOLIVAR",-66.22723,-19.87498,11,3,266,277,36,26,201,237
"Bolivia","Potosí","Antonio Quijarro","Tomave","U.E. TOMAS FRIAS",-66.30714,-19.96937,27,15,191,218,78,4,94,172
"Bolivia","Potosí","Antonio Quijarro","Uyuni (Thola Pampa)","SUB SEDE UNIV. ECONOMIA",-66.82623,-20.46294,301,33,1661,1962,712,68,848,1560
"Bolivia","Potosí","Antonio Quijarro","Uyuni (Thola Pampa)","U.E.ALTO ALIANZA",-66.43998,-19.54232,4,0,36,40,23,4,9,32
"Bolivia","Potosí","Antonio Quijarro","Uyuni (Thola Pampa)","U.E. ANTONIO QUIJARRO",-66.82595,-20.45747,654,41,3074,3728,1678,139,1216,2894
"Bolivia","Potosí","Antonio Quijarro","Uyuni (Thola Pampa)","U.E. EDUARDO AVAROA",-66.85102,-20.36443,21,3,241,262,149,12,77,226
"Bolivia","Potosí","Antonio Quijarro","Uyuni (Thola Pampa)","U.E. FRANZ TAMAYO",-66.92651,-20.11757,23,4,160,183,94,11,51,145
"Bolivia","Potosí","Antonio Quijarro","Uyuni (Thola Pampa)","U.E. GERMAN BUSCH",-66.93522,-20.30083,48,4,339,387,183,13,139,322
"Bolivia","Potosí","Antonio Quijarro","Uyuni (Thola Pampa)","U.E. GUALBERTO VILLARROEL",-67.06178,-19.53462,61,10,312,373,161,28,113,274
"Bolivia","Potosí","Antonio Quijarro","Uyuni (Thola Pampa)","U.E. JAIME DE ZUDAÑES",-66.82595,-20.45747,736,45,3224,3960,1718,113,1348,3066
"Bolivia","Potosí","Antonio Quijarro","Uyuni (Thola Pampa)","U.E. JUANA AZURDUY DE PADILLA",-67.0053,-19.61859,9,1,94,103,50,2,41,91
"Bolivia","Potosí","Antonio Quijarro","Uyuni (Thola Pampa)","U.E. JUAN SANJINEZ",-67.16636,-19.68052,63,42,490,553,250,15,183,433
"Bolivia","Potosí","Antonio Quijarro","Uyuni (Thola Pampa)","U.E. KATARINA KRSUL",-66.81326,-19.52889,120,26,718,838,476,27,189,665
"Bolivia","Potosí","Antonio Quijarro","Uyuni (Thola Pampa)","U.E. MARISCAL BRAUN",-66.68245,-19.51538,31,5,316,347,137,20,154,291
"Bolivia","Potosí","Antonio Quijarro","Uyuni (Thola Pampa)","U.E. MARISCAL DE AYACUCHO",-66.3906,-20.81844,36,8,177,213,57,9,103,160
"Bolivia","Potosí","Antonio Quijarro","Uyuni (Thola Pampa)","U.E. POTOSI",-66.82595,-20.45747,233,24,1350,1583,706,71,549,1255
"Bolivia","Potosí","Antonio Quijarro","Uyuni (Thola Pampa)","U.E. PULACAYO A",-66.70123,-20.39232,34,7,219,253,105,11,96,201
"Bolivia","Potosí","Antonio Quijarro","Uyuni (Thola Pampa)","U.E. RICARDO RODRIGUEZ",-66.89848,-19.89956,52,11,279,331,126,13,129,255
"Bolivia","Potosí","Antonio Quijarro","Uyuni (Thola Pampa)","U.E. RIO MULATO",-66.77838,-19.69697,71,20,437,508,213,16,188,401
"Bolivia","Potosí","Antonio Quijarro","Uyuni (Thola Pampa)","U.E. UYUNI A",-66.81758,-20.45736,321,27,1851,2172,1044,65,715,1759
"Bolivia","Potosí","Charcas","San Pedro de Buena Vista","COLEG. NAL. CHARCAS",-65.981,-18.26995,855,167,2189,3044,517,100,1405,1922
"Bolivia","Potosí","Charcas","San Pedro de Buena Vista","ESC. ARAKANI",-65.94547,-18.44892,1,2,156,157,0,2,152,152
"Bolivia","Potosí","Charcas","San Pedro de Buena Vista","ESC. CHIRO CKASA",-66.18792,-18.26068,267,58,1164,1431,257,92,757,1014
"Bolivia","Potosí","Charcas","San Pedro de Buena Vista","ESC. IPOTE",-65.76811,-18.33076,1,0,73,74,0,1,72,72
"Bolivia","Potosí","Charcas","San Pedro de Buena Vista","ESC. MARTIN CALA",-65.68661,-18.55701,9,0,194,203,2,1,191,193
"Bolivia","Potosí","Charcas","San Pedro de Buena Vista","ESC. MOSCARI",-66.00932,-18.36224,218,11,526,744,13,4,498,511
"Bolivia","Potosí","Charcas","San Pedro de Buena Vista","ESC. ÑEQUETA",-66.21066,-18.28477,153,60,516,669,76,20,360,436
"Bolivia","Potosí","Charcas","San Pedro de Buena Vista","ESC. QUINAMARA",-65.843,-18.236,160,3,269,429,11,23,232,243
"Bolivia","Potosí","Charcas","San Pedro de Buena Vista","ESC. SAN MARCOS",-65.71427,-18.49057,105,0,617,722,5,0,612,617
"Bolivia","Potosí","Charcas","San Pedro de Buena Vista","ESC. SAPACARI",-66.24672,-18.3837,62,10,163,225,40,7,106,146
"Bolivia","Potosí","Charcas","San Pedro de Buena Vista","ESC. SECCIONAL ESKENCACHI",-66.164,-18.427,95,40,424,519,65,18,301,366
"Bolivia","Potosí","Charcas","San Pedro de Buena Vista","ESC. SORA SORA",-66.272,-18.19449,3,1,62,65,12,1,48,60
"Bolivia","Potosí","Charcas","San Pedro de Buena Vista","ESC. TORACARI",-66.13522,-18.13033,246,30,559,805,158,29,342,500
"Bolivia","Potosí","Charcas","San Pedro de Buena Vista","ESCUELA SECCIONAL COTA COTA",-66.21744,-18.34191,23,2,268,291,20,5,241,261
"Bolivia","Potosí","Charcas","San Pedro de Buena Vista","NUCLEO EDUCATIVO BANDURIRI",-66.0399,-18.15632,7,4,358,365,11,7,336,347
"Bolivia","Potosí","Charcas","San Pedro de Buena Vista","NUCLEO ESCOLAR MICANI",-65.83389,-18.3693,114,12,917,1031,13,3,889,902
"Bolivia","Potosí","Charcas","Toro Toro","ESC. PALLA PALLA",-65.52338,-18.32186,55,3,412,467,16,6,387,403
"Bolivia","Potosí","Charcas","Toro Toro","ESC. SECCIONAL",-65.77195,-18.19173,36,2,390,426,13,4,371,384
"Bolivia","Potosí","Charcas","Toro Toro","ESC. SECCIONAL AÑAHUANI",-65.64471,-18.23354,64,9,350,414,17,7,317,334
"Bolivia","Potosí","Charcas","Toro Toro","ESC. SECCIONAL CARASI",-65.68874,-18.31779,142,7,453,595,39,12,395,434
"Bolivia","Potosí","Charcas","Toro Toro","ESC. TORO TORO",-65.79198,-18.02429,451,37,1814,2265,347,77,1353,1700
"Bolivia","Potosí","Charcas","Toro Toro","ESC. TORO TORO",-65.76296,-18.13375,451,37,1814,2265,347,77,1353,1700
"Bolivia","Potosí","Charcas","Toro Toro","ESC. YAMBATA",-65.91856,-18.05247,61,3,282,343,25,8,246,271
"Bolivia","Potosí","Charcas","Toro Toro","NUCLEO POCO SUCO",-65.73625,-18.25639,49,4,257,306,11,6,236,247
"Bolivia","Potosí","Chayanta","Colquechaca","COLEG. TOMAS CATARI",-66.0375,-18.8177,642,157,1752,2394,211,131,1253,1464
"Bolivia","Potosí","Chayanta","Colquechaca","ESC. AYOMA",-66.14678,-18.86896,185,45,452,637,69,28,310,379
"Bolivia","Potosí","Chayanta","Colquechaca","ESC. CENTRAL ULUCHI",-66.14444,-18.95846,166,47,864,1030,150,65,602,752
"Bolivia","Potosí","Chayanta","Colquechaca","ESC. GUADALUPE",-65.79741,-18.69036,143,4,555,698,21,2,528,549
"Bolivia","Potosí","Chayanta","Colquechaca","ESC. GUALBERTO VILLARROEL TITIRI",-65.97601,-18.97547,31,3,145,176,7,6,129,136
"Bolivia","Potosí","Chayanta","Colquechaca","ESC. JACINTO PINTO DE PHUTINA",-66.21133,-18.83524,207,13,637,844,88,19,517,605
"Bolivia","Potosí","Chayanta","Colquechaca","ESC. JAIME MENDOZA",-66.20398,-18.9043,69,8,674,743,66,95,505,571
"Bolivia","Potosí","Chayanta","Colquechaca","ESC. JAMANCHIRI",-65.8834,-18.70837,29,3,141,170,5,13,120,125
"Bolivia","Potosí","Chayanta","Colquechaca","ESC. JUNIN",-66.00296,-18.69715,269,44,893,1162,355,84,410,765
"Bolivia","Potosí","Chayanta","Colquechaca","ESC. MARCELO QUIRVES",-66.05211,-18.97724,110,50,338,448,69,39,180,249
"Bolivia","Potosí","Chayanta","Colquechaca","ESC. MEJILLONES DE CAYARANI",-65.94516,-18.74131,32,2,279,311,17,47,213,230
"Bolivia","Potosí","Chayanta","Colquechaca","ESC. ROSARIO",-65.97795,-18.77202,59,26,418,477,41,17,334,375
"Bolivia","Potosí","Chayanta","Colquechaca","ESC. SALINAS",-66.11065,-19.01487,69,28,711,780,101,33,549,650
"Bolivia","Potosí","Chayanta","Colquechaca","ESC. S.BOLIVAR CHOQUECAYARA",-66.23908,-18.92873,35,19,208,243,46,22,121,167
"Bolivia","Potosí","Chayanta","Colquechaca","ESC. SECCIONAL SALINAS DE MACHA",-66.11683,-18.9747,41,0,150,191,22,11,117,139
"Bolivia","Potosí","Chayanta","Colquechaca","OFIC. CORREGIMIENTO",-65.84781,-18.56566,231,17,484,715,37,11,419,456
"Bolivia","Potosí","Chayanta","Colquechaca","TOMAYCURI",-65.90958,-18.85932,153,26,508,661,118,26,338,456
"Bolivia","Potosí","Chayanta","Colquechaca","U.E. AYACUCHO DE SICUTA",-65.80147,-18.59073,19,6,238,257,4,6,222,226
"Bolivia","Potosí","Chayanta","Colquechaca","U.E. MILLURI",-66.15628,-18.90602,4,1,100,104,14,10,75,89
"Bolivia","Potosí","Chayanta","Colquechaca","U.E. ROBERTO ALVARADO",-66.0021,-18.70359,235,50,881,1116,414,68,349,763
"Bolivia","Potosí","Chayanta","Ocurí","COLEGIO DANIEL SALAMANCA",-65.79628,-18.8428,338,62,843,1181,256,60,465,721
"Bolivia","Potosí","Chayanta","Ocurí","COL. NAC. MARCELO QUIROGA SANTA CRUZ",-65.79628,-18.8428,364,40,850,1214,226,91,493,719
"Bolivia","Potosí","Chayanta","Ocurí","ESC. KARA KARA",-65.70093,-18.81138,102,33,337,439,84,21,199,283
"Bolivia","Potosí","Chayanta","Ocurí","ESC. MARAGUA",-65.77851,-18.95468,268,32,515,783,171,59,253,424
"Bolivia","Potosí","Chayanta","Ocurí","ESC ROCO ROCO",-65.84806,-18.79057,17,2,84,101,8,4,70,78
"Bolivia","Potosí","Chayanta","Ocurí","ESC. SECCIONAL MARCOMA",-65.65381,-18.95084,87,22,326,413,90,19,195,285
"Bolivia","Potosí","Chayanta","Ocurí","ESC. SIMON BOLIVAR DE PEANA",-65.785,-18.719,54,6,366,420,31,16,313,344
"Bolivia","Potosí","Chayanta","Ocurí","ESC. YURIMATA",-65.69332,-18.93946,63,18,237,300,55,13,151,206
"Bolivia","Potosí","Chayanta","Ocurí","U.E. CHAUPI LOMA",-65.77997,-19.00577,3,2,65,68,15,11,37,52
"Bolivia","Potosí","Chayanta","Ocurí","U.E. COLLPA",-65.82913,-18.99837,10,13,158,168,25,7,113,138
"Bolivia","Potosí","Chayanta","Pocoata","ESC. ACHACANA",-66.15985,-18.5925,100,2,465,565,12,18,433,445
"Bolivia","Potosí","Chayanta","Pocoata","ESC. CACHUYO",-66.04868,-18.71111,39,17,260,299,39,14,190,229
"Bolivia","Potosí","Chayanta","Pocoata","ESC. CAMPAYA",-66.30963,-18.75883,68,12,1019,1087,84,12,911,995
"Bolivia","Potosí","Chayanta","Pocoata","ESC. CENTRAL JACHATAJO",-66.07078,-18.51748,67,17,231,298,11,8,195,206
"Bolivia","Potosí","Chayanta","Pocoata","ESC. CENTRAL VILLA ALCARAPI",-66.28011,-18.8248,19,0,329,348,16,12,301,317
"Bolivia","Potosí","Chayanta","Pocoata","ESC. CHAYALA",-66.04488,-18.53314,164,6,291,455,22,5,258,280
"Bolivia","Potosí","Chayanta","Pocoata","ESC. COLLANA TUICA",-66.20734,-18.60429,29,12,373,402,17,7,337,354
"Bolivia","Potosí","Chayanta","Pocoata","ESC. COLLPA CKASA",-66.118,-18.49396,36,4,235,271,40,7,184,224
"Bolivia","Potosí","Chayanta","Pocoata","ESC. HUANCARANI",-66.13522,-18.73722,146,56,638,784,133,34,415,548
"Bolivia","Potosí","Chayanta","Pocoata","ESC. JARANA",-66.12551,-18.6998,65,27,342,407,54,20,241,295
"Bolivia","Potosí","Chayanta","Pocoata","ESC. KAPARANCHO",-66.06309,-18.63861,19,7,126,145,19,7,93,112
"Bolivia","Potosí","Chayanta","Pocoata","ESC.PACOTANCA",-66.25257,-18.74593,33,2,97,130,6,0,89,95
"Bolivia","Potosí","Chayanta","Pocoata","ESC. PEDRO GUTIERREZ",-66.1626,-18.69938,484,118,1818,2302,559,146,995,1554
"Bolivia","Potosí","Chayanta","Pocoata","ESC. SAN MIGUEL DE KARI",-66.26031,-18.59378,3,3,385,388,42,14,326,368
"Bolivia","Potosí","Chayanta","Pocoata","ESC. SAYI",-66.22854,-18.75826,4,0,174,178,5,12,157,162
"Bolivia","Potosí","Chayanta","Pocoata","ESC. SECCIONAL SENAJO",-66.14663,-18.49398,16,5,77,93,30,4,38,68
"Bolivia","Potosí","Chayanta","Pocoata","ESC. SECCIONAL TURBERIA",-66.07927,-18.6298,118,18,531,649,47,59,407,454
"Bolivia","Potosí","Chayanta","Pocoata","ESC SECCIONAL YAHUACO",-66.02201,-18.5216,14,5,83,97,13,10,55,68
"Bolivia","Potosí","Chayanta","Pocoata","ESC. TOMOYO",-66.134,-18.463,41,1,187,228,34,5,147,181
"Bolivia","Potosí","Chayanta","Pocoata","ESC. VILA VILA",-66.27483,-18.82087,10,3,323,333,26,6,288,314
"Bolivia","Potosí","Chayanta","Pocoata","NUCLEO ESCOLAR JUAN DE ARROZ PATA",-66.17729,-18.4751,8,5,104,112,25,7,67,92
"Bolivia","Potosí","Chayanta","Pocoata","NUCLEO ESCOLAR KESIMPUCU",-66.05427,-18.56416,13,27,399,412,73,33,266,339
"Bolivia","Potosí","Chayanta","Ravelo","COL. JOSE ALONSO DE IBAÑEZ",-65.60184,-18.87419,28,27,252,280,21,9,195,216
"Bolivia","Potosí","Chayanta","Ravelo","ESC. ANTORA",-65.64693,-18.75318,72,21,278,350,52,30,175,227
"Bolivia","Potosí","Chayanta","Ravelo","ESC. CENTRAL 1º DE MAYO",-65.67611,-18.87961,78,9,235,313,36,19,171,207
"Bolivia","Potosí","Chayanta","Ravelo","ESC. CENTRAL RODEO HUAYLLAS",-65.59853,-18.7994,107,36,358,465,67,14,241,308
"Bolivia","Potosí","Chayanta","Ravelo","ESC. CENTRAL SAUCY MAYU",-65.55036,-18.78822,65,20,359,424,59,17,263,322
"Bolivia","Potosí","Chayanta","Ravelo","ESC. CHALLUMA",-65.54932,-18.85223,9,8,119,128,12,6,93,105
"Bolivia","Potosí","Chayanta","Ravelo","ESC. CHIPIRINA",-65.4499,-18.80882,23,1,101,124,19,10,71,90
"Bolivia","Potosí","Chayanta","Ravelo","ESC. HUAYCOMA",-65.48942,-18.58409,75,23,189,264,34,19,113,147
"Bolivia","Potosí","Chayanta","Ravelo","ESC. LACAYANI",-65.57085,-18.71785,52,30,271,323,37,14,190,227
"Bolivia","Potosí","Chayanta","Ravelo","ESC. LAMPHASUNI",-65.43322,-18.60605,18,1,116,134,7,9,99,106
"Bolivia","Potosí","Chayanta","Ravelo","ESC. M. ASCENCIO PADILLA",-65.50803,-18.80719,378,54,1383,1761,459,96,774,1233
"Bolivia","Potosí","Chayanta","Ravelo","ESC. MOROTO",-65.51731,-18.72289,13,9,77,90,2,4,62,64
"Bolivia","Potosí","Chayanta","Ravelo","ESC. PITANTORA",-65.6319,-18.70022,99,5,266,365,14,20,227,241
"Bolivia","Potosí","Chayanta","Ravelo","ESC. SASANTA",-65.48589,-18.85652,35,3,243,278,52,13,175,227
"Bolivia","Potosí","Chayanta","Ravelo","ESC. SECCIONAL MOKO KOTANI",-65.55286,-18.6043,65,14,132,197,7,5,106,113
"Bolivia","Potosí","Chayanta","Ravelo","ESC. SECCIONAL MOLLE MOLLE",-65.5581,-18.99458,68,52,444,512,55,19,318,373
"Bolivia","Potosí","Chayanta","Ravelo","ESC. SECC. LUQUI PAMPA",-65.71329,-18.71529,44,5,98,142,19,17,57,76
"Bolivia","Potosí","Chayanta","Ravelo","ESC. SECC TEJA MOLINO",-65.56034,-18.51546,71,1,151,222,21,11,118,139
"Bolivia","Potosí","Chayanta","Ravelo","ESC. S. YURUBAMBA",-65.45452,-18.86363,56,20,340,396,71,17,232,303
"Bolivia","Potosí","Chayanta","Ravelo","ESC. TOMOYO",-65.58306,-18.92324,76,38,316,392,50,27,201,251
"Bolivia","Potosí","Chayanta","Ravelo","TOROCA",-65.49248,-18.66342,22,2,146,168,6,7,131,137
"Bolivia","Potosí","Chayanta","Ravelo","U.E. JANINA",-65.67776,-18.77756,20,4,199,219,75,14,106,181
"Bolivia","Potosí","Cornelio Saavedra","Betanzos","CENTRAL ELIZARDO PEREZ",-66.42453,-18.54064,89,16,368,457,74,19,259,333
"Bolivia","Potosí","Cornelio Saavedra","Betanzos","COLEG. R. BOHORQUEZ",-65.44724,-19.55169,334,54,1686,2020,865,95,672,1537
"Bolivia","Potosí","Cornelio Saavedra","Betanzos","ESC. ALONZO DE IBAÑEZ",-65.45937,-19.3632,65,11,395,460,90,12,282,372
"Bolivia","Potosí","Cornelio Saavedra","Betanzos","ESC. ANCO MAYU",-65.26953,-19.413,16,0,70,86,3,1,66,69
"Bolivia","Potosí","Cornelio Saavedra","Betanzos","ESC. BLAS S. DE PEDRO",-65.27425,-19.36944,35,1,110,145,25,9,75,100
"Bolivia","Potosí","Cornelio Saavedra","Betanzos","ESC. BUEY TAMBO",-65.33926,-19.56878,74,7,312,386,93,22,190,283
"Bolivia","Potosí","Cornelio Saavedra","Betanzos","ESC. CAMALI",-65.00764,-19.49642,84,17,443,527,54,15,357,411
"Bolivia","Potosí","Cornelio Saavedra","Betanzos","ESC. CENTRAL OTUYO",-65.23023,-19.48659,82,13,295,377,49,8,225,274
"Bolivia","Potosí","Cornelio Saavedra","Betanzos","ESC. CENTRAL TECOYA",-65.4239,-19.50207,302,112,1167,1469,243,57,755,998
"Bolivia","Potosí","Cornelio Saavedra","Betanzos","ESC. CENTRAL VILA VILA",-65.33044,-19.34779,94,6,376,470,70,37,263,333
"Bolivia","Potosí","Cornelio Saavedra","Betanzos","ESC. DE HUANO HUANO",-64.985,-19.61366,48,10,125,173,27,8,80,107
"Bolivia","Potosí","Cornelio Saavedra","Betanzos","ESC. DE MAMAHOTA",-65.48484,-19.48434,36,12,238,274,27,6,193,220
"Bolivia","Potosí","Cornelio Saavedra","Betanzos","ESC. DE MARIACA",-65.35322,-19.41788,67,12,240,307,19,8,201,220
"Bolivia","Potosí","Cornelio Saavedra","Betanzos","ESC. ELIZARDO PEREZ",-65.3391,-19.44707,38,15,182,220,37,7,123,160
"Bolivia","Potosí","Cornelio Saavedra","Betanzos","ESC. GERMAN BUSH",-65.54766,-19.82024,47,8,340,387,151,26,155,306
"Bolivia","Potosí","Cornelio Saavedra","Betanzos","ESC. MEDIA LUNA",-64.77518,-19.76643,16,0,70,86,4,2,64,68
"Bolivia","Potosí","Cornelio Saavedra","Betanzos","ESC. MODESTO OMISTE",-65.44724,-19.55169,347,41,1391,1738,664,70,616,1280
"Bolivia","Potosí","Cornelio Saavedra","Betanzos","ESC. POCO POCO",-65.01298,-19.36994,139,8,527,666,109,20,390,499
"Bolivia","Potosí","Cornelio Saavedra","Betanzos","ESC. POTOBAMBA",-65.3583,-19.2998,58,0,241,299,21,2,218,239
"Bolivia","Potosí","Cornelio Saavedra","Betanzos","ESC. POTONGO ALTO",-65.24026,-19.39199,9,0,65,74,0,2,63,63
"Bolivia","Potosí","Cornelio Saavedra","Betanzos","ESC. SECCIONAL DE SAN PEDRO DE COLILA",-65.12701,-19.44642,21,1,132,153,8,2,121,129
"Bolivia","Potosí","Cornelio Saavedra","Betanzos","ESC. TARIJA CUCHU",-65.33474,-19.49068,66,17,317,383,67,21,212,279
"Bolivia","Potosí","Cornelio Saavedra","Betanzos","ESC. TAURI CANCHA",-65.31977,-19.59806,203,60,1079,1282,541,55,423,964
"Bolivia","Potosí","Cornelio Saavedra","Betanzos","ESC. TIRISPAYA",-65.40837,-19.27494,45,2,229,274,2,12,213,215
"Bolivia","Potosí","Cornelio Saavedra","Betanzos","ESC. TRAPICHE ALTA",-65.5425,-19.42349,20,1,144,164,66,3,74,140
"Bolivia","Potosí","Cornelio Saavedra","Betanzos","ESC. TROJA PAMPA",-64.96799,-19.44878,21,8,189,210,11,6,164,175
"Bolivia","Potosí","Cornelio Saavedra","Betanzos","ESC. UNZAGA DE LA VEGA",-65.18517,-19.4238,71,7,515,586,128,22,358,486
"Bolivia","Potosí","Cornelio Saavedra","Betanzos","ESC. URIFAYA",-64.92088,-19.48255,4,1,235,239,12,2,220,232
"Bolivia","Potosí","Cornelio Saavedra","Betanzos","ESC. VILLA IMPERIAL",-65.37331,-19.54539,84,49,314,398,56,13,196,252
"Bolivia","Potosí","Cornelio Saavedra","Betanzos","ESC. VIÑA QUEMADA",-64.85901,-19.42301,15,9,102,117,26,6,61,87
"Bolivia","Potosí","Cornelio Saavedra","Betanzos","KINDER VILLA IMPERIAL",-65.44724,-19.55169,162,42,949,1111,381,65,461,842
"Bolivia","Potosí","Cornelio Saavedra","Chaquí","COL. VILLA IMPERIAL",-65.57073,-19.62471,140,30,512,652,232,72,178,410
"Bolivia","Potosí","Cornelio Saavedra","Chaquí","ESC. ANDRES DE SANTA CRUZ",-65.56108,-19.58838,306,52,1152,1458,563,97,440,1003
"Bolivia","Potosí","Cornelio Saavedra","Chaquí","ESC. C. CHIUTALUYO",-65.51266,-19.63994,135,37,351,486,137,63,114,251
"Bolivia","Potosí","Cornelio Saavedra","Chaquí","ESC. CENTRAL EL PALOMAR",-65.41072,-19.65163,57,5,169,226,28,6,130,158
"Bolivia","Potosí","Cornelio Saavedra","Chaquí","ESC. CHARCA FLORIDA",-65.41967,-19.71643,34,1,103,137,26,4,72,98
"Bolivia","Potosí","Cornelio Saavedra","Chaquí","ESC. CHICO CHICO",-65.53385,-19.67762,130,41,320,450,72,23,184,256
"Bolivia","Potosí","Cornelio Saavedra","Chaquí","ESC. DON DIEGO",-65.60049,-19.50195,66,13,469,535,311,29,116,427
"Bolivia","Potosí","Cornelio Saavedra","Chaquí","ESC. RODERO",-65.51254,-19.56043,34,11,166,200,70,14,71,141
"Bolivia","Potosí","Cornelio Saavedra","Chaquí","ESC. SAN ANTONIO",-65.44303,-19.60513,90,13,228,318,95,16,104,199
"Bolivia","Potosí","Cornelio Saavedra","Tacobamba","COL. GUALBERTO VILLARROEL",-65.54424,-19.31846,46,8,213,259,133,17,55,188
"Bolivia","Potosí","Cornelio Saavedra","Tacobamba","ESC. ANCOMA",-65.63528,-19.13348,58,2,258,316,20,0,236,256
"Bolivia","Potosí","Cornelio Saavedra","Tacobamba","ESC. CAJAS ALTA",-65.63494,-19.29129,60,0,163,223,74,14,75,149
"Bolivia","Potosí","Cornelio Saavedra","Tacobamba","ESC. CENTRAL MACHACAMARCA",-65.54421,-19.37108,10,0,55,65,32,4,19,51
"Bolivia","Potosí","Cornelio Saavedra","Tacobamba","ESC. CHALLVIRI",-65.63294,-19.32677,47,5,210,257,116,14,75,191
"Bolivia","Potosí","Cornelio Saavedra","Tacobamba","ESC. C. MIGMA",-65.65115,-19.21268,95,13,197,292,84,16,84,168
"Bolivia","Potosí","Cornelio Saavedra","Tacobamba","ESC. GENOVEVA RIOS",-65.54977,-19.32013,57,16,221,278,90,5,110,200
"Bolivia","Potosí","Cornelio Saavedra","Tacobamba","ESC. HUAJCHI BAJO",-65.58374,-19.20394,38,1,67,105,17,3,46,63
"Bolivia","Potosí","Cornelio Saavedra","Tacobamba","ESC. JURUNA",-65.426,-19.219,50,5,284,334,21,10,248,269
"Bolivia","Potosí","Cornelio Saavedra","Tacobamba","ESC. RODEO",-65.58909,-19.07606,70,2,182,252,16,12,152,168
"Bolivia","Potosí","Cornelio Saavedra","Tacobamba","ESC. SECCIONAL TRAPICHE BAJO",-65.53699,-19.41847,12,1,69,81,26,4,38,64
"Bolivia","Potosí","Cornelio Saavedra","Tacobamba","ESC. SIMON BOLIVAR",-65.54227,-19.34671,22,2,44,66,21,3,18,39
"Bolivia","Potosí","Cornelio Saavedra","Tacobamba","ESC. TACOBAMBA",-65.55141,-19.20102,264,64,550,814,131,32,323,454
"Bolivia","Potosí","Cornelio Saavedra","Tacobamba","ESC. YAGUACARI",-65.60043,-19.04875,20,2,86,106,20,3,61,81
"Bolivia","Potosí","Cornelio Saavedra","Tacobamba","UNID. EDU. FRANZ TAMAYO",-65.44989,-19.16096,37,2,266,303,16,6,242,258
"Bolivia","Potosí","Daniel Campos","Llica","U.E. BERNABE LEDEZMA",-68.29847,-19.99556,13,0,66,79,8,1,57,65
"Bolivia","Potosí","Daniel Campos","Llica","U.E. CANQUELLA",-68.2532,-20.08167,14,0,65,79,19,0,46,65
"Bolivia","Potosí","Daniel Campos","Llica","U.E. ELIZARDO PEREZ",-68.10056,-19.62237,4,1,54,58,6,2,45,51
"Bolivia","Potosí","Daniel Campos","Llica","U.E. FRANZ TAMAYO",-68.2407,-19.86069,240,14,1053,1293,326,24,689,1015
"Bolivia","Potosí","Daniel Campos","Llica","U.E. HUANAQUE",-68.33338,-20.01662,24,4,89,113,13,0,72,85
"Bolivia","Potosí","Daniel Campos","Llica","U.E. MANUAL ANTONIO AGUIRRE",-68.30267,-20.11507,23,1,70,93,10,1,58,68
"Bolivia","Potosí","Daniel Campos","Llica","U.E. PALAYA",-68.13572,-19.80343,15,3,95,110,16,1,75,91
"Bolivia","Potosí","Daniel Campos","Llica","U.E. PEDRO GARCIA IGNACIO",-68.48859,-19.71477,16,3,62,78,19,0,40,59
"Bolivia","Potosí","Daniel Campos","Llica","U.E. VILLQUE",-68.10628,-19.66033,3,1,33,36,4,0,28,32
"Bolivia","Potosí","Daniel Campos","Tahua","ESC. JARUMA",-67.945,-19.77135,9,0,24,33,1,0,23,24
"Bolivia","Potosí","Daniel Campos","Tahua","ESC. TAMANCASA",-68.00201,-19.72284,5,0,27,32,5,2,20,25
"Bolivia","Potosí","Daniel Campos","Tahua","U.E. ANICETO ARCE",-67.9101,-19.7663,2,0,20,22,3,0,17,20
"Bolivia","Potosí","Daniel Campos","Tahua","U.E. BERNABE LEDEZMA",-67.80781,-19.82589,7,4,60,67,6,0,50,56
"Bolivia","Potosí","Daniel Campos","Tahua","U.E. CAQUENA",-67.76733,-19.84044,17,1,78,95,34,3,40,74
"Bolivia","Potosí","Daniel Campos","Tahua","U.E. FRANZ TAMAYO",-68.02673,-20.63319,1,2,120,121,37,1,80,117
"Bolivia","Potosí","Daniel Campos","Tahua","U.E. GERMAN BUSCH",-67.66147,-19.91329,4,0,35,39,10,1,24,34
"Bolivia","Potosí","Daniel Campos","Tahua","U.E. JOHN F. KENNEDY",-67.69619,-19.891,30,5,178,208,35,5,133,168
"Bolivia","Potosí","Enrique Baldivieso","San Agustín","ESC. SAN AGUSTIN",-67.6795,-21.1566,67,6,223,290,70,6,141,211
"Bolivia","Potosí","Enrique Baldivieso","San Agustín","ESC. VICTOR PAZ ESTENSORO",-67.35812,-21.51948,10,0,132,142,40,3,89,129
"Bolivia","Potosí","Enrique Baldivieso","San Agustín","U.E. 1RO DE MAYO",-67.23789,-21.70214,4,0,89,93,8,0,81,89
"Bolivia","Potosí","Enrique Baldivieso","San Agustín","U.E. ELIZARDO PEREZ",-67.18568,-21.72287,10,1,78,88,15,1,61,76
"Bolivia","Potosí","Enrique Baldivieso","San Agustín","U.E. LITORAL",-67.59641,-21.40281,36,4,223,259,109,5,105,214
"Bolivia","Potosí","General Bernardino B","Acacio","ESC. CHURITACA",-65.98965,-18.1063,78,7,417,495,12,9,389,401
"Bolivia","Potosí","General Bernardino B","Acacio","ESC. JOSE RIVERO",-66.05407,-18.02672,206,21,746,952,223,27,475,698
"Bolivia","Potosí","General Bernardino B","Acacio","ESC. PIRIQUINA",-66.01617,-18.0789,49,9,233,282,15,4,205,220
"Bolivia","Potosí","General Bernardino B","Acacio","ESC. TACONI DE CAINE",-66.00538,-17.94402,14,2,81,95,9,0,70,79
"Bolivia","Potosí","General Bernardino B","Acacio","ESC. TACONI YAMBATA",-65.94917,-18.04741,72,5,165,237,1,2,157,158
"Bolivia","Potosí","General Bernardino B","Acacio","ESC. TUQUIZA",-66.00704,-18.02213,41,11,208,249,15,5,177,192
"Bolivia","Potosí","General Bernardino B","Arampampa","ESC. ARAMPAMPA",-66.08163,-17.87692,50,14,225,275,54,27,130,184
"Bolivia","Potosí","General Bernardino B","Arampampa","ESC. CALACHUA",-66.12383,-17.98363,17,0,121,138,2,2,117,119
"Bolivia","Potosí","General Bernardino B","Arampampa","ESC. CATACORA",-66.15216,-17.94774,43,1,94,137,5,0,88,93
"Bolivia","Potosí","General Bernardino B","Arampampa","ESC. CHARCA MARCAVI",-66.04567,-17.92901,7,0,51,58,0,2,49,49
"Bolivia","Potosí","General Bernardino B","Arampampa","ESC. HUAYCURI",-66.10529,-17.85553,7,0,28,35,3,0,25,28
"Bolivia","Potosí","General Bernardino B","Arampampa","ESC. HUMAVIZA",-66.03617,-17.88659,4,1,16,20,4,2,9,13
"Bolivia","Potosí","General Bernardino B","Arampampa","ESC. MOLLEVILQUE",-66.10755,-17.84728,7,0,42,49,3,1,38,41
"Bolivia","Potosí","General Bernardino B","Arampampa","ESC. PARARANI",-66.105,-17.919,8,0,58,66,0,0,58,58
"Bolivia","Potosí","General Bernardino B","Arampampa","ESC. QOARACA",-66.17999,-18.0151,1,0,95,96,2,3,90,92
"Bolivia","Potosí","General Bernardino B","Arampampa","ESC. SANTIAGO",-66.19445,-17.99237,88,5,366,454,23,8,330,353
"Bolivia","Potosí","General Bernardino B","Arampampa","ESC. SARCURI",-66.08449,-17.94726,37,2,201,238,0,1,198,198
"Bolivia","Potosí","José María Linares","Caiza","COL. FRANZ TAMAYO",-65.69497,-19.88101,64,17,502,566,318,23,144,462
"Bolivia","Potosí","José María Linares","Caiza","ESC.DE KALTAPI",-65.55387,-20.01271,20,2,123,143,60,3,58,118
"Bolivia","Potosí","José María Linares","Caiza","ESC.DE PANOCOCHI",-65.6757,-20.1773,47,3,145,192,15,9,118,133
"Bolivia","Potosí","José María Linares","Caiza","ESC.HORNOS",-65.48529,-19.90132,92,5,253,345,67,14,167,234
"Bolivia","Potosí","José María Linares","Caiza","ESC. LA FRAGUA",-65.61447,-20.2052,29,4,154,183,18,9,123,141
"Bolivia","Potosí","José María Linares","Caiza","ESC.LA LAVA",-65.64637,-19.8947,79,15,372,451,134,21,202,336
"Bolivia","Potosí","José María Linares","Caiza","ESC. PALCA CANCHA",-65.56768,-19.94123,31,0,74,105,29,2,43,72
"Bolivia","Potosí","José María Linares","Caiza","ESC. SECCIONAL CHILLMA",-65.72665,-19.93593,58,15,309,367,156,23,115,271
"Bolivia","Potosí","José María Linares","Caiza","ESC. TRES CRUCES",-65.5471,-19.87114,253,40,801,1054,299,44,418,717
"Bolivia","Potosí","José María Linares","Caiza","ESC.TUCTAPARI",-65.53459,-20.04247,34,10,210,244,116,10,74,190
"Bolivia","Potosí","José María Linares","Caiza","NORMAL RURAL CAIZA D",-65.65247,-20.00772,212,28,953,1165,475,31,419,894
"Bolivia","Potosí","José María Linares","Ckochas","ESC. ALEJANDRO CORONADO",-65.14595,-19.67983,21,0,167,188,43,19,105,148
"Bolivia","Potosí","José María Linares","Ckochas","ESC. CENTRAL EUSEBIO B. FLORES",-64.83906,-19.61541,47,18,238,285,32,9,179,211
"Bolivia","Potosí","José María Linares","Ckochas","ESC.CKOCHAS",-65.2905,-19.63276,152,26,698,850,265,39,368,633
"Bolivia","Potosí","José María Linares","Ckochas","ESC.DE CALAPAYA",-65.206,-19.756,74,22,182,256,54,6,100,154
"Bolivia","Potosí","José María Linares","Ckochas","ESC.DE MELENA ALTA",-65.14054,-19.64427,37,4,221,258,55,7,155,210
"Bolivia","Potosí","José María Linares","Ckochas","ESC.DE MOJON CKASA",-64.9791,-19.75853,115,7,349,464,60,11,271,331
"Bolivia","Potosí","José María Linares","Ckochas","ESC.DE QUELUYO",-65.1904,-19.8398,128,8,297,425,61,24,204,265
"Bolivia","Potosí","José María Linares","Ckochas","ESC.DURAZNOS",-64.98342,-19.66648,56,4,240,296,54,12,170,224
"Bolivia","Potosí","José María Linares","Ckochas","ESC.ESQUIRI",-65.219,-19.64303,15,1,72,87,37,4,30,67
"Bolivia","Potosí","José María Linares","Ckochas","ESC.JOSE MA.LINARES",-64.94132,-19.81973,46,2,140,186,41,7,90,131
"Bolivia","Potosí","José María Linares","Ckochas","ESC. LAJAS",-64.91263,-19.58851,16,0,152,168,2,0,150,152
"Bolivia","Potosí","José María Linares","Ckochas","ESC. MEDIA LUNA",-64.77805,-19.76315,20,4,255,275,7,4,240,247
"Bolivia","Potosí","José María Linares","Ckochas","ESC. RODEO PAMPA",-64.81729,-19.81045,1,1,75,76,5,0,69,74
"Bolivia","Potosí","José María Linares","Ckochas","ESC. SAN PEDRO DE ESQUIRI",-65.19585,-19.5817,14,1,63,77,22,0,40,62
"Bolivia","Potosí","José María Linares","Ckochas","ESC.SECCIONAL",-64.83231,-19.83634,215,9,538,753,29,19,481,510
"Bolivia","Potosí","José María Linares","Ckochas","ESC. SECCIONAL CAPILLANI",-65.16954,-19.93791,35,3,104,139,33,7,61,94
"Bolivia","Potosí","José María Linares","Ckochas","ESC. SECCIONAL HUAYLLAJARA",-64.92155,-19.6202,35,3,141,176,21,3,114,135
"Bolivia","Potosí","José María Linares","Ckochas","ESC. SECCIONAL UYUNI",-65.12721,-19.85135,58,2,132,190,25,3,102,127
"Bolivia","Potosí","José María Linares","Ckochas","ESC. SEUCOCHI",-64.86348,-19.90878,111,13,339,450,32,14,280,312
"Bolivia","Potosí","José María Linares","Ckochas","ESC. SUCHINA",-65.24477,-19.72506,29,1,83,112,15,2,65,80
"Bolivia","Potosí","José María Linares","Ckochas","SECC. CARPA HUATA",-65.086,-19.586,19,1,59,78,12,2,44,56
"Bolivia","Potosí","José María Linares","Puna (Villa Talavera)","COLEG.LITORAL",-65.50571,-19.79494,223,50,819,1042,396,55,318,714
"Bolivia","Potosí","José María Linares","Puna (Villa Talavera)","ESC.BELEN",-65.54243,-19.86561,88,26,307,395,118,19,144,262
"Bolivia","Potosí","José María Linares","Puna (Villa Talavera)","ESC.CENTRAL",-65.52189,-19.49838,49,2,195,244,84,14,95,179
"Bolivia","Potosí","José María Linares","Puna (Villa Talavera)","ESC. CENTRAL JOSE MARIA LINARES",-65.30202,-19.6668,43,4,340,383,119,13,204,323
"Bolivia","Potosí","José María Linares","Puna (Villa Talavera)","ESC.DE ALCATUYO",-65.564,-19.86951,106,7,324,430,180,15,122,302
"Bolivia","Potosí","José María Linares","Puna (Villa Talavera)","ESC.DE HUAYCAYA",-65.61684,-19.8672,52,9,193,245,127,3,54,181
"Bolivia","Potosí","José María Linares","Puna (Villa Talavera)","ESC.DE KEPALLO",-65.31073,-19.90731,172,8,418,590,127,14,269,396
"Bolivia","Potosí","José María Linares","Puna (Villa Talavera)","ESC.DE LA ESMERALDA",-65.30669,-19.68868,77,30,307,384,125,13,139,264
"Bolivia","Potosí","José María Linares","Puna (Villa Talavera)","ESC.DE NUQUI",-65.30702,-19.97297,87,3,221,308,77,5,136,213
"Bolivia","Potosí","José María Linares","Puna (Villa Talavera)","ESC.DE SUQUICHA",-65.28864,-19.82753,117,7,266,383,111,16,132,243
"Bolivia","Potosí","José María Linares","Puna (Villa Talavera)","ESC. G.MALDINI CHACABUCO",-65.34591,-19.65162,49,6,301,350,124,16,155,279
"Bolivia","Potosí","José María Linares","Puna (Villa Talavera)","ESC.INCHASI",-65.47024,-19.7256,31,5,68,99,17,8,38,55
"Bolivia","Potosí","José María Linares","Puna (Villa Talavera)","ESC.JOSE MA. LINARES",-65.37317,-19.75613,123,4,315,438,89,16,206,295
"Bolivia","Potosí","José María Linares","Puna (Villa Talavera)","ESC.JOSE MARIA LINARES",-65.50571,-19.79494,195,53,871,1066,435,71,312,747
"Bolivia","Potosí","José María Linares","Puna (Villa Talavera)","ESC.MARAZA",-65.35992,-19.68579,43,22,174,217,60,7,85,145
"Bolivia","Potosí","José María Linares","Puna (Villa Talavera)","ESC. MOJONA",-65.33739,-20.07207,72,7,233,305,44,8,174,218
"Bolivia","Potosí","José María Linares","Puna (Villa Talavera)","ESC. SAN LORENZO",-65.32391,-19.80195,78,24,202,280,77,10,91,168
"Bolivia","Potosí","José María Linares","Puna (Villa Talavera)","ESC. SECCIONAL PAMPA TAMBO",-65.35207,-19.97996,54,4,125,179,43,5,73,116
"Bolivia","Potosí","José María Linares","Puna (Villa Talavera)","ESC.SEPULTURAS",-65.59354,-19.86297,82,25,300,382,118,18,139,257
"Bolivia","Potosí","José María Linares","Puna (Villa Talavera)","ESC.SIMON BOLIVAR",-65.33378,-20.05038,213,15,568,781,153,19,381,534
"Bolivia","Potosí","José María Linares","Puna (Villa Talavera)","ESC. TOMAS FRIAS",-65.51495,-19.7167,189,42,458,647,89,41,286,375
"Bolivia","Potosí","José María Linares","Puna (Villa Talavera)","ESC. TURQUIÑA",-65.26543,-19.7833,55,11,113,168,57,5,40,97
"Bolivia","Potosí","José María Linares","Puna (Villa Talavera)","ESC.VILACAYA",-65.48064,-19.99248,108,5,285,393,122,22,136,258
"Bolivia","Potosí","José María Linares","Puna (Villa Talavera)","ESC.YASPACI",-65.44774,-19.89478,66,2,174,240,59,6,107,166
"Bolivia","Potosí","José María Linares","Puna (Villa Talavera)","UNID. VILAMANI",-65.40481,-19.95643,38,4,142,180,40,6,92,132
"Bolivia","Potosí","Modesto Omiste","Villazón","COLEG. FRANZ TAMAYO",-65.81631,-21.80585,64,5,226,290,43,6,172,215
"Bolivia","Potosí","Modesto Omiste","Villazón","COLEGIO 9 DE ABRIL",-65.59546,-22.09029,712,61,2350,3062,1008,98,1183,2191
"Bolivia","Potosí","Modesto Omiste","Villazón","COL MARISCAL ANDRES DE SANTA CRUZ",-65.48156,-21.95128,17,5,130,147,28,5,92,120
"Bolivia","Potosí","Modesto Omiste","Villazón","COL.MODESTO OMISTE",-65.5955,-22.09031,587,24,1715,2302,859,63,769,1628
"Bolivia","Potosí","Modesto Omiste","Villazón","ESC. BERQUE",-65.78044,-21.94482,56,5,155,211,11,9,130,141
"Bolivia","Potosí","Modesto Omiste","Villazón","ESC. CORNELIO SAAVEDRA",-65.59546,-22.09029,818,44,2770,3588,1274,117,1335,2609
"Bolivia","Potosí","Modesto Omiste","Villazón","ESC. DANIEL CAMPOS",-65.59546,-22.09029,611,77,2640,3251,841,173,1549,2390
"Bolivia","Potosí","Modesto Omiste","Villazón","ESC. LIZARDO PEREZ",-65.51073,-21.91479,32,9,178,210,46,10,113,159
"Bolivia","Potosí","Modesto Omiste","Villazón","ESC. MAX FERNANDEZ",-65.59546,-22.09029,543,53,1897,2440,690,118,1036,1726
"Bolivia","Potosí","Modesto Omiste","Villazón","ESC. MORAYA",-65.54895,-21.74982,37,2,146,183,23,9,112,135
"Bolivia","Potosí","Modesto Omiste","Villazón","ESC. SALITRE",-65.34576,-22.02467,33,1,136,169,22,15,98,120
"Bolivia","Potosí","Modesto Omiste","Villazón","ESC. SAN PEDRO DE SOCOCHA",-65.45055,-21.93332,66,2,168,234,21,5,140,161
"Bolivia","Potosí","Modesto Omiste","Villazón","ESC. SARCARI",-66.02132,-21.91025,37,3,70,107,11,3,53,64
"Bolivia","Potosí","Modesto Omiste","Villazón","ESC. SARGENTO M. PAREDES",-65.87511,-21.95138,56,1,187,243,16,4,166,182
"Bolivia","Potosí","Modesto Omiste","Villazón","ESC. SECCIONAL CHAGUA",-65.80781,-21.88188,71,1,191,262,34,9,147,181
"Bolivia","Potosí","Modesto Omiste","Villazón","ESC. SECCIONAL SELOCHA",-65.48174,-21.80499,30,2,96,126,8,2,84,92
"Bolivia","Potosí","Modesto Omiste","Villazón","ESC. SECCIONAL SOCOCHA",-65.48177,-22.00244,93,14,166,259,19,10,123,142
"Bolivia","Potosí","Modesto Omiste","Villazón","ESC. YURUMA",-65.57485,-21.69375,38,2,209,247,62,10,135,197
"Bolivia","Potosí","Modesto Omiste","Villazón","NUCLEO DE MOJO",-65.55168,-21.83154,40,2,153,193,38,8,105,143
"Bolivia","Potosí","Modesto Omiste","Villazón","U.E. CALDERILLA",-65.58203,-21.71236,0,2,74,74,6,1,65,71
"Bolivia","Potosí","Modesto Omiste","Villazón","U.E.CUARTOS",-65.56418,-21.99242,1,0,27,28,6,1,20,26
"Bolivia","Potosí","Modesto Omiste","Villazón","U.E. MANTACILLAS",-65.59058,-22.06434,10,16,249,259,67,19,147,214
"Bolivia","Potosí","Modesto Omiste","Villazón","U.E. MONSEÑOR FELIX GAINZA",-65.56264,-21.73403,4,0,81,85,15,4,62,77
"Bolivia","Potosí","Modesto Omiste","Villazón","U.E. OJO DE AGUA",-65.61392,-22.08941,0,2,53,53,5,2,44,49
"Bolivia","Potosí","Modesto Omiste","Villazón","UN. ED. 1RO DE MAYO",-65.59546,-22.09029,999,107,4246,5245,1384,208,2547,3931
"Bolivia","Potosí","Modesto Omiste","Villazón","UN. ED. ALONSO DE IBAÑEZ",-65.59546,-22.09029,1085,73,2868,3953,950,184,1661,2611
"Bolivia","Potosí","Nor Chichas","Cotagaita","COLEG. CARLOS MEDINACELI",-65.66064,-20.8168,230,38,1159,1389,468,41,612,1080
"Bolivia","Potosí","Nor Chichas","Cotagaita","U.E. 2 DE ABRIL",-65.61977,-20.49149,31,4,145,176,50,2,89,139
"Bolivia","Potosí","Nor Chichas","Cotagaita","U.E. 6 DE JUNIO",-65.55482,-20.86805,27,2,236,263,30,5,199,229
"Bolivia","Potosí","Nor Chichas","Cotagaita","U.E. ASCANTY",-65.69196,-20.93444,24,11,234,258,19,4,200,219
"Bolivia","Potosí","Nor Chichas","Cotagaita","U.E. CARLOS MEDINACELI DE TASNA ROSARIO",-66.17947,-20.67462,182,16,841,1023,236,44,545,781
"Bolivia","Potosí","Nor Chichas","Cotagaita","U.E. CERRO COLORADO",-65.41893,-20.59675,9,0,49,58,2,0,47,49
"Bolivia","Potosí","Nor Chichas","Cotagaita","U.E. CHATI",-65.63601,-20.4317,39,1,123,162,27,10,85,112
"Bolivia","Potosí","Nor Chichas","Cotagaita","U.E. CHUI CHUI",-65.4746,-20.73512,29,0,59,88,3,2,54,57
"Bolivia","Potosí","Nor Chichas","Cotagaita","U.E. COLLPA UNO",-65.56855,-20.92512,22,3,231,253,65,1,162,227
"Bolivia","Potosí","Nor Chichas","Cotagaita","U.E. CORNACA",-65.57293,-21.06026,33,1,192,225,39,4,148,187
"Bolivia","Potosí","Nor Chichas","Cotagaita","U.E. COTAGAITILLA",-65.76016,-20.80183,49,7,252,301,34,15,196,230
"Bolivia","Potosí","Nor Chichas","Cotagaita","U.E. ELIZARDO PEREZ DE SAN JORGE",-65.72311,-20.26165,39,1,74,113,7,7,59,66
"Bolivia","Potosí","Nor Chichas","Cotagaita","U.E. EL MANZANAL",-65.5703,-21.10514,15,4,75,90,12,1,58,70
"Bolivia","Potosí","Nor Chichas","Cotagaita","U.E. EL PORVENIR A DE TOTORA I",-65.7318,-20.95282,194,22,614,808,148,18,426,574
"Bolivia","Potosí","Nor Chichas","Cotagaita","U.E. EL RANCHO",-65.43662,-20.66881,10,1,66,76,9,0,56,65
"Bolivia","Potosí","Nor Chichas","Cotagaita","U.E. JOSE ALONZO DE IBAÑEZ",-66.20502,-20.73754,63,6,354,417,117,19,212,329
"Bolivia","Potosí","Nor Chichas","Cotagaita","U.E. LAYTAPI",-65.61054,-20.99541,5,4,140,145,6,3,127,133
"Bolivia","Potosí","Nor Chichas","Cotagaita","U.E. MANUEL JOSE CORTEZ",-65.66064,-20.8168,220,21,1009,1229,404,45,539,943
"Bolivia","Potosí","Nor Chichas","Cotagaita","U.E. MARISCAL SUCRE",-65.69301,-20.41956,147,10,324,471,71,4,239,310
"Bolivia","Potosí","Nor Chichas","Cotagaita","U.E. MARTIN PRIMERO DE URUPALCA",-65.85529,-20.18545,47,0,84,131,27,1,56,83
"Bolivia","Potosí","Nor Chichas","Cotagaita","U.E. MOCKO PATA",-65.833,-20.729,15,0,169,184,10,5,154,164
"Bolivia","Potosí","Nor Chichas","Cotagaita","U.E. PAMPA GRANDE I",-65.39799,-20.70718,20,2,108,128,17,0,89,106
"Bolivia","Potosí","Nor Chichas","Cotagaita","U.E. PEDRO DOMINGO MURILLO DE SAGRARIO",-66.01643,-20.90559,53,8,326,379,65,14,239,304
"Bolivia","Potosí","Nor Chichas","Cotagaita","U.E. QUECHISLA",-66.11058,-20.87414,13,1,33,46,7,2,23,30
"Bolivia","Potosí","Nor Chichas","Cotagaita","U.E. RAMADAS",-65.63293,-21.08755,21,11,147,168,30,1,105,135
"Bolivia","Potosí","Nor Chichas","Cotagaita","U.E. SAN LORENZO",-65.40493,-20.75586,20,0,83,103,6,0,77,83
"Bolivia","Potosí","Nor Chichas","Cotagaita","U.E. SAN PEDRO DE CHECOCHI",-65.83663,-20.22395,43,1,102,145,31,4,66,97
"Bolivia","Potosí","Nor Chichas","Cotagaita","U.E. SANTIAGO WRIGHT",-65.70607,-20.62816,64,10,359,423,65,29,255,320
"Bolivia","Potosí","Nor Chichas","Cotagaita","U.E. SIMON BOLIVAR A DE TOROPALCA",-65.728,-20.329,228,28,555,783,119,16,392,511
"Bolivia","Potosí","Nor Chichas","Cotagaita","U.E. TAPCHIQUIRA",-65.79283,-20.41512,27,2,98,125,15,7,74,89
"Bolivia","Potosí","Nor Chichas","Cotagaita","U.E. TUPAC KATARI",-65.67236,-20.91708,87,6,194,281,20,3,165,185
"Bolivia","Potosí","Nor Chichas","Cotagaita","U.E. VILLA CONCEPCION",-65.567,-20.968,64,0,119,183,5,2,112,117
"Bolivia","Potosí","Nor Chichas","Cotagaita","U.E. VILLA IMPERIAL DE VICHACLA",-65.59898,-20.63377,40,9,208,248,34,15,150,184
"Bolivia","Potosí","Nor Chichas","Cotagaita","U.E. VILLA SAN LORENZO",-65.81915,-21.01485,46,1,195,241,8,2,184,192
"Bolivia","Potosí","Nor Chichas","Vitichi","U.E. ARA",-65.49908,-20.52345,84,10,223,307,70,10,133,203
"Bolivia","Potosí","Nor Chichas","Vitichi","U.E. AYOMA BAJA",-65.34461,-20.14421,65,7,180,245,17,4,152,169
"Bolivia","Potosí","Nor Chichas","Vitichi","U.E. CALCHA",-65.4649,-20.36904,180,45,415,595,119,25,226,345
"Bolivia","Potosí","Nor Chichas","Vitichi","U.E. ESTUMILLA",-65.40064,-20.5226,29,3,158,187,23,3,129,152
"Bolivia","Potosí","Nor Chichas","Vitichi","U.E. FRAY ANGELLO STELLINI DE CALVI",-65.35645,-20.34421,105,19,278,383,34,6,219,253
"Bolivia","Potosí","Nor Chichas","Vitichi","U.E. JUAN PELLEGRINI",-65.38126,-20.24069,177,38,508,685,86,7,377,463
"Bolivia","Potosí","Nor Chichas","Vitichi","U.E. MANUEL MORA DE PECKAJSI",-65.388,-20.354,85,0,256,341,20,11,225,245
"Bolivia","Potosí","Nor Chichas","Vitichi","U.E. PRIMO MARTINEZ",-65.49222,-20.55351,19,2,117,136,52,3,60,112
"Bolivia","Potosí","Nor Chichas","Vitichi","U.E. PULAXI",-65.51803,-20.55417,14,2,32,46,13,2,15,28
"Bolivia","Potosí","Nor Chichas","Vitichi","U.E. SAN MIGUEL DE TUSQUIÑA",-65.32579,-20.28519,72,9,483,555,95,7,372,467
"Bolivia","Potosí","Nor Chichas","Vitichi","U.E. TOMAS FRIAS",-65.49218,-20.20666,343,60,904,1247,348,34,462,810
"Bolivia","Potosí","Nor Lípez","Colcha K (Villa Martín)","ESC. ANTOFAGASTA",-67.76271,-20.89953,44,6,213,257,108,5,94,202
"Bolivia","Potosí","Nor Lípez","Colcha K (Villa Martín)","ESC. SANTIAGO",-67.1608,-21.64687,27,6,121,148,64,8,43,107
"Bolivia","Potosí","Nor Lípez","Colcha K (Villa Martín)","ESC. TOMAS FRIAS",-67.68085,-20.58681,3,0,93,96,40,0,53,93
"Bolivia","Potosí","Nor Lípez","Colcha K (Villa Martín)","U.E. 2 DE AGOSTO",-67.9187,-21.21596,27,6,195,222,84,7,98,182
"Bolivia","Potosí","Nor Lípez","Colcha K (Villa Martín)","U.E. ALFONZO IBAÑES",-67.70047,-20.62012,10,0,56,66,13,1,42,55
"Bolivia","Potosí","Nor Lípez","Colcha K (Villa Martín)","U.E. ANTOFAGASTA",-67.34248,-21.83394,35,2,241,276,107,5,127,234
"Bolivia","Potosí","Nor Lípez","Colcha K (Villa Martín)","U.E. BUENAS NUEVAS DE VINTO K",-67.02643,-20.68222,24,5,218,242,62,5,146,208
"Bolivia","Potosí","Nor Lípez","Colcha K (Villa Martín)","U.E. EDUARDO ABAROA",-67.66145,-20.73985,271,10,797,1068,329,25,433,762
"Bolivia","Potosí","Nor Lípez","Colcha K (Villa Martín)","U.E. EDUARDO ABAROA",-67.22194,-21.25105,271,10,797,1068,329,25,433,762
"Bolivia","Potosí","Nor Lípez","Colcha K (Villa Martín)","U.E. EDUARDO ABAROA DE VILLA MAR",-67.48146,-21.75496,42,12,182,224,64,4,102,166
"Bolivia","Potosí","Nor Lípez","Colcha K (Villa Martín)","U.E. HENRY LAREDO",-67.56828,-20.91416,11,0,38,49,17,0,21,38
"Bolivia","Potosí","Nor Lípez","Colcha K (Villa Martín)","U.E. JOSE BALLIVIAN",-66.3466,-18.14842,20,2,213,233,59,1,151,210
"Bolivia","Potosí","Nor Lípez","Colcha K (Villa Martín)","U.E. JUANA AZURDUY",-67.6095,-20.59178,2,3,33,35,15,1,14,29
"Bolivia","Potosí","Nor Lípez","Colcha K (Villa Martín)","U.E. LADISLAO CABRERA",-66.54451,-21.06077,30,2,122,152,25,8,87,112
"Bolivia","Potosí","Nor Lípez","Colcha K (Villa Martín)","U.E. LITORAL",-67.53351,-21.04118,38,0,96,134,33,2,61,94
"Bolivia","Potosí","Nor Lípez","Colcha K (Villa Martín)","U.E. LUIS ESPINAL",-67.63012,-20.57336,0,0,57,57,7,1,49,56
"Bolivia","Potosí","Nor Lípez","Colcha K (Villa Martín)","U.E. NUEVO AMANECER",-67.29654,-20.82078,88,6,354,442,141,6,201,342
"Bolivia","Potosí","Nor Lípez","Colcha K (Villa Martín)","U.E. RICARDO RODRIGUEZ",-67.17109,-21.16474,223,23,1485,1708,468,50,944,1412
"Bolivia","Potosí","Nor Lípez","Colcha K (Villa Martín)","U.E. SIMON BOLIVAR",-66.56165,-21.23029,50,4,208,258,58,13,133,191
"Bolivia","Potosí","Nor Lípez","Colcha K (Villa Martín)","U.E. TOMAS FRIAS",-66.79474,-21.20591,36,2,196,232,55,10,129,184
"Bolivia","Potosí","Nor Lípez","San Pedro de Quemes","U.E. CECILIO VELIZ",-68.04866,-20.74629,55,2,227,282,93,1,131,224
"Bolivia","Potosí","Nor Lípez","San Pedro de Quemes","U.E. CORNELIO SAAVEDRA",-68.03695,-20.94468,20,1,42,62,8,0,33,41
"Bolivia","Potosí","Nor Lípez","San Pedro de Quemes","U.E. EDUARDO ABAROA",-68.21673,-21.19829,1,0,12,13,3,0,9,12
"Bolivia","Potosí","Nor Lípez","San Pedro de Quemes","U.E.LADISLAO CABRERA",-68.34213,-21.01003,5,0,25,30,20,0,5,25
"Bolivia","Potosí","Rafael Bustillo","Chayanta","ESC. COCAFAYA",-66.37881,-18.50657,34,5,344,378,62,10,267,329
"Bolivia","Potosí","Rafael Bustillo","Chayanta","ESC. COPANA",-66.35302,-18.23664,16,27,352,368,34,13,278,312
"Bolivia","Potosí","Rafael Bustillo","Chayanta","ESC. MANCO CAPAC",-66.30493,-18.52878,23,22,329,352,40,9,258,298
"Bolivia","Potosí","Rafael Bustillo","Chayanta","ESC. MCAL. SANTA CRUZ",-66.44352,-18.46028,263,67,1688,1951,664,77,880,1544
"Bolivia","Potosí","Rafael Bustillo","Chayanta","ESC. OCTAVIO MURILLO",-66.38741,-18.48727,53,36,750,803,282,36,396,678
"Bolivia","Potosí","Rafael Bustillo","Chayanta","ESC. PHUSUTA PAMPA",-66.23933,-18.47786,13,7,120,133,13,11,89,102
"Bolivia","Potosí","Rafael Bustillo","Chayanta","ESC. PICHATA",-66.39987,-18.40766,30,0,284,314,24,7,253,277
"Bolivia","Potosí","Rafael Bustillo","Chayanta","ESC. QUINTA PAMPA",-66.32737,-18.23514,55,8,327,382,15,13,291,306
"Bolivia","Potosí","Rafael Bustillo","Chayanta","ESC. RAFAEL PABON",-66.46142,-18.44868,68,20,486,554,169,34,263,432
"Bolivia","Potosí","Rafael Bustillo","Chayanta","NUCLEO ESCOLAR",-66.28407,-18.42465,61,28,231,292,92,14,97,189
"Bolivia","Potosí","Rafael Bustillo","Chayanta","NUCLEO ESCOLAR IRUPATA",-66.37756,-18.29441,166,66,924,1090,117,43,698,815
"Bolivia","Potosí","Rafael Bustillo","Chayanta","NUCLEO ESCOLAR NUEVA COLCHA",-66.26283,-18.54489,43,0,277,320,13,12,252,265
"Bolivia","Potosí","Rafael Bustillo","Chayanta","NUCLEO ESCOLAR RIO VERDE (QUILA QUILA)",-66.30909,-18.37211,19,8,187,206,70,4,105,175
"Bolivia","Potosí","Rafael Bustillo","Chuquihuta","COL. PABLO ZARATE VILLCA",-66.36883,-18.59564,286,101,1568,1854,526,127,814,1340
"Bolivia","Potosí","Rafael Bustillo","Chuquihuta","ESC. LULUNI",-66.41494,-18.66807,41,59,284,325,40,17,168,208
"Bolivia","Potosí","Rafael Bustillo","Chuquihuta","ESC. TACOPALCA",-66.33701,-18.641,222,52,923,1145,240,103,528,768
"Bolivia","Potosí","Rafael Bustillo","Llallagua","COLEG. 1RO. DE MAYO",-66.58627,-18.42284,553,104,3722,4275,1973,182,1463,3436
"Bolivia","Potosí","Rafael Bustillo","Llallagua","COLEG. JUNIN",-66.58627,-18.42284,342,69,2250,2592,986,166,1029,2015
"Bolivia","Potosí","Rafael Bustillo","Llallagua","COLEG. SIGLO XX-AMERICA",-66.58627,-18.42284,562,67,3368,3930,1690,164,1447,3137
"Bolivia","Potosí","Rafael Bustillo","Llallagua","ESC. 6 DE JUNIO",-66.58627,-18.42284,227,47,1161,1388,537,83,494,1031
"Bolivia","Potosí","Rafael Bustillo","Llallagua","ESC. BARTOLINA SISA",-66.66508,-18.34604,50,34,503,553,130,37,302,432
"Bolivia","Potosí","Rafael Bustillo","Llallagua","ESC. CAPUNITA",-66.48626,-18.40959,47,6,279,326,67,16,190,257
"Bolivia","Potosí","Rafael Bustillo","Llallagua","ESC. CARLOS MEDINACELI",-66.58627,-18.42284,279,53,2121,2400,1133,106,829,1962
"Bolivia","Potosí","Rafael Bustillo","Llallagua","ESC. CHIRU CHIRU",-66.43234,-18.28475,14,3,207,221,21,9,174,195
"Bolivia","Potosí","Rafael Bustillo","Llallagua","ESC. JAIME MENDOZA",-66.58627,-18.42284,401,65,3191,3592,1809,148,1169,2978
"Bolivia","Potosí","Rafael Bustillo","Llallagua","ESC. UYUNI",-66.82401,-20.45792,24,0,318,342,16,37,265,281
"Bolivia","Potosí","Rafael Bustillo","Llallagua","HUMANISTICO LLALLAGUA",-66.58627,-18.42284,422,73,2559,2981,1343,152,991,2334
"Bolivia","Potosí","Rafael Bustillo","Llallagua","MARTIN CARDENAS",-66.58627,-18.42284,358,96,2566,2924,1036,215,1219,2255
"Bolivia","Potosí","Rafael Bustillo","Llallagua","NUCLEO JISK'ANQUI",-66.55359,-18.32512,20,21,253,273,106,11,115,221
"Bolivia","Potosí","Rafael Bustillo","Uncía","CÁRCEL SAN MIGUEL DE UNCÍA",-66.56538,-18.46565,7,1,29,36,15,0,13,28
"Bolivia","Potosí","Rafael Bustillo","Uncía","CHILCA PALCA",-66.48528,-18.62824,82,33,384,466,93,49,209,302
"Bolivia","Potosí","Rafael Bustillo","Uncía","COLEG. RAFAEL BUSTILLO",-66.56538,-18.46565,466,77,2251,2717,1085,97,992,2077
"Bolivia","Potosí","Rafael Bustillo","Uncía","COL. INTERMEDIO INDEPENDENCIA",-66.56538,-18.46565,276,72,1938,2214,1068,136,662,1730
"Bolivia","Potosí","Rafael Bustillo","Uncía","ESC. CHOCO CHICO",-66.56693,-18.66152,17,7,91,108,57,5,22,79
"Bolivia","Potosí","Rafael Bustillo","Uncía","ESC. HUACUTA A",-66.57107,-18.59737,20,10,123,143,62,5,46,108
"Bolivia","Potosí","Rafael Bustillo","Uncía","ESC. JUANA AZURDUY DE PADILLA",-66.56538,-18.46565,272,60,1759,2031,826,94,779,1605
"Bolivia","Potosí","Rafael Bustillo","Uncía","ESC. MODESTO OMISTE",-66.56538,-18.46565,162,35,1160,1322,707,45,373,1080
"Bolivia","Potosí","Rafael Bustillo","Uncía","ESC. MOROCOMARCA",-66.529,-18.674,116,29,334,450,80,28,197,277
"Bolivia","Potosí","Rafael Bustillo","Uncía","ESC. SUBCENTRAL LAGUNILLAS",-66.41483,-18.5441,46,18,337,383,57,19,243,300
"Bolivia","Potosí","Rafael Bustillo","Uncía","NUCLEO ESCOLAR CALA CALA",-66.48356,-18.52519,109,35,991,1100,173,48,735,908
"Bolivia","Potosí","Sur Chichas","Atocha","COL. CHOROLQUE",-66.0516,-20.92446,145,28,1092,1237,316,50,698,1014
"Bolivia","Potosí","Sur Chichas","Atocha","COLEG. GREGORIO PACHECO",-66.22056,-20.93593,181,20,751,932,293,33,405,698
"Bolivia","Potosí","Sur Chichas","Atocha","ESC. CHOCAYA",-66.3306,-20.97412,14,1,72,86,10,4,57,67
"Bolivia","Potosí","Sur Chichas","Atocha","ESC. CHOROLQUE VIEJO",-66.06475,-21.01707,4,0,12,16,2,0,10,12
"Bolivia","Potosí","Sur Chichas","Atocha","ESC. DE ANIMAS",-66.30733,-20.96173,83,20,677,760,312,15,330,642
"Bolivia","Potosí","Sur Chichas","Atocha","ESC. DE SIETE SUYOS",-66.29662,-20.9496,91,16,527,618,176,23,312,488
"Bolivia","Potosí","Sur Chichas","Atocha","ESC. DE TACMARI",-66.06282,-21.08223,0,0,21,21,3,1,17,20
"Bolivia","Potosí","Sur Chichas","Atocha","ESC. EDUARDO AVAROA",-66.22056,-20.93593,123,20,606,729,213,35,338,551
"Bolivia","Potosí","Sur Chichas","Atocha","ESC. GUADALUPE",-65.79517,-18.69062,17,0,46,63,9,3,34,43
"Bolivia","Potosí","Sur Chichas","Atocha","ESC. JULIO URQUIETA",-66.31551,-21.26756,94,12,473,567,137,26,298,435
"Bolivia","Potosí","Sur Chichas","Atocha","ESC. PORTUGALETE",-66.14603,-21.16817,50,8,310,360,74,13,215,289
"Bolivia","Potosí","Sur Chichas","Atocha","UNIDAD EDUCATIVA TELAMAYU",-66.22509,-20.94718,84,5,369,453,122,13,229,351
"Bolivia","Potosí","Sur Chichas","Tupiza","CÁRCEL TUPIZA",-65.72643,-21.4452,1,0,27,28,11,0,16,27
"Bolivia","Potosí","Sur Chichas","Tupiza","COLEGIO ANTOFAGASTA",-65.72643,-21.4452,364,38,1879,2243,788,83,970,1758
"Bolivia","Potosí","Sur Chichas","Tupiza","COL. NAL. MIXTO CHICHAS",-65.6029,-21.18405,22,6,107,129,9,5,87,96
"Bolivia","Potosí","Sur Chichas","Tupiza","EL MOLINO",-65.49464,-21.74079,13,0,58,71,11,1,46,57
"Bolivia","Potosí","Sur Chichas","Tupiza","ESC. CHACO PAMPA",-65.77544,-21.51714,69,7,283,352,46,10,220,266
"Bolivia","Potosí","Sur Chichas","Tupiza","ESC. CHIFLOCA",-65.79998,-21.48615,13,3,95,108,36,5,51,87
"Bolivia","Potosí","Sur Chichas","Tupiza","ESC. CHILLCO",-66.10437,-21.40515,28,4,104,132,29,8,63,92
"Bolivia","Potosí","Sur Chichas","Tupiza","ESC. CHUQUI",-66.17671,-21.72463,12,1,42,54,3,2,36,39
"Bolivia","Potosí","Sur Chichas","Tupiza","ESC. CHUQUIAGO",-65.64294,-21.56561,60,9,225,285,37,9,170,207
"Bolivia","Potosí","Sur Chichas","Tupiza","ESC. CONCEPCION",-66.12894,-21.69586,2,0,12,14,1,0,11,12
"Bolivia","Potosí","Sur Chichas","Tupiza","ESC. DE ALMONA",-65.78484,-21.17253,23,10,118,141,21,2,85,106
"Bolivia","Potosí","Sur Chichas","Tupiza","ESC. DE MOCHARA",-65.59682,-21.27156,25,5,218,243,14,5,194,208
"Bolivia","Potosí","Sur Chichas","Tupiza","ESC. DE OPLOCA",-65.80829,-21.33162,68,17,365,433,94,32,222,316
"Bolivia","Potosí","Sur Chichas","Tupiza","ESC. DE RIO BLANCO",-65.59937,-21.14781,33,0,125,158,10,6,109,119
"Bolivia","Potosí","Sur Chichas","Tupiza","ESC. DE SALO",-65.78109,-21.24509,32,7,183,215,28,4,144,172
"Bolivia","Potosí","Sur Chichas","Tupiza","ESC. DE SAN MIGUEL",-65.75484,-21.3053,28,1,121,149,21,7,92,113
"Bolivia","Potosí","Sur Chichas","Tupiza","ESC. ESMORACA",-66.22615,-21.6957,20,6,202,222,64,5,127,191
"Bolivia","Potosí","Sur Chichas","Tupiza","ESC. ESPICAYA",-65.79379,-21.58842,32,2,165,197,32,7,124,156
"Bolivia","Potosí","Sur Chichas","Tupiza","ESC. ESTARCA",-65.95553,-21.66106,22,0,138,160,21,1,116,137
"Bolivia","Potosí","Sur Chichas","Tupiza","ESC. HUARIRACA",-65.98829,-21.71672,5,1,33,38,5,0,27,32
"Bolivia","Potosí","Sur Chichas","Tupiza","ESC. KUCHU",-66.01013,-21.51916,11,1,54,65,11,1,41,52
"Bolivia","Potosí","Sur Chichas","Tupiza","ESC. MIXTA 7 DE NOVIEMBRE",-65.72643,-21.4452,415,23,2101,2516,1080,80,918,1998
"Bolivia","Potosí","Sur Chichas","Tupiza","ESC. NAZARENO",-65.58674,-21.60765,50,15,251,301,40,11,185,225
"Bolivia","Potosí","Sur Chichas","Tupiza","ESC. ORO INGENIO",-65.96437,-21.31153,13,1,44,57,7,5,31,38
"Bolivia","Potosí","Sur Chichas","Tupiza","ESC. REYNECILLA",-65.2538,-21.58071,45,0,113,158,19,4,90,109
"Bolivia","Potosí","Sur Chichas","Tupiza","ESC. SAN JOSE PAMPA GRANDE",-65.81684,-21.67879,52,15,178,230,14,7,142,156
"Bolivia","Potosí","Sur Chichas","Tupiza","ESC. SANTO DOMINCO",-66.10701,-21.56706,8,0,19,27,2,0,17,19
"Bolivia","Potosí","Sur Chichas","Tupiza","ESC. SECCIONAL",-65.30436,-21.69688,31,1,128,159,18,8,101,119
"Bolivia","Potosí","Sur Chichas","Tupiza","ESC. SUIPACHA",-65.60592,-21.57154,178,29,560,738,155,37,339,494
"Bolivia","Potosí","Sur Chichas","Tupiza","ESC. SUPIRA",-65.52016,-21.59575,31,6,148,179,40,15,87,127
"Bolivia","Potosí","Sur Chichas","Tupiza","ESC. TALINA",-65.82471,-21.74855,47,8,129,176,10,2,109,119
"Bolivia","Potosí","Sur Chichas","Tupiza","ESC. TAPAXA",-65.9848,-21.61774,15,4,96,111,13,5,74,87
"Bolivia","Potosí","Sur Chichas","Tupiza","ESC. TITIHOYO",-65.75745,-21.5398,8,1,78,86,10,6,61,71
"Bolivia","Potosí","Sur Chichas","Tupiza","ESC. TOCLOCA",-65.68027,-21.51474,74,11,285,359,57,10,207,264
"Bolivia","Potosí","Sur Chichas","Tupiza","ESC. VILLA FATIMA ANDRES DE SANTA CRUZ",-65.72643,-21.4452,330,63,1990,2320,775,115,1037,1812
"Bolivia","Potosí","Sur Chichas","Tupiza","ESC. ZAPATERA",-66.18834,-21.62791,5,0,33,38,9,0,24,33
"Bolivia","Potosí","Sur Chichas","Tupiza","INSTITUTO SAN JUAN",-65.72643,-21.4452,468,37,2402,2870,1277,102,986,2263
"Bolivia","Potosí","Sur Chichas","Tupiza","KINDER REMEDIOS",-65.72643,-21.4452,738,87,3803,4541,1206,200,2310,3516
"Bolivia","Potosí","Sur Chichas","Tupiza","NUCLEO ESCOLAR QUIRIZA",-65.79105,-21.61311,45,10,223,268,28,2,183,211
"Bolivia","Potosí","Sur Chichas","Tupiza","U.E. G. BERRIOS",-65.72643,-21.4452,22,5,137,159,39,5,88,127
"Bolivia","Potosí","Sur Chichas","Tupiza","U.E. NACIONAL 6 DE JUNIO",-65.58966,-21.57787,19,13,280,299,70,33,164,234
"Bolivia","Potosí","Sur Chichas","Tupiza","U.E. P. HARRIS",-65.72643,-21.4452,16,7,157,173,37,15,98,135
"Bolivia","Potosí","Sur Chichas","Tupiza","U.E. TOMATAS",-65.63572,-21.54967,11,4,115,126,20,13,78,98
"Bolivia","Potosí","Sur Chichas","Tupiza","UNIDAD EDUCATIVA RITA ROMANO",-65.72643,-21.4452,296,40,1575,1871,586,98,851,1437
"Bolivia","Potosí","Sur Chichas","Tupiza","UNIDAD EDUCATIVA TUPIZA B",-65.72643,-21.4452,337,30,1464,1801,493,78,863,1356
"Bolivia","Potosí","Sur Chichas","Tupiza","VETERINARIA SUB SEDE UATF",-65.72643,-21.4452,199,29,1070,1269,460,53,528,988
"Bolivia","Potosí","Sur Lípez","Mojinete","ESC. BONETE PALCA",-66.394,-21.788,0,0,13,13,1,0,12,13
"Bolivia","Potosí","Sur Lípez","Mojinete","ESC. CASA GRANDE",-66.27042,-21.93487,14,4,64,78,3,3,54,57
"Bolivia","Potosí","Sur Lípez","Mojinete","ESC. LA CIENEGA",-66.33878,-21.79782,7,0,24,31,2,1,21,23
"Bolivia","Potosí","Sur Lípez","Mojinete","ESC. PUEBLO VIEJO",-66.28301,-21.84269,2,0,20,22,1,0,19,20
"Bolivia","Potosí","Sur Lípez","Mojinete","H. ALCALDIA MUNICIPAL",-66.23934,-21.76464,24,2,97,121,12,2,81,93
"Bolivia","Potosí","Sur Lípez","San Antonio de Esmoruco","ESC. 10 DE NOVIEMBRE",-66.51337,-21.84954,20,0,73,93,12,0,61,73
"Bolivia","Potosí","Sur Lípez","San Antonio de Esmoruco","ESC. ANTOFAGASTA",-66.41882,-22.10488,34,6,112,146,31,3,72,103
"Bolivia","Potosí","Sur Lípez","San Antonio de Esmoruco","ESC. CENTRAL CALAMA",-66.51688,-21.9479,55,7,252,307,56,9,180,236
"Bolivia","Potosí","Sur Lípez","San Antonio de Esmoruco","ESC. DE RIO SECO",-66.33189,-21.99798,4,1,76,80,14,2,59,73
"Bolivia","Potosí","Sur Lípez","San Antonio de Esmoruco","ESC. OCKE ORCKO",-66.31582,-21.96951,7,2,48,55,6,0,40,46
"Bolivia","Potosí","Sur Lípez","San Antonio de Esmoruco","ESC. RANCHO CHILENO",-66.79728,-22.40032,9,0,29,38,8,0,21,29
"Bolivia","Potosí","Sur Lípez","San Pablo de Lípez","ESC. EDUARDO AVAROA",-67.35746,-22.22936,3,8,53,56,28,5,12,40
"Bolivia","Potosí","Sur Lípez","San Pablo de Lípez","ESC. KOLLPANI",-66.91783,-22.03759,6,0,51,57,7,3,41,48
"Bolivia","Potosí","Sur Lípez","San Pablo de Lípez","ESC. QUETENA CHICO",-67.34043,-22.1941,18,4,223,241,104,3,112,216
"Bolivia","Potosí","Sur Lípez","San Pablo de Lípez","ESC. RELAVE",-66.79867,-21.76142,15,1,45,60,16,4,24,40
"Bolivia","Potosí","Sur Lípez","San Pablo de Lípez","ESC. SANTA ISABEL",-66.45042,-21.64084,19,0,30,49,1,0,29,30
"Bolivia","Potosí","Sur Lípez","San Pablo de Lípez","ESC. SECCIONAL RIO SAN PABLO",-66.76449,-21.60779,12,3,89,101,23,2,61,84
"Bolivia","Potosí","Sur Lípez","San Pablo de Lípez","ESC. SECCIONAL VILUYO",-66.35195,-21.53281,16,0,83,99,5,3,75,80
"Bolivia","Potosí","Sur Lípez","San Pablo de Lípez","ESC. VILLA PORVENIR",-66.88214,-21.87592,23,3,111,134,37,9,62,99
"Bolivia","Potosí","Sur Lípez","San Pablo de Lípez","SALON DE COMUNIDAD",-66.48465,-21.41609,3,3,91,94,26,3,59,85
"Bolivia","Potosí","Sur Lípez","San Pablo de Lípez","SALON DE PLAZA",-66.67158,-21.50187,27,4,126,153,38,13,71,109
"Bolivia","Potosí","Sur Lípez","San Pablo de Lípez","U.E. COLORADOS DE BOLIVIA",-66.61893,-21.68718,12,0,70,82,23,7,40,63
"Bolivia","Potosí","Tomás Frías","Potosí","(CÁRCEL) PENAL DE CANTUMARCA",-65.78258,-19.59936,39,1,106,145,70,4,31,101
"Bolivia","Potosí","Tomás Frías","Potosí","CENTRO ED. FRAY VICENTE BERNEDO",-65.749,-19.58,551,40,4272,4823,3555,124,553,4108
"Bolivia","Potosí","Tomás Frías","Potosí","COL. 31 DE OCTUBRE",-65.7597,-19.58211,181,3,1186,1367,1006,30,147,1153
"Bolivia","Potosí","Tomás Frías","Potosí","COL. ANICETO ARCE",-65.75697,-19.58251,113,4,841,954,719,21,97,816
"Bolivia","Potosí","Tomás Frías","Potosí","COL. CARLOS MEDINACELI",-65.75753,-19.58196,96,3,731,827,641,9,78,719
"Bolivia","Potosí","Tomás Frías","Potosí","COL. DIVINO MAESTRO",-65.77073,-19.56213,348,7,2512,2860,2122,54,329,2451
"Bolivia","Potosí","Tomás Frías","Potosí","COLEG. ANTOFAGASTA",-65.74934,-19.59519,368,17,2803,3171,2396,54,336,2732
"Bolivia","Potosí","Tomás Frías","Potosí","COLEG. BANCARIO",-65.7532,-19.5843,131,3,1009,1140,910,9,87,997
"Bolivia","Potosí","Tomás Frías","Potosí","COLEG. CRISTO MAESTRO",-65.753,-19.583,63,1,548,611,497,4,46,543
"Bolivia","Potosí","Tomás Frías","Potosí","COLEG. DAVID BERRIOS",-65.76199,-19.58034,223,4,1576,1799,1323,42,207,1530
"Bolivia","Potosí","Tomás Frías","Potosí","COLEG. DON BOSCO",-65.75298,-19.58537,129,0,985,1114,887,10,88,975
"Bolivia","Potosí","Tomás Frías","Potosí","COLEGIO FRANCISCANO",-65.75263,-19.59103,94,2,927,1021,851,6,68,919
"Bolivia","Potosí","Tomás Frías","Potosí","COLEG. LUIS ESPINAL",-65.74538,-19.59578,525,34,3280,3805,2729,106,411,3140
"Bolivia","Potosí","Tomás Frías","Potosí","COLEG. SAN RAFAEL",-65.59398,-19.45205,99,17,822,921,503,89,213,716
"Bolivia","Potosí","Tomás Frías","Potosí","ESC. 12 DE ABRIL",-65.7491,-19.59479,119,5,898,1017,739,33,121,860
"Bolivia","Potosí","Tomás Frías","Potosí","ESC. 1RO DE ABRIL",-65.75495,-19.58885,61,2,526,587,456,9,59,515
"Bolivia","Potosí","Tomás Frías","Potosí","ESC. 6 DE JUNIO",-65.77945,-19.58491,182,25,1695,1877,1122,88,460,1582
"Bolivia","Potosí","Tomás Frías","Potosí","ESC. ANTONIO QUIJARRO",-65.75183,-19.59038,73,0,552,625,505,6,41,546
"Bolivia","Potosí","Tomás Frías","Potosí","ESC. BENICIO MONTERO MALLO",-65.74702,-19.59106,221,7,1868,2089,1631,42,188,1819
"Bolivia","Potosí","Tomás Frías","Potosí","ESC. BOLIVIANO ALEMÁN",-65.771,-19.583,155,20,1233,1388,1012,37,164,1176
"Bolivia","Potosí","Tomás Frías","Potosí","ESC. CLETO LOAYZA",-65.75833,-19.59216,352,27,2543,2895,2186,56,274,2460
"Bolivia","Potosí","Tomás Frías","Potosí","ESC. COBIJA",-65.75887,-19.57669,465,17,3334,3799,2826,73,418,3244
"Bolivia","Potosí","Tomás Frías","Potosí","ESC. COPACABANA",-65.75468,-19.59232,282,10,2160,2442,1905,52,193,2098
"Bolivia","Potosí","Tomás Frías","Potosí","ESC. DANIEL CAMPOS",-65.75119,-19.57934,792,30,4956,5748,4150,132,644,4794
"Bolivia","Potosí","Tomás Frías","Potosí","ESC. ENRIQUE VIANA",-65.75941,-19.57416,487,23,3819,4306,3238,81,477,3715
"Bolivia","Potosí","Tomás Frías","Potosí","ESC. GERMAN BUSCH",-65.76686,-19.59209,332,27,2128,2460,1676,100,325,2001
"Bolivia","Potosí","Tomás Frías","Potosí","ESC. GREGORIO BARRIGA",-65.75343,-19.58554,58,1,383,441,344,3,35,379
"Bolivia","Potosí","Tomás Frías","Potosí","ESC. GUALBERTO VILLARROEL",-65.75404,-19.59555,282,19,2176,2458,1756,77,324,2080
"Bolivia","Potosí","Tomás Frías","Potosí","ESC. JAIME MENDOZA",-65.744,-19.60323,201,21,1240,1441,981,41,197,1178
"Bolivia","Potosí","Tomás Frías","Potosí","ESC. JESUS DE NAZARET",-65.77232,-19.56954,321,28,2478,2799,1917,83,450,2367
"Bolivia","Potosí","Tomás Frías","Potosí","ESC. JOSE A.ZAMPA",-65.75164,-19.58199,175,9,725,900,613,18,85,698
"Bolivia","Potosí","Tomás Frías","Potosí","ESC. JOSE MARIA LINARES",-65.74564,-19.59069,225,10,1835,2060,1593,46,186,1779
"Bolivia","Potosí","Tomás Frías","Potosí","ESC. KARACHIPAMPA",-65.72121,-19.55614,98,6,576,674,402,46,122,524
"Bolivia","Potosí","Tomás Frías","Potosí","ESC. KENNY PRIETO MELGAREJO",-65.756,-19.561,443,43,3315,3758,2636,101,535,3171
"Bolivia","Potosí","Tomás Frías","Potosí","ESC. LITORAL",-65.75475,-19.58171,329,5,2262,2591,1948,37,272,2220
"Bolivia","Potosí","Tomás Frías","Potosí","ESC.L.SUBIETA SAGARNAGA",-65.74593,-19.59545,287,16,1934,2221,1405,81,432,1837
"Bolivia","Potosí","Tomás Frías","Potosí","ESC. MANQUIRI",-65.713,-19.422,42,6,191,233,126,21,38,164
"Bolivia","Potosí","Tomás Frías","Potosí","ESC. MARTIN CRUZ",-65.63708,-19.4641,47,18,411,458,227,13,153,380
"Bolivia","Potosí","Tomás Frías","Potosí","ESC. MODESTO OMISTE",-65.75407,-19.5905,80,1,498,578,428,9,60,488
"Bolivia","Potosí","Tomás Frías","Potosí","ESC. OCKORURO",-65.68793,-19.34093,39,14,148,187,84,12,38,122
"Bolivia","Potosí","Tomás Frías","Potosí","ESC. PARANTACA",-65.67346,-19.41582,14,2,126,140,91,2,31,122
"Bolivia","Potosí","Tomás Frías","Potosí","ESC. PARANTURI",-65.84405,-19.38804,8,5,86,94,55,8,18,73
"Bolivia","Potosí","Tomás Frías","Potosí","ESC. SALVADOR REVILLA",-65.75059,-19.58397,99,3,1074,1173,953,16,102,1055
"Bolivia","Potosí","Tomás Frías","Potosí","ESC. SAN JOSE",-65.75632,-19.58005,167,2,1693,1860,1478,35,178,1656
"Bolivia","Potosí","Tomás Frías","Potosí","ESC. SIMON RODRIGUEZ",-65.75714,-19.58396,172,5,1428,1600,1227,28,168,1395
"Bolivia","Potosí","Tomás Frías","Potosí","ESC. TARAPAYA",-65.79939,-19.47568,23,2,220,243,144,29,45,189
"Bolivia","Potosí","Tomás Frías","Potosí","ESC. TOMAS FRIAS",-65.78917,-19.42753,2,0,105,107,82,0,23,105
"Bolivia","Potosí","Tomás Frías","Potosí","ESC. TOPATER",-65.76611,-19.57706,524,19,3624,4148,3119,89,397,3516
"Bolivia","Potosí","Tomás Frías","Potosí","ESCUELA JOSÉ ALONSO DE IBÁÑEZ",-65.75143,-19.58758,191,4,1307,1498,1167,22,114,1281
"Bolivia","Potosí","Tomás Frías","Potosí","FE Y ALEGRIA Y SAN CLEMENTE",-65.76543,-19.57224,481,21,4159,4640,3662,81,395,4057
"Bolivia","Potosí","Tomás Frías","Potosí","INSTITUTO I.S.E.C.",-65.76514,-19.57146,109,3,1199,1308,1062,19,115,1177
"Bolivia","Potosí","Tomás Frías","Potosí","INSTITUTO SAN JUAN",-65.75861,-19.59069,116,7,1018,1134,866,30,115,981
"Bolivia","Potosí","Tomás Frías","Potosí","KINDER CONCEPCION",-65.747,-19.59719,207,14,1372,1579,1117,43,198,1315
"Bolivia","Potosí","Tomás Frías","Potosí","KINDER ISMAEL MONTES",-65.74657,-19.58614,448,37,3719,4167,3177,82,423,3600
"Bolivia","Potosí","Tomás Frías","Potosí","LIC. SUCRE",-65.7513,-19.58862,226,9,1737,1963,1560,19,149,1709
"Bolivia","Potosí","Tomás Frías","Potosí","MARISCAL SANTA CRUZ",-65.75602,-19.57199,599,43,4278,4877,3492,139,604,4096
"Bolivia","Potosí","Tomás Frías","Potosí","UE 31 DE OCTUBRE",-65.76176,-19.58175,458,27,3685,4143,3094,76,488,3582
"Bolivia","Potosí","Tomás Frías","Potosí","U.E. ANTONIO JOSE DE SUCRE",-65.75098,-19.57251,500,36,3678,4178,2914,151,577,3491
"Bolivia","Potosí","Tomás Frías","Potosí","U.E. CECILIO GUZMAN ROJAS",-65.75775,-19.56903,22,2,192,214,155,8,27,182
"Bolivia","Potosí","Tomás Frías","Potosí","U.E. DON BOSCO B",-65.76209,-19.59194,27,6,257,284,200,7,44,244
"Bolivia","Potosí","Tomás Frías","Potosí","U.E. DR. GONZALO CALDERON RIOS",-65.73939,-19.58194,21,8,312,333,219,17,68,287
"Bolivia","Potosí","Tomás Frías","Potosí","U.E. HUMBERTO IPORRE SALINAS",-65.748,-19.576,368,35,2350,2718,1653,127,535,2188
"Bolivia","Potosí","Tomás Frías","Potosí","UNIDAD EDUCATIVA JUAN PABLO II",-65.77334,-19.57676,490,50,4248,4738,3330,175,693,4023
"Bolivia","Potosí","Tomás Frías","Potosí","UNIDAD EDUCATIVA MEJILLONES",-65.74363,-19.58617,544,58,3993,4537,3174,181,580,3754
"Bolivia","Potosí","Tomás Frías","Potosí","UNIDAD EDUCATIVA SANTA ROSA",-65.75475,-19.58914,182,3,1341,1523,1180,35,123,1303
"Bolivia","Potosí","Tomás Frías","Potosí","UNIDAD EDUCATIVA VILLA COLON",-65.7385,-19.59098,531,60,3875,4406,2921,197,697,3618
"Bolivia","Potosí","Tomás Frías","Potosí","UNID. EDUCATIVA OSCAR ALFARO",-65.74941,-19.58645,130,4,1045,1175,928,18,95,1023
"Bolivia","Potosí","Tomás Frías","Tinguipaya","ESC. ACTARA",-65.95901,-19.07407,227,26,575,802,212,110,227,439
"Bolivia","Potosí","Tomás Frías","Tinguipaya","ESC. CALASAYA",-65.94428,-19.09865,88,1,192,280,3,10,178,181
"Bolivia","Potosí","Tomás Frías","Tinguipaya","ESC. CENTRAL ANTHURA",-65.96957,-19.12422,146,56,983,1129,145,112,670,815
"Bolivia","Potosí","Tomás Frías","Tinguipaya","ESC. CENTRAL JAHUACAYA",-65.88607,-19.19718,187,103,720,907,183,57,377,560
"Bolivia","Potosí","Tomás Frías","Tinguipaya","ESC. CENTRAL UTACALLA",-65.82983,-19.32134,111,18,327,438,124,20,165,289
"Bolivia","Potosí","Tomás Frías","Tinguipaya","ESC. EJE CAQUENA",-65.93787,-19.10439,75,30,320,395,122,15,153,275
"Bolivia","Potosí","Tomás Frías","Tinguipaya","ESC. FOROCTIRI",-65.71165,-19.14012,108,2,354,462,38,14,300,338
"Bolivia","Potosí","Tomás Frías","Tinguipaya","ESC. ISLA",-65.79921,-19.34833,15,2,69,84,47,5,15,62
"Bolivia","Potosí","Tomás Frías","Tinguipaya","ESC. ITHINOCA",-65.74291,-19.17638,53,4,370,423,50,18,298,348
"Bolivia","Potosí","Tomás Frías","Tinguipaya","ESC. LEÑAS",-66.08008,-19.24488,52,23,262,314,102,26,111,213
"Bolivia","Potosí","Tomás Frías","Tinguipaya","ESC. MARISCAL SUCRE",-65.86382,-19.09476,349,99,1428,1777,403,82,844,1247
"Bolivia","Potosí","Tomás Frías","Tinguipaya","ESC. MARISCAL SUCRE",-65.823,-19.22001,349,99,1428,1777,403,82,844,1247
"Bolivia","Potosí","Tomás Frías","Tinguipaya","ESC. MATANSUYO",-65.89815,-19.03701,83,20,208,291,83,15,90,173
"Bolivia","Potosí","Tomás Frías","Tinguipaya","ESC. MCAL. A. JOSE DE SUCRE",-65.72488,-19.24366,151,7,326,477,82,18,219,301
"Bolivia","Potosí","Tomás Frías","Tinguipaya","ESC. PUCA PUNTA",-65.68548,-19.11989,62,5,209,271,20,10,174,194
"Bolivia","Potosí","Tomás Frías","Tinguipaya","ESC. TACOHUARA",-65.7727,-19.13595,45,5,194,239,13,3,173,186
"Bolivia","Potosí","Tomás Frías","Tinguipaya","ESCUELA SAYACA",-66.0471,-19.11271,3,6,91,94,26,6,53,79
"Bolivia","Potosí","Tomás Frías","Tinguipaya","U.E. CIENEGOMA",-65.84728,-19.06967,0,1,256,256,52,19,184,236
"Bolivia","Potosí","Tomás Frías","Tinguipaya","U.E. MACHAC MARCA",-65.92706,-19.16479,12,24,195,207,131,10,30,161
"Bolivia","Potosí","Tomás Frías","Urmiri (Belén de Andamarca)","ESC. CAHUAYO",-66.17896,-19.27176,6,2,87,93,14,3,68,82
"Bolivia","Potosí","Tomás Frías","Urmiri (Belén de Andamarca)","ESC. JUAN JOSE PEREZ",-66.06399,-19.38641,27,2,267,294,85,12,168,253
"Bolivia","Potosí","Tomás Frías","Urmiri (Belén de Andamarca)","ESC. PUITUCO",-66.093,-19.315,19,3,112,131,47,2,60,107
"Bolivia","Potosí","Tomás Frías","Urmiri (Belén de Andamarca)","ESC. SECC. VACUYO",-66.10999,-19.45775,24,7,164,188,111,5,41,152
"Bolivia","Potosí","Tomás Frías","Yocalla","COLEG. ELIZARDO PEREZ",-65.97868,-19.41173,35,8,259,294,83,5,163,246
"Bolivia","Potosí","Tomás Frías","Yocalla","ESC. ALONSO DE IBANEZ",-65.81144,-19.51297,24,9,243,267,178,5,51,229
"Bolivia","Potosí","Tomás Frías","Yocalla","ESC. CAYARA",-65.88385,-19.55053,70,16,403,473,262,13,112,374
"Bolivia","Potosí","Tomás Frías","Yocalla","ESC. CHIRACORO",-65.9007,-19.60283,32,8,298,330,146,28,116,262
"Bolivia","Potosí","Tomás Frías","Yocalla","ESC. EDUARDO AVAROA",-65.90892,-19.38971,136,39,634,770,339,35,221,560
"Bolivia","Potosí","Tomás Frías","Yocalla","ESC. JOSE ANTONIO ZAMPA",-65.8355,-19.45168,63,29,503,566,281,26,167,448
"Bolivia","Potosí","Tomás Frías","Yocalla","ESC. JUAN XXIII",-66.019,-19.356,58,8,360,418,99,9,244,343
"Bolivia","Potosí","Tomás Frías","Yocalla","ESC. SAN ANTONIO",-65.79968,-19.58194,59,7,397,456,293,17,80,373
"Bolivia","Potosí","Tomás Frías","Yocalla","ESC. SANTA LUCIA",-65.84718,-19.55035,35,12,372,407,291,4,65,356
"Bolivia","Santa Cruz","Andrés Ibáñez","Cotoca","COLEGIO NAL. BENEMERITOS DE LA PATRIA",-62.99899,-17.75773,546,58,3675,4221,2367,95,1155,3522
"Bolivia","Santa Cruz","Andrés Ibáñez","Cotoca","ESC. GREMIAL CORTEZ",-63.01388,-17.82349,60,8,454,514,194,17,235,429
"Bolivia","Santa Cruz","Andrés Ibáñez","Cotoca","ESC. MARISCAL ANTONIO JOSE DE SUCRE",-63.05227,-17.74769,135,14,821,956,497,26,284,781
"Bolivia","Santa Cruz","Andrés Ibáñez","Cotoca","ESCUELA.COLEGIO LORENZO CORTEZ RIVERA",-62.9951,-17.75099,642,69,3952,4594,2513,117,1253,3766
"Bolivia","Santa Cruz","Andrés Ibáñez","Cotoca","ESCUELA.COLEGIO MANUEL ANGEL CORTEZ",-63.0035,-17.75491,443,33,2682,3125,1574,77,998,2572
"Bolivia","Santa Cruz","Andrés Ibáñez","Cotoca","ESCUELA.COL. SAN MARCOS",-62.98962,-17.75545,629,27,3675,4304,2039,131,1478,3517
"Bolivia","Santa Cruz","Andrés Ibáñez","Cotoca","ESCUELA DEMETRIO AÑEZ",-62.79085,-17.66665,462,16,2146,2608,1158,33,939,2097
"Bolivia","Santa Cruz","Andrés Ibáñez","Cotoca","ESCUELA GERMAN BUSCH",-62.93764,-17.73404,141,9,1072,1213,316,70,677,993
"Bolivia","Santa Cruz","Andrés Ibáñez","Cotoca","ESCUELA JESUS GOMEZ",-62.99224,-17.75945,187,14,991,1178,558,16,403,961
"Bolivia","Santa Cruz","Andrés Ibáñez","Cotoca","ESCUELA REP. DE MEXICO",-62.95778,-17.7372,279,27,1621,1900,356,137,1101,1457
"Bolivia","Santa Cruz","Andrés Ibáñez","Cotoca","ESCUELA.U.E. CALLEJAS",-62.9951,-17.75099,203,8,978,1181,666,14,290,956
"Bolivia","Santa Cruz","Andrés Ibáñez","Cotoca","ESCUELA U.E CLUB SOCIAL 24 DE SEPTIEMBRE",-63.0174,-17.69314,258,14,1674,1932,891,70,699,1590
"Bolivia","Santa Cruz","Andrés Ibáñez","Cotoca","ESCUELA UNIDADEDUCATIVA OSCAR ALFARO",-63.01909,-17.79542,202,26,1730,1932,356,66,1282,1638
"Bolivia","Santa Cruz","Andrés Ibáñez","Cotoca","U.E. PATUJU",-63.05326,-17.77304,12,4,236,248,146,8,78,224
"Bolivia","Santa Cruz","Andrés Ibáñez","Cotoca","U.E. SAN ANTONIO",-62.98827,-17.75096,7,1,62,69,39,1,21,60
"Bolivia","Santa Cruz","Andrés Ibáñez","Cotoca","UNIDAD EDUCATIVA FIDEL SAUCEDO",-62.99212,-17.69003,110,23,1116,1226,609,32,452,1061
"Bolivia","Santa Cruz","Andrés Ibáñez","El Torno","ESC.  29 DE JUNIO",-63.42663,-18.05655,314,62,2328,2642,1063,112,1091,2154
"Bolivia","Santa Cruz","Andrés Ibáñez","El Torno","ESC. ALBERTO RIBERA TAPIA",-63.50418,-18.15956,150,24,994,1144,371,105,494,865
"Bolivia","Santa Cruz","Andrés Ibáñez","El Torno","ESC. CAÑADA DOS",-63.32237,-18.06299,31,15,261,292,34,6,206,240
"Bolivia","Santa Cruz","Andrés Ibáñez","El Torno","ESC. CENTRAL MONTEVERDE",-63.50122,-17.92225,20,5,154,174,23,5,121,144
"Bolivia","Santa Cruz","Andrés Ibáñez","El Torno","ESC. ELENA VACA ANTELO",-63.3835,-17.99134,864,64,5819,6683,2753,271,2731,5484
"Bolivia","Santa Cruz","Andrés Ibáñez","El Torno","ESC. FE Y ALEGRIA",-63.45194,-17.981,42,6,369,411,114,11,238,352
"Bolivia","Santa Cruz","Andrés Ibáñez","El Torno","ESC. LA ELVIRA",-63.44523,-18.05682,0,2,24,24,13,0,9,22
"Bolivia","Santa Cruz","Andrés Ibáñez","El Torno","ESC. NACIONES UNIDAS",-63.38043,-17.9931,921,129,6202,7123,2304,309,3460,5764
"Bolivia","Santa Cruz","Andrés Ibáñez","El Torno","ESC, NUCLEO SAN LUIS",-63.48095,-18.1413,216,30,1305,1521,675,57,543,1218
"Bolivia","Santa Cruz","Andrés Ibáñez","El Torno","ESC. QUEBRADA LEON",-63.47776,-17.96212,17,3,140,157,39,4,94,133
"Bolivia","Santa Cruz","Andrés Ibáñez","El Torno","ESC. SECCIONAL SANTA RITA",-63.37109,-17.97818,207,32,1700,1907,740,72,856,1596
"Bolivia","Santa Cruz","Andrés Ibáñez","El Torno","ESCUELA 23 DE MARZO",-63.34325,-18.09747,61,3,374,435,57,16,298,355
"Bolivia","Santa Cruz","Andrés Ibáñez","El Torno","ESCUELA ANDRES IBAÑEZ",-63.40279,-18.02817,178,35,1785,1963,749,106,895,1644
"Bolivia","Santa Cruz","Andrés Ibáñez","El Torno","ESCUELA PUERTO RICO",-63.39142,-18.00683,357,48,2672,3029,1015,131,1478,2493
"Bolivia","Santa Cruz","Andrés Ibáñez","El Torno","ESCUELA SANTA MARTHA",-63.36341,-17.96476,157,13,1125,1282,334,110,668,1002
"Bolivia","Santa Cruz","Andrés Ibáñez","El Torno","ESCUELA TIQUIPAYA",-63.45114,-18.08387,134,43,1060,1194,224,42,751,975
"Bolivia","Santa Cruz","Andrés Ibáñez","El Torno","ESC. VILLA BARRIENTOS",-63.35257,-18.01478,14,3,90,104,16,3,68,84
"Bolivia","Santa Cruz","Andrés Ibáñez","El Torno","NUCLEO CENTRAL TARUMA",-63.46047,-18.11805,66,19,532,598,229,36,248,477
"Bolivia","Santa Cruz","Andrés Ibáñez","El Torno","SECCIONAL PARABANOCITO",-63.46001,-18.22056,14,6,135,149,53,3,73,126
"Bolivia","Santa Cruz","Andrés Ibáñez","El Torno","U.E. BICENTENARIO",-63.38105,-17.98782,21,4,178,199,71,2,101,172
"Bolivia","Santa Cruz","Andrés Ibáñez","El Torno","U.E. BICENTENARIO II",-63.38103,-17.98801,1,0,9,10,6,0,3,9
"Bolivia","Santa Cruz","Andrés Ibáñez","El Torno","U.E. LIC. ZACHARY MACY",-63.38482,-17.99942,25,2,199,224,72,4,121,193
"Bolivia","Santa Cruz","Andrés Ibáñez","El Torno","U.E. LIC. ZACHARY MACY",-63.38501,-17.9992,25,2,199,224,72,4,121,193
"Bolivia","Santa Cruz","Andrés Ibáñez","La Guardia","CAMBAO",-63.23442,-17.87344,79,6,822,901,397,22,397,794
"Bolivia","Santa Cruz","Andrés Ibáñez","La Guardia","ESC. CENTRAL ANGEL FOIANINI",-63.2851,-17.8802,572,78,4598,5170,2218,245,2057,4275
"Bolivia","Santa Cruz","Andrés Ibáñez","La Guardia","ESC. CENTRAL BASILIO",-63.19316,-18.12562,232,44,1398,1630,516,71,767,1283
"Bolivia","Santa Cruz","Andrés Ibáñez","La Guardia","ESC. JOSE MIGUEL DE VELASCO",-63.21535,-17.9662,35,5,282,317,172,5,100,272
"Bolivia","Santa Cruz","Andrés Ibáñez","La Guardia","ESC. JOSE VICENTE SOLIZ Y RAMOS",-63.32945,-17.89064,554,77,3290,3844,1744,169,1300,3044
"Bolivia","Santa Cruz","Andrés Ibáñez","La Guardia","ESC. JUANA AZURDUY DE PADILLA",-63.26641,-17.87674,350,17,2453,2803,1373,98,965,2338
"Bolivia","Santa Cruz","Andrés Ibáñez","La Guardia","ESC. LA PEÑA- BRECHA-3",-63.05506,-17.98781,67,17,470,537,213,13,227,440
"Bolivia","Santa Cruz","Andrés Ibáñez","La Guardia","ESC. NATANIEL VERDUGEZ",-63.25018,-17.85087,1438,62,9085,10523,4641,248,4134,8775
"Bolivia","Santa Cruz","Andrés Ibáñez","La Guardia","ESC. RUBEN DARIO SOLIZ",-63.35154,-17.93966,357,51,2252,2609,1051,76,1074,2125
"Bolivia","Santa Cruz","Andrés Ibáñez","La Guardia","ESC. TOMAS JOSE MORALES",-63.33047,-17.89173,650,39,4522,5172,2617,193,1673,4290
"Bolivia","Santa Cruz","Andrés Ibáñez","La Guardia","ESC. U. EDUC. ALFREDO IBAÑEZ FRANCO",-63.24312,-17.85056,637,105,4629,5266,2224,296,2004,4228
"Bolivia","Santa Cruz","Andrés Ibáñez","La Guardia","ESCUELA JOSE GIL SORUCO",-63.2532,-17.95629,141,15,850,991,457,61,317,774
"Bolivia","Santa Cruz","Andrés Ibáñez","La Guardia","ESCUELA MAESTRO PITAGORAS",-63.29059,-17.89535,625,47,4633,5258,1776,151,2659,4435
"Bolivia","Santa Cruz","Andrés Ibáñez","La Guardia","ESCUELA NUEVA ESPERANZA",-63.26702,-17.86146,440,17,2777,3217,1817,65,878,2695
"Bolivia","Santa Cruz","Andrés Ibáñez","La Guardia","MADRE TERESA DE CALCUTA",-63.23131,-17.87858,42,3,536,578,228,31,274,502
"Bolivia","Santa Cruz","Andrés Ibáñez","La Guardia","NUCLEO SAN CARLOS",-63.33423,-18.13221,22,4,142,164,78,4,56,134
"Bolivia","Santa Cruz","Andrés Ibáñez","La Guardia","U.E. ANGEL FOIANINI BANZER II",-63.2851,-17.8802,20,2,253,273,130,10,111,241
"Bolivia","Santa Cruz","Andrés Ibáñez","La Guardia","U.E. AYACUCHO",-63.21905,-17.86675,21,3,359,380,135,7,214,349
"Bolivia","Santa Cruz","Andrés Ibáñez","La Guardia","U.E. BARRIO LINDO",-63.26904,-17.89636,42,3,588,630,249,28,308,557
"Bolivia","Santa Cruz","Andrés Ibáñez","La Guardia","U.E. BICENTENARIO ARCO IRIS",-63.2214,-17.86212,22,1,180,202,112,5,62,174
"Bolivia","Santa Cruz","Andrés Ibáñez","La Guardia","U.E. CORDECRUZ",-63.24748,-17.84745,124,3,858,982,477,30,348,825
"Bolivia","Santa Cruz","Andrés Ibáñez","La Guardia","U.E. HERNANDO ZANABRIA",-63.28431,-17.89734,17,3,251,268,95,10,143,238
"Bolivia","Santa Cruz","Andrés Ibáñez","La Guardia","U.E. INTEGRACION DE LAS AMERICAS",-63.27132,-17.88183,42,6,608,650,88,10,504,592
"Bolivia","Santa Cruz","Andrés Ibáñez","La Guardia","U.E. JOSE MARIANO SERRANO",-63.25946,-17.83774,48,2,639,687,318,19,300,618
"Bolivia","Santa Cruz","Andrés Ibáñez","La Guardia","U.E. LUZ DE ESPERANZA",-63.27512,-17.85011,10,1,168,178,106,1,60,166
"Bolivia","Santa Cruz","Andrés Ibáñez","La Guardia","U.E. NACIONAL LA GUARDIA",-63.32025,-17.89236,31,6,451,482,215,18,212,427
"Bolivia","Santa Cruz","Andrés Ibáñez","La Guardia","U.E. NATANIEL GARCIA CHAVEZ",-63.23131,-17.87858,69,0,485,554,295,15,175,470
"Bolivia","Santa Cruz","Andrés Ibáñez","La Guardia","U.E. QUEBRADA SECA",-63.34096,-17.9067,0,1,41,41,26,1,13,39
"Bolivia","Santa Cruz","Andrés Ibáñez","La Guardia","U.E. TOMAS MORALES PADILLA",-63.22071,-17.89719,21,4,374,395,95,94,181,276
"Bolivia","Santa Cruz","Andrés Ibáñez","Porongo (Ayacucho)","ESC. FRAY SANTIAGO DE RIVERO",-63.30791,-17.85656,312,34,2277,2589,1348,50,845,2193
"Bolivia","Santa Cruz","Andrés Ibáñez","Porongo (Ayacucho)","ESC. JOSE PARADA LAGUINDEY",-63.38077,-17.72245,141,12,570,711,379,7,172,551
"Bolivia","Santa Cruz","Andrés Ibáñez","Porongo (Ayacucho)","ESC. NUCLEO CENTRAL SANTA FE",-63.45945,-17.70892,52,7,329,381,63,4,255,318
"Bolivia","Santa Cruz","Andrés Ibáñez","Porongo (Ayacucho)","ESCUELA 6 DE AGOSTO",-63.21883,-17.72828,26,4,694,720,568,75,47,615
"Bolivia","Santa Cruz","Andrés Ibáñez","Porongo (Ayacucho)","ESCUELA CENTRAL ANICETO PARADA ROCA",-63.44804,-17.6197,61,4,252,313,205,5,38,243
"Bolivia","Santa Cruz","Andrés Ibáñez","Porongo (Ayacucho)","ESCUELA CENTRAL SOMBRERITO",-63.36818,-17.88821,55,6,203,258,93,11,93,186
"Bolivia","Santa Cruz","Andrés Ibáñez","Porongo (Ayacucho)","ESCUELA IRENIA MONTERO",-63.4469,-17.87279,46,1,107,153,27,9,70,97
"Bolivia","Santa Cruz","Andrés Ibáñez","Porongo (Ayacucho)","ESCUELA PUERTO ICHILO",-63.23566,-17.74908,51,5,266,317,183,12,66,249
"Bolivia","Santa Cruz","Andrés Ibáñez","Porongo (Ayacucho)","ESCUELA SAN LORENZO",-63.24335,-17.76947,211,13,1196,1407,842,30,311,1153
"Bolivia","Santa Cruz","Andrés Ibáñez","Porongo (Ayacucho)","ESCUELA TARUMATU",-63.24299,-17.65729,71,2,360,431,263,12,83,346
"Bolivia","Santa Cruz","Andrés Ibáñez","Porongo (Ayacucho)","U.E. LAS CRUCES",-63.35539,-17.76963,8,0,72,80,48,4,20,68
"Bolivia","Santa Cruz","Andrés Ibáñez","Porongo (Ayacucho)","U.E. SAN PEDRO",-63.43151,-17.72083,0,0,50,50,23,0,27,50
"Bolivia","Santa Cruz","Andrés Ibáñez","Porongo (Ayacucho)","U.E. TACUAREMBO",-63.39894,-17.93078,1,0,6,7,0,0,6,6
"Bolivia","Santa Cruz","Andrés Ibáñez","Porongo (Ayacucho)","URUBO OPEN MALL",-63.21519,-17.7493,60,1,510,570,463,7,39,502
"Bolivia","Santa Cruz","Andrés Ibáñez","Santa Cruz de la Sierra","16 DE FEBRERO",-63.09864,-17.74821,0,1,139,139,82,14,42,124
"Bolivia","Santa Cruz","Andrés Ibáñez","Santa Cruz de la Sierra","16 DE JULIO",-63.11146,-17.75544,72,8,775,847,460,54,253,713
"Bolivia","Santa Cruz","Andrés Ibáñez","Santa Cruz de la Sierra","ANGELINA RIVERA",-63.17871,-17.85304,21,0,214,235,126,2,86,212
"Bolivia","Santa Cruz","Andrés Ibáñez","Santa Cruz de la Sierra","CAMPUS UNIVERSITARIO",-63.1925,-17.77396,566,6,2742,3308,2256,35,445,2701
"Bolivia","Santa Cruz","Andrés Ibáñez","Santa Cruz de la Sierra","COL. 12 DE DICIEMBRE",-63.13068,-17.821,1193,53,6567,7760,3871,178,2465,6336
"Bolivia","Santa Cruz","Andrés Ibáñez","Santa Cruz de la Sierra","COL. 18 DE MARZO",-63.12068,-17.78999,855,52,5021,5876,3225,153,1591,4816
"Bolivia","Santa Cruz","Andrés Ibáñez","Santa Cruz de la Sierra","COL. 27 DE MAYO",-63.1305,-17.80221,655,18,3291,3946,1750,112,1411,3161
"Bolivia","Santa Cruz","Andrés Ibáñez","Santa Cruz de la Sierra","COL. 30 DE MARZO",-63.14708,-17.80647,532,11,3569,4101,2721,91,746,3467
"Bolivia","Santa Cruz","Andrés Ibáñez","Santa Cruz de la Sierra","COL. 7 DE SEPTIEMBRE",-63.17094,-17.72965,552,10,3062,3614,2429,83,540,2969
"Bolivia","Santa Cruz","Andrés Ibáñez","Santa Cruz de la Sierra","COL.ADVENTISTA SANTA CRUZ",-63.16123,-17.73494,575,13,3616,4191,2831,147,625,3456
"Bolivia","Santa Cruz","Andrés Ibáñez","Santa Cruz de la Sierra","COL. ALAN FARAH",-63.0952,-17.79962,566,18,3107,3673,1992,150,947,2939
"Bolivia","Santa Cruz","Andrés Ibáñez","Santa Cruz de la Sierra","COL. ALFA Y OMEGA",-63.18944,-17.80245,212,7,1587,1799,1123,72,385,1508
"Bolivia","Santa Cruz","Andrés Ibáñez","Santa Cruz de la Sierra","COL. AMERICAN SCHOOL COOP.",-63.19998,-17.80871,315,4,1992,2307,1772,56,160,1932
"Bolivia","Santa Cruz","Andrés Ibáñez","Santa Cruz de la Sierra","COL. ANGELA PINCKERT",-63.12423,-17.80643,889,30,5378,6267,2843,179,2326,5169
"Bolivia","Santa Cruz","Andrés Ibáñez","Santa Cruz de la Sierra","COL. ANGLO AMERICANO",-63.17102,-17.75651,45,29,643,688,557,8,49,606
"Bolivia","Santa Cruz","Andrés Ibáñez","Santa Cruz de la Sierra","COL.  ANITA SUAREZ DE LEYGUE",-63.24062,-17.82561,262,17,2119,2381,1164,42,896,2060
"Bolivia","Santa Cruz","Andrés Ibáñez","Santa Cruz de la Sierra","COL.ANTONIO VICENTE SEOANE",-63.19352,-17.80136,281,9,2239,2520,1749,88,393,2142
"Bolivia","Santa Cruz","Andrés Ibáñez","Santa Cruz de la Sierra","COL. ARTURO MEDEIROS",-63.1909,-17.72338,192,8,1349,1541,855,41,445,1300
"Bolivia","Santa Cruz","Andrés Ibáñez","Santa Cruz de la Sierra","COL. ARZ. DANIEL RIVERO",-63.18145,-17.78975,25,0,137,162,108,1,28,136
"Bolivia","Santa Cruz","Andrés Ibáñez","Santa Cruz de la Sierra","COL. BAILON MERCADO ORTIZ",-63.16036,-17.75771,376,11,2633,3009,2098,62,462,2560
"Bolivia","Santa Cruz","Andrés Ibáñez","Santa Cruz de la Sierra","COL. BASILIO DE CUELLAR",-63.1786,-17.7843,145,1,778,923,709,15,53,762
"Bolivia","Santa Cruz","Andrés Ibáñez","Santa Cruz de la Sierra","COL. BATALLON TREN",-63.12371,-17.79344,243,9,1562,1805,1055,77,421,1476
"Bolivia","Santa Cruz","Andrés Ibáñez","Santa Cruz de la Sierra","COL. BERTHA CUELLAR",-63.13752,-17.78985,1101,25,5105,6206,3293,345,1442,4735
"Bolivia","Santa Cruz","Andrés Ibáñez","Santa Cruz de la Sierra","COL. BOSTON COLLEGE",-63.17429,-17.77369,188,3,1410,1598,1246,22,139,1385
"Bolivia","Santa Cruz","Andrés Ibáñez","Santa Cruz de la Sierra","COL. BRITANICO",-63.17352,-17.7643,381,4,2798,3179,2581,31,182,2763
"Bolivia","Santa Cruz","Andrés Ibáñez","Santa Cruz de la Sierra","COL. BUENAS NUEVAS",-63.13937,-17.8226,978,116,6445,7423,3805,205,2319,6124
"Bolivia","Santa Cruz","Andrés Ibáñez","Santa Cruz de la Sierra","COL. CAÑADA EL CARMEN",-63.15352,-17.81458,450,8,3510,3960,2813,87,602,3415
"Bolivia","Santa Cruz","Andrés Ibáñez","Santa Cruz de la Sierra","COL. CAÑADA PAILITAS",-63.14665,-17.81992,401,11,2507,2908,1766,63,667,2433
"Bolivia","Santa Cruz","Andrés Ibáñez","Santa Cruz de la Sierra","COL.CARCEL PUBLICA",-63.17891,-17.87441,400,3,530,930,265,9,253,518
"Bolivia","Santa Cruz","Andrés Ibáñez","Santa Cruz de la Sierra","COL.CARDENAL CUSHING JESUS MARIA",-63.18533,-17.79161,318,11,1929,2247,1566,41,311,1877
"Bolivia","Santa Cruz","Andrés Ibáñez","Santa Cruz de la Sierra","COL. CASTILLA LA MANCHA",-63.06415,-17.85068,1619,151,9549,11168,5034,419,3945,8979
"Bolivia","Santa Cruz","Andrés Ibáñez","Santa Cruz de la Sierra","COL. CENTRAL OBRERA DEPARTAMENTAL",-63.10396,-17.80835,771,69,4763,5534,2602,171,1921,4523
"Bolivia","Santa Cruz","Andrés Ibáñez","Santa Cruz de la Sierra","COL.CENTRO APRONDY",-63.15873,-17.77472,251,34,2255,2506,1823,114,284,2107
"Bolivia","Santa Cruz","Andrés Ibáñez","Santa Cruz de la Sierra","COL. CENTRO EDUCATIVO CARITAS",-63.18559,-17.83982,520,11,4777,5297,3648,162,956,4604
"Bolivia","Santa Cruz","Andrés Ibáñez","Santa Cruz de la Sierra","COL. CENTRO INTERNO BOL. ALEMAN",-63.11688,-17.82509,1431,53,6686,8117,3081,196,3356,6437
"Bolivia","Santa Cruz","Andrés Ibáñez","Santa Cruz de la Sierra","COL. CIUDAD NIÑO JESUS",-63.18233,-17.82738,643,18,4033,4676,2573,199,1243,3816
"Bolivia","Santa Cruz","Andrés Ibáñez","Santa Cruz de la Sierra","COL.CLUB DE LEONES",-63.17753,-17.7902,245,6,1758,2003,1297,32,423,1720
"Bolivia","Santa Cruz","Andrés Ibáñez","Santa Cruz de la Sierra","COL.CLUB DE LEONES #10",-63.17753,-17.7902,148,32,1130,1278,930,34,134,1064
"Bolivia","Santa Cruz","Andrés Ibáñez","Santa Cruz de la Sierra","COL. CLUB DE LEONES #6",-63.18416,-17.7943,118,3,670,788,450,45,172,622
"Bolivia","Santa Cruz","Andrés Ibáñez","Santa Cruz de la Sierra","COL. COMPLEJO EDUCATIVO JAPON",-63.18984,-17.80635,777,27,4684,5461,2821,182,1654,4475
"Bolivia","Santa Cruz","Andrés Ibáñez","Santa Cruz de la Sierra","COL. COVIPAL",-63.23657,-17.83965,151,14,933,1084,341,31,547,888
"Bolivia","Santa Cruz","Andrés Ibáñez","Santa Cruz de la Sierra","COL. CUPESI TERRADO",-63.09699,-17.81237,764,46,4206,4970,1806,173,2181,3987
"Bolivia","Santa Cruz","Andrés Ibáñez","Santa Cruz de la Sierra","COL. DIOS ES AMOR",-63.16571,-17.78535,174,8,1294,1468,1097,20,169,1266
"Bolivia","Santa Cruz","Andrés Ibáñez","Santa Cruz de la Sierra","COL.DOMINGO LEIGUE (BOLIVIANO CANADIENSE",-63.16274,-17.77073,265,5,1803,2068,1519,31,248,1767
"Bolivia","Santa Cruz","Andrés Ibáñez","Santa Cruz de la Sierra","COL. EDUCATIVO COTOCA",-63.11758,-17.74604,506,85,3026,3532,1654,128,1159,2813
"Bolivia","Santa Cruz","Andrés Ibáñez","Santa Cruz de la Sierra","COL. EDUCATIVO SAN ISIDRO",-63.13194,-17.80816,850,54,5300,6150,3113,144,1989,5102
"Bolivia","Santa Cruz","Andrés Ibáñez","Santa Cruz de la Sierra","COLEGIO  23 DE ABRIL",-63.14577,-17.74856,444,9,2730,3174,1761,123,837,2598
"Bolivia","Santa Cruz","Andrés Ibáñez","Santa Cruz de la Sierra","COLEGIO  6 DE JUNIO",-63.16083,-17.75763,600,7,2213,2813,1755,93,358,2113
"Bolivia","Santa Cruz","Andrés Ibáñez","Santa Cruz de la Sierra","COLEGIO ADELA ZAMUDIO",-63.17396,-17.8329,935,25,5934,6869,3515,228,2166,5681
"Bolivia","Santa Cruz","Andrés Ibáñez","Santa Cruz de la Sierra","COLEGIO BERTHA CUELLAR",-63.1344,-17.77751,187,5,856,1043,652,12,187,839
"Bolivia","Santa Cruz","Andrés Ibáñez","Santa Cruz de la Sierra","COLEGIO CASTULO CHAVEZ",-63.18775,-17.77663,395,14,2078,2473,1772,24,268,2040
"Bolivia","Santa Cruz","Andrés Ibáñez","Santa Cruz de la Sierra","COLEGIO CUPESO DE LOS REYES",-63.10786,-17.82436,609,21,3885,4494,1653,152,2059,3712
"Bolivia","Santa Cruz","Andrés Ibáñez","Santa Cruz de la Sierra","COLEGIO DOMINGO SAVIO - DON BOSCO",-63.19939,-17.83571,1167,39,7171,8338,4296,250,2586,6882
"Bolivia","Santa Cruz","Andrés Ibáñez","Santa Cruz de la Sierra","COLEGIO DON BOSCO",-63.17539,-17.79467,346,5,2023,2369,1752,37,229,1981
"Bolivia","Santa Cruz","Andrés Ibáñez","Santa Cruz de la Sierra","COLEGIO EL PROGRESO",-63.20576,-17.82713,926,33,5004,5930,2443,242,2286,4729
"Bolivia","Santa Cruz","Andrés Ibáñez","Santa Cruz de la Sierra","COLEGIO ELVIRA PARADA",-63.12992,-17.75476,646,16,3534,4180,2305,104,1109,3414
"Bolivia","Santa Cruz","Andrés Ibáñez","Santa Cruz de la Sierra","COLEGIO FUENTE DEL SABER",-63.16189,-17.87296,100,7,766,866,296,23,440,736
"Bolivia","Santa Cruz","Andrés Ibáñez","Santa Cruz de la Sierra","COLEGIO IGNACIO WARNES",-63.15627,-17.86588,614,20,3784,4398,1638,145,1981,3619
"Bolivia","Santa Cruz","Andrés Ibáñez","Santa Cruz de la Sierra","COLEGIO JOSEFINA BALSAMO( LOS TUSEQUIS)",-63.1523,-17.78086,539,50,3818,4357,2803,157,808,3611
"Bolivia","Santa Cruz","Andrés Ibáñez","Santa Cruz de la Sierra","COLEGIO JUSTO LEIGUE",-63.16701,-17.79873,132,4,1430,1562,1189,65,172,1361
"Bolivia","Santa Cruz","Andrés Ibáñez","Santa Cruz de la Sierra","COLEGIO LUZ Y VERDAD",-63.18724,-17.876,472,18,2520,2992,1136,76,1290,2426
"Bolivia","Santa Cruz","Andrés Ibáñez","Santa Cruz de la Sierra","COLEGIO MARCELINO CHAMPAGNAT",-63.18896,-17.85419,315,15,2690,3005,1976,107,592,2568
"Bolivia","Santa Cruz","Andrés Ibáñez","Santa Cruz de la Sierra","COLEGIO MARISTA",-63.17305,-17.78898,250,6,1698,1948,1523,21,148,1671
"Bolivia","Santa Cruz","Andrés Ibáñez","Santa Cruz de la Sierra","COLEGIO MARTIN SAPP",-63.17467,-17.82512,828,25,5678,6506,3614,179,1860,5474
"Bolivia","Santa Cruz","Andrés Ibáñez","Santa Cruz de la Sierra","COLEGIO NESTOR SUAREZ",-63.17374,-17.81688,548,12,3694,4242,2568,146,968,3536
"Bolivia","Santa Cruz","Andrés Ibáñez","Santa Cruz de la Sierra","COLEGIO PLAN 4000",-63.17594,-17.88471,685,37,4624,5309,1666,153,2768,4434
"Bolivia","Santa Cruz","Andrés Ibáñez","Santa Cruz de la Sierra","COLEGIO RAQUEL SOSSA",-63.19794,-17.77104,94,1,888,982,789,15,83,872
"Bolivia","Santa Cruz","Andrés Ibáñez","Santa Cruz de la Sierra","COLEGIO SAN FELIPE",-63.123,-17.76667,1279,166,7396,8675,3972,234,3024,6996
"Bolivia","Santa Cruz","Andrés Ibáñez","Santa Cruz de la Sierra","COLEGIO SAN FRANCISCO DE ASIS",-63.14429,-17.85693,46,5,434,480,220,6,203,423
"Bolivia","Santa Cruz","Andrés Ibáñez","Santa Cruz de la Sierra","COLEGIO SAN JORGE",-63.1956,-17.87261,466,49,2424,2890,1129,98,1148,2277
"Bolivia","Santa Cruz","Andrés Ibáñez","Santa Cruz de la Sierra","COLEGIO SIMON BOLIVAR",-63.1228,-17.82358,745,64,4324,5069,1870,135,2255,4125
"Bolivia","Santa Cruz","Andrés Ibáñez","Santa Cruz de la Sierra","COLEGIO TOKIO",-63.18006,-17.77509,273,2,1112,1385,708,25,377,1085
"Bolivia","Santa Cruz","Andrés Ibáñez","Santa Cruz de la Sierra","COLEGIO VILLA GLADYS THEVENETH",-63.11954,-17.82021,709,42,4643,5352,1923,222,2456,4379
"Bolivia","Santa Cruz","Andrés Ibáñez","Santa Cruz de la Sierra","COL. EL BUEN SAMARITANO",-63.08056,-17.81198,231,16,1724,1955,830,68,810,1640
"Bolivia","Santa Cruz","Andrés Ibáñez","Santa Cruz de la Sierra","COL. EL CARMEN 16 DE JULIO",-63.19295,-17.80798,301,12,2046,2347,1548,58,428,1976
"Bolivia","Santa Cruz","Andrés Ibáñez","Santa Cruz de la Sierra","COL.  ELFI RIVERA DE BARBERY",-63.15907,-17.73966,1594,50,8265,9859,4971,298,2946,7917
"Bolivia","Santa Cruz","Andrés Ibáñez","Santa Cruz de la Sierra","COL. EL PAJONAL",-63.16722,-17.81264,284,11,1633,1917,1353,29,240,1593
"Bolivia","Santa Cruz","Andrés Ibáñez","Santa Cruz de la Sierra","COL. ESC. 29 DE DICIEMBRE",-63.21157,-17.80971,337,8,1915,2252,1112,58,737,1849
"Bolivia","Santa Cruz","Andrés Ibáñez","Santa Cruz de la Sierra","COL.ESC.  AMSTERDAN",-63.14972,-17.85901,408,8,2357,2765,922,70,1357,2279
"Bolivia","Santa Cruz","Andrés Ibáñez","Santa Cruz de la Sierra","COL. ESC. CORONEL IGNACIO WARNES",-63.1825,-17.78679,150,2,585,735,466,21,96,562
"Bolivia","Santa Cruz","Andrés Ibáñez","Santa Cruz de la Sierra","COL.ESC. GRAL. ISMAEL MONTES GAMBOA",-63.10978,-17.74466,733,84,5227,5960,2676,238,2229,4905
"Bolivia","Santa Cruz","Andrés Ibáñez","Santa Cruz de la Sierra","COL. ESC. HILANDERIA",-63.21956,-17.80578,503,17,3062,3565,2090,98,857,2947
"Bolivia","Santa Cruz","Andrés Ibáñez","Santa Cruz de la Sierra","COL. ESC. HOLANDA",-63.19473,-17.88406,211,14,1625,1836,662,82,867,1529
"Bolivia","Santa Cruz","Andrés Ibáñez","Santa Cruz de la Sierra","COL. ESC. HONORATO MEJIA",-63.21367,-17.86145,335,52,2678,3013,1407,107,1112,2519
"Bolivia","Santa Cruz","Andrés Ibáñez","Santa Cruz de la Sierra","COL.ESC. INOCENCIO ROMAN",-63.06305,-17.85023,947,89,4783,5730,1783,171,2740,4523
"Bolivia","Santa Cruz","Andrés Ibáñez","Santa Cruz de la Sierra","COL. ESC.JUANA AZURDUY DE PADILLA",-63.10905,-17.84618,1216,186,7968,9184,3786,336,3660,7446
"Bolivia","Santa Cruz","Andrés Ibáñez","Santa Cruz de la Sierra","COL. ESC. LA BASE",-63.21367,-17.83001,351,14,2562,2913,1613,49,886,2499
"Bolivia","Santa Cruz","Andrés Ibáñez","Santa Cruz de la Sierra","COL. ESC. MAGISTERIO SUR",-63.18134,-17.86983,397,20,2581,2978,1301,103,1157,2458
"Bolivia","Santa Cruz","Andrés Ibáñez","Santa Cruz de la Sierra","COL. ESC. MANUEL IGNACIO SALVATIERRA",-63.17845,-17.78334,103,1,537,640,458,9,69,527
"Bolivia","Santa Cruz","Andrés Ibáñez","Santa Cruz de la Sierra","COL. ESC. MARIA ALICIA PAZ B.",-63.19432,-17.85304,810,32,5206,6016,3276,164,1734,5010
"Bolivia","Santa Cruz","Andrés Ibáñez","Santa Cruz de la Sierra","COL. ESC. MAX FERNANDEZ ROJAS B",-63.16543,-17.87381,524,28,3050,3574,1335,156,1531,2866
"Bolivia","Santa Cruz","Andrés Ibáñez","Santa Cruz de la Sierra","COL. ESC. NAUN FERNANDEZ",-63.17404,-17.83272,308,11,2526,2834,1607,101,807,2414
"Bolivia","Santa Cruz","Andrés Ibáñez","Santa Cruz de la Sierra","COL. ESC.PEREGRINA DAVALOS",-63.16763,-17.87231,589,17,3259,3848,1456,92,1694,3150
"Bolivia","Santa Cruz","Andrés Ibáñez","Santa Cruz de la Sierra","COL.ESC. ROCA CORONADO",-63.15992,-17.83748,872,36,5345,6217,2591,129,2589,5180
"Bolivia","Santa Cruz","Andrés Ibáñez","Santa Cruz de la Sierra","COL.ESC. TIERRAS NUEVAS EL CARMEN",-63.21467,-17.84509,1769,213,9544,11313,4380,453,4498,8878
"Bolivia","Santa Cruz","Andrés Ibáñez","Santa Cruz de la Sierra","COL. ESCUELA 2 DE AGOSTO",-63.15519,-17.75298,390,9,2532,2922,2063,32,428,2491
"Bolivia","Santa Cruz","Andrés Ibáñez","Santa Cruz de la Sierra","COL. ESCUELA AMBROCIO VILLARROEL",-63.2262,-17.79013,294,53,1659,1953,859,44,703,1562
"Bolivia","Santa Cruz","Andrés Ibáñez","Santa Cruz de la Sierra","COL.ESCUELA BOLIVIA HOLANDA",-63.14489,-17.86903,595,21,3656,4251,1247,190,2198,3445
"Bolivia","Santa Cruz","Andrés Ibáñez","Santa Cruz de la Sierra","COL.ESCUELA DELCY MARTINEZ SALINAS",-63.15478,-17.84095,300,8,1829,2129,890,186,745,1635
"Bolivia","Santa Cruz","Andrés Ibáñez","Santa Cruz de la Sierra","COL.ESCUELA EL FUERTE",-63.14807,-17.84582,999,75,5729,6728,2589,398,2667,5256
"Bolivia","Santa Cruz","Andrés Ibáñez","Santa Cruz de la Sierra","COL. ESCUELA JORGE URENDA TRIGO",-63.23063,-17.81518,505,17,3198,3703,2256,120,805,3061
"Bolivia","Santa Cruz","Andrés Ibáñez","Santa Cruz de la Sierra","COL. ESCUELA MAGISTERIO",-63.15523,-17.76229,390,43,3336,3726,2735,67,491,3226
"Bolivia","Santa Cruz","Andrés Ibáñez","Santa Cruz de la Sierra","COL.ESCUELA NUEVA ESPERANZA",-63.07431,-17.83275,291,18,1282,1573,511,36,717,1228
"Bolivia","Santa Cruz","Andrés Ibáñez","Santa Cruz de la Sierra","COL.ESCUELA POLY VILLARROEL",-63.1315,-17.8723,206,6,1541,1747,1034,81,420,1454
"Bolivia","Santa Cruz","Andrés Ibáñez","Santa Cruz de la Sierra","COL. ESCUELA SARA PORRAS DE PINTO",-63.22218,-17.79663,377,8,2465,2842,1720,127,610,2330
"Bolivia","Santa Cruz","Andrés Ibáñez","Santa Cruz de la Sierra","COL. ESC. UNZAGA DE LA VEGA",-63.22689,-17.82803,1549,91,9194,10743,5199,370,3534,8733
"Bolivia","Santa Cruz","Andrés Ibáñez","Santa Cruz de la Sierra","COL.ESC. VIRGEN DE URKUPINA",-63.10241,-17.74881,1331,65,7212,8543,2693,318,4136,6829
"Bolivia","Santa Cruz","Andrés Ibáñez","Santa Cruz de la Sierra","COL. FAUSTO MEDRANO",-63.12659,-17.78748,451,22,2839,3290,1664,130,1023,2687
"Bolivia","Santa Cruz","Andrés Ibáñez","Santa Cruz de la Sierra","COL. FELIX BASCOPE",-63.14538,-17.79648,433,11,3613,4046,2789,79,734,3523
"Bolivia","Santa Cruz","Andrés Ibáñez","Santa Cruz de la Sierra","COL. FELIX BASCOPE SANANDITA",-63.15129,-17.78336,309,8,2073,2382,1667,74,324,1991
"Bolivia","Santa Cruz","Andrés Ibáñez","Santa Cruz de la Sierra","COL. FE Y ALEGRIA",-63.13117,-17.79493,814,26,4302,5116,2823,74,1379,4202
"Bolivia","Santa Cruz","Andrés Ibáñez","Santa Cruz de la Sierra","COL. FE Y ALEGRIA - ANICETO ARZE",-63.15612,-17.7986,684,28,5033,5717,3934,218,853,4787
"Bolivia","Santa Cruz","Andrés Ibáñez","Santa Cruz de la Sierra","COL. FE Y ALEGRIA LA MERCED",-63.19189,-17.78853,575,20,4235,4810,3105,268,842,3947
"Bolivia","Santa Cruz","Andrés Ibáñez","Santa Cruz de la Sierra","COL. FE Y ALEGRIA NUEVA AMERICA",-63.13412,-17.82978,1332,62,7094,8426,3674,208,3150,6824
"Bolivia","Santa Cruz","Andrés Ibáñez","Santa Cruz de la Sierra","COL. GABRIEL RENE MORENO",-63.18595,-17.78357,230,2,1393,1623,1170,25,196,1366
"Bolivia","Santa Cruz","Andrés Ibáñez","Santa Cruz de la Sierra","COL.GASTON GUILLAUX",-63.17099,-17.77877,728,6,2912,3640,2454,57,395,2849
"Bolivia","Santa Cruz","Andrés Ibáñez","Santa Cruz de la Sierra","COL. GILBERTO MENACHO",-63.12507,-17.79899,871,62,5200,6071,3129,216,1793,4922
"Bolivia","Santa Cruz","Andrés Ibáñez","Santa Cruz de la Sierra","COL. GUALBERTO VILLARROEL",-63.16062,-17.77363,402,10,2624,3026,2179,45,390,2569
"Bolivia","Santa Cruz","Andrés Ibáñez","Santa Cruz de la Sierra","COL. GUAPILO JUNIN",-63.10236,-17.79171,769,31,4730,5499,3204,127,1368,4572
"Bolivia","Santa Cruz","Andrés Ibáñez","Santa Cruz de la Sierra","COL. HENRRY PRINCE",-63.20725,-17.81194,243,11,1409,1652,1048,27,323,1371
"Bolivia","Santa Cruz","Andrés Ibáñez","Santa Cruz de la Sierra","COL. HERMANOS CAVANIS",-63.22014,-17.81549,703,20,5427,6130,4031,164,1212,5243
"Bolivia","Santa Cruz","Andrés Ibáñez","Santa Cruz de la Sierra","COL. HERNANDO SILES",-63.17575,-17.86155,1926,71,10283,12209,5075,366,4771,9846
"Bolivia","Santa Cruz","Andrés Ibáñez","Santa Cruz de la Sierra","COL. HEROES DEL CHACO",-63.14454,-17.80119,730,21,4927,5657,3419,210,1277,4696
"Bolivia","Santa Cruz","Andrés Ibáñez","Santa Cruz de la Sierra","COL. HISPANO AMERICANO",-63.13283,-17.79934,319,12,1765,2084,1102,27,624,1726
"Bolivia","Santa Cruz","Andrés Ibáñez","Santa Cruz de la Sierra","COL. HNAS. ARREDONDO(COL.JESUS PEREDO)",-63.20106,-17.78474,533,39,3512,4045,2482,141,850,3332
"Bolivia","Santa Cruz","Andrés Ibáñez","Santa Cruz de la Sierra","COL. HUMBERTO EGUEZ",-63.11185,-17.79594,405,29,2887,3292,1660,168,1030,2690
"Bolivia","Santa Cruz","Andrés Ibáñez","Santa Cruz de la Sierra","COL.INST. DOMINGO SAVIO",-63.17353,-17.75908,178,1,870,1048,738,20,111,849
"Bolivia","Santa Cruz","Andrés Ibáñez","Santa Cruz de la Sierra","COL. INSTITUTO AMERICANO JUAN WESLEY",-63.16511,-17.78164,395,8,2843,3238,2379,93,363,2742
"Bolivia","Santa Cruz","Andrés Ibáñez","Santa Cruz de la Sierra","COL. INTERNACIONAL (BETHESDA)",-63.22035,-17.8294,344,14,2344,2688,1489,99,742,2231
"Bolivia","Santa Cruz","Andrés Ibáñez","Santa Cruz de la Sierra","COL. JHON KENNEDY",-63.19871,-17.78818,988,55,5951,6939,4339,182,1375,5714
"Bolivia","Santa Cruz","Andrés Ibáñez","Santa Cruz de la Sierra","COL. JOSEFINA GOYTIA",-63.17068,-17.79632,144,2,989,1133,860,20,107,967
"Bolivia","Santa Cruz","Andrés Ibáñez","Santa Cruz de la Sierra","COL. JOSE MALKY JESUS MARIA",-63.18144,-17.80808,895,13,4268,5163,3254,109,892,4146
"Bolivia","Santa Cruz","Andrés Ibáñez","Santa Cruz de la Sierra","COL. JUAN LA BORDE MOREL",-63.16035,-17.72277,282,3,2193,2475,1706,40,444,2150
"Bolivia","Santa Cruz","Andrés Ibáñez","Santa Cruz de la Sierra","COL. JUAN PABLO II",-63.17759,-17.7325,397,9,3247,3644,2813,126,299,3112
"Bolivia","Santa Cruz","Andrés Ibáñez","Santa Cruz de la Sierra","COL. JULIO A. GUTIERREZ",-63.18236,-17.79789,341,5,1524,1865,1214,30,275,1489
"Bolivia","Santa Cruz","Andrés Ibáñez","Santa Cruz de la Sierra","COL.KINDER FANNY ANTELO",-63.15987,-17.75532,107,3,704,811,537,13,151,688
"Bolivia","Santa Cruz","Andrés Ibáñez","Santa Cruz de la Sierra","COL. LA MADRE",-63.20914,-17.78125,598,17,3800,4398,2524,79,1180,3704
"Bolivia","Santa Cruz","Andrés Ibáñez","Santa Cruz de la Sierra","COL. LAS AMERICAS II",-63.19033,-17.86217,595,38,4929,5524,2664,348,1879,4543
"Bolivia","Santa Cruz","Andrés Ibáñez","Santa Cruz de la Sierra","COL.LA SANTA CRUZ",-63.17908,-17.76664,280,4,1998,2278,1757,54,183,1940
"Bolivia","Santa Cruz","Andrés Ibáñez","Santa Cruz de la Sierra","COL.LICEO MARIA VACADIEZ",-63.16927,-17.76587,164,1,1623,1787,1381,89,152,1533
"Bolivia","Santa Cruz","Andrés Ibáñez","Santa Cruz de la Sierra","COL. LUIS BARRANCO ALVAREZ",-63.12068,-17.84258,1072,48,5995,7067,2744,137,3066,5810
"Bolivia","Santa Cruz","Andrés Ibáñez","Santa Cruz de la Sierra","COL. LUIS ESPINAL CAMPOS",-63.16032,-17.86751,876,29,4883,5759,2253,222,2379,4632
"Bolivia","Santa Cruz","Andrés Ibáñez","Santa Cruz de la Sierra","COL. LUZ DEL ORIENTE",-63.13755,-17.79396,592,18,2849,3441,1917,78,836,2753
"Bolivia","Santa Cruz","Andrés Ibáñez","Santa Cruz de la Sierra","COL. LUZ Y SABER II",-63.14804,-17.73533,590,14,3343,3933,2463,113,753,3216
"Bolivia","Santa Cruz","Andrés Ibáñez","Santa Cruz de la Sierra","COL. MADRE CLARA RICCI (JESUS ROMAN VACA",-63.14016,-17.79584,208,2,1639,1847,1102,52,483,1585
"Bolivia","Santa Cruz","Andrés Ibáñez","Santa Cruz de la Sierra","COL. MAGDALENA POSTEL",-63.17854,-17.82687,569,19,3862,4431,2894,147,802,3696
"Bolivia","Santa Cruz","Andrés Ibáñez","Santa Cruz de la Sierra","COL. MARIA TERESA PULIDO",-63.1305,-17.8336,850,109,5129,5979,2601,250,2169,4770
"Bolivia","Santa Cruz","Andrés Ibáñez","Santa Cruz de la Sierra","COL. MARISCAL SUCRE",-63.15338,-17.77866,352,11,2646,2998,2240,45,350,2590
"Bolivia","Santa Cruz","Andrés Ibáñez","Santa Cruz de la Sierra","COL. MATEO KULJIS SECUNDARIO",-63.22539,-17.8377,463,43,4733,5196,2542,333,1815,4357
"Bolivia","Santa Cruz","Andrés Ibáñez","Santa Cruz de la Sierra","COL. MIRETTE SCIARONI",-63.18918,-17.76269,351,6,2162,2513,1833,48,275,2108
"Bolivia","Santa Cruz","Andrés Ibáñez","Santa Cruz de la Sierra","COL. M. NELLY VDA. DE BERTERO",-63.11536,-17.81427,271,13,1544,1815,770,44,717,1487
"Bolivia","Santa Cruz","Andrés Ibáñez","Santa Cruz de la Sierra","COL.MODULO # 5 ELVA ANTELO JORDAN",-63.16745,-17.86005,564,36,3171,3735,1558,63,1514,3072
"Bolivia","Santa Cruz","Andrés Ibáñez","Santa Cruz de la Sierra","COL. MODULO FLAMINGO",-63.21369,-17.82285,368,8,2480,2848,1922,45,505,2427
"Bolivia","Santa Cruz","Andrés Ibáñez","Santa Cruz de la Sierra","COL. MONSEÑOR LUIS RODRIGUEZ P.",-63.19559,-17.81594,916,24,5119,6035,3131,124,1840,4971
"Bolivia","Santa Cruz","Andrés Ibáñez","Santa Cruz de la Sierra","COL. NACIONAL 9 DE OCTUBRE",-63.15674,-17.84428,526,50,4490,5016,2931,218,1291,4222
"Bolivia","Santa Cruz","Andrés Ibáñez","Santa Cruz de la Sierra","COL. NACIONAL FLORIDA",-63.18027,-17.79039,150,4,1339,1489,1123,89,123,1246
"Bolivia","Santa Cruz","Andrés Ibáñez","Santa Cruz de la Sierra","COL. NACIONAL SALESIANO",-63.16814,-17.78925,276,6,1510,1786,1204,34,266,1470
"Bolivia","Santa Cruz","Andrés Ibáñez","Santa Cruz de la Sierra","COL. NIMIA CENTELLA",-63.11775,-17.78436,637,31,4115,4752,2457,170,1457,3914
"Bolivia","Santa Cruz","Andrés Ibáñez","Santa Cruz de la Sierra","COL. NORMANDIA JOSEFINA BALSAMO",-63.06764,-17.84974,559,35,3871,4430,1769,114,1953,3722
"Bolivia","Santa Cruz","Andrés Ibáñez","Santa Cruz de la Sierra","COL. NUCLEO ESCOLAR RAMAFA",-63.1834,-17.80372,238,7,1704,1942,1458,26,213,1671
"Bolivia","Santa Cruz","Andrés Ibáñez","Santa Cruz de la Sierra","COL. NUEVA AMERICA",-63.15847,-17.76582,330,8,1992,2322,1579,40,365,1944
"Bolivia","Santa Cruz","Andrés Ibáñez","Santa Cruz de la Sierra","COL. NUEVA ESPERANZA",-63.14962,-17.74375,384,10,1860,2244,1446,42,362,1808
"Bolivia","Santa Cruz","Andrés Ibáñez","Santa Cruz de la Sierra","COL. OBISPO SANTISTEVAN",-63.1792,-17.78578,113,2,731,844,653,16,60,713
"Bolivia","Santa Cruz","Andrés Ibáñez","Santa Cruz de la Sierra","COL. OSCAR ARNULFO",-63.23433,-17.82932,590,47,3909,4499,2207,272,1383,3590
"Bolivia","Santa Cruz","Andrés Ibáñez","Santa Cruz de la Sierra","COL. OVIDIO SANTISTEVAN",-63.19029,-17.74906,841,12,4602,5443,3526,130,934,4460
"Bolivia","Santa Cruz","Andrés Ibáñez","Santa Cruz de la Sierra","COL. PABLO SEXTO",-63.16424,-17.76425,256,3,1888,2144,1481,35,369,1850
"Bolivia","Santa Cruz","Andrés Ibáñez","Santa Cruz de la Sierra","COL. PAMPA DE LA CRUZ",-63.12878,-17.79276,436,15,2714,3150,1905,82,712,2617
"Bolivia","Santa Cruz","Andrés Ibáñez","Santa Cruz de la Sierra","COL. PAMPA DE LA ISLA",-63.12679,-17.77277,483,15,2007,2490,1340,39,613,1953
"Bolivia","Santa Cruz","Andrés Ibáñez","Santa Cruz de la Sierra","COL. PART. ALFRED B. NOBEL",-63.19432,-17.85304,275,8,1762,2037,1287,42,425,1712
"Bolivia","Santa Cruz","Andrés Ibáñez","Santa Cruz de la Sierra","COL.  PEDRO AÑEZ",-63.11894,-17.76698,815,27,4613,5428,2861,161,1564,4425
"Bolivia","Santa Cruz","Andrés Ibáñez","Santa Cruz de la Sierra","COL. PEDRO GUTIERREZ",-63.16812,-17.7553,264,7,2337,2601,2046,87,197,2243
"Bolivia","Santa Cruz","Andrés Ibáñez","Santa Cruz de la Sierra","COL  PLACIDO MOLILNA",-63.19062,-17.79406,506,21,2269,2775,1364,83,801,2165
"Bolivia","Santa Cruz","Andrés Ibáñez","Santa Cruz de la Sierra","COL.POLIFUNCIONAL CALAMA",-63.21886,-17.83718,533,26,3216,3749,1588,88,1514,3102
"Bolivia","Santa Cruz","Andrés Ibáñez","Santa Cruz de la Sierra","COL. PRIMAVERA",-63.1032,-17.81673,900,61,5207,6107,2346,200,2600,4946
"Bolivia","Santa Cruz","Andrés Ibáñez","Santa Cruz de la Sierra","COL. RAFAEL BUSTILLOS",-63.12329,-17.81418,625,21,3368,3993,1706,84,1557,3263
"Bolivia","Santa Cruz","Andrés Ibáñez","Santa Cruz de la Sierra","COL. RAMON DARIO GUTIERREZ",-63.164,-17.80529,196,0,1418,1614,1210,36,172,1382
"Bolivia","Santa Cruz","Andrés Ibáñez","Santa Cruz de la Sierra","COL.REPUBLICA DEL URUGUAY",-63.17242,-17.77493,459,9,2705,3164,2296,35,365,2661
"Bolivia","Santa Cruz","Andrés Ibáñez","Santa Cruz de la Sierra","COL. RODOLFO JOEM",-63.16545,-17.82204,1478,51,8097,9575,4736,285,3025,7761
"Bolivia","Santa Cruz","Andrés Ibáñez","Santa Cruz de la Sierra","COL.ROMULO HERRERA",-63.17609,-17.78023,217,5,1177,1394,840,29,303,1143
"Bolivia","Santa Cruz","Andrés Ibáñez","Santa Cruz de la Sierra","COL. SAGRADO CORAZON",-63.17153,-17.81605,139,5,937,1076,667,23,242,909
"Bolivia","Santa Cruz","Andrés Ibáñez","Santa Cruz de la Sierra","COL. SAN CARLOS",-63.15134,-17.79229,229,7,2142,2371,1689,94,352,2041
"Bolivia","Santa Cruz","Andrés Ibáñez","Santa Cruz de la Sierra","COL. SAN FRANCISCO DE SALES DON BOSCO",-63.0923,-17.76109,1196,51,7315,8511,5448,217,1599,7047
"Bolivia","Santa Cruz","Andrés Ibáñez","Santa Cruz de la Sierra","COL. SAN FRANCISCO SUR",-63.16087,-17.85275,562,26,3415,3977,1453,94,1842,3295
"Bolivia","Santa Cruz","Andrés Ibáñez","Santa Cruz de la Sierra","COL. SAN MARTIN DE PORRES",-63.2021,-17.77761,1088,30,7593,8681,4828,450,2285,7113
"Bolivia","Santa Cruz","Andrés Ibáñez","Santa Cruz de la Sierra","COL. SAN MARTIN NORTE",-63.14275,-17.7284,580,23,3799,4379,2529,217,1030,3559
"Bolivia","Santa Cruz","Andrés Ibáñez","Santa Cruz de la Sierra","COL. SAN PABLO",-63.18967,-17.83693,232,1,2029,2261,1671,29,328,1999
"Bolivia","Santa Cruz","Andrés Ibáñez","Santa Cruz de la Sierra","COL. SAN SILVESTRE",-63.11408,-17.81204,713,30,4262,4975,2053,119,2060,4113
"Bolivia","Santa Cruz","Andrés Ibáñez","Santa Cruz de la Sierra","COL. SANTA RAFAELA",-63.14124,-17.81471,378,44,2450,2828,1644,66,696,2340
"Bolivia","Santa Cruz","Andrés Ibáñez","Santa Cruz de la Sierra","COL. SECCIONAL MONSEÑOR SANTIESTEVAN",-63.18117,-17.77959,326,9,1516,1842,1195,25,287,1482
"Bolivia","Santa Cruz","Andrés Ibáñez","Santa Cruz de la Sierra","COL. SEFERINO NAMUCARA DON BOSCO",-63.17717,-17.77525,88,1,570,658,532,3,34,566
"Bolivia","Santa Cruz","Andrés Ibáñez","Santa Cruz de la Sierra","COL. SOCIEDAD DE INGENIEROS",-63.19918,-17.79882,427,8,3497,3924,2745,160,584,3329
"Bolivia","Santa Cruz","Andrés Ibáñez","Santa Cruz de la Sierra","COL. SOR MARIA CRISTINA PEREZ",-63.14532,-17.78059,1026,27,7718,8744,6347,174,1170,7517
"Bolivia","Santa Cruz","Andrés Ibáñez","Santa Cruz de la Sierra","COL.TECNOLOGICO SANTA CRUZ",-63.15675,-17.76927,192,8,1437,1629,1227,17,185,1412
"Bolivia","Santa Cruz","Andrés Ibáñez","Santa Cruz de la Sierra","COL. TRISTAN ROCA",-63.16394,-17.78412,376,11,2502,2878,1972,52,467,2439
"Bolivia","Santa Cruz","Andrés Ibáñez","Santa Cruz de la Sierra","COL.U.E.23 DE DICIEMBRE(J.  CARLOS TRUJI",-63.11529,-17.76983,847,40,4357,5204,3046,95,1176,4222
"Bolivia","Santa Cruz","Andrés Ibáñez","Santa Cruz de la Sierra","COL.U.E. 26 DE SEPTIEMBRE",-63.10361,-17.72374,994,45,5166,6160,2338,118,2665,5003
"Bolivia","Santa Cruz","Andrés Ibáñez","Santa Cruz de la Sierra","COL.U.E. ALFREDO BARBERY CHAVEZ",-63.11797,-17.75344,1039,47,6218,7257,3563,368,2240,5803
"Bolivia","Santa Cruz","Andrés Ibáñez","Santa Cruz de la Sierra","COL.U. E. CARLOS LA TORRE",-63.12363,-17.77396,515,47,3281,3796,2362,146,726,3088
"Bolivia","Santa Cruz","Andrés Ibáñez","Santa Cruz de la Sierra","COL.U.  E. EL DORADO NORTE",-63.09708,-17.73737,1662,45,8177,9839,4100,353,3679,7779
"Bolivia","Santa Cruz","Andrés Ibáñez","Santa Cruz de la Sierra","COL.U. E. EL RETOÑO",-63.07298,-17.73956,1068,34,5500,6568,3218,183,2065,5283
"Bolivia","Santa Cruz","Andrés Ibáñez","Santa Cruz de la Sierra","COL.U. E. ESCUELA ÑUFLO DE CHAVEZ",-63.15858,-17.74715,284,6,2043,2327,1766,43,228,1994
"Bolivia","Santa Cruz","Andrés Ibáñez","Santa Cruz de la Sierra","COL. U.E. LA RESURECCION -ESC.CONVIF",-63.17194,-17.7436,189,4,1609,1798,1478,10,117,1595
"Bolivia","Santa Cruz","Andrés Ibáñez","Santa Cruz de la Sierra","COL.U.E. NUEVO HORIZONTE",-63.10971,-17.73058,541,15,3152,3693,1403,265,1469,2872
"Bolivia","Santa Cruz","Andrés Ibáñez","Santa Cruz de la Sierra","COL.UNIDAD EDUCATIVA ESPAÑA",-63.11751,-17.77592,401,41,3081,3482,1827,141,1072,2899
"Bolivia","Santa Cruz","Andrés Ibáñez","Santa Cruz de la Sierra","COL. UNIDAD EDUCATIVA LA COLINA",-63.20247,-17.81842,705,25,4472,5177,2993,165,1289,4282
"Bolivia","Santa Cruz","Andrés Ibáñez","Santa Cruz de la Sierra","COL.UNIDAD EDUCATIVA LORENZO CABALLERO",-63.18774,-17.80008,241,8,1776,2017,1354,74,340,1694
"Bolivia","Santa Cruz","Andrés Ibáñez","Santa Cruz de la Sierra","COL.UNIDAD EDUCATIVA SAN JORGE",-63.10691,-17.83507,853,25,5194,6047,1655,299,3215,4870
"Bolivia","Santa Cruz","Andrés Ibáñez","Santa Cruz de la Sierra","COL. UV. LA MADRE",-63.21101,-17.78952,739,24,5166,5905,3851,183,1108,4959
"Bolivia","Santa Cruz","Andrés Ibáñez","Santa Cruz de la Sierra","COL.VENANCIO AQUINO VILLEGAS",-63.15873,-17.77472,176,1,1415,1591,1231,21,162,1393
"Bolivia","Santa Cruz","Andrés Ibáñez","Santa Cruz de la Sierra","COL. VICTOR PAZ ESTENSORO",-63.18661,-17.81709,729,26,4631,5360,2955,167,1483,4438
"Bolivia","Santa Cruz","Andrés Ibáñez","Santa Cruz de la Sierra","COL. VILLA ALEGRE",-63.17024,-17.87461,345,11,2083,2428,659,99,1314,1973
"Bolivia","Santa Cruz","Andrés Ibáñez","Santa Cruz de la Sierra","COL. VILLA BOLIVIA",-63.19029,-17.74906,746,17,3594,4340,2670,144,763,3433
"Bolivia","Santa Cruz","Andrés Ibáñez","Santa Cruz de la Sierra","COL. VILLA FATIMA",-63.20216,-17.81076,719,27,4231,4950,2904,118,1182,4086
"Bolivia","Santa Cruz","Andrés Ibáñez","Santa Cruz de la Sierra","COL. VILLA ROSARIO",-63.2086,-17.79646,787,24,3893,4680,2047,122,1700,3747
"Bolivia","Santa Cruz","Andrés Ibáñez","Santa Cruz de la Sierra","COL. VIRGEN DE COTOCA",-63.1789,-17.74445,463,14,3401,3864,2656,37,694,3350
"Bolivia","Santa Cruz","Andrés Ibáñez","Santa Cruz de la Sierra","COL.WENSESLAO MONTERO",-63.15583,-17.76315,370,12,2532,2902,2121,53,346,2467
"Bolivia","Santa Cruz","Andrés Ibáñez","Santa Cruz de la Sierra","ESC. APONTE TINEO(ESC.GREGORIO MORENO)",-63.18357,-17.76609,245,3,1632,1877,1412,54,163,1575
"Bolivia","Santa Cruz","Andrés Ibáñez","Santa Cruz de la Sierra","ESC.BERNARDO CADARIO(COL.KURT RICHTER)",-63.19029,-17.74906,537,11,2828,3365,2099,70,648,2747
"Bolivia","Santa Cruz","Andrés Ibáñez","Santa Cruz de la Sierra","ESC. CLARACUTA",-63.15587,-17.73351,342,10,2088,2430,1626,49,403,2029
"Bolivia","Santa Cruz","Andrés Ibáñez","Santa Cruz de la Sierra","ESC. GABRIEL JOSE MORENO",-62.94179,-17.88486,170,32,1584,1754,1141,42,369,1510
"Bolivia","Santa Cruz","Andrés Ibáñez","Santa Cruz de la Sierra","ESC. GERMAN BUSCH",-63.1716,-17.73681,401,6,2476,2877,1995,55,420,2415
"Bolivia","Santa Cruz","Andrés Ibáñez","Santa Cruz de la Sierra","ESC.HUGO BANZER SUAREZ",-63.1536,-17.88131,164,10,1245,1409,597,29,609,1206
"Bolivia","Santa Cruz","Andrés Ibáñez","Santa Cruz de la Sierra","ESC. JOSE MARIANO SERRANO",-63.16407,-17.72271,212,3,1279,1491,1103,12,161,1264
"Bolivia","Santa Cruz","Andrés Ibáñez","Santa Cruz de la Sierra","ESC. LA PEÑA",-62.96586,-17.96183,138,12,741,879,95,28,606,701
"Bolivia","Santa Cruz","Andrés Ibáñez","Santa Cruz de la Sierra","ESC LOS SAUCES I",-63.17955,-17.72833,408,10,2328,2736,1633,63,622,2255
"Bolivia","Santa Cruz","Andrés Ibáñez","Santa Cruz de la Sierra","ESC.MAMERTO CUELLAR COSTA",-63.16402,-17.69388,246,9,1758,2004,1254,46,449,1703
"Bolivia","Santa Cruz","Andrés Ibáñez","Santa Cruz de la Sierra","ESC. NORMAL ENRIQUET  FINOT",-63.19629,-17.76357,709,2,3948,4657,3621,20,305,3926
"Bolivia","Santa Cruz","Andrés Ibáñez","Santa Cruz de la Sierra","ESC. REAL AMERICA(ESC.F.FLORIDA)",-63.14962,-17.74375,237,4,1785,2022,1336,27,418,1754
"Bolivia","Santa Cruz","Andrés Ibáñez","Santa Cruz de la Sierra","ESC. RENE BARRIENTOS",-63.19794,-17.77104,590,10,3093,3683,2349,44,690,3039
"Bolivia","Santa Cruz","Andrés Ibáñez","Santa Cruz de la Sierra","ESC. SECCIONAL VILLA FLOR",-63.12761,-17.91508,92,11,643,735,324,20,288,612
"Bolivia","Santa Cruz","Andrés Ibáñez","Santa Cruz de la Sierra","ESC.SOLIDARIDAD 55",-63.09384,-17.88467,644,32,4023,4667,1800,199,1992,3792
"Bolivia","Santa Cruz","Andrés Ibáñez","Santa Cruz de la Sierra","ESCUELA 1RO DE MAYO",-63.12766,-17.79881,226,7,1399,1625,1031,62,299,1330
"Bolivia","Santa Cruz","Andrés Ibáñez","Santa Cruz de la Sierra","ESCUELA 23 DE MARZO",-63.14704,-17.71829,544,17,2990,3534,1885,104,984,2869
"Bolivia","Santa Cruz","Andrés Ibáñez","Santa Cruz de la Sierra","ESCUELA ADOLFO ROMAN HIJO",-62.82351,-17.6432,180,9,1323,1503,805,61,448,1253
"Bolivia","Santa Cruz","Andrés Ibáñez","Santa Cruz de la Sierra","ESCUELA CANOTO",-63.19444,-17.78442,162,3,1077,1239,867,14,193,1060
"Bolivia","Santa Cruz","Andrés Ibáñez","Santa Cruz de la Sierra","ESCUELA KM 9",-63.15509,-17.6916,574,11,3766,4340,2661,110,984,3645
"Bolivia","Santa Cruz","Andrés Ibáñez","Santa Cruz de la Sierra","ESCUELA NUEVA AURORA",-62.8249,-17.57719,40,0,63,103,48,3,12,60
"Bolivia","Santa Cruz","Andrés Ibáñez","Santa Cruz de la Sierra","ESCUELA PRIMAVERA",-63.1032,-17.81673,121,7,508,629,337,11,153,490
"Bolivia","Santa Cruz","Andrés Ibáñez","Santa Cruz de la Sierra","ESCUELA SAN CARLOS",-63.18186,-17.7572,467,7,2738,3205,2256,39,436,2692
"Bolivia","Santa Cruz","Andrés Ibáñez","Santa Cruz de la Sierra","ESCUELA SAN JOAQUIN",-63.13668,-17.72238,354,15,2179,2533,1317,129,718,2035
"Bolivia","Santa Cruz","Andrés Ibáñez","Santa Cruz de la Sierra","ESCUELA SECCIONAL GUAPILO",-63.08126,-17.74644,401,16,2227,2628,1374,81,756,2130
"Bolivia","Santa Cruz","Andrés Ibáñez","Santa Cruz de la Sierra","ESCUELA SECCIONAL ZAFRANILLA",-63.00508,-17.62794,43,2,314,357,199,9,104,303
"Bolivia","Santa Cruz","Andrés Ibáñez","Santa Cruz de la Sierra","ESC. USURI APONTE",-63.05743,-17.92564,60,2,218,278,132,7,77,209
"Bolivia","Santa Cruz","Andrés Ibáñez","Santa Cruz de la Sierra","ESC VILLA NORTE",-63.18038,-17.74704,265,5,1467,1732,1193,13,256,1449
"Bolivia","Santa Cruz","Andrés Ibáñez","Santa Cruz de la Sierra","ESC..ZENOVIA APONTE",-63.10257,-17.87117,277,11,1687,1964,782,39,855,1637
"Bolivia","Santa Cruz","Andrés Ibáñez","Santa Cruz de la Sierra","FACULTAD DE CIENCIAS AGRICOLAS UAGRM",-63.14874,-17.69814,22,2,303,325,207,8,86,293
"Bolivia","Santa Cruz","Andrés Ibáñez","Santa Cruz de la Sierra","FRED NUÑEZ GONZALES",-63.06961,-17.71776,88,9,1011,1099,453,26,523,976
"Bolivia","Santa Cruz","Andrés Ibáñez","Santa Cruz de la Sierra","GLADYS RIVERO DE JIMENEZ",-63.20806,-17.77348,469,14,3062,3531,2000,229,819,2819
"Bolivia","Santa Cruz","Andrés Ibáñez","Santa Cruz de la Sierra","KINDER CARIÑOSITO",-63.21444,-17.8494,1,0,3,4,2,0,1,3
"Bolivia","Santa Cruz","Andrés Ibáñez","Santa Cruz de la Sierra","KINDER FERROVIARIO",-63.145,-17.781,2,0,19,21,12,0,7,19
"Bolivia","Santa Cruz","Andrés Ibáñez","Santa Cruz de la Sierra","KINDER GUARDERIA EL CARMEN",-63.20383,-17.77054,1,1,48,49,39,2,6,45
"Bolivia","Santa Cruz","Andrés Ibáñez","Santa Cruz de la Sierra","KINDER LIBERTAD",-63.12066,-17.80011,0,0,9,9,7,1,1,8
"Bolivia","Santa Cruz","Andrés Ibáñez","Santa Cruz de la Sierra","KINDER LUISA SAUCEDO",-63.18323,-17.77909,103,0,758,861,677,5,76,753
"Bolivia","Santa Cruz","Andrés Ibáñez","Santa Cruz de la Sierra","KINDER NIMIA CENTELLA",-63.11775,-17.78436,0,0,45,45,31,10,4,35
"Bolivia","Santa Cruz","Andrés Ibáñez","Santa Cruz de la Sierra","LUZ DEL MUNDO C",-63.1118,-17.77199,10,0,142,152,98,0,44,142
"Bolivia","Santa Cruz","Andrés Ibáñez","Santa Cruz de la Sierra","MISIONES DE JESUS",-63.21696,-17.84764,0,1,285,285,130,53,101,231
"Bolivia","Santa Cruz","Andrés Ibáñez","Santa Cruz de la Sierra","MODULO EDUCATIVO 24 DE SEPTIEMBRE",-63.20504,-17.81955,28,1,110,138,73,4,32,105
"Bolivia","Santa Cruz","Andrés Ibáñez","Santa Cruz de la Sierra","MODULO EDUCATIVO 3 LAGUNAS",-63.1305,-17.80221,286,14,1915,2201,1082,40,779,1861
"Bolivia","Santa Cruz","Andrés Ibáñez","Santa Cruz de la Sierra","MODULO EDUCATIVO CENETROP",-63.17531,-17.86828,6,0,53,59,32,1,20,52
"Bolivia","Santa Cruz","Andrés Ibáñez","Santa Cruz de la Sierra","MODULO EDUCATIVO GERMAN BUSCH",-63.17423,-17.73516,13,2,151,164,126,2,21,147
"Bolivia","Santa Cruz","Andrés Ibáñez","Santa Cruz de la Sierra","MODULO EDUCATIVO JARDIN LATINO",-63.22685,-17.81104,0,0,65,65,52,3,10,62
"Bolivia","Santa Cruz","Andrés Ibáñez","Santa Cruz de la Sierra","MODULO EDUCATIVO JOSE MIGUEL DE VELASCO",-63.18459,-17.75368,703,54,4506,5209,3568,115,769,4337
"Bolivia","Santa Cruz","Andrés Ibáñez","Santa Cruz de la Sierra","MODULO EDUCATIVO MARIA DE MATTIAS",-63.19329,-17.84451,5,0,79,84,57,1,21,78
"Bolivia","Santa Cruz","Andrés Ibáñez","Santa Cruz de la Sierra","MODULO EDUCATIVO REPUBLICA DE COLOMBIA",-63.20602,-17.86002,18,4,196,214,84,0,108,192
"Bolivia","Santa Cruz","Andrés Ibáñez","Santa Cruz de la Sierra","MODULO RANCHO NUEVO",-63.12128,-17.74573,256,9,1188,1444,735,28,416,1151
"Bolivia","Santa Cruz","Andrés Ibáñez","Santa Cruz de la Sierra","MOTACUSAL",-63.10342,-17.68219,0,1,176,176,14,46,115,129
"Bolivia","Santa Cruz","Andrés Ibáñez","Santa Cruz de la Sierra","NACIONES UNIDAS",-63.17759,-17.7325,532,11,3355,3887,2418,150,776,3194
"Bolivia","Santa Cruz","Andrés Ibáñez","Santa Cruz de la Sierra","PEDRO DIEZ",-63.18398,-17.85394,31,0,133,164,83,2,48,131
"Bolivia","Santa Cruz","Andrés Ibáñez","Santa Cruz de la Sierra","PROGRESO",-63.13077,-17.72208,27,1,147,174,99,4,43,142
"Bolivia","Santa Cruz","Andrés Ibáñez","Santa Cruz de la Sierra","SAHARA GUARDIA",-63.20287,-17.85209,35,7,616,651,413,32,164,577
"Bolivia","Santa Cruz","Andrés Ibáñez","Santa Cruz de la Sierra","U.E. 18 DE JULIO",-63.0932,-17.7454,149,7,1028,1177,520,59,442,962
"Bolivia","Santa Cruz","Andrés Ibáñez","Santa Cruz de la Sierra","U.E 19 DE MARZO",-63.08685,-17.86819,16,1,294,310,91,1,201,292
"Bolivia","Santa Cruz","Andrés Ibáñez","Santa Cruz de la Sierra","U.E. 24 DE MARZO",-63.10131,-17.72942,16,1,153,169,51,6,95,146
"Bolivia","Santa Cruz","Andrés Ibáñez","Santa Cruz de la Sierra","U.E. 25 DE OCTUBRE",-63.0919,-17.81277,29,1,294,323,117,38,138,255
"Bolivia","Santa Cruz","Andrés Ibáñez","Santa Cruz de la Sierra","U.E. 26 DE JUNIO",-63.10215,-17.84533,37,2,245,282,100,9,134,234
"Bolivia","Santa Cruz","Andrés Ibáñez","Santa Cruz de la Sierra","U.E. 26 DE NOVIEMBRE",-63.13193,-17.73059,9,0,91,100,62,1,28,90
"Bolivia","Santa Cruz","Andrés Ibáñez","Santa Cruz de la Sierra","U.E. 2 DE ABRIL",-63.14366,-17.81759,17,1,111,128,86,3,21,107
"Bolivia","Santa Cruz","Andrés Ibáñez","Santa Cruz de la Sierra","UE 3 DE MAYO",-63.12704,-17.82614,95,7,635,730,284,19,325,609
"Bolivia","Santa Cruz","Andrés Ibáñez","Santa Cruz de la Sierra","U.E. APONTE DE JORORI",-63.02875,-17.88749,122,15,709,831,249,40,405,654
"Bolivia","Santa Cruz","Andrés Ibáñez","Santa Cruz de la Sierra","U.E. ARBOLEDA DE FATIMA",-63.09396,-17.77194,60,7,638,698,386,63,182,568
"Bolivia","Santa Cruz","Andrés Ibáñez","Santa Cruz de la Sierra","U.E. ARCA DE NOE",-63.0994,-17.74709,0,39,1073,1073,561,123,350,911
"Bolivia","Santa Cruz","Andrés Ibáñez","Santa Cruz de la Sierra","U.E. BIBOSI",-63.10976,-17.72477,16,1,109,125,53,2,53,106
"Bolivia","Santa Cruz","Andrés Ibáñez","Santa Cruz de la Sierra","U.E. CIELITO LINDO",-63.10667,-17.77039,97,39,1192,1289,746,61,346,1092
"Bolivia","Santa Cruz","Andrés Ibáñez","Santa Cruz de la Sierra","U.E. CLARA SERRANO",-63.06764,-17.69809,10,2,136,146,66,0,68,134
"Bolivia","Santa Cruz","Andrés Ibáñez","Santa Cruz de la Sierra","UE DOMINGO FAUSTINO",-63.1547,-17.78424,203,11,1367,1570,1142,21,193,1335
"Bolivia","Santa Cruz","Andrés Ibáñez","Santa Cruz de la Sierra","U.E. EL ARENAL C",-63.12381,-17.76286,0,3,29,29,10,0,16,26
"Bolivia","Santa Cruz","Andrés Ibáñez","Santa Cruz de la Sierra","U.E. HACIA LA CUMBRE",-63.13114,-17.79115,15,0,67,82,52,0,15,67
"Bolivia","Santa Cruz","Andrés Ibáñez","Santa Cruz de la Sierra","U.E. ISUTO",-63.19371,-17.74409,77,1,524,601,385,16,122,507
"Bolivia","Santa Cruz","Andrés Ibáñez","Santa Cruz de la Sierra","U.E. JOSEFINA BALSAMO CORDECRUZ",-63.13193,-17.73059,2,0,25,27,20,2,3,23
"Bolivia","Santa Cruz","Andrés Ibáñez","Santa Cruz de la Sierra","U.E. JOSEFINA BALSAMO LOS PINOS",-63.13827,-17.73302,10,3,107,117,67,0,37,104
"Bolivia","Santa Cruz","Andrés Ibáñez","Santa Cruz de la Sierra","U.E. LOS CUSIS",-63.07648,-17.73135,106,9,849,955,516,58,266,782
"Bolivia","Santa Cruz","Andrés Ibáñez","Santa Cruz de la Sierra","U.E. LUIS ANTONIO AÑEZ CAMPOS",-63.12105,-17.83816,18,0,117,135,49,4,64,113
"Bolivia","Santa Cruz","Andrés Ibáñez","Santa Cruz de la Sierra","U.E. MANANTIAL DE VIDA",-63.07259,-17.85223,64,8,804,868,307,17,472,779
"Bolivia","Santa Cruz","Andrés Ibáñez","Santa Cruz de la Sierra","U.E. MANOS UNIDAS",-63.12869,-17.83705,6,0,30,36,13,1,16,29
"Bolivia","Santa Cruz","Andrés Ibáñez","Santa Cruz de la Sierra","U.E. MARIA DE LAS CANDELARIAS",-63.11254,-17.78087,0,0,3,3,3,0,0,3
"Bolivia","Santa Cruz","Andrés Ibáñez","Santa Cruz de la Sierra","U.E. MATEO KULJIS LLIC II",-63.22541,-17.83761,19,2,65,84,35,3,25,60
"Bolivia","Santa Cruz","Andrés Ibáñez","Santa Cruz de la Sierra","U.E. MIGUEL APONTE",-63.02794,-17.93152,1,0,3,4,3,0,0,3
"Bolivia","Santa Cruz","Andrés Ibáñez","Santa Cruz de la Sierra","U.E. NESTOR PAZ ZAMORA",-63.16751,-17.82976,35,5,249,284,157,2,85,242
"Bolivia","Santa Cruz","Andrés Ibáñez","Santa Cruz de la Sierra","U.E. PALMAR DEL ORIENTE",-63.16326,-17.84556,0,0,38,38,23,4,11,34
"Bolivia","Santa Cruz","Andrés Ibáñez","Santa Cruz de la Sierra","U.E. PASTORCITO DE FÁTIMA (DON BOSCO)",-63.19865,-17.77891,5,0,32,37,27,0,5,32
"Bolivia","Santa Cruz","Andrés Ibáñez","Santa Cruz de la Sierra","U.E. REP. DEL PARAGUAY",-63.19029,-17.74906,9,0,74,83,38,6,30,68
"Bolivia","Santa Cruz","Andrés Ibáñez","Santa Cruz de la Sierra","U.E. SAN CAYETANO",-63.08637,-17.73178,122,9,946,1068,529,14,394,923
"Bolivia","Santa Cruz","Andrés Ibáñez","Santa Cruz de la Sierra","U.E. SAN DIEGO DE SAMARIA",-63.07624,-17.84651,39,0,237,276,99,3,135,234
"Bolivia","Santa Cruz","Andrés Ibáñez","Santa Cruz de la Sierra","U.E. SAN JUAN BAUTISTA",-63.084,-17.82422,27,2,323,350,143,9,169,312
"Bolivia","Santa Cruz","Andrés Ibáñez","Santa Cruz de la Sierra","U.E. SAN JUAN DEL ESTE",-63.05619,-17.85738,15,1,80,95,36,2,41,77
"Bolivia","Santa Cruz","Andrés Ibáñez","Santa Cruz de la Sierra","U.E. SAN MIGUEL APONTE",-63.02491,-17.91358,4,6,133,137,73,2,52,125
"Bolivia","Santa Cruz","Andrés Ibáñez","Santa Cruz de la Sierra","U.E. SANTA ANA C",-63.22587,-17.82052,19,0,118,137,66,2,50,116
"Bolivia","Santa Cruz","Andrés Ibáñez","Santa Cruz de la Sierra","U.E. SANTA CRUZ DE LA SIERRA",-63.15969,-17.70646,415,6,3367,3782,2847,58,456,3303
"Bolivia","Santa Cruz","Andrés Ibáñez","Santa Cruz de la Sierra","U.E. SEÑOR DE LOS MILAGROS",-63.11103,-17.73937,0,0,124,124,69,12,43,112
"Bolivia","Santa Cruz","Andrés Ibáñez","Santa Cruz de la Sierra","U.E. SIXTO SUAREZ NAVARRO",-63.08702,-17.83393,23,7,321,344,119,8,187,306
"Bolivia","Santa Cruz","Andrés Ibáñez","Santa Cruz de la Sierra","U.E. SIXTO SUAREZ NAVARRO",-63.08702,-17.83391,23,7,321,344,119,8,187,306
"Bolivia","Santa Cruz","Andrés Ibáñez","Santa Cruz de la Sierra","U.E. THEVENET DE VIANA",-63.05536,-17.87156,17,7,275,292,122,5,141,263
"Bolivia","Santa Cruz","Andrés Ibáñez","Santa Cruz de la Sierra","UE UNION Y PROGRESO",-63.20576,-17.82713,633,27,3331,3964,1659,127,1518,3177
"Bolivia","Santa Cruz","Andrés Ibáñez","Santa Cruz de la Sierra","U.E. VICTORIA",-63.10123,-17.8158,35,1,113,148,55,1,56,111
"Bolivia","Santa Cruz","Andrés Ibáñez","Santa Cruz de la Sierra","U.E. VICTORIA DIEZ",-63.19228,-17.87336,2,0,37,39,21,5,11,32
"Bolivia","Santa Cruz","Andrés Ibáñez","Santa Cruz de la Sierra","U.E. VILLA ALBA",-63.11149,-17.76056,4,1,12,16,7,0,4,11
"Bolivia","Santa Cruz","Andrés Ibáñez","Santa Cruz de la Sierra","U.E. VILLA MODERNA",-63.08892,-17.84801,59,10,444,503,158,7,269,427
"Bolivia","Santa Cruz","Andrés Ibáñez","Santa Cruz de la Sierra","U.E. ZARAGOZA",-63.0803,-17.73039,71,5,839,910,460,27,347,807
"Bolivia","Santa Cruz","Andrés Ibáñez","Santa Cruz de la Sierra","UNIDAD EDUCATIVA POMPEYA SANTISIMO REDENTOR",-63.13646,-17.73572,1180,25,6120,7300,3745,175,2175,5920
"Bolivia","Santa Cruz","Andrés Ibáñez","Santa Cruz de la Sierra","UNIDAD EDUCATIVA SAN JORGE NORTE",-63.18151,-17.74152,366,6,2032,2398,1567,47,412,1979
"Bolivia","Santa Cruz","Andrés Ibáñez","Santa Cruz de la Sierra","UNIDAD EDUCATIVA SAN JUAN",-63.15163,-17.71595,101,5,661,762,458,19,179,637
"Bolivia","Santa Cruz","Andrés Ibáñez","Santa Cruz de la Sierra","UNIVERSITARIO SUR",-63.20155,-17.84228,11,2,203,214,138,10,53,191
"Bolivia","Santa Cruz","Andrés Ibáñez","Santa Cruz de la Sierra","URKUPIÑA",-63.10837,-17.74188,39,51,579,618,278,20,230,508
"Bolivia","Santa Cruz","Andrés Ibáñez","Santa Cruz de la Sierra","VIRGEN DE GUADALUPE",-63.12177,-17.72815,178,21,1962,2140,1155,89,697,1852
"Bolivia","Santa Cruz","Ángel Sandoval","San Matías","ESC. BENJAMIN CATACORA",-59.44956,-16.31998,104,6,544,648,294,40,204,498
"Bolivia","Santa Cruz","Ángel Sandoval","San Matías","ESC. LAS PETAS",-58.39948,-16.36022,94,4,318,412,206,3,105,311
"Bolivia","Santa Cruz","Ángel Sandoval","San Matías","ESC. SAN FERNANDO",-58.50947,-17.16588,29,0,41,70,32,0,9,41
"Bolivia","Santa Cruz","Ángel Sandoval","San Matías","ESC. SANTA ISABEL",-58.64299,-16.41756,15,0,96,111,24,1,71,95
"Bolivia","Santa Cruz","Ángel Sandoval","San Matías","ESC. SANTO CORAZON",-58.80663,-17.97362,65,1,218,283,144,3,70,214
"Bolivia","Santa Cruz","Ángel Sandoval","San Matías","ESC. SECCIONAL CANDELARIA",-58.98688,-18.62612,92,1,259,351,132,5,121,253
"Bolivia","Santa Cruz","Ángel Sandoval","San Matías","ESC. U.E. EMILIA RODAT",-58.40152,-16.35967,635,77,2354,2989,1139,27,1111,2250
"Bolivia","Santa Cruz","Ángel Sandoval","San Matías","ESC. U.E.TECNICA VOCACIONAL",-58.40529,-16.36109,559,83,1882,2441,855,36,908,1763
"Bolivia","Santa Cruz","Chiquitos","Pailón","ESC. 25 DE MAYO (CHIQUITOS)",-62.72187,-17.665,7,2,97,104,18,4,73,91
"Bolivia","Santa Cruz","Chiquitos","Pailón","ESC. 3 DE MAYO",-62.71723,-17.65756,240,24,1005,1245,435,32,514,949
"Bolivia","Santa Cruz","Chiquitos","Pailón","ESC. EL TINTO",-61.51249,-17.66647,41,1,104,145,58,2,43,101
"Bolivia","Santa Cruz","Chiquitos","Pailón","ESC. EMILIO SUNCER SALINAS",-61.98844,-17.60188,99,4,358,457,159,6,189,348
"Bolivia","Santa Cruz","Chiquitos","Pailón","ESC. FE ALEGRIA",-62.72065,-17.65843,1615,81,7072,8687,4100,231,2660,6760
"Bolivia","Santa Cruz","Chiquitos","Pailón","ESC. MUNICIPAL ROSAL CENTRO",-62.68006,-17.93407,80,3,517,597,281,14,219,500
"Bolivia","Santa Cruz","Chiquitos","Pailón","ESC. POZA VERDE",-62.70517,-17.71927,18,0,93,111,17,3,73,90
"Bolivia","Santa Cruz","Chiquitos","Pailón","ESC. PUESTO PAZ",-62.44294,-17.48613,0,2,75,75,20,15,38,58
"Bolivia","Santa Cruz","Chiquitos","Pailón","ESC. SECCIONAL CAÑADA LARGA",-62.49146,-17.64193,57,2,278,335,167,2,107,274
"Bolivia","Santa Cruz","Chiquitos","Pailón","ESCUELA TUNAS NUEVO",-61.71287,-17.63908,195,9,605,800,105,8,483,588
"Bolivia","Santa Cruz","Chiquitos","Pailón","U.E. 12 DE OCTUBRE",-61.51058,-17.54329,0,1,39,39,26,0,12,38
"Bolivia","Santa Cruz","Chiquitos","Pailón","U.E. ING. JORGE MAURICIO ROJAS P.",-62.76874,-17.66311,9,3,129,138,85,4,37,122
"Bolivia","Santa Cruz","Chiquitos","Roboré","ESC. DON BOSCO",-59.75139,-18.33508,506,10,1459,1965,962,17,470,1432
"Bolivia","Santa Cruz","Chiquitos","Roboré","ESC. GUIDO OSWALDO SUANZO",-59.75161,-18.33875,343,17,1223,1566,824,15,367,1191
"Bolivia","Santa Cruz","Chiquitos","Roboré","ESC. LOS SOTOS",-59.8557,-18.24889,19,0,90,109,38,1,51,89
"Bolivia","Santa Cruz","Chiquitos","Roboré","ESC. MARISTA",-59.75665,-18.34039,455,11,1400,1855,909,18,462,1371
"Bolivia","Santa Cruz","Chiquitos","Roboré","ESC. NAPOLEON MONTERO MONTERO",-59.59888,-18.33945,176,7,616,792,463,5,141,604
"Bolivia","Santa Cruz","Chiquitos","Roboré","ESC. SAGRADA FAMILIA",-59.75781,-18.33087,484,17,1757,2241,1185,43,512,1697
"Bolivia","Santa Cruz","Chiquitos","Roboré","ESC. SAN ANTONIO DEL POTRERO",-59.74802,-18.342,8,1,45,53,13,1,30,43
"Bolivia","Santa Cruz","Chiquitos","Roboré","ESC. SECCIONAL AGUAS CALIENTES",-59.50294,-18.45304,55,5,346,401,108,12,221,329
"Bolivia","Santa Cruz","Chiquitos","Roboré","ESC.SECCIONAL CHOCHIS",-60.03102,-18.14897,94,3,453,547,350,8,92,442
"Bolivia","Santa Cruz","Chiquitos","San José de Chiquitos","ESC. EDUCACIONAL TAPERAS",-62.70883,-17.65825,113,6,445,558,267,8,164,431
"Bolivia","Santa Cruz","Chiquitos","San José de Chiquitos","ESC. GERMAN BUSCH",-60.74323,-17.84692,794,15,2574,3368,1633,53,873,2506
"Bolivia","Santa Cruz","Chiquitos","San José de Chiquitos","ESC. LEONOR RIVERA",-60.7432,-17.83881,673,19,2279,2952,1367,33,860,2227
"Bolivia","Santa Cruz","Chiquitos","San José de Chiquitos","ESC.MUNICIPAL",-61.17406,-17.70868,29,1,233,262,140,4,88,228
"Bolivia","Santa Cruz","Chiquitos","San José de Chiquitos","ESC. NUEVO HORIZONTE",-60.73072,-17.43794,0,15,75,75,40,0,20,60
"Bolivia","Santa Cruz","Chiquitos","San José de Chiquitos","ESC. SAN JUAN",-59.93511,-17.77805,129,6,304,433,169,1,128,297
"Bolivia","Santa Cruz","Chiquitos","San José de Chiquitos","ESC. SANTA TERESITA",-60.49098,-17.94919,0,0,13,13,0,0,13,13
"Bolivia","Santa Cruz","Chiquitos","San José de Chiquitos","ESC. UNZAGA DE LA VEGA",-60.73931,-17.84642,603,63,2603,3206,1663,52,825,2488
"Bolivia","Santa Cruz","Chiquitos","San José de Chiquitos","U.E. BUENA VISTA",-59.97245,-17.82214,12,2,166,178,98,3,63,161
"Bolivia","Santa Cruz","Chiquitos","San José de Chiquitos","U.E. RAMADA",-60.05825,-18.00214,2,1,41,43,22,1,17,39
"Bolivia","Santa Cruz","Cordillera","Boyuibe","ESC. CENTRAL RAFAEL PABON",-63.28176,-20.43133,615,20,1770,2385,806,55,889,1695
"Bolivia","Santa Cruz","Cordillera","Boyuibe","ESC. SECC. CHOROQUETAL LA ELE",-62.71613,-20.43031,11,0,13,24,8,0,5,13
"Bolivia","Santa Cruz","Cordillera","Boyuibe","ESC. SECC. POZO DE MONTE",-63.21899,-20.28442,0,1,85,85,25,13,46,71
"Bolivia","Santa Cruz","Cordillera","Cabezas","ESC. 12 DE ABRIL",-63.21368,-18.45699,296,37,1584,1880,796,61,690,1486
"Bolivia","Santa Cruz","Cordillera","Cabezas","ESC. COTOCA (CORDILLERA)",-63.19016,-18.28279,10,1,82,92,65,1,15,80
"Bolivia","Santa Cruz","Cordillera","Cabezas","ESC. EDUARDO ABAROA",-63.42406,-18.29929,20,2,178,198,77,25,74,151
"Bolivia","Santa Cruz","Cordillera","Cabezas","ESC. PAMPA DEL COSCAL",-63.31197,-18.78212,48,2,226,274,68,10,146,214
"Bolivia","Santa Cruz","Cordillera","Cabezas","ESC. PTO. CAMACHO",-63.39868,-18.90593,301,26,1630,1931,899,68,637,1536
"Bolivia","Santa Cruz","Cordillera","Cabezas","ESC. RIO SECO FLORIDA",-63.24144,-18.67221,93,3,413,506,207,28,175,382
"Bolivia","Santa Cruz","Cordillera","Cabezas","ESC. SANTA ROSA",-63.00379,-18.31618,30,3,145,175,74,1,67,141
"Bolivia","Santa Cruz","Cordillera","Cabezas","ESC. SECC. EL CURICHI",-63.18411,-18.36359,15,0,105,120,68,6,31,99
"Bolivia","Santa Cruz","Cordillera","Cabezas","ESC. SECCIONAL EL FILO",-63.31801,-18.78696,0,1,22,22,20,0,1,21
"Bolivia","Santa Cruz","Cordillera","Cabezas","ESC. SECCIONAL PUEBLO VIEJO",-63.32113,-18.79173,66,8,221,287,116,2,95,211
"Bolivia","Santa Cruz","Cordillera","Cabezas","ESC. SECC SAN FRANCISCO DE ASIS",-62.9499,-18.13124,75,8,297,372,97,11,181,278
"Bolivia","Santa Cruz","Cordillera","Cabezas","ESC. SERAFIN RODRIGUEZ",-63.31145,-18.78667,419,19,1402,1821,760,94,529,1289
"Bolivia","Santa Cruz","Cordillera","Cabezas","ESC. YATIRENDA",-63.22488,-18.60128,11,3,196,207,147,4,42,189
"Bolivia","Santa Cruz","Cordillera","Cabezas","ESC. ZANJA HONDA",-63.30159,-18.78745,219,23,1238,1457,611,41,563,1174
"Bolivia","Santa Cruz","Cordillera","Camiri","AULAS U.A.G.R.M.",-63.52124,-20.03783,635,37,2928,3563,1600,107,1184,2784
"Bolivia","Santa Cruz","Cordillera","Camiri","COL. HUGO ARTEAGA",-63.51498,-20.03587,214,14,968,1182,600,25,329,929
"Bolivia","Santa Cruz","Cordillera","Camiri","ESC. 12 DE JULIO",-63.53097,-20.04149,431,27,2244,2675,1228,122,867,2095
"Bolivia","Santa Cruz","Cordillera","Camiri","ESC. 16 DE MARZO",-63.52925,-20.04896,254,22,1233,1487,640,50,521,1161
"Bolivia","Santa Cruz","Cordillera","Camiri","ESC. 24 DE SEPTIEMBRE",-63.5203,-20.04004,370,17,1891,2261,1173,60,641,1814
"Bolivia","Santa Cruz","Cordillera","Camiri","ESC. ABEL ITURRALDE",-63.52305,-20.04487,309,11,1455,1764,906,35,503,1409
"Bolivia","Santa Cruz","Cordillera","Camiri","ESC. APONTE J. MANUEL O.H. DEL CHACO",-63.52154,-20.04499,240,15,1528,1768,949,36,528,1477
"Bolivia","Santa Cruz","Cordillera","Camiri","ESC. CENTRAL DE ITANAMBIKUA",-63.51152,-20.01815,70,15,484,554,109,26,334,443
"Bolivia","Santa Cruz","Cordillera","Camiri","ESC. CENTRAL URBANA",-63.53619,-20.01045,231,14,718,949,327,20,357,684
"Bolivia","Santa Cruz","Cordillera","Camiri","ESC. CRISTIANA EVANGELICA",-63.52061,-20.04179,153,7,889,1042,590,17,275,865
"Bolivia","Santa Cruz","Cordillera","Camiri","ESC. GABRIEL RENE MORENO",-63.52212,-20.03892,393,15,1646,2039,957,42,632,1589
"Bolivia","Santa Cruz","Cordillera","Camiri","ESC. JOSE CASTRILLO",-63.52077,-20.03724,301,18,1404,1705,708,42,636,1344
"Bolivia","Santa Cruz","Cordillera","Camiri","ESC. NIÑO JESUS",-63.51853,-20.04194,165,7,916,1081,635,21,253,888
"Bolivia","Santa Cruz","Cordillera","Camiri","ESC. SECC. CURUNDAITY",-63.52541,-19.96275,39,5,284,323,44,4,231,275
"Bolivia","Santa Cruz","Cordillera","Camiri","ESC. SECC. GUIRARAPO",-63.48684,-20.09914,18,2,120,138,41,5,72,113
"Bolivia","Santa Cruz","Cordillera","Camiri","ESC. SECC. IMBOCHI",-63.51324,-20.06726,19,9,114,133,36,3,66,102
"Bolivia","Santa Cruz","Cordillera","Camiri","ESC. SECCIONAL EL RODEO",-63.41266,-19.96312,31,9,205,236,31,13,152,183
"Bolivia","Santa Cruz","Cordillera","Camiri","ESC. SECCIONAL PIPI",-63.42315,-20.08308,37,2,147,184,22,2,121,143
"Bolivia","Santa Cruz","Cordillera","Camiri","ESC. SECC. PUENTE VIEJO",-63.54469,-20.01106,36,9,185,221,49,5,122,171
"Bolivia","Santa Cruz","Cordillera","Charagua","ESC. 25 DE MAYO",-62.11812,-18.4546,47,0,79,126,12,1,66,78
"Bolivia","Santa Cruz","Cordillera","Charagua","ESC. CENTRAL IYOBI",-63.14491,-19.7853,129,14,596,725,249,13,320,569
"Bolivia","Santa Cruz","Cordillera","Charagua","ESC. COOPERE BRECHA",-62.7429,-19.42522,146,6,419,565,105,14,294,399
"Bolivia","Santa Cruz","Cordillera","Charagua","ESC. ENRIQUE QUINTELA",-63.18414,-20.00909,116,10,549,665,228,14,297,525
"Bolivia","Santa Cruz","Cordillera","Charagua","ESC. ESTACION CHARAGUA",-63.1487,-19.78266,181,15,819,1000,392,22,390,782
"Bolivia","Santa Cruz","Cordillera","Charagua","ESC. NUCLEO ESCOLAR LA BRECHA",-62.7429,-19.42522,150,8,547,697,188,10,341,529
"Bolivia","Santa Cruz","Cordillera","Charagua","ESC. NUEVA ESPERANZA",-63.20002,-19.79183,53,0,84,137,19,1,64,83
"Bolivia","Santa Cruz","Cordillera","Charagua","ESC. OKITA",-63.2003,-19.79011,16,2,72,88,10,0,60,70
"Bolivia","Santa Cruz","Cordillera","Charagua","ESC. PUEBLO NUEVO PARAPETI",-63.13974,-19.98935,31,3,163,194,63,8,89,152
"Bolivia","Santa Cruz","Cordillera","Charagua","ESC. SECC. CENTRAL MASAVI",-63.19563,-19.79061,63,14,348,411,84,9,241,325
"Bolivia","Santa Cruz","Cordillera","Charagua","ESC. SECC. DE KAIPEPE",-63.19104,-19.79076,29,5,264,293,72,7,180,252
"Bolivia","Santa Cruz","Cordillera","Charagua","ESC. SECC. EL ESPINO",-63.32734,-19.21872,47,8,394,441,54,8,324,378
"Bolivia","Santa Cruz","Cordillera","Charagua","ESC. SECC. HUARIRENDA NUEVA",-63.19857,-19.78299,120,7,310,430,104,6,193,297
"Bolivia","Santa Cruz","Cordillera","Charagua","ESC. SECCIONAL ISIPORENDA",-62.5005,-19.24791,49,0,112,161,28,2,82,110
"Bolivia","Santa Cruz","Cordillera","Charagua","ESC. SECCIONAL ITATIQUE",-63.17703,-19.99888,11,0,82,93,8,1,73,81
"Bolivia","Santa Cruz","Cordillera","Charagua","ESC. SECCIONAL SAN F. DE PARAPETI",-63.17523,-19.99946,36,7,144,180,43,2,92,135
"Bolivia","Santa Cruz","Cordillera","Charagua","ESC. SECCIONAL SAN LORENZO",-63.12445,-19.649,19,0,87,106,36,4,47,83
"Bolivia","Santa Cruz","Cordillera","Charagua","ESC. SECC. RANCHO NUEVO",-63.1832,-20.01321,117,18,387,504,160,11,198,358
"Bolivia","Santa Cruz","Cordillera","Charagua","ESC. SECC. TACOBO",-63.19634,-19.78686,26,7,216,242,50,9,150,200
"Bolivia","Santa Cruz","Cordillera","Charagua","ESC. SECC. TAPUTA",-63.22105,-19.5902,0,33,272,272,13,9,217,230
"Bolivia","Santa Cruz","Cordillera","Charagua","ESCUELA CENTRAL FE Y ALEGRIA",-63.19686,-19.79076,461,28,2212,2673,1281,67,836,2117
"Bolivia","Santa Cruz","Cordillera","Charagua","ESCUELA SECCIONAL SAIPURU",-63.14339,-19.78258,0,2,132,132,56,27,47,103
"Bolivia","Santa Cruz","Cordillera","Charagua","U.E. 24 DE SEPTIEMBRE",-63.19831,-19.75614,1,4,65,66,16,5,40,56
"Bolivia","Santa Cruz","Cordillera","Charagua","U.E. JOSERAVI",-62.29416,-18.33184,19,0,62,81,36,1,25,61
"Bolivia","Santa Cruz","Cordillera","Charagua","U.E. JUAN LUIS OTIN",-63.08943,-19.97976,2,2,90,92,37,6,45,82
"Bolivia","Santa Cruz","Cordillera","Charagua","U.E. MACHIPO",-63.17883,-19.83895,6,8,100,106,36,4,52,88
"Bolivia","Santa Cruz","Cordillera","Charagua","U.E. PEDRO RAMOS",-63.21563,-19.63187,3,2,121,124,49,2,68,117
"Bolivia","Santa Cruz","Cordillera","Charagua","U.E. YAPIROA",-62.57546,-19.60771,5,1,185,190,112,5,67,179
"Bolivia","Santa Cruz","Cordillera","Cuevo","ESC. SECC. EL ARENAL",-63.51422,-20.40347,0,0,8,8,1,0,7,8
"Bolivia","Santa Cruz","Cordillera","Cuevo","ESC. SECC. ITAKUATIA",-63.51872,-20.45691,10,2,64,74,42,3,17,59
"Bolivia","Santa Cruz","Cordillera","Cuevo","ESC. UB. ANGEL SANDOVAL",-63.46928,-20.39243,502,20,1218,1720,706,26,466,1172
"Bolivia","Santa Cruz","Cordillera","Cuevo","ESC. UNIDAD EDUCATIVA IVICUATI",-63.41391,-20.37102,42,3,144,186,95,0,46,141
"Bolivia","Santa Cruz","Cordillera","Cuevo","ESC. UNIDAD SECCIONAL HUARACA",-63.51622,-20.4536,29,2,116,145,83,3,28,111
"Bolivia","Santa Cruz","Cordillera","Cuevo","U.E. EL ARENAL",-63.51412,-20.40366,9,2,98,107,5,3,88,93
"Bolivia","Santa Cruz","Cordillera","Cuevo","U.E. SALINAS",-63.46267,-20.226,16,1,93,109,19,2,71,90
"Bolivia","Santa Cruz","Cordillera","Gutiérrez","ESC. CENTRAL IPATIMIRI",-63.48169,-19.76727,85,7,515,600,167,30,311,478
"Bolivia","Santa Cruz","Cordillera","Gutiérrez","ESC. EMILIO FINOT",-63.52944,-19.42346,196,10,749,945,446,15,278,724
"Bolivia","Santa Cruz","Cordillera","Gutiérrez","ESC. IBAMIRAPINTA",-63.53056,-19.4212,90,18,552,642,185,17,332,517
"Bolivia","Santa Cruz","Cordillera","Gutiérrez","ESC. KURUGUAKUA",-63.52905,-19.42271,20,1,107,127,22,1,83,105
"Bolivia","Santa Cruz","Cordillera","Gutiérrez","ESC. MARCELINO REVOLLO",-63.39302,-19.72541,92,19,566,658,229,16,302,531
"Bolivia","Santa Cruz","Cordillera","Gutiérrez","ESC. MARISCAL SUCRE",-63.50597,-19.35422,67,15,298,365,181,4,98,279
"Bolivia","Santa Cruz","Cordillera","Gutiérrez","ESC. MIGUEL LANDIVAR",-63.50658,-19.34445,59,8,348,407,111,21,208,319
"Bolivia","Santa Cruz","Cordillera","Gutiérrez","ESC. PALMARITO",-63.46463,-19.50546,69,2,267,336,21,11,233,254
"Bolivia","Santa Cruz","Cordillera","Gutiérrez","ESC. SECC. GUASANTI",-63.42537,-19.78613,32,4,243,275,57,7,175,232
"Bolivia","Santa Cruz","Cordillera","Gutiérrez","ESC. SECCIONAL CAIPIPENDI",-63.3559,-19.78204,0,5,54,54,11,0,38,49
"Bolivia","Santa Cruz","Cordillera","Gutiérrez","ESC. SECCIONAL CAPIRENDA",-63.37655,-19.6701,36,5,225,261,45,10,165,210
"Bolivia","Santa Cruz","Cordillera","Gutiérrez","ESC. SECCIONAL ITEMBEGUAZU",-63.36713,-19.36706,33,7,181,214,80,4,90,170
"Bolivia","Santa Cruz","Cordillera","Gutiérrez","ESC. SECCIONAL S. MIGUEL POCITO",-63.45378,-19.68275,16,5,126,142,78,3,40,118
"Bolivia","Santa Cruz","Cordillera","Gutiérrez","ESC. TATARENDA VIEJA",-63.53038,-19.42489,62,8,339,401,94,18,219,313
"Bolivia","Santa Cruz","Cordillera","Lagunillas","ESC. LAGUNILLAS",-63.67723,-19.65222,334,18,1086,1420,478,26,564,1042
"Bolivia","Santa Cruz","Cordillera","Lagunillas","ESC. PROF. DELFIN ARTEAGA IPATI",-63.56137,-19.76491,99,17,666,765,316,21,312,628
"Bolivia","Santa Cruz","Cordillera","Lagunillas","ESC. SECCIONAL AGUADA GRANDE",-63.67469,-19.64971,40,5,191,231,76,7,103,179
"Bolivia","Santa Cruz","Cordillera","Lagunillas","ESC. SECCIONAL ALTO PARAPETI",-63.67161,-19.65821,15,2,67,82,11,5,49,60
"Bolivia","Santa Cruz","Cordillera","Lagunillas","ESC. TASETE",-63.65621,-19.65524,3,0,40,43,7,3,30,37
"Bolivia","Santa Cruz","Cordillera","Lagunillas","ESCUELA SECCIONAL AQUIO",-63.68824,-19.70833,6,1,69,75,49,2,17,66
"Bolivia","Santa Cruz","Cordillera","Lagunillas","U.E. CARPARICITO",-63.66229,-19.80228,41,5,145,186,44,10,86,130
"Bolivia","Santa Cruz","Cordillera","Lagunillas","U.E. PAMPA REDONDA",-63.66234,-19.60102,5,4,73,78,26,4,39,65
"Bolivia","Santa Cruz","Cordillera","Lagunillas","U. E. TENTA PIAU",-63.66815,-19.55789,12,0,73,85,32,5,36,68
"Bolivia","Santa Cruz","Cordillera","Lagunillas","U.E. YAITY",-63.63815,-20.06437,9,2,80,89,15,3,60,75
"Bolivia","Santa Cruz","Florida","Mairana","ESC. ANANIAS MELENDRES",-64.03188,-17.97899,99,18,599,698,203,31,347,550
"Bolivia","Santa Cruz","Florida","Mairana","ESC. ANGEL SAAVEDRA CHAVEZ",-63.96286,-18.12236,19,5,139,158,74,8,52,126
"Bolivia","Santa Cruz","Florida","Mairana","ESC. RENE BARRIENTOS ORTUÑO",-63.95997,-18.11939,690,134,4900,5590,2049,323,2394,4443
"Bolivia","Santa Cruz","Florida","Pampa Grande","ESC. NUCLEO SANTA ROSA",-64.24594,-17.86679,18,2,172,190,68,4,98,166
"Bolivia","Santa Cruz","Florida","Pampa Grande","ESC. PALMASOLA (EL CARMEN)",-64.2088,-17.89188,23,6,156,179,47,4,99,146
"Bolivia","Santa Cruz","Florida","Pampa Grande","ESC. PEDRO ARISTIDES",-64.11092,-18.08937,98,21,602,700,372,15,194,566
"Bolivia","Santa Cruz","Florida","Pampa Grande","ESC. SAN IGNACIO DE LOYOLA",-64.11346,-18.0916,83,12,457,540,294,18,133,427
"Bolivia","Santa Cruz","Florida","Pampa Grande","ESC. U.E. EDUARDO AVAROA",-64.12405,-18.05703,457,72,2948,3405,980,151,1745,2725
"Bolivia","Santa Cruz","Florida","Quirusillas","ESC. NESTOR PAZ ZAMORA",-63.96211,-18.37715,208,27,865,1073,465,56,317,782
"Bolivia","Santa Cruz","Florida","Samaipata","ESC. CENTRAL BELLA VICTORIA",-63.94548,-18.23438,74,23,893,967,436,49,385,821
"Bolivia","Santa Cruz","Florida","Samaipata","ESC. GRAL. AGUSTIN SAAVEDRA",-63.87621,-18.1794,270,15,1483,1753,850,94,524,1374
"Bolivia","Santa Cruz","Florida","Samaipata","ESC. NAPOLEON GOMEZ",-63.87625,-18.17913,229,45,1779,2008,1079,74,581,1660
"Bolivia","Santa Cruz","Florida","Samaipata","ESC. NUCLEO SAN JUAN DEL ROSARIO",-63.8751,-18.17855,63,2,193,256,108,6,77,185
"Bolivia","Santa Cruz","Florida","Samaipata","ESC. SANTIAGO DEL VALLE",-63.91644,-18.22129,62,7,327,389,224,7,89,313
"Bolivia","Santa Cruz","Florida","Samaipata","ESC. TIMOTEO RONDALES",-63.63435,-18.13063,64,12,341,405,206,23,100,306
"Bolivia","Santa Cruz","Florida","Samaipata","ESC. UNIDAD EDUCATIVA 27 DE MAYO",-63.79241,-18.17142,18,3,110,128,39,2,66,105
"Bolivia","Santa Cruz","Germán Busch","El Carmen Rivero Tórrez","ESC. CANDELARIA (CHIQUITOS)",-58.98688,-18.62612,11,1,59,70,26,2,30,56
"Bolivia","Santa Cruz","Germán Busch","El Carmen Rivero Tórrez","ESC. DANIEL ZAMBRANA",-58.62548,-18.82769,546,24,1737,2283,910,29,774,1684
"Bolivia","Santa Cruz","Germán Busch","El Carmen Rivero Tórrez","ESC. EVANGELICA RINCON DEL TIGRE",-58.16805,-18.21079,90,4,199,289,104,8,83,187
"Bolivia","Santa Cruz","Germán Busch","El Carmen Rivero Tórrez","ESC. PALMERAS",-58.20692,-18.22021,39,2,87,126,41,4,40,81
"Bolivia","Santa Cruz","Germán Busch","El Carmen Rivero Tórrez","ESC. SANTA ANA",-58.78492,-18.70716,59,0,181,240,87,4,90,177
"Bolivia","Santa Cruz","Germán Busch","El Carmen Rivero Tórrez","U.E. PALMITO",-58.40663,-18.91338,19,0,34,53,21,0,13,34
"Bolivia","Santa Cruz","Germán Busch","Puerto Quijarro","ESC. GISELA BRUN SCIARONI",-57.7165,-19.00469,238,24,2908,3146,1610,453,821,2431
"Bolivia","Santa Cruz","Germán Busch","Puerto Quijarro","ESC. MIXTA LA FRONTERA",-57.70963,-19.02897,1229,24,2836,4065,1399,111,1302,2701
"Bolivia","Santa Cruz","Germán Busch","Puerto Quijarro","ESC. SAMUEL LOPEZ MENDOZA",-57.7174,-19.00237,971,14,2691,3662,1543,66,1068,2611
"Bolivia","Santa Cruz","Germán Busch","Puerto Quijarro","U.E. SAN SALVADOR",-57.74367,-18.91407,0,0,13,13,1,0,12,13
"Bolivia","Santa Cruz","Germán Busch","Puerto Suárez","ESC. ANGELICA RIVERO",-57.79461,-18.96881,171,7,812,983,542,10,253,795
"Bolivia","Santa Cruz","Germán Busch","Puerto Suárez","ESC. COLONIA WARNES",-57.94844,-19.21188,0,0,62,62,12,9,41,53
"Bolivia","Santa Cruz","Germán Busch","Puerto Suárez","ESC. COOP EDUCACIONAL PUERTO SUAREZ",-57.80175,-18.96629,674,24,2287,2961,1408,33,822,2230
"Bolivia","Santa Cruz","Germán Busch","Puerto Suárez","ESC. ELIODORO PAZ",-57.79655,-18.96109,357,6,946,1303,644,18,278,922
"Bolivia","Santa Cruz","Germán Busch","Puerto Suárez","ESC. GERMAN BUSCH YACUSES",-58.23871,-18.97605,80,10,382,462,167,11,194,361
"Bolivia","Santa Cruz","Germán Busch","Puerto Suárez","ESC. JOSEFINA GOYTIA",-57.80096,-18.96123,351,10,1330,1681,944,20,356,1300
"Bolivia","Santa Cruz","Germán Busch","Puerto Suárez","ESC. MIGUEL SUAREZ ARANA",-57.79474,-18.96855,533,19,2294,2827,1447,108,720,2167
"Bolivia","Santa Cruz","Germán Busch","Puerto Suárez","U.E. EL SALAO",-57.80831,-18.97087,3,0,4,7,3,0,1,4
"Bolivia","Santa Cruz","Germán Busch","Puerto Suárez","U.E. MOTACUCITO",-57.86888,-18.9975,2,1,19,21,6,0,12,18
"Bolivia","Santa Cruz","Guarayos","Ascención de Guarayos","COL. JOSE BARRERA",-63.19069,-15.89573,67,4,371,438,230,7,130,360
"Bolivia","Santa Cruz","Guarayos","Ascención de Guarayos","ESC. 17 DE FEBRERO",-63.46325,-15.73225,45,0,218,263,29,4,185,214
"Bolivia","Santa Cruz","Guarayos","Ascención de Guarayos","ESC. 6 DE ABRIL",-63.45643,-15.72873,16,0,86,102,29,2,55,84
"Bolivia","Santa Cruz","Guarayos","Ascención de Guarayos","ESC. ASCENCION CENTRAL",-63.18915,-15.89754,1057,37,3873,4930,2022,94,1720,3742
"Bolivia","Santa Cruz","Guarayos","Ascención de Guarayos","ESC. COLONIA 5 DE MARZO",-63.79241,-15.32275,39,3,163,202,65,4,91,156
"Bolivia","Santa Cruz","Guarayos","Ascención de Guarayos","ESC. ESTEBAN GEBARD",-63.187,-15.90327,1040,40,4564,5604,2575,136,1813,4388
"Bolivia","Santa Cruz","Guarayos","Ascención de Guarayos","ESC. SAN PABLO",-63.30412,-15.89327,82,14,476,558,174,17,271,445
"Bolivia","Santa Cruz","Guarayos","Ascención de Guarayos","ESC. SANTA MARIA",-63.45824,-15.73023,48,11,345,393,103,9,222,325
"Bolivia","Santa Cruz","Guarayos","Ascención de Guarayos","KINDER MI DULCE HOGAR",-63.19152,-15.89707,68,1,480,548,214,13,252,466
"Bolivia","Santa Cruz","Guarayos","El Puente","ESC. 10 DE NOVIEMBRE",-63.10825,-16.43058,95,13,493,588,137,13,330,467
"Bolivia","Santa Cruz","Guarayos","El Puente","ESC. ALFREDO SMITH",-62.90907,-16.32987,442,29,1732,2174,1003,42,658,1661
"Bolivia","Santa Cruz","Guarayos","El Puente","ESC. CACHUELA",-63.11323,-16.20543,10,1,65,75,11,2,51,62
"Bolivia","Santa Cruz","Guarayos","El Puente","ESC. CORRALON",-63.21976,-16.36582,83,0,220,303,32,2,186,218
"Bolivia","Santa Cruz","Guarayos","El Puente","ESC. EL COMBATE",-64.34967,-15.96244,5,0,34,39,10,0,24,34
"Bolivia","Santa Cruz","Guarayos","El Puente","ESC. LOS CHACOS",-63.53627,-15.93622,19,0,51,70,46,1,4,50
"Bolivia","Santa Cruz","Guarayos","El Puente","ESC. PUEBLOS UNIDOS",-64.45015,-15.95046,154,1,222,376,30,8,183,213
"Bolivia","Santa Cruz","Guarayos","El Puente","ESC. SAN JOSE DE YOTAU",-63.02123,-16.17607,257,20,1041,1298,322,29,670,992
"Bolivia","Santa Cruz","Guarayos","El Puente","ESC. SECCIONAL EL CARMEN",-63.38649,-16.17395,75,5,346,421,128,15,198,326
"Bolivia","Santa Cruz","Guarayos","El Puente","ESC. SECCIONAL LIMONCITO",-63.38322,-15.91767,15,0,33,48,21,1,11,32
"Bolivia","Santa Cruz","Guarayos","El Puente","ESC. U.E. BOLIVAR",-63.2851,-16.27928,35,13,255,290,70,13,159,229
"Bolivia","Santa Cruz","Guarayos","El Puente","MONTE SINAI",-63.28524,-16.28186,32,2,224,256,32,7,183,215
"Bolivia","Santa Cruz","Guarayos","El Puente","U.E EL CORRALON",-63.44645,-16.40989,0,4,104,104,12,9,79,91
"Bolivia","Santa Cruz","Guarayos","Urubichá","ESC, MARIA DE LOS ANGELES",-63.08243,-15.62326,404,27,1715,2119,720,44,924,1644
"Bolivia","Santa Cruz","Guarayos","Urubichá","ESC. NUCLEO ESCOLAR YAGUARU",-63.22532,-15.60033,180,14,860,1040,538,28,280,818
"Bolivia","Santa Cruz","Guarayos","Urubichá","ESC. SANTA TERESITA (CURURU)",-63.19052,-15.89766,15,2,57,72,45,0,10,55
"Bolivia","Santa Cruz","Guarayos","Urubichá","ESC. SECC.MON.SALVATIERRA",-63.01738,-15.50296,29,1,78,107,32,0,45,77
"Bolivia","Santa Cruz","Ichilo","Buena Vista","ESC. ADHEMAR ORTIZ",-63.5253,-17.61063,31,1,213,244,81,1,130,211
"Bolivia","Santa Cruz","Ichilo","Buena Vista","ESC. EDUARDO ABAROA",-63.6379,-17.55737,109,14,762,871,218,30,500,718
"Bolivia","Santa Cruz","Ichilo","Buena Vista","ESC. MARIANO SAUCEDO SEVILLA",-63.66378,-17.45934,380,13,1750,2130,1047,43,647,1694
"Bolivia","Santa Cruz","Ichilo","Buena Vista","ESC. OVIDIO SUAREZ",-63.66139,-17.45913,473,25,1661,2134,850,75,711,1561
"Bolivia","Santa Cruz","Ichilo","Buena Vista","ESC. U.E. CARANDA",-63.53439,-17.52241,117,15,643,760,262,21,345,607
"Bolivia","Santa Cruz","Ichilo","Buena Vista","ESC. U.E. LUCIO  PEREZ",-63.5322,-17.4093,34,3,182,216,140,5,34,174
"Bolivia","Santa Cruz","Ichilo","Buena Vista","ESC. U.E. PEDRO DOMINGO MURILLO",-63.57303,-17.63503,75,8,459,534,57,10,384,441
"Bolivia","Santa Cruz","Ichilo","Buena Vista","ESC. U.E. SAN ISIDRO",-63.53614,-17.44589,44,1,199,243,175,0,23,198
"Bolivia","Santa Cruz","Ichilo","Buena Vista","ESC. U.E. SAN JAVIER",-63.56753,-17.36419,0,0,48,48,36,3,9,45
"Bolivia","Santa Cruz","Ichilo","Buena Vista","ESC. U.E. SANTO ESPOSORIO",-63.60875,-17.35815,40,0,158,198,130,2,26,156
"Bolivia","Santa Cruz","Ichilo","Buena Vista","U.E. 5 DE SEPTIEMBRE",-63.69266,-17.53192,3,2,89,92,5,0,82,87
"Bolivia","Santa Cruz","Ichilo","Buena Vista","U.E. 6 DE AGOSTO",-63.60951,-17.40799,6,6,265,271,214,5,40,254
"Bolivia","Santa Cruz","Ichilo","San Carlos","ESC. CENTRAL SAN CARLOS",-63.72837,-17.40302,456,40,2762,3218,1740,104,878,2618
"Bolivia","Santa Cruz","Ichilo","San Carlos","ESC. FISCAL DE NINOS SANTA FE",-63.82872,-17.39861,865,58,4764,5629,1936,215,2555,4491
"Bolivia","Santa Cruz","Ichilo","San Carlos","ESC. NUCLEO CENTRAL",-63.76135,-17.16378,95,14,740,835,148,14,564,712
"Bolivia","Santa Cruz","Ichilo","San Carlos","ESC. U.E. POPULAR DON BOSCO",-63.76614,-17.09247,66,11,934,1000,533,123,267,800
"Bolivia","Santa Cruz","Ichilo","San Juan","ESC. POPULAR DON BOSCO",-63.85132,-17.29254,435,75,2475,2910,1395,47,958,2353
"Bolivia","Santa Cruz","Ichilo","San Juan","NUCLEO CENTRAL LA ENCONADA",-63.89576,-17.05627,105,17,652,757,203,21,411,614
"Bolivia","Santa Cruz","Ichilo","San Juan","UN. ED. AYACUCHO",-63.90579,-17.00542,54,6,288,342,90,2,190,280
"Bolivia","Santa Cruz","Ichilo","San Juan","UN. ED.  NUCLEO CENTRAL",-63.99822,-16.91391,34,1,126,160,31,2,92,123
"Bolivia","Santa Cruz","Ichilo","San Juan","UN. ED. RAUL MENACHO",-64.04461,-16.70449,44,1,225,269,61,7,156,217
"Bolivia","Santa Cruz","Ichilo","Yapacaní","ESC. CESAR BANZER ALIAGA",-63.88105,-17.40066,1311,94,7132,8443,2413,387,4238,6651
"Bolivia","Santa Cruz","Ichilo","Yapacaní","ESC. DON BOSCO FE Y ALEGRIA",-64.09068,-17.35061,419,24,2019,2438,432,50,1513,1945
"Bolivia","Santa Cruz","Ichilo","Yapacaní","ESC. EL PALLAR",-64.81531,-16.76252,77,6,197,274,57,4,130,187
"Bolivia","Santa Cruz","Ichilo","Yapacaní","ESC. GERMAN BUSCH",-63.88563,-17.40492,683,66,4440,5123,1652,151,2571,4223
"Bolivia","Santa Cruz","Ichilo","Yapacaní","ESC. MARISCAL SUCRE",-63.96143,-17.38778,129,16,997,1126,226,24,731,957
"Bolivia","Santa Cruz","Ichilo","Yapacaní","ESC. NACIONAL BOLIVIA",-63.88673,-17.40517,69,3,372,441,99,37,233,332
"Bolivia","Santa Cruz","Ichilo","Yapacaní","ESC. NOEL KENP MERCADO",-64.29475,-17.08242,217,16,1115,1332,156,22,921,1077
"Bolivia","Santa Cruz","Ichilo","Yapacaní","ESC. NUEVO SIMON BOLLIVAR",-63.88425,-17.4061,847,37,4136,4983,1514,94,2491,4005
"Bolivia","Santa Cruz","Ichilo","Yapacaní","ESC. U.E. CASCABEL",-64.25111,-17.05944,124,8,494,618,84,11,391,475
"Bolivia","Santa Cruz","Ichilo","Yapacaní","ESC. U.E. GERMAN BUSCH (P. GRETHER)",-64.3512,-17.18946,68,7,299,367,99,14,179,278
"Bolivia","Santa Cruz","Ichilo","Yapacaní","ESCUELA CORTE HONDO",-64.77988,-16.74353,0,0,69,69,7,1,61,68
"Bolivia","Santa Cruz","Ichilo","Yapacaní","ESC. U.E. NUCLEO CENTRAL",-64.03771,-17.36884,85,5,625,710,145,15,460,605
"Bolivia","Santa Cruz","Ichilo","Yapacaní","ESC. U.E. NUCLEO CENTRAL EL CONDOR",-64.12843,-17.42864,44,6,251,295,49,5,191,240
"Bolivia","Santa Cruz","Ichilo","Yapacaní","ESC. U.E. NUCLEO CENTRAL LOS POZOS",-64.07143,-17.0136,31,5,228,259,64,9,150,214
"Bolivia","Santa Cruz","Ichilo","Yapacaní","ESC. U.E. PUERTO AVAROA",-64.22526,-17.25569,58,6,402,460,113,8,275,388
"Bolivia","Santa Cruz","Ichilo","Yapacaní","U.E. JUANA AZURDUY",-63.90387,-17.41217,7,0,58,65,21,5,32,53
"Bolivia","Santa Cruz","Ichilo","Yapacaní","U.E. NUEVO HORIZONTE",-64.1521,-17.31313,25,12,394,419,57,13,312,369
"Bolivia","Santa Cruz","Ichilo","Yapacaní","U.E. SAN RAFAEL",-63.92513,-17.45016,5,0,121,126,14,3,104,118
"Bolivia","Santa Cruz","Manuel M. Caballero","Comarapa","ESC.  EL JAGUE",-64.32232,-18.02102,10,0,48,58,26,0,22,48
"Bolivia","Santa Cruz","Manuel M. Caballero","Comarapa","ESC. ESCUELA SAN MATEO",-64.66756,-17.75924,19,4,205,224,24,4,173,197
"Bolivia","Santa Cruz","Manuel M. Caballero","Comarapa","ESC. GABRIEL RENE MORENO",-64.52667,-17.91351,532,73,3949,4481,1439,227,2210,3649
"Bolivia","Santa Cruz","Manuel M. Caballero","Comarapa","ESC. HABRA DE CAPILLA",-64.73131,-17.87328,9,2,116,125,17,6,91,108
"Bolivia","Santa Cruz","Manuel M. Caballero","Comarapa","ESC. MANZANAL",-64.77901,-17.84591,12,0,98,110,8,3,87,95
"Bolivia","Santa Cruz","Manuel M. Caballero","Comarapa","ESC. MARCELINO CHAIPANA",-64.43036,-18.10087,48,4,372,420,158,19,191,349
"Bolivia","Santa Cruz","Manuel M. Caballero","Comarapa","ESC. SAN ISIDRO",-64.43211,-18.04461,162,14,909,1071,427,43,425,852
"Bolivia","Santa Cruz","Manuel M. Caballero","Comarapa","ESC. SAN JOSE DE LA CAPILLA",-64.4388,-18.0994,56,8,365,421,160,23,174,334
"Bolivia","Santa Cruz","Manuel M. Caballero","Comarapa","ESC. SAN JUAN DEL POTRERO",-64.29284,-17.96157,53,13,331,384,164,12,142,306
"Bolivia","Santa Cruz","Manuel M. Caballero","Comarapa","ESC. SIBERIA",-64.75382,-17.82761,10,0,120,130,30,3,87,117
"Bolivia","Santa Cruz","Manuel M. Caballero","Comarapa","ESC. TORRECILLAS",-64.61208,-17.86851,67,28,740,807,112,60,540,652
"Bolivia","Santa Cruz","Manuel M. Caballero","Comarapa","ESC. U.E. LA PALIZADA",-64.43266,-18.06145,45,13,328,373,126,12,177,303
"Bolivia","Santa Cruz","Manuel M. Caballero","Saipina","ESC. EMILIA CABALLERO",-64.63905,-17.96113,1,0,33,34,6,1,26,32
"Bolivia","Santa Cruz","Manuel M. Caballero","Saipina","ESC. HUMBERTO VILLARROEL",-64.58239,-18.09421,322,35,2105,2427,718,73,1279,1997
"Bolivia","Santa Cruz","Manuel M. Caballero","Saipina","ESC. OCONI",-64.68318,-17.98282,21,3,103,124,6,2,92,98
"Bolivia","Santa Cruz","Manuel M. Caballero","Saipina","ESC. SAN RAFAEL",-64.56412,-18.1077,16,1,207,223,54,6,146,200
"Bolivia","Santa Cruz","Manuel M. Caballero","Saipina","ESC. U.E. SANTA CATALINA CHILON",-64.63826,-18.00198,65,8,397,462,99,15,275,374
"Bolivia","Santa Cruz","Ñuflo De Chávez","Concepción","ESC. CENT. JULIO FLORES FRANCO",-62.01875,-16.44536,26,7,207,233,112,3,85,197
"Bolivia","Santa Cruz","Ñuflo De Chávez","Concepción","ESC. CENTRAL SAN PEDRO",-62.2496,-16.67241,28,0,143,171,94,3,46,140
"Bolivia","Santa Cruz","Ñuflo De Chávez","Concepción","ESC. EDUCATIVA MAKANATE",-62.29666,-15.48511,15,2,109,124,4,3,100,104
"Bolivia","Santa Cruz","Ñuflo De Chávez","Concepción","ESC. GUADALUPE FE Y ALEGRIA",-62.02316,-16.13626,1293,115,7052,8345,3589,185,3163,6752
"Bolivia","Santa Cruz","Ñuflo De Chávez","Concepción","ESC. PALESTINA",-62.25437,-15.5535,0,0,73,73,3,12,58,61
"Bolivia","Santa Cruz","Ñuflo De Chávez","Concepción","ESC. SECCIONAL CALENDARIA",-62.12077,-16.2456,13,5,188,201,64,7,112,176
"Bolivia","Santa Cruz","Ñuflo De Chávez","Concepción","ESC. SECCIONAL PALMARITO",-61.58675,-15.68015,29,2,211,240,155,3,51,206
"Bolivia","Santa Cruz","Ñuflo De Chávez","Concepción","ESC. TIERRA HERMOZA",-61.96533,-16.47223,116,6,486,602,42,11,427,469
"Bolivia","Santa Cruz","Ñuflo De Chávez","Concepción","ESC. U.E. ALTAMIRA",-62.02086,-16.13548,74,10,374,448,166,18,180,346
"Bolivia","Santa Cruz","Ñuflo De Chávez","Concepción","ESC. U.E. GUAYABA",-62.00958,-16.11202,9,4,130,139,16,2,108,124
"Bolivia","Santa Cruz","Ñuflo De Chávez","Concepción","ESC. U.E. LAS MERCEDES",-62.15521,-16.63746,13,1,38,51,18,0,19,37
"Bolivia","Santa Cruz","Ñuflo De Chávez","Concepción","ESC. U.E. SAN SILVESTRE",-61.8651,-15.87338,14,1,123,137,45,8,69,114
"Bolivia","Santa Cruz","Ñuflo De Chávez","Concepción","ESC. U.E. SANTA MONICA",-62.19145,-15.97295,13,1,91,104,6,0,84,90
"Bolivia","Santa Cruz","Ñuflo De Chávez","Concepción","ESC. U.E. ZAPOCO",-61.64749,-16.49761,7,0,14,21,9,0,5,14
"Bolivia","Santa Cruz","Ñuflo De Chávez","Concepción","MEDIO MONTE",-62.07742,-16.52462,6,0,108,114,10,1,97,107
"Bolivia","Santa Cruz","Ñuflo De Chávez","Concepción","U.E. JOSE ORTIZ SENAR",-61.9508,-16.22951,9,0,63,72,6,0,57,63
"Bolivia","Santa Cruz","Ñuflo De Chávez","Concepción","U.E. NUBIASIX",-62.1369,-16.33951,4,2,59,63,16,2,39,55
"Bolivia","Santa Cruz","Ñuflo De Chávez","Concepción","U.E. SAN FRANCISCO DE ASIS",-62.06047,-16.13365,3,2,80,83,13,4,61,74
"Bolivia","Santa Cruz","Ñuflo De Chávez","Cuatro Cañadas","COL. NACIONAL CUATRO CAÑANDAS",-62.55971,-17.27547,21,5,147,168,40,4,98,138
"Bolivia","Santa Cruz","Ñuflo De Chávez","Cuatro Cañadas","ESC. 26 DE AGOSTO",-62.60896,-17.44349,89,14,703,792,226,29,434,660
"Bolivia","Santa Cruz","Ñuflo De Chávez","Cuatro Cañadas","ESC. JOSE LUIS CASTRO",-62.55427,-17.34488,180,17,1297,1477,418,39,823,1241
"Bolivia","Santa Cruz","Ñuflo De Chávez","Cuatro Cañadas","ESC. JUAN PABLO SEGUNDO",-62.55701,-17.26752,996,72,5934,6930,2113,310,3439,5552
"Bolivia","Santa Cruz","Ñuflo De Chávez","Cuatro Cañadas","ESC. LOS TRONCOS",-62.63882,-17.06814,25,3,182,207,96,3,80,176
"Bolivia","Santa Cruz","Ñuflo De Chávez","Cuatro Cañadas","ESC. MONTE RICO",-62.48614,-17.37492,34,2,206,240,24,1,179,203
"Bolivia","Santa Cruz","Ñuflo De Chávez","Cuatro Cañadas","U.E. HAZIEL",-62.152,-17.22365,13,2,235,248,181,7,45,226
"Bolivia","Santa Cruz","Ñuflo De Chávez","San Antonio de Lomerio","ESC. CENTRAL EL PUQUIO",-61.9117,-16.73251,54,3,400,454,4,3,390,394
"Bolivia","Santa Cruz","Ñuflo De Chávez","San Antonio de Lomerio","ESC. HOLANDA",-61.79376,-16.88703,0,0,7,7,0,2,5,5
"Bolivia","Santa Cruz","Ñuflo De Chávez","San Antonio de Lomerio","ESC. PADRE MATIAS LENS",-61.81025,-16.76787,209,11,1149,1358,496,36,606,1102
"Bolivia","Santa Cruz","Ñuflo De Chávez","San Antonio de Lomerio","ESC.SAN LORENZO",-61.87291,-16.70838,31,7,265,296,5,1,252,257
"Bolivia","Santa Cruz","Ñuflo De Chávez","San Antonio de Lomerio","ESC. SECCIONAL SALINAS",-61.85703,-16.98182,43,8,188,231,72,5,103,175
"Bolivia","Santa Cruz","Ñuflo De Chávez","San Antonio de Lomerio","ESC. U.E. LAS TRANCAS",-61.86698,-16.5975,9,0,109,118,6,2,101,107
"Bolivia","Santa Cruz","Ñuflo De Chávez","San Antonio de Lomerio","ESC. U.E. MONTERITO",-61.96834,-16.70661,8,1,173,181,0,0,172,172
"Bolivia","Santa Cruz","Ñuflo De Chávez","San Antonio de Lomerio","ESC. U.E. PADRE PIO",-61.8397,-16.68229,16,1,147,163,10,2,134,144
"Bolivia","Santa Cruz","Ñuflo De Chávez","San Antonio de Lomerio","PEDRO PABLO PEÑA GARCIA",-61.93461,-16.75292,2,0,60,62,0,0,60,60
"Bolivia","Santa Cruz","Ñuflo De Chávez","San Javier","ESC. SECCIONAL CORONACION",-62.63953,-16.50191,59,6,424,483,132,9,277,409
"Bolivia","Santa Cruz","Ñuflo De Chávez","San Javier","ESCUELA ADOLFO BURTON",-62.50405,-16.27246,877,109,4625,5502,2881,73,1562,4443
"Bolivia","Santa Cruz","Ñuflo De Chávez","San Javier","ESC. U.E. LAS ABRAS",-62.62867,-16.31566,37,2,195,232,16,2,175,191
"Bolivia","Santa Cruz","Ñuflo De Chávez","San Javier","ESC. U.E. SAN PABLO",-62.59928,-16.16368,12,0,104,116,4,0,100,104
"Bolivia","Santa Cruz","Ñuflo De Chávez","San Javier","ESC. U.E. SANTA RITA",-62.41707,-16.19858,10,0,59,69,21,0,38,59
"Bolivia","Santa Cruz","Ñuflo De Chávez","San Javier","ESC. U.E. TURUX NAPEZ",-62.54155,-16.06091,13,2,86,99,1,1,82,83
"Bolivia","Santa Cruz","Ñuflo De Chávez","San Julián","ESC. 26 DE OCT. FE Y ALEGRIA",-62.75789,-16.80131,48,4,501,549,43,6,448,491
"Bolivia","Santa Cruz","Ñuflo De Chávez","San Julián","ESC. CENTRAL FRANZ TAMAYO",-62.84544,-16.9986,153,26,865,1018,190,43,606,796
"Bolivia","Santa Cruz","Ñuflo De Chávez","San Julián","ESC. COL  CIRO MEALLA",-62.61414,-16.90736,1235,165,9306,10541,2619,651,5871,8490
"Bolivia","Santa Cruz","Ñuflo De Chávez","San Julián","ESC. EL PROGRESO",-62.62124,-16.91284,74,4,498,572,116,38,340,456
"Bolivia","Santa Cruz","Ñuflo De Chávez","San Julián","ESC. FE Y ALEGRIA",-62.68461,-17.09639,153,16,786,939,385,26,359,744
"Bolivia","Santa Cruz","Ñuflo De Chávez","San Julián","ESC. GRAL SAN MARTIN",-62.85691,-16.70174,81,9,499,580,90,17,383,473
"Bolivia","Santa Cruz","Ñuflo De Chávez","San Julián","ESC. LA ASUNTA SAN BERNARDO",-62.57837,-16.76817,171,17,1201,1372,445,34,705,1150
"Bolivia","Santa Cruz","Ñuflo De Chávez","San Julián","ESC.LIMONCITO",-63.06672,-16.76165,51,6,223,274,60,6,151,211
"Bolivia","Santa Cruz","Ñuflo De Chávez","San Julián","ESC. MAX FERNANDEZ ROJAS",-62.54577,-16.97607,44,11,477,521,101,13,352,453
"Bolivia","Santa Cruz","Ñuflo De Chávez","San Julián","ESC. NUCLEO 66 2 DE AGOSTO",-62.78839,-16.6398,55,8,417,472,128,9,272,400
"Bolivia","Santa Cruz","Ñuflo De Chávez","San Julián","ESC. PATUJU",-62.61599,-16.9081,65,2,497,562,133,19,343,476
"Bolivia","Santa Cruz","Ñuflo De Chávez","San Julián","ESC. SAN ANTONIO",-62.72305,-16.83416,7,1,125,132,24,1,99,123
"Bolivia","Santa Cruz","Ñuflo De Chávez","San Julián","ESC. SAN SALVADOR NUCLEO 38",-63.01813,-16.53014,94,7,480,574,50,23,400,450
"Bolivia","Santa Cruz","Ñuflo De Chávez","San Julián","ESC. SEBASTIAN PAGADOR",-62.62574,-16.91129,9,0,104,113,6,0,98,104
"Bolivia","Santa Cruz","Ñuflo De Chávez","San Julián","ESC. U.E. 16 DE MARZO",-62.46996,-16.93457,42,5,276,318,23,25,223,246
"Bolivia","Santa Cruz","Ñuflo De Chávez","San Julián","ESC. U.E. EL LIMONAL",-62.94872,-16.60476,41,5,263,304,34,8,216,250
"Bolivia","Santa Cruz","Ñuflo De Chávez","San Julián","ESCUELA EDUARDO AVAROA",-62.93443,-17.02607,143,17,1026,1169,287,40,682,969
"Bolivia","Santa Cruz","Ñuflo De Chávez","San Julián","ESCUELA LUZ Y VERDAD",-62.91896,-16.63566,35,10,282,317,75,11,186,261
"Bolivia","Santa Cruz","Ñuflo De Chávez","San Julián","ESC. U.E. SEGUNDA MILLA",-62.91419,-16.50614,12,1,123,135,89,6,27,116
"Bolivia","Santa Cruz","Ñuflo De Chávez","San Julián","U.E. 27 DE ABRIL",-62.61187,-16.86376,3,0,28,31,10,2,16,26
"Bolivia","Santa Cruz","Ñuflo De Chávez","San Julián","U.E. GUILLERMO JORDAN",-62.62149,-16.91677,350,19,2052,2402,535,122,1376,1911
"Bolivia","Santa Cruz","Ñuflo De Chávez","San Julián","U.E. JOSE DAVID BERRIOS",-62.63219,-16.90126,0,0,20,20,6,2,12,18
"Bolivia","Santa Cruz","Ñuflo De Chávez","San Julián","U.E. SAN JULIAN DE BERLIN",-62.63087,-17.0567,3,1,31,34,6,3,21,27
"Bolivia","Santa Cruz","Ñuflo De Chávez","San Julián","U.E. SANTA ANA",-63.06822,-16.33947,3,2,98,101,8,2,86,94
"Bolivia","Santa Cruz","Ñuflo De Chávez","San Ramón","ESC. CENTRAL SAN RAMON",-62.49786,-16.61663,737,58,3465,4202,1874,146,1387,3261
"Bolivia","Santa Cruz","Ñuflo De Chávez","San Ramón","ESC. SANTA ROSA DE LA MINA",-62.46406,-16.54375,19,1,156,175,89,9,57,146
"Bolivia","Santa Cruz","Obispo Santisteban","Fernández Alonso","ESC. AGUAICES",-63.31085,-16.89686,33,3,274,307,88,14,169,257
"Bolivia","Santa Cruz","Obispo Santisteban","Fernández Alonso","ESC. EDUARDO AVAROA",-63.23214,-16.96287,63,12,499,562,156,15,316,472
"Bolivia","Santa Cruz","Obispo Santisteban","Fernández Alonso","ESC. NUCLEO MARISCAL SUCRE",-63.2194,-16.96726,276,20,1815,2091,575,67,1153,1728
"Bolivia","Santa Cruz","Obispo Santisteban","Fernández Alonso","ESC. SECCIONAL",-63.31478,-17.03029,4,0,20,24,2,1,17,19
"Bolivia","Santa Cruz","Obispo Santisteban","Fernández Alonso","ESC. SECCIONAL FAJA BOLIVAR",-63.22898,-16.97343,0,1,10,10,0,0,9,9
"Bolivia","Santa Cruz","Obispo Santisteban","Fernández Alonso","ESC. U.E. BETANIA",-63.20389,-16.86883,5,3,106,111,30,2,71,101
"Bolivia","Santa Cruz","Obispo Santisteban","Fernández Alonso","ESC. U.E. VICTOR HUGO OTALORA",-63.22835,-17.00979,494,52,3096,3590,1080,138,1826,2906
"Bolivia","Santa Cruz","Obispo Santisteban","General Agustín Saavedra","COL. PRINCIPE DE PAZ",-63.21263,-17.22497,523,39,3217,3740,1900,134,1144,3044
"Bolivia","Santa Cruz","Obispo Santisteban","General Agustín Saavedra","ESC. 1 DE SEPTIEMBRE",-63.08397,-17.09076,78,7,379,457,140,7,225,365
"Bolivia","Santa Cruz","Obispo Santisteban","General Agustín Saavedra","ESC. NUCLEO CENTRAL NUEVA ESPERANZA",-63.21746,-17.16079,129,9,823,952,363,22,429,792
"Bolivia","Santa Cruz","Obispo Santisteban","General Agustín Saavedra","ESC. NUCLEO  MARISCAL SUCRE",-63.12855,-17.10982,149,17,857,1006,283,34,523,806
"Bolivia","Santa Cruz","Obispo Santisteban","General Agustín Saavedra","ESC. U.E. CHANE BEDOYA",-63.07076,-17.02967,68,3,313,381,109,8,193,302
"Bolivia","Santa Cruz","Obispo Santisteban","General Agustín Saavedra","ESC. U.E. GUALBERTO VILLARROEL",-63.13241,-17.22034,96,12,458,554,129,25,292,421
"Bolivia","Santa Cruz","Obispo Santisteban","General Agustín Saavedra","ESC. U.E. SANTIAGO CORNEN",-63.07765,-17.07392,53,1,352,405,171,13,167,338
"Bolivia","Santa Cruz","Obispo Santisteban","General Agustín Saavedra","U.E. ARMINDA MERCADO P.",-63.27879,-17.22003,4,4,81,85,57,2,18,75
"Bolivia","Santa Cruz","Obispo Santisteban","General Agustín Saavedra","U.E. MARCELO QUIROGA SANTA CRUZ",-63.23772,-17.25334,1,6,81,82,17,1,57,74
"Bolivia","Santa Cruz","Obispo Santisteban","General Agustín Saavedra","U.E. SAN FELIX",-63.16826,-17.22752,6,3,45,51,15,2,25,40
"Bolivia","Santa Cruz","Obispo Santisteban","Mineros","ESC. LA PATRIA",-63.33168,-17.13894,48,6,220,268,99,10,105,204
"Bolivia","Santa Cruz","Obispo Santisteban","Mineros","ESC. LAS PALMAS",-63.27835,-17.07745,46,5,326,372,115,11,195,310
"Bolivia","Santa Cruz","Obispo Santisteban","Mineros","ESC. NUCLEO CENTRAL MINERO",-63.23399,-17.11312,1568,165,9457,11025,5140,371,3781,8921
"Bolivia","Santa Cruz","Obispo Santisteban","Mineros","ESC. SUB. CENTRAL LA PORFIA",-63.15114,-17.05671,98,5,388,486,144,6,233,377
"Bolivia","Santa Cruz","Obispo Santisteban","Mineros","ESC. U.E. SAN JUAN DEL CARMEN",-63.18584,-17.07821,6,1,58,64,21,3,33,54
"Bolivia","Santa Cruz","Obispo Santisteban","Mineros","U.E. 24 DE JUNIO",-63.37979,-17.01744,0,0,88,88,14,7,67,81
"Bolivia","Santa Cruz","Obispo Santisteban","Mineros","U.E. ALIANZA EL PROGRESO",-63.2196,-17.05495,0,19,183,183,42,5,117,159
"Bolivia","Santa Cruz","Obispo Santisteban","Mineros","U.E. ALICE ALVAREZ DE AREDONDO I",-63.23064,-17.11864,81,9,560,641,305,11,235,540
"Bolivia","Santa Cruz","Obispo Santisteban","Mineros","U.E. BENJAMIN BANEGAS VACA",-63.22878,-17.1259,37,5,252,289,131,4,112,243
"Bolivia","Santa Cruz","Obispo Santisteban","Montero","CARCEL PUBLICA DE MONTERO",-63.20849,-17.31119,84,0,26,110,15,4,7,22
"Bolivia","Santa Cruz","Obispo Santisteban","Montero","COL. ANGEL LIMPIAS",-63.23486,-17.34456,384,28,2254,2638,929,72,1225,2154
"Bolivia","Santa Cruz","Obispo Santisteban","Montero","COL. DANIEL RIVERO",-63.24461,-17.34128,1029,58,5460,6489,2066,169,3167,5233
"Bolivia","Santa Cruz","Obispo Santisteban","Montero","COL. EDUARDO ABAROA",-63.23902,-17.32316,331,15,2193,2524,1362,54,762,2124
"Bolivia","Santa Cruz","Obispo Santisteban","Montero","COL. FE Y ALEGRIA",-63.22857,-17.34315,222,13,1807,2029,1483,28,283,1766
"Bolivia","Santa Cruz","Obispo Santisteban","Montero","COL. FRANZ TAMAYO",-63.23262,-17.34123,343,21,2293,2636,1066,76,1130,2196
"Bolivia","Santa Cruz","Obispo Santisteban","Montero","COL. GUILLERMO KRUEGLER",-63.26248,-17.34654,475,19,2960,3435,2154,119,668,2822
"Bolivia","Santa Cruz","Obispo Santisteban","Montero","COL. JOSE CRONEMBOL",-63.25688,-17.35259,404,15,2141,2545,1565,78,483,2048
"Bolivia","Santa Cruz","Obispo Santisteban","Montero","COL. JUAN ZABALA",-63.27181,-17.31366,770,35,4491,5261,2796,132,1528,4324
"Bolivia","Santa Cruz","Obispo Santisteban","Montero","COL. MARCELIANO MONTERO",-63.25363,-17.34717,325,42,2464,2789,1844,86,492,2336
"Bolivia","Santa Cruz","Obispo Santisteban","Montero","COL. MARCOS CHAVEZ",-63.24632,-17.35353,348,23,2349,2697,1490,51,785,2275
"Bolivia","Santa Cruz","Obispo Santisteban","Montero","COL. NACIONAL GUABIRA",-63.26613,-17.30766,346,11,2427,2773,1400,126,890,2290
"Bolivia","Santa Cruz","Obispo Santisteban","Montero","COL. OBISPO SANTISTEBAN",-63.25393,-17.34288,253,4,1683,1936,1226,41,412,1638
"Bolivia","Santa Cruz","Obispo Santisteban","Montero","COL. RAFAEL TERRAZAS",-63.25919,-17.3407,325,8,1954,2279,1572,46,328,1900
"Bolivia","Santa Cruz","Obispo Santisteban","Montero","COL. RENE MORENO",-63.25811,-17.33856,199,9,2754,2953,2172,155,418,2590
"Bolivia","Santa Cruz","Obispo Santisteban","Montero","COL. SAN JOSE OBRERO",-63.24022,-17.34599,621,38,3672,4293,1383,137,2114,3497
"Bolivia","Santa Cruz","Obispo Santisteban","Montero","COL. SIMON BOLIVAR",-63.25801,-17.34814,173,8,1404,1577,983,110,303,1286
"Bolivia","Santa Cruz","Obispo Santisteban","Montero","COL. U.E. ELVIRA FRIAS",-63.25016,-17.33013,929,77,5774,6703,1833,287,3577,5410
"Bolivia","Santa Cruz","Obispo Santisteban","Montero","COL. U.E. MONTECRISTO",-63.26806,-17.34976,359,13,1873,2232,738,310,812,1550
"Bolivia","Santa Cruz","Obispo Santisteban","Montero","COL. UNIDAD EDUCATIVA LA ESPERANZA",-63.23973,-17.35262,304,10,2210,2514,1188,81,931,2119
"Bolivia","Santa Cruz","Obispo Santisteban","Montero","COL. UNIDAD EDUCATIVA VILLA VIRGINIA",-63.23734,-17.33811,358,24,1977,2335,563,86,1304,1867
"Bolivia","Santa Cruz","Obispo Santisteban","Montero","COL. VICTOR SALVATIERRA",-63.25366,-17.34156,266,8,1851,2117,1398,42,403,1801
"Bolivia","Santa Cruz","Obispo Santisteban","Montero","ESC. U.E. MARILUZ ESTREMADOIRO",-63.22701,-17.32729,27,4,158,185,74,8,72,146
"Bolivia","Santa Cruz","Obispo Santisteban","Montero","U.E. 12 DE ABRIL",-63.25831,-17.33828,23,3,331,354,148,19,161,309
"Bolivia","Santa Cruz","Obispo Santisteban","Montero","U.E. JUANCITO PINTO",-63.14261,-17.58141,44,15,922,966,189,31,687,876
"Bolivia","Santa Cruz","Obispo Santisteban","Montero","U.E. MARCELIANO MONTERO",-63.25181,-17.34623,251,14,1663,1914,1287,33,329,1616
"Bolivia","Santa Cruz","Obispo Santisteban","Montero","UE MAXIMILIANO KOLBE",-63.26643,-17.3404,613,29,4199,4812,2592,165,1413,4005
"Bolivia","Santa Cruz","Obispo Santisteban","Montero","U.E. NUEVO MILENIO",-63.24696,-17.32077,31,2,170,201,62,5,101,163
"Bolivia","Santa Cruz","Obispo Santisteban","Montero","U.E. SAN RAMON DE LA VIBORA",-63.26657,-17.33263,15,0,154,169,41,4,109,150
"Bolivia","Santa Cruz","Obispo Santisteban","Montero","U.E. SAN SILVESTRE",-63.26012,-17.3525,33,3,234,267,96,9,126,222
"Bolivia","Santa Cruz","Obispo Santisteban","Montero","U.E. SANTA ROSITA",-63.2749,-17.30831,0,0,4,4,3,0,1,4
"Bolivia","Santa Cruz","Obispo Santisteban","San Pedro","ESC. 9 DE ABRIL",-63.66607,-16.60111,106,9,588,694,180,12,387,567
"Bolivia","Santa Cruz","Obispo Santisteban","San Pedro","ESC. CANANDOA",-63.71227,-16.52267,80,6,343,423,68,13,256,324
"Bolivia","Santa Cruz","Obispo Santisteban","San Pedro","ESC. FE Y ALEGRIA",-63.48004,-16.82541,301,38,1758,2059,789,34,897,1686
"Bolivia","Santa Cruz","Obispo Santisteban","San Pedro","ESC. FE Y ALEGRIA TITO BOLTAN",-63.42871,-16.84723,113,7,864,977,420,12,425,845
"Bolivia","Santa Cruz","Obispo Santisteban","San Pedro","ESC. NUCLEO CENTRAL MURILLO",-63.55027,-16.75557,15,4,178,193,62,4,108,170
"Bolivia","Santa Cruz","Obispo Santisteban","San Pedro","ESC. OBISPO SANTISTEBAN",-63.38285,-16.84942,77,6,601,678,162,34,399,561
"Bolivia","Santa Cruz","Obispo Santisteban","San Pedro","ESC. PADRE REMO PRANDINI VIOTTI",-63.6132,-16.67545,195,29,1059,1254,380,22,628,1008
"Bolivia","Santa Cruz","Obispo Santisteban","San Pedro","ESC. SAN SILVESTRE",-63.3363,-16.87776,16,0,113,129,34,1,78,112
"Bolivia","Santa Cruz","Obispo Santisteban","San Pedro","ESC. SECCIONAL LITORAL",-63.57311,-16.72976,28,2,270,298,75,1,192,267
"Bolivia","Santa Cruz","Obispo Santisteban","San Pedro","ESC. U.E. PETA GRANDE",-63.68477,-16.44438,25,1,112,137,24,8,79,103
"Bolivia","Santa Cruz","Obispo Santisteban","San Pedro","ESC. VILLA ROSARIO",-63.42629,-16.93978,74,5,291,365,47,8,231,278
"Bolivia","Santa Cruz","Sara","Colpa Bélgica","ESC. LOLA TERRAZAS DE GASSER",-63.23116,-17.5691,440,15,2358,2798,1357,39,947,2304
"Bolivia","Santa Cruz","Sara","Colpa Bélgica","ESC, REPUBLICA DEL BRASIL",-63.2303,-17.56968,109,8,689,798,478,20,183,661
"Bolivia","Santa Cruz","Sara","Portachuelo","ESC. ANGEL MARIA LIMPIAS",-63.39923,-17.35743,236,11,1770,2006,1310,24,425,1735
"Bolivia","Santa Cruz","Sara","Portachuelo","ESC. JULIO LANDIVAR",-63.39304,-17.35695,176,6,1373,1549,1085,23,259,1344
"Bolivia","Santa Cruz","Sara","Portachuelo","ESC. LA APLICACION",-63.39476,-17.35477,368,54,3185,3553,2389,107,635,3024
"Bolivia","Santa Cruz","Sara","Portachuelo","ESC. MARTINA DORADO",-63.39271,-17.35174,365,60,2771,3136,1964,71,676,2640
"Bolivia","Santa Cruz","Sara","Portachuelo","ESC. NUCLEO CENTRAL",-63.51644,-17.58445,88,9,595,683,403,4,179,582
"Bolivia","Santa Cruz","Sara","Portachuelo","ESC. PEROTO",-63.41801,-17.47633,0,0,53,53,38,2,13,51
"Bolivia","Santa Cruz","Sara","Portachuelo","ESC. SAN IGNACIO",-63.57069,-17.2788,59,3,363,422,225,7,128,353
"Bolivia","Santa Cruz","Sara","Santa Rosa del Sara","ESC. 4 DE MARZO",-63.89693,-16.93718,35,5,293,328,31,10,247,278
"Bolivia","Santa Cruz","Sara","Santa Rosa del Sara","ESC.  ALFREDO VACA FLOR",-63.86467,-16.67098,100,8,454,554,58,13,375,433
"Bolivia","Santa Cruz","Sara","Santa Rosa del Sara","ESC  ALFREDO VASQUEZ",-63.18314,-17.78275,65,7,575,640,438,33,97,535
"Bolivia","Santa Cruz","Sara","Santa Rosa del Sara","ESC. EL COLORADO",-63.42475,-17.17983,18,2,97,115,40,3,52,92
"Bolivia","Santa Cruz","Sara","Santa Rosa del Sara","ESC.GALILEA",-63.67821,-16.95352,63,2,404,467,71,4,327,398
"Bolivia","Santa Cruz","Sara","Santa Rosa del Sara","ESC. LA CONQUISTA",-63.95355,-16.73366,72,6,363,435,53,17,287,340
"Bolivia","Santa Cruz","Sara","Santa Rosa del Sara","ESC.  MIXTO LOS ANDES",-63.83144,-16.88512,206,20,1067,1273,175,44,828,1003
"Bolivia","Santa Cruz","Sara","Santa Rosa del Sara","ESC. PALOMETAS",-63.52637,-17.03255,16,0,83,99,46,0,37,83
"Bolivia","Santa Cruz","Sara","Santa Rosa del Sara","ESC. PASTO MERCADO QUIROGA",-63.43382,-17.12932,64,6,318,382,145,12,155,300
"Bolivia","Santa Cruz","Sara","Santa Rosa del Sara","ESC. RINCON DE PALOMETA",-63.18314,-17.78275,67,7,405,472,263,2,133,396
"Bolivia","Santa Cruz","Sara","Santa Rosa del Sara","ESC. SAN LUIS",-63.78288,-16.94883,63,4,295,358,39,11,241,280
"Bolivia","Santa Cruz","Sara","Santa Rosa del Sara","ESC. SANTA ROSA",-63.59691,-17.11006,565,37,2833,3398,1803,52,941,2744
"Bolivia","Santa Cruz","Valle Grande","Moro Moro","ESC. ASTILLERO",-64.3554,-18.40132,4,9,119,123,26,5,79,105
"Bolivia","Santa Cruz","Valle Grande","Moro Moro","ESC.LA LAJA",-64.29583,-18.25416,14,8,175,189,96,9,62,158
"Bolivia","Santa Cruz","Valle Grande","Moro Moro","ESC. MOROMORO",-64.3226,-18.36664,94,11,646,740,393,30,212,605
"Bolivia","Santa Cruz","Valle Grande","Moro Moro","ESC.NUCLEO AÑAPACO",-64.28843,-18.44178,0,0,25,25,15,1,9,24
"Bolivia","Santa Cruz","Valle Grande","Moro Moro","ESC. NUCLEO ARIRUMA",-64.32661,-18.43659,23,1,155,178,65,8,81,146
"Bolivia","Santa Cruz","Valle Grande","Moro Moro","ESC. NUCLEO CENTRAL",-64.29378,-18.52514,6,0,61,67,17,2,42,59
"Bolivia","Santa Cruz","Valle Grande","Moro Moro","ESC. U.E. EL VELADERO",-64.26523,-18.35126,39,8,245,284,114,14,109,223
"Bolivia","Santa Cruz","Valle Grande","Postrer Valle","ESC. NUCLEO POSTERVALLE",-63.83601,-18.49309,143,19,603,746,398,23,163,561
"Bolivia","Santa Cruz","Valle Grande","Postrer Valle","ESC.SAN PABLO DE LA LADERA",-63.92479,-18.43073,7,0,36,43,18,1,17,35
"Bolivia","Santa Cruz","Valle Grande","Postrer Valle","ESC.TIERRAS NUEVAS",-63.90362,-18.48421,16,0,105,121,87,3,15,102
"Bolivia","Santa Cruz","Valle Grande","Postrer Valle","ESC. UNIDAD EDUCATIVA MOSQUERA",-63.75977,-18.62887,31,5,92,123,68,3,16,84
"Bolivia","Santa Cruz","Valle Grande","Pucará","ESC. EDEY CORBAN SEHALLER",-64.18601,-18.71765,99,9,593,692,262,18,304,566
"Bolivia","Santa Cruz","Valle Grande","Pucará","ESC. LA HIGUERA",-64.18205,-18.71724,54,8,322,376,195,10,109,304
"Bolivia","Santa Cruz","Valle Grande","Trigal","ESC. LA AGUADA",-64.05747,-18.29873,0,1,53,53,29,7,16,45
"Bolivia","Santa Cruz","Valle Grande","Trigal","ESC.LAGUNILLAS",-64.15909,-18.26369,39,4,276,315,113,60,99,212
"Bolivia","Santa Cruz","Valle Grande","Trigal","ESC.SAN JOSE AGUIRRE ACHA",-64.15065,-18.30182,136,10,533,669,266,15,242,508
"Bolivia","Santa Cruz","Valle Grande","Trigal","ESC.TTE.ROMAN ALDERETTE",-64.15926,-18.35822,29,2,156,185,88,7,59,147
"Bolivia","Santa Cruz","Valle Grande","Vallegrande","ESC. ALTO SECO",-64.07446,-18.87057,53,5,285,338,151,12,117,268
"Bolivia","Santa Cruz","Valle Grande","Vallegrande","ESC. CASAMONTES",-64.02926,-18.70448,44,4,138,182,90,3,41,131
"Bolivia","Santa Cruz","Valle Grande","Vallegrande","ESC. CENTRAL GUADALUPE",-64.08943,-18.55554,39,12,378,417,196,9,161,357
"Bolivia","Santa Cruz","Valle Grande","Vallegrande","ESC. DE CHACOPATA",-64.22842,-18.35763,11,8,153,164,77,21,47,124
"Bolivia","Santa Cruz","Valle Grande","Vallegrande","ESC.DE MANKAILLPA",-64.21599,-18.39356,0,0,61,61,44,7,10,54
"Bolivia","Santa Cruz","Valle Grande","Vallegrande","ESC. IGNACIO TERAN",-64.10592,-18.48932,362,42,2095,2457,1261,109,683,1944
"Bolivia","Santa Cruz","Valle Grande","Vallegrande","ESC. JUANA CARMEN ROMAN",-64.10367,-18.4858,300,25,1457,1757,857,71,504,1361
"Bolivia","Santa Cruz","Valle Grande","Vallegrande","ESC.LOMA LARGA",-63.90175,-18.76361,13,1,88,101,67,1,19,86
"Bolivia","Santa Cruz","Valle Grande","Vallegrande","ESC. LOS SITANOS",-63.95913,-18.86104,31,4,151,182,116,3,28,144
"Bolivia","Santa Cruz","Valle Grande","Vallegrande","ESC.MASICURI",-63.7827,-18.83035,30,3,166,196,109,7,47,156
"Bolivia","Santa Cruz","Valle Grande","Vallegrande","ESC.NARANJO",-64.25002,-18.42377,9,1,69,78,55,0,13,68
"Bolivia","Santa Cruz","Valle Grande","Vallegrande","ESC. NUCLEO EL BELLO",-64.1921,-18.4416,8,4,90,98,76,0,10,86
"Bolivia","Santa Cruz","Valle Grande","Vallegrande","ESC. NUCLEO SAN JUAN",-64.20347,-18.3373,15,5,158,173,101,3,49,150
"Bolivia","Santa Cruz","Valle Grande","Vallegrande","ESC. NUCLEO TUCUMANCILLO",-64.14893,-18.37689,4,1,54,58,37,0,16,53
"Bolivia","Santa Cruz","Valle Grande","Vallegrande","ESC. OBISPO MANUEL JOSE PEÑA",-64.10788,-18.48844,343,26,1917,2260,1149,100,642,1791
"Bolivia","Santa Cruz","Valle Grande","Vallegrande","ESC. PIRAIMIRI",-63.96607,-18.63742,13,5,83,96,46,7,25,71
"Bolivia","Santa Cruz","Valle Grande","Vallegrande","ESC.SANTA ANA",-64.14568,-18.59265,11,1,108,119,52,5,50,102
"Bolivia","Santa Cruz","Valle Grande","Vallegrande","ESC. SANTA ROSITA",-64.08921,-18.52326,22,3,132,154,85,3,41,126
"Bolivia","Santa Cruz","Valle Grande","Vallegrande","ESC. TEMPORAL",-64.07647,-18.63612,6,0,29,35,21,1,7,28
"Bolivia","Santa Cruz","Valle Grande","Vallegrande","ESC. UNIDAD EDUCATIVA ARENALES",-63.72049,-18.95825,28,0,113,141,87,4,22,109
"Bolivia","Santa Cruz","Valle Grande","Vallegrande","KINDER SANTA MARIA",-64.1016,-18.48618,239,26,1628,1867,968,80,554,1522
"Bolivia","Santa Cruz","Velasco","San Ignacio (San Ignacio de Velasco)","15 DE AGOSTO",-61.22021,-16.04663,28,5,192,220,13,6,168,181
"Bolivia","Santa Cruz","Velasco","San Ignacio (San Ignacio de Velasco)","ESC.ALBERTO NATUSCH BUSCH",-61.19359,-14.61075,6,0,36,42,11,0,25,36
"Bolivia","Santa Cruz","Velasco","San Ignacio (San Ignacio de Velasco)","ESC. CAMPAMENTO",-61.01795,-15.1786,121,10,391,512,206,16,159,365
"Bolivia","Santa Cruz","Velasco","San Ignacio (San Ignacio de Velasco)","ESC. CARLOS MAYSER",-60.96424,-16.37827,751,52,3206,3957,2263,74,817,3080
"Bolivia","Santa Cruz","Velasco","San Ignacio (San Ignacio de Velasco)","ESC.CENTRAL EL PORVENIR",-59.49656,-16.28357,89,2,119,208,46,1,70,116
"Bolivia","Santa Cruz","Velasco","San Ignacio (San Ignacio de Velasco)","ESC.CENTRAL PISO FIRME",-61.73743,-13.63076,32,4,143,175,49,6,84,133
"Bolivia","Santa Cruz","Velasco","San Ignacio (San Ignacio de Velasco)","ESC. DON BOSCO",-60.9684,-16.38181,500,65,2505,3005,1494,60,886,2380
"Bolivia","Santa Cruz","Velasco","San Ignacio (San Ignacio de Velasco)","ESC.EL CARMEN DE RUIZ",-61.09895,-16.04755,92,6,488,580,359,13,110,469
"Bolivia","Santa Cruz","Velasco","San Ignacio (San Ignacio de Velasco)","ESC. LIC. SENORITAS MONSENOR DANIEL RIVE",-60.95947,-16.38194,1047,45,4525,5572,3400,116,964,4364
"Bolivia","Santa Cruz","Velasco","San Ignacio (San Ignacio de Velasco)","ESC. MARISCAL SUCRE",-60.97673,-16.37599,890,47,3456,4346,2594,78,737,3331
"Bolivia","Santa Cruz","Velasco","San Ignacio (San Ignacio de Velasco)","ESC.MIRAFLORES",-60.39898,-15.7093,9,0,31,40,25,0,6,31
"Bolivia","Santa Cruz","Velasco","San Ignacio (San Ignacio de Velasco)","ESC.NUCLEO CENTRAL ESPIRITU",-60.52824,-16.18724,116,5,244,360,164,3,72,236
"Bolivia","Santa Cruz","Velasco","San Ignacio (San Ignacio de Velasco)","ESC. PAILITA",-60.71217,-16.55711,12,1,54,66,22,0,31,53
"Bolivia","Santa Cruz","Velasco","San Ignacio (San Ignacio de Velasco)","ESC. RECREO",-61.05543,-16.42583,17,1,108,125,38,1,68,106
"Bolivia","Santa Cruz","Velasco","San Ignacio (San Ignacio de Velasco)","ESC. SAN JOSEMA",-61.0378,-16.26388,6,5,97,103,27,4,61,88
"Bolivia","Santa Cruz","Velasco","San Ignacio (San Ignacio de Velasco)","ESC. SAN JUAN DEL MACOÑO",-60.1824,-16.04592,8,0,56,64,37,3,16,53
"Bolivia","Santa Cruz","Velasco","San Ignacio (San Ignacio de Velasco)","ESC. SAN MARTIN",-61.48943,-15.39137,193,14,705,898,97,29,565,662
"Bolivia","Santa Cruz","Velasco","San Ignacio (San Ignacio de Velasco)","ESC.SANTA ANA",-60.68709,-16.58516,107,2,363,470,274,4,83,357
"Bolivia","Santa Cruz","Velasco","San Ignacio (San Ignacio de Velasco)","ESC.SANTA ROSA ROCA",-61.43752,-15.9136,394,22,1053,1447,549,45,437,986
"Bolivia","Santa Cruz","Velasco","San Ignacio (San Ignacio de Velasco)","ESC.SAN VICENTE",-60.07525,-16.27286,61,5,229,290,122,10,92,214
"Bolivia","Santa Cruz","Velasco","San Ignacio (San Ignacio de Velasco)","ESC. U.E. 25 DE JULIO",-60.34592,-15.55293,18,1,67,85,41,5,20,61
"Bolivia","Santa Cruz","Velasco","San Ignacio (San Ignacio de Velasco)","ESC. U.E. LA ESTRELLA",-61.51268,-15.57549,44,5,337,381,106,13,213,319
"Bolivia","Santa Cruz","Velasco","San Ignacio (San Ignacio de Velasco)","ESC. U.E. SIMON BOLIVAR",-60.42154,-15.33675,14,0,118,132,55,6,57,112
"Bolivia","Santa Cruz","Velasco","San Ignacio (San Ignacio de Velasco)","U.E. 15 DE AGOSTO",-61.221,-16.0462,5,0,105,110,16,2,87,103
"Bolivia","Santa Cruz","Velasco","San Ignacio (San Ignacio de Velasco)","U.E. 19 DE MARZO",-61.04763,-16.33254,8,0,0,8,0,0,0,0
"Bolivia","Santa Cruz","Velasco","San Ignacio (San Ignacio de Velasco)","U.E. BERNARDO MONTEAGUDO",-61.43381,-15.22893,11,1,94,105,6,2,85,91
"Bolivia","Santa Cruz","Velasco","San Ignacio (San Ignacio de Velasco)","U.E. CELEDONIO CORTEZON",-61.15897,-16.03947,4,0,0,4,0,0,0,0
"Bolivia","Santa Cruz","Velasco","San Ignacio (San Ignacio de Velasco)","U.E. JOSE CHAVEZ",-61.42244,-15.99493,1,0,75,76,41,1,33,74
"Bolivia","Santa Cruz","Velasco","San Ignacio (San Ignacio de Velasco)","U.E. JOSE FERREIRA",-60.96625,-15.38916,3,0,41,44,25,0,16,41
"Bolivia","Santa Cruz","Velasco","San Ignacio (San Ignacio de Velasco)","U.E. JOSE PESSOA",-60.89307,-15.46235,0,2,42,42,23,2,15,38
"Bolivia","Santa Cruz","Velasco","San Ignacio (San Ignacio de Velasco)","U.E. MERCEDES DE LAS MINAS",-60.87927,-16.38784,3,2,50,53,27,0,21,48
"Bolivia","Santa Cruz","Velasco","San Ignacio (San Ignacio de Velasco)","U.E. SAN BARTOLO DE LA FRONTERA",-59.89635,-16.29955,22,1,109,131,57,5,46,103
"Bolivia","Santa Cruz","Velasco","San Ignacio (San Ignacio de Velasco)","U.E. SAN JAVIERITO",-61.00164,-16.16473,12,3,247,259,155,21,68,223
"Bolivia","Santa Cruz","Velasco","San Ignacio (San Ignacio de Velasco)","U.E. SAN LORENCITO DE LA FRONTERA",-60.32001,-15.62855,12,1,107,119,68,2,36,104
"Bolivia","Santa Cruz","Velasco","San Ignacio (San Ignacio de Velasco)","U.E. SAN RAFAELITO DE SUPONEMA",-60.73782,-16.51591,4,1,107,111,86,1,19,105
"Bolivia","Santa Cruz","Velasco","San Ignacio (San Ignacio de Velasco)","U.E. SANTA ANITA DE LA FRONTERA",-60.46891,-16.16416,5,1,64,69,9,1,53,62
"Bolivia","Santa Cruz","Velasco","San Ignacio (San Ignacio de Velasco)","U.E. TARCILA JUSTINIANO",-61.3272,-15.92669,4,1,68,72,30,3,34,64
"Bolivia","Santa Cruz","Velasco","San Ignacio (San Ignacio de Velasco)","U.E. TIERRA FIRME",-61.38297,-15.43932,13,1,123,136,7,4,111,118
"Bolivia","Santa Cruz","Velasco","San Miguel (San Miguel de Velasco)","ESC. BELISARIO SANTISTEBAN",-60.96719,-16.70072,369,14,1819,2188,784,34,987,1771
"Bolivia","Santa Cruz","Velasco","San Miguel (San Miguel de Velasco)","ESC. JOSE J.DORADO",-60.96856,-16.69866,431,61,2409,2840,1178,44,1126,2304
"Bolivia","Santa Cruz","Velasco","San Miguel (San Miguel de Velasco)","ESC. MONSEÑOR BONIFACIO",-61.49168,-17.07628,59,9,378,437,203,7,159,362
"Bolivia","Santa Cruz","Velasco","San Miguel (San Miguel de Velasco)","ESC. U.E. CRUZ DEL TOCOIGO",-61.14905,-16.62491,14,3,112,126,27,1,81,108
"Bolivia","Santa Cruz","Velasco","San Miguel (San Miguel de Velasco)","ESC. U.E. SAN LUISITO DE LIMA",-61.22618,-16.79143,2,0,20,22,1,2,17,18
"Bolivia","Santa Cruz","Velasco","San Miguel (San Miguel de Velasco)","ESC. U.E. SAN PEDRO DEL CERRITO",-61.1039,-16.61456,6,0,49,55,17,2,30,47
"Bolivia","Santa Cruz","Velasco","San Miguel (San Miguel de Velasco)","U.E. ALTAMIRA",-61.0463,-16.71514,6,2,49,55,6,1,40,46
"Bolivia","Santa Cruz","Velasco","San Miguel (San Miguel de Velasco)","U.E. SAPOCO",-60.99136,-16.61194,0,3,85,85,11,1,70,81
"Bolivia","Santa Cruz","Velasco","San Rafael","ESC. EL TUNA",-59.6983,-16.62828,32,0,138,170,106,3,29,135
"Bolivia","Santa Cruz","Velasco","San Rafael","ESC. GODOFREDO TRENKER",-60.67352,-16.78576,458,24,1673,2131,1119,39,491,1610
"Bolivia","Santa Cruz","Velasco","San Rafael","ESC. MIRAFLORES II",-60.58031,-17.12125,64,0,228,292,56,5,167,223
"Bolivia","Santa Cruz","Velasco","San Rafael","ESC. VILLA FATIMA",-60.60354,-16.9649,17,1,52,69,34,3,14,48
"Bolivia","Santa Cruz","Warnes","Okinawa Uno","ESC. NUEVA AURORA",-62.80148,-17.49827,7,0,48,55,39,0,9,48
"Bolivia","Santa Cruz","Warnes","Okinawa Uno","ESCUELA. COLEGIO EVANGELICO METODISTA",-62.88918,-17.21915,486,66,3233,3719,2007,172,988,2995
"Bolivia","Santa Cruz","Warnes","Okinawa Uno","ESCUELA UNID. EDU.NUEVO HORIZONTE",-62.80159,-17.32424,135,14,934,1069,639,9,272,911
"Bolivia","Santa Cruz","Warnes","Okinawa Uno","ESC. UNIDAD EDUCATIVA NUEVA ESPERANZA",-62.7861,-17.24826,30,5,201,231,107,6,83,190
"Bolivia","Santa Cruz","Warnes","Okinawa Uno","ESC. UNID. EDU. SAN MIGUEL",-62.90409,-17.43998,60,3,373,433,217,8,145,362
"Bolivia","Santa Cruz","Warnes","Okinawa Uno","ESC. UNID.EDU. SECCIONAL PUERTO NUEVO",-62.79018,-17.17909,52,5,338,390,251,5,77,328
"Bolivia","Santa Cruz","Warnes","Okinawa Uno","ESC.UNID EDU.  VILLA REYES",-62.82537,-17.39157,19,0,129,148,54,5,70,124
"Bolivia","Santa Cruz","Warnes","Warnes","26 DE MARZO",-63.13284,-17.58807,25,2,152,177,57,28,65,122
"Bolivia","Santa Cruz","Warnes","Warnes","ESC. ADRIAN JUSTINIANO ROCA",-63.01891,-17.59505,73,12,474,547,287,10,165,452
"Bolivia","Santa Cruz","Warnes","Warnes","ESC. CIUDAD SATELITE NORTE",-63.14571,-17.60657,1688,57,8634,10322,3703,302,4572,8275
"Bolivia","Santa Cruz","Warnes","Warnes","ESC. COL. CONSTANTINO CUELLAR",-63.16426,-17.50641,477,89,3386,3863,2007,85,1205,3212
"Bolivia","Santa Cruz","Warnes","Warnes","ESC. COLEGIO JULIA SAID",-63.16407,-17.51213,1125,51,6745,7870,3208,253,3233,6441
"Bolivia","Santa Cruz","Warnes","Warnes","ESC. EL JIPA",-63.14586,-17.50428,34,5,450,484,197,17,231,428
"Bolivia","Santa Cruz","Warnes","Warnes","ESC. FISCAL POTRERO LARGO",-63.11728,-17.56155,448,24,2508,2956,1064,103,1317,2381
"Bolivia","Santa Cruz","Warnes","Warnes","ESC. JUANA AZURDUY DE PADILLA",-63.0628,-17.51302,633,32,4061,4694,1485,187,2357,3842
"Bolivia","Santa Cruz","Warnes","Warnes","ESC. TERRACOR",-63.18655,-17.65559,324,24,2002,2326,1188,49,741,1929
"Bolivia","Santa Cruz","Warnes","Warnes","ESC. UE ANGELMIRA MONTE. DE DALENCE",-62.96617,-17.45183,46,6,429,475,269,9,145,414
"Bolivia","Santa Cruz","Warnes","Warnes","ESC. UE LAS BARRERAS",-63.18001,-17.44845,189,29,1575,1764,761,101,684,1445
"Bolivia","Santa Cruz","Warnes","Warnes","ESC. UE MARIANO VACA MONTERO",-63.05692,-17.42761,163,10,849,1012,458,49,332,790
"Bolivia","Santa Cruz","Warnes","Warnes","ESC. UE. NUCLEO CENTRAL CLARA CHUCHIO",-63.10474,-17.6164,84,8,615,699,397,14,196,593
"Bolivia","Santa Cruz","Warnes","Warnes","ESC. UE SECCIONAL AZUZAQUI",-63.15946,-17.43235,33,3,340,373,149,13,175,324
"Bolivia","Santa Cruz","Warnes","Warnes","ESC. UE SECCIONAL LA MARINA",-63.00195,-17.4187,62,9,345,407,123,8,205,328
"Bolivia","Santa Cruz","Warnes","Warnes","ESC. UE TUROBITO",-63.14501,-17.36471,26,5,314,340,193,16,100,293
"Bolivia","Santa Cruz","Warnes","Warnes","ESC. UNID. EDU. 21 DE OCTUBRE",-62.99185,-17.40991,30,5,171,201,27,5,134,161
"Bolivia","Santa Cruz","Warnes","Warnes","ESC. UNID. EDU. DON BOSCO",-63.20383,-17.40809,91,4,566,657,333,17,212,545
"Bolivia","Santa Cruz","Warnes","Warnes","ESC. UNID. EDU. EL TAJIBO",-62.99646,-17.24698,146,14,736,882,434,18,270,704
"Bolivia","Santa Cruz","Warnes","Warnes","ESC.  UNID. EDU. FELIX PAZ VIEIRA",-63.04347,-17.29358,26,17,287,313,127,9,134,261
"Bolivia","Santa Cruz","Warnes","Warnes","ESC. UNID. EDU.  JUAN LATINO",-63.22111,-17.4443,59,5,392,451,188,17,182,370
"Bolivia","Santa Cruz","Warnes","Warnes","ESC. UNID. EDU.  LA REFORMA",-63.07001,-17.26757,87,13,627,714,301,7,306,607
"Bolivia","Santa Cruz","Warnes","Warnes","ESC. UNID. EDU.  LOS CHACOS",-63.01535,-17.29066,54,5,360,414,251,2,102,353
"Bolivia","Santa Cruz","Warnes","Warnes","ESC.UNID.EDU.    MOTACU",-63.11813,-17.55554,30,2,206,236,140,3,61,201
"Bolivia","Santa Cruz","Warnes","Warnes","ESC. UNID. EDU. SECCIONAL EL FUTURO",-63.0559,-17.36139,6,3,73,79,27,2,41,68
"Bolivia","Santa Cruz","Warnes","Warnes","ESC. VALLE SANCHEZ",-63.16564,-17.65603,523,14,2806,3329,1988,78,726,2714
"Bolivia","Santa Cruz","Warnes","Warnes","POLITECNICO PENTAGUAZU",-63.13067,-17.59501,8,0,53,61,23,0,30,53
"Bolivia","Santa Cruz","Warnes","Warnes","U.E. AKUALAND",-63.17204,-17.64403,23,1,330,353,217,5,107,324
"Bolivia","Santa Cruz","Warnes","Warnes","U.E. ANTONIO ANZUATI",-63.17149,-17.53695,12,2,163,175,52,8,101,153
"Bolivia","Santa Cruz","Warnes","Warnes","U.E. BUENA FE",-63.0742,-17.5464,52,5,673,725,181,55,432,613
"Bolivia","Santa Cruz","Warnes","Warnes","U.E. CAMPO ROSSO 4 DE ABRIL",-63.13654,-17.59862,157,9,1048,1205,489,28,522,1011
"Bolivia","Santa Cruz","Warnes","Warnes","U.E. EL MANANTIAL",-63.12106,-17.60827,94,2,738,832,407,14,315,722
"Bolivia","Santa Cruz","Warnes","Warnes","U.E. IGNACIO WARNES",-63.16686,-17.50828,1162,44,7429,8591,4224,228,2933,7157
"Bolivia","Santa Cruz","Warnes","Warnes","U.E. JOSE MANUEL VACA",-63.16396,-17.50945,34,5,235,269,134,4,92,226
"Bolivia","Santa Cruz","Warnes","Warnes","U.E. JUANCITO PINTO",-63.27866,-17.35187,19,1,252,271,78,6,167,245
"Bolivia","Santa Cruz","Warnes","Warnes","U.E. MAXIMO NOVILLO",-63.12106,-17.60827,0,10,975,975,320,107,538,858
"Bolivia","Santa Cruz","Warnes","Warnes","U.E. MONTE CARMELO",-63.11643,-17.59848,26,2,251,277,104,37,108,212
"Bolivia","Santa Cruz","Warnes","Warnes","U.E. NUEVA JERUSALEN-PENTAGUAZU",-63.12896,-17.60241,30,1,377,407,155,8,213,368
"Bolivia","Santa Cruz","Warnes","Warnes","U.E. PAITITI",-63.17518,-17.5598,18,3,232,250,68,5,156,224
"Bolivia","Santa Cruz","Warnes","Warnes","U.E . SAN JUAN",-63.10375,-17.60646,122,3,865,987,414,31,417,831
"Bolivia","Santa Cruz","Warnes","Warnes","U.E. SATELITE NORTE",-63.14511,-17.60841,91,3,565,656,251,25,286,537
"Bolivia","Santa Cruz","Warnes","Warnes","U.E. WAJOJO",-63.18615,-17.54112,12,5,225,237,89,15,116,205
"Bolivia","Tarija","Arce","Bermejo","(CÁRCEL) CARCELETA BERMEJO",-64.34433,-22.73379,1,0,14,15,6,0,8,14
"Bolivia","Tarija","Arce","Bermejo","U.E. 25 DE MAYO",-64.33881,-22.73283,751,34,2989,3740,1773,60,1122,2895
"Bolivia","Tarija","Arce","Bermejo","U.E. 8 DE SEPTIEMBRE",-64.3345,-22.74253,499,33,1867,2366,936,54,844,1780
"Bolivia","Tarija","Arce","Bermejo","U.E. ANTONIO JOSE DE SUCRE",-64.33714,-22.72646,197,5,812,1009,408,22,377,785
"Bolivia","Tarija","Arce","Bermejo","U.E. ARROZALES",-64.28224,-22.71737,45,2,187,232,72,6,107,179
"Bolivia","Tarija","Arce","Bermejo","U.E. AULIO ARAOZ",-64.34415,-22.72519,444,32,1518,1962,708,62,716,1424
"Bolivia","Tarija","Arce","Bermejo","U.E. BARREDERO",-64.25467,-22.60689,59,6,258,317,42,5,205,247
"Bolivia","Tarija","Arce","Bermejo","U.E. CAMPO GRANDE (ARCE)",-64.31056,-22.8059,111,12,300,411,84,30,174,258
"Bolivia","Tarija","Arce","Bermejo","U.E. COLONIA LINARES",-64.27553,-22.67242,127,18,486,613,124,20,324,448
"Bolivia","Tarija","Arce","Bermejo","U.E. EDUARDO AVAROA",-64.34496,-22.72868,920,44,3542,4462,1931,103,1464,3395
"Bolivia","Tarija","Arce","Bermejo","U.E. FLOR DE ORO",-64.42138,-22.64809,47,3,141,188,56,4,78,134
"Bolivia","Tarija","Arce","Bermejo","U.E. GUIDO VILLAGOMEZ",-64.333,-22.73719,648,45,2524,3172,1332,71,1076,2408
"Bolivia","Tarija","Arce","Bermejo","U.E. LA ESPERANZA",-64.31773,-22.72795,16,6,289,305,77,5,201,278
"Bolivia","Tarija","Arce","Bermejo","U.E. MOTO MENDEZ",-64.40874,-22.67791,78,11,209,287,71,8,119,190
"Bolivia","Tarija","Arce","Bermejo","U.E. MSCAL. ANDRES DE SANTA CRUZ",-64.33983,-22.73268,620,20,1911,2531,1155,37,699,1854
"Bolivia","Tarija","Arce","Bermejo","U.E. OCTAVIO CAMPERO ECHAZU (BERMEJO)",-64.33255,-22.73421,795,42,3075,3870,1617,101,1315,2932
"Bolivia","Tarija","Arce","Bermejo","U.E. PORCELANA",-64.2924,-22.77003,40,6,97,137,28,3,60,88
"Bolivia","Tarija","Arce","Padcaya","ESC. SECCIONAL QUEÑAHUAYCO",-64.95709,-21.92935,31,2,259,290,37,9,211,248
"Bolivia","Tarija","Arce","Padcaya","ESC. TACUARA SIMON BOLIVAR",-64.85365,-21.8613,38,2,154,192,30,2,120,150
"Bolivia","Tarija","Arce","Padcaya","NUCLEO 9 DE OCTUBRE",-64.16064,-22.4478,73,5,169,242,30,7,127,157
"Bolivia","Tarija","Arce","Padcaya","NUCLEO  SAN TELMO/PRIMERO DE MAYO",-64.41067,-22.53317,50,8,278,328,124,16,130,254
"Bolivia","Tarija","Arce","Padcaya","U.E. 2 DE AGOSTO",-64.24153,-22.49751,66,3,248,314,30,8,207,237
"Bolivia","Tarija","Arce","Padcaya","U.E. ABRA DE SAN MIGUEL",-64.80976,-21.90239,12,1,213,225,80,1,131,211
"Bolivia","Tarija","Arce","Padcaya","U.E. ANICETO ARCE",-64.71397,-21.88711,317,26,1759,2076,975,41,717,1692
"Bolivia","Tarija","Arce","Padcaya","U.E. ANZELMO ONTIVEROS",-64.53857,-22.26854,73,4,365,438,71,8,282,353
"Bolivia","Tarija","Arce","Padcaya","U.E. BLANCA NAVAJAS",-64.84832,-21.89751,89,6,384,473,105,31,242,347
"Bolivia","Tarija","Arce","Padcaya","U.E. CAMACHO",-64.91243,-21.89222,64,5,367,431,84,9,269,353
"Bolivia","Tarija","Arce","Padcaya","U.E. CANCHAS MAYU",-64.89188,-21.89764,28,2,209,237,42,2,163,205
"Bolivia","Tarija","Arce","Padcaya","U.E. EL CARMEN",-64.84747,-22.04908,25,1,135,160,32,1,101,133
"Bolivia","Tarija","Arce","Padcaya","U.E. ELOY APARICIO",-64.67204,-21.83963,116,8,518,634,188,12,310,498
"Bolivia","Tarija","Arce","Padcaya","U.E. JUAN PABLO II",-64.47629,-22.45985,54,1,127,181,50,3,73,123
"Bolivia","Tarija","Arce","Padcaya","U.E. LA HUERTA",-64.93794,-21.91131,43,7,209,252,27,6,169,196
"Bolivia","Tarija","Arce","Padcaya","U.E. LA MERCED",-64.67546,-22.02656,64,4,338,402,171,11,152,323
"Bolivia","Tarija","Arce","Padcaya","U.E. LIMAL",-64.49821,-22.32937,21,0,107,128,35,3,69,104
"Bolivia","Tarija","Arce","Padcaya","U.E. NARANJO AGRIO",-64.49283,-22.30481,23,1,100,123,17,1,81,98
"Bolivia","Tarija","Arce","Padcaya","U.E. OROZAS ARRIBA",-64.64409,-21.91746,90,15,505,595,137,23,330,467
"Bolivia","Tarija","Arce","Padcaya","U.E. OSCAR HIZA BASTIAS",-64.66535,-22.17904,117,9,466,583,149,19,289,438
"Bolivia","Tarija","Arce","Padcaya","U.E. PAMPA GRANDE",-64.43581,-22.04747,181,23,464,645,110,17,314,424
"Bolivia","Tarija","Arce","Padcaya","U.E. QUEBRADA DE CAÑAS",-64.88522,-21.96515,25,3,135,160,19,6,107,126
"Bolivia","Tarija","Arce","Padcaya","U.E. RIO NEGRO",-64.67294,-22.10281,53,11,305,358,103,11,180,283
"Bolivia","Tarija","Arce","Padcaya","U.E. ROSILLAS II",-64.78128,-21.93346,110,10,525,635,211,11,293,504
"Bolivia","Tarija","Arce","Padcaya","U.E. RUMY CANCHA",-64.67708,-21.94845,45,6,146,191,57,6,77,134
"Bolivia","Tarija","Arce","Padcaya","U.E. SALADO CONCHAS",-64.41152,-22.36673,15,0,122,137,27,2,93,120
"Bolivia","Tarija","Arce","Padcaya","U.E. SAN ANTONIO DE MACOYA",-64.89361,-22.10435,92,6,233,325,164,12,51,215
"Bolivia","Tarija","Arce","Padcaya","U.E. SAN FRANCISCO (ARCE)",-64.81699,-21.99598,22,1,151,173,34,5,111,145
"Bolivia","Tarija","Arce","Padcaya","U.E. SAN JOSE DE MARAÑUELO",-64.8847,-21.02283,20,3,175,195,18,2,152,170
"Bolivia","Tarija","Arce","Padcaya","U.E. SIMON BOLIVAR DE REJARA",-64.98435,-22.00053,49,2,271,320,21,4,244,265
"Bolivia","Tarija","Arce","Padcaya","U.E. VIRGEN DE CHAGUAYA",-64.82275,-21.86792,70,4,296,366,108,11,173,281
"Bolivia","Tarija","Avilés","Uriondo (Concepción)","COL. DELFIN PINO ICHAZU",-64.65437,-21.69452,359,20,1833,2192,1080,75,658,1738
"Bolivia","Tarija","Avilés","Uriondo (Concepción)","ESC. FELIPE ARAOZ",-64.79521,-21.81298,72,8,255,327,107,10,130,237
"Bolivia","Tarija","Avilés","Uriondo (Concepción)","ESC. MULLI CANCHA 27 DE MAYO",-64.75569,-21.66716,15,2,67,82,23,7,35,58
"Bolivia","Tarija","Avilés","Uriondo (Concepción)","ESC. NICOLAS GARECA",-64.73965,-21.68574,18,8,125,143,36,8,73,109
"Bolivia","Tarija","Avilés","Uriondo (Concepción)","ESC. WALTER MADALLENO",-64.87085,-21.83233,79,4,223,302,48,8,163,211
"Bolivia","Tarija","Avilés","Uriondo (Concepción)","U.E. 15 DE OCTUBRE",-64.87048,-21.78415,121,9,347,468,82,12,244,326
"Bolivia","Tarija","Avilés","Uriondo (Concepción)","U.E. 19 DE MARZO",-64.76694,-21.79675,44,4,203,247,73,7,119,192
"Bolivia","Tarija","Avilés","Uriondo (Concepción)","U.E. ANCON CHICO",-64.65513,-21.67163,37,5,295,332,106,4,180,286
"Bolivia","Tarija","Avilés","Uriondo (Concepción)","U.E. ANCON GRANDE",-64.65231,-21.62995,9,0,129,138,82,8,39,121
"Bolivia","Tarija","Avilés","Uriondo (Concepción)","U.E. ANICETO ARCE",-64.73565,-21.75162,181,22,870,1051,431,28,389,820
"Bolivia","Tarija","Avilés","Uriondo (Concepción)","U.E. LA CHOZA",-64.61714,-21.67806,85,13,590,675,323,32,222,545
"Bolivia","Tarija","Avilés","Uriondo (Concepción)","U.E. LA COMPAÑIA",-64.68107,-21.70434,37,7,329,366,106,14,202,308
"Bolivia","Tarija","Avilés","Uriondo (Concepción)","U.E. NUEVO AMANECER",-64.65608,-21.7632,178,17,888,1066,450,19,402,852
"Bolivia","Tarija","Avilés","Uriondo (Concepción)","U.E. ROSARIO JARAMILLO",-64.62204,-21.69797,261,40,1842,2103,823,84,895,1718
"Bolivia","Tarija","Avilés","Uriondo (Concepción)","U.E. VIRGEN DE LADERAS",-64.55874,-21.6606,27,4,166,193,45,9,108,153
"Bolivia","Tarija","Avilés","Yunchará","COL. 6 DE ABRIL",-65.22864,-21.82303,67,1,260,327,61,12,186,247
"Bolivia","Tarija","Avilés","Yunchará","U.E. 13 DE ABRIL",-65.09945,-21.99084,28,1,162,190,10,8,143,153
"Bolivia","Tarija","Avilés","Yunchará","U.E. 15 DE ABRIL",-65.32096,-21.76059,13,3,67,80,8,2,54,62
"Bolivia","Tarija","Avilés","Yunchará","U.E.  25 DE MAYO",-65.13538,-21.55874,39,2,194,233,26,7,159,185
"Bolivia","Tarija","Avilés","Yunchará","U.E. CHORCOYA AVILES",-65.05279,-21.65858,24,4,123,147,43,5,71,114
"Bolivia","Tarija","Avilés","Yunchará","U.E. FELIX RAMOS",-65.28792,-21.84653,23,0,54,77,7,2,45,52
"Bolivia","Tarija","Avilés","Yunchará","U.E. HUGO AMABLE HOYOS",-65.25793,-21.60342,8,1,45,53,3,0,41,44
"Bolivia","Tarija","Avilés","Yunchará","U.E. JOSE BALLIVIAN",-65.09161,-21.8291,90,10,208,298,44,6,148,192
"Bolivia","Tarija","Avilés","Yunchará","U.E. JOSE MARIA AVILES",-65.24372,-21.56001,18,1,99,117,15,7,76,91
"Bolivia","Tarija","Avilés","Yunchará","U.E. NARCISO CAMPERO",-65.32111,-21.81886,36,6,124,160,23,6,89,112
"Bolivia","Tarija","Avilés","Yunchará","U.E. ÑOQUERA",-65.13422,-21.62397,35,5,151,186,53,3,90,143
"Bolivia","Tarija","Avilés","Yunchará","U.E. PASAJES",-65.08871,-21.74598,48,5,272,320,50,10,207,257
"Bolivia","Tarija","Avilés","Yunchará","U.E. QUEBRADA HONDA",-65.15102,-21.95652,36,0,125,161,19,5,101,120
"Bolivia","Tarija","Avilés","Yunchará","U.E. SAN JOSE DE CHURQUIS",-65.23459,-21.72629,22,3,68,90,8,6,51,59
"Bolivia","Tarija","Avilés","Yunchará","U.E. SATURNINO URZAGASTE",-65.30037,-21.69103,18,0,123,141,15,0,108,123
"Bolivia","Tarija","Avilés","Yunchará","U.E. YUTICANCHA",-65.06479,-21.91516,4,2,91,95,13,5,71,84
"Bolivia","Tarija","Burnet O'Connor","Entre Ríos (La Moreta)","CENTRO P.A.N TENTAGUAZU",-63.96276,-21.11408,35,0,116,151,75,4,37,112
"Bolivia","Tarija","Burnet O'Connor","Entre Ríos (La Moreta)","U.E. 12 DE ABRIL",-63.78238,-21.41462,69,5,350,419,235,5,105,340
"Bolivia","Tarija","Burnet O'Connor","Entre Ríos (La Moreta)","U.E. CANALETAS CENTRO",-64.35432,-21.45255,32,2,134,166,33,7,92,125
"Bolivia","Tarija","Burnet O'Connor","Entre Ríos (La Moreta)","U.E. CHIQUIACA CENTRO",-64.12215,-21.86438,64,14,431,495,153,11,253,406
"Bolivia","Tarija","Burnet O'Connor","Entre Ríos (La Moreta)","U.E. CNL. EUSTAQUIO MENDEZ",-64.27944,-21.40812,43,6,346,389,94,14,232,326
"Bolivia","Tarija","Burnet O'Connor","Entre Ríos (La Moreta)","U.E. FRANZ TAMAYO",-64.17131,-21.52566,870,75,4070,4940,2194,116,1685,3879
"Bolivia","Tarija","Burnet O'Connor","Entre Ríos (La Moreta)","U.E. HUAICO ACERRADERO",-64.25552,-21.33019,53,4,244,297,90,12,138,228
"Bolivia","Tarija","Burnet O'Connor","Entre Ríos (La Moreta)","U.E. JUAN SAAVEDRA MEALLA",-64.23573,-21.79252,62,5,262,324,119,11,127,246
"Bolivia","Tarija","Burnet O'Connor","Entre Ríos (La Moreta)","U.E. LAGUNITAS",-63.89547,-21.41483,42,2,101,143,61,5,33,94
"Bolivia","Tarija","Burnet O'Connor","Entre Ríos (La Moreta)","U.E. LUIS VACA GALLARDO",-64.1218,-21.31882,47,5,176,223,98,7,66,164
"Bolivia","Tarija","Burnet O'Connor","Entre Ríos (La Moreta)","U.E. MISTOLAR",-63.78576,-21.17984,80,1,146,226,86,4,55,141
"Bolivia","Tarija","Burnet O'Connor","Entre Ríos (La Moreta)","U.E. ÑAURENDA",-64.05932,-21.1314,58,4,265,323,100,9,152,252
"Bolivia","Tarija","Burnet O'Connor","Entre Ríos (La Moreta)","U.E. PAJONAL",-64.16981,-21.48504,34,4,161,195,74,3,80,154
"Bolivia","Tarija","Burnet O'Connor","Entre Ríos (La Moreta)","U.E. PAMPA REDONDA",-64.17494,-21.997,16,0,118,134,23,3,92,115
"Bolivia","Tarija","Burnet O'Connor","Entre Ríos (La Moreta)","U.E. POTRERILLOS (O CONNOR)",-64.10823,-21.2234,45,13,250,295,105,3,129,234
"Bolivia","Tarija","Burnet O'Connor","Entre Ríos (La Moreta)","U.E. PROF. EMILIANO VILLARRUBIA",-63.98725,-21.52296,44,2,226,270,114,6,104,218
"Bolivia","Tarija","Burnet O'Connor","Entre Ríos (La Moreta)","U.E. PROFESOR RENE AVILA BAYON",-64.23028,-21.20329,141,13,504,645,179,21,291,470
"Bolivia","Tarija","Burnet O'Connor","Entre Ríos (La Moreta)","U.E. PUESTO MARGARITA",-63.79027,-21.1828,27,3,108,135,65,4,36,101
"Bolivia","Tarija","Burnet O'Connor","Entre Ríos (La Moreta)","U.E. REMIGIO VACA",-64.14987,-21.6035,31,2,118,149,60,23,33,93
"Bolivia","Tarija","Burnet O'Connor","Entre Ríos (La Moreta)","U.E. SAN DIEGO CENTRO",-64.18287,-21.42213,69,6,263,332,70,4,183,253
"Bolivia","Tarija","Burnet O'Connor","Entre Ríos (La Moreta)","U.E. SAN SIMON",-64.12061,-21.44145,20,7,123,143,56,1,59,115
"Bolivia","Tarija","Burnet O'Connor","Entre Ríos (La Moreta)","U.E. SECCIONAL BERETY",-64.03776,-21.44295,24,1,127,151,60,3,63,123
"Bolivia","Tarija","Burnet O'Connor","Entre Ríos (La Moreta)","U.E. SECCIONAL CAÑADAS",-63.97494,-21.41901,11,1,25,36,15,0,9,24
"Bolivia","Tarija","Burnet O'Connor","Entre Ríos (La Moreta)","U.E. SIVINGAL",-64.20417,-21.33499,30,3,188,218,23,8,154,177
"Bolivia","Tarija","Burnet O'Connor","Entre Ríos (La Moreta)","U.E. TAQUILLOS",-64.11756,-21.39566,15,3,75,90,18,2,52,70
"Bolivia","Tarija","Burnet O'Connor","Entre Ríos (La Moreta)","U.E. TARUPAYO",-63.95544,-21.32335,52,0,129,181,63,5,61,124
"Bolivia","Tarija","Burnet O'Connor","Entre Ríos (La Moreta)","U.E. TENTAPIAO",-63.91972,-21.15654,27,1,72,99,53,2,16,69
"Bolivia","Tarija","Burnet O'Connor","Entre Ríos (La Moreta)","U.E. TIMBOY",-64.06391,-21.16788,106,7,357,463,203,16,131,334
"Bolivia","Tarija","Burnet O'Connor","Entre Ríos (La Moreta)","U.E. TTE. GUALBERTO VILLARROEL",-64.20447,-21.69906,54,3,223,277,80,10,130,210
"Bolivia","Tarija","Burnet O'Connor","Entre Ríos (La Moreta)","U.E. VALLECITO DE LOS LAPACHOS",-64.05889,-21.7324,25,8,157,182,91,6,52,143
"Bolivia","Tarija","Burnet O'Connor","Entre Ríos (La Moreta)","U.E. YUKIMBIA",-63.97997,-21.04885,21,0,128,149,17,3,108,125
"Bolivia","Tarija","Cercado","Tarija","ALDEAS S.O.S ALTO SENAC",-64.76811,-21.53532,133,11,842,975,603,19,209,812
"Bolivia","Tarija","Cercado","Tarija","(CÁRCEL) PENAL DE MORROS BLANCOS",-64.70137,-21.54816,38,3,153,191,66,5,79,145
"Bolivia","Tarija","Cercado","Tarija","C.E.B.A.",-64.74647,-21.51721,571,37,2861,3432,1716,96,1012,2728
"Bolivia","Tarija","Cercado","Tarija","LOCAL PALO SANTO",-64.74363,-21.53167,342,12,1738,2080,1148,35,543,1691
"Bolivia","Tarija","Cercado","Tarija","SALON CAPACITACION BARRIO CATEDRAL",-64.76089,-21.54589,107,8,696,803,472,9,207,679
"Bolivia","Tarija","Cercado","Tarija","U.A.J.M.S CAMPUS",-64.72205,-21.54214,396,6,2039,2435,1603,47,383,1986
"Bolivia","Tarija","Cercado","Tarija","U.E. 15 DE ABRIL",-64.70269,-21.39775,49,7,209,258,155,5,42,197
"Bolivia","Tarija","Cercado","Tarija","U.E. 6 DE JUNIO",-64.73151,-21.56649,168,11,904,1072,604,25,264,868
"Bolivia","Tarija","Cercado","Tarija","U.E. ALTO DE ESPAÑA NORTE",-64.44588,-21.33693,58,9,212,270,63,34,106,169
"Bolivia","Tarija","Cercado","Tarija","U.E. AUDELIO QUIFRE",-64.53367,-21.61713,53,4,178,231,57,7,110,167
"Bolivia","Tarija","Cercado","Tarija","U.E. AVELINA RAÑA",-64.73672,-21.52712,614,26,3520,4134,2628,50,816,3444
"Bolivia","Tarija","Cercado","Tarija","U.E. BANCARIO",-64.73233,-21.54881,86,4,639,725,518,7,110,628
"Bolivia","Tarija","Cercado","Tarija","U.E. BELGRANO",-64.72131,-21.53838,965,25,5409,6374,4355,105,924,5279
"Bolivia","Tarija","Cercado","Tarija","U.E. BELLA VISTA",-64.84763,-21.65682,124,17,444,568,153,27,247,400
"Bolivia","Tarija","Cercado","Tarija","U.E. BOLIVIA",-64.7492,-21.54095,581,18,4290,4871,3316,114,842,4158
"Bolivia","Tarija","Cercado","Tarija","U.E. CARLAZO CENTRO",-64.48372,-21.48354,34,4,140,174,67,6,63,130
"Bolivia","Tarija","Cercado","Tarija","U.E. CARMEN ECHAZU",-64.72836,-21.53263,223,7,1348,1571,1121,17,203,1324
"Bolivia","Tarija","Cercado","Tarija","U.E. CASTELFORT CASTELLANOS",-64.70528,-21.54581,639,22,4069,4708,3124,110,813,3937
"Bolivia","Tarija","Cercado","Tarija","U.E. CHURQUIS",-64.78795,-21.66093,82,13,263,345,95,19,136,231
"Bolivia","Tarija","Cercado","Tarija","U.E. EL PORTILLO",-64.65661,-21.56547,204,13,1138,1342,681,39,405,1086
"Bolivia","Tarija","Cercado","Tarija","U.E. ESTEBAN MIGLIACI",-64.71228,-21.53156,800,38,5623,6423,4074,138,1373,5447
"Bolivia","Tarija","Cercado","Tarija","U.E. EULOGIO RUIZ",-64.7403,-21.51833,764,39,3787,4551,2177,103,1468,3645
"Bolivia","Tarija","Cercado","Tarija","U.E. FE Y ALEGRIA",-64.73994,-21.52347,933,40,4992,5925,3342,135,1475,4817
"Bolivia","Tarija","Cercado","Tarija","U.E. GAMONEDA",-64.62419,-21.49576,24,5,176,200,69,10,92,161
"Bolivia","Tarija","Cercado","Tarija","U.E. HERMANN GMEINER",-64.73551,-21.50994,1019,72,5020,6039,2440,227,2281,4721
"Bolivia","Tarija","Cercado","Tarija","U.E. IGNACIA NAZARIA MARCH",-64.75533,-21.50238,406,37,3082,3488,1585,128,1332,2917
"Bolivia","Tarija","Cercado","Tarija","U.E. J. NAVAL MONZON",-64.76114,-21.53481,406,33,2559,2965,1560,71,895,2455
"Bolivia","Tarija","Cercado","Tarija","U.E. JOSE MANUEL AVILA",-64.72959,-21.52524,1334,41,7435,8769,5604,189,1601,7205
"Bolivia","Tarija","Cercado","Tarija","U.E. JUANA AZURDUY DE PADILLA",-64.7084,-21.54054,372,5,2667,3039,2048,73,541,2589
"Bolivia","Tarija","Cercado","Tarija","U.E. JUAN PABLO II",-64.7523,-21.53608,542,40,3599,4141,2092,185,1282,3374
"Bolivia","Tarija","Cercado","Tarija","U.E. JUAN XXIII",-64.71565,-21.53829,604,19,3610,4214,2932,81,578,3510
"Bolivia","Tarija","Cercado","Tarija","U.E. JULIO CALVO",-64.72686,-21.51741,1247,70,7131,8378,3926,272,2863,6789
"Bolivia","Tarija","Cercado","Tarija","U.E. JUNACAS SUD",-64.46302,-21.43147,40,9,223,263,71,16,127,198
"Bolivia","Tarija","Cercado","Tarija","U.E. LA PAZ",-64.71841,-21.52833,663,36,3836,4499,2671,143,986,3657
"Bolivia","Tarija","Cercado","Tarija","U.E. LA PINTADA",-64.64189,-21.60837,106,19,823,929,502,18,284,786
"Bolivia","Tarija","Cercado","Tarija","U.E. LICEO CAMPERO",-64.73161,-21.53495,213,4,1162,1375,981,11,166,1147
"Bolivia","Tarija","Cercado","Tarija","U.E. LOS CALLEJONES",-64.73492,-21.54672,151,13,922,1073,666,27,216,882
"Bolivia","Tarija","Cercado","Tarija","U.E. LUIS DE FUENTES",-64.82387,-21.70473,178,6,323,501,173,6,138,311
"Bolivia","Tarija","Cercado","Tarija","U.E. MARIA LAURA JUSTINIANO",-64.72923,-21.53517,334,7,2046,2380,1770,27,242,2012
"Bolivia","Tarija","Cercado","Tarija","U.E. MONS ABEL COSTAS",-64.71011,-21.52861,304,28,2615,2919,1621,107,859,2480
"Bolivia","Tarija","Cercado","Tarija","U.E. MONTE CERCADO",-64.6991,-21.43521,25,3,145,170,109,8,25,134
"Bolivia","Tarija","Cercado","Tarija","U.E. NACIONAL SAN LUIS",-64.73555,-21.53229,326,7,1721,2047,1459,27,228,1687
"Bolivia","Tarija","Cercado","Tarija","U.E. NARCISO CAMPERO",-64.73502,-21.53197,210,4,1059,1269,898,14,143,1041
"Bolivia","Tarija","Cercado","Tarija","U.E. NUESTRA SEÑORA DEL ROSARIO",-64.73557,-21.52024,401,16,1990,2391,1276,72,626,1902
"Bolivia","Tarija","Cercado","Tarija","U.E. OCTAVIO CAMPERO ECHAZU",-64.72095,-21.52139,969,50,5770,6739,3400,197,2123,5523
"Bolivia","Tarija","Cercado","Tarija","U.E. OSCAR ZAMORA",-64.77103,-21.62803,184,12,596,780,237,49,298,535
"Bolivia","Tarija","Cercado","Tarija","U.E. PAPACHACRA",-64.40735,-21.48955,46,7,152,198,39,12,94,133
"Bolivia","Tarija","Cercado","Tarija","U.E. PINOS SUD",-64.87549,-21.73471,110,10,328,438,73,19,226,299
"Bolivia","Tarija","Cercado","Tarija","U.E.ROSA ARCE",-64.73045,-21.53088,344,12,2149,2493,1788,41,308,2096
"Bolivia","Tarija","Cercado","Tarija","U.E. SAN AGUSTIN SUD",-64.5279,-21.55583,56,1,136,192,70,6,59,129
"Bolivia","Tarija","Cercado","Tarija","U.E. SAN ANDRES",-64.81682,-21.62062,273,22,1369,1642,580,61,706,1286
"Bolivia","Tarija","Cercado","Tarija","U.E. SAN BLAS",-64.71835,-21.56428,84,8,466,550,313,8,137,450
"Bolivia","Tarija","Cercado","Tarija","U.E. SAN FRANCISCO DE ASIS",-64.7686,-21.51214,37,7,307,344,190,9,101,291
"Bolivia","Tarija","Cercado","Tarija","U.E. SAN GERONIMO",-64.71439,-21.54964,1257,22,3256,4513,2473,73,688,3161
"Bolivia","Tarija","Cercado","Tarija","U.E. SAN JACINTO SUD",-64.72188,-21.61152,63,8,325,388,138,16,163,301
"Bolivia","Tarija","Cercado","Tarija","U.E. SAN JORGE",-64.69663,-21.55364,693,30,3914,4607,2790,120,974,3764
"Bolivia","Tarija","Cercado","Tarija","U.E. SAN LAZARO DE GUERRA HUAYCO",-64.81322,-21.59201,385,34,1176,1561,414,45,683,1097
"Bolivia","Tarija","Cercado","Tarija","U.E. SAN LUIS",-64.69969,-21.56867,265,18,1518,1783,1013,55,432,1445
"Bolivia","Tarija","Cercado","Tarija","U.E. SAN MATEO",-64.75101,-21.48644,207,20,1239,1446,713,42,464,1177
"Bolivia","Tarija","Cercado","Tarija","U.E. SAN ROQUE",-64.73508,-21.52923,465,6,2503,2968,2108,32,357,2465
"Bolivia","Tarija","Cercado","Tarija","U.E. SANTA ANA LA NUEVA",-64.57794,-21.5435,80,12,467,547,250,5,200,450
"Bolivia","Tarija","Cercado","Tarija","U.E. SELLA QUEBRADA",-64.66478,-21.38699,86,21,257,343,112,18,106,218
"Bolivia","Tarija","Cercado","Tarija","U.E. TARIJA",-64.74217,-21.51051,455,25,2446,2901,1404,85,932,2336
"Bolivia","Tarija","Cercado","Tarija","U.E. TERESA DE CALCUTA",-64.74924,-21.53217,284,25,2053,2337,1317,79,632,1949
"Bolivia","Tarija","Cercado","Tarija","U.E. TOLOMOSITA",-64.75163,-21.6041,41,15,259,300,101,18,125,226
"Bolivia","Tarija","Cercado","Tarija","U.E. TORRECILLAS",-64.67634,-21.55232,205,19,1434,1639,862,61,492,1354
"Bolivia","Tarija","Cercado","Tarija","U.E. YESERA CENTRO",-64.5505,-21.41345,36,6,220,256,102,6,106,208
"Bolivia","Tarija","Cercado","Tarija","U.E. YESERA NORTE",-64.54983,-21.37354,59,11,251,310,111,17,112,223
"Bolivia","Tarija","Cercado","Tarija","U.E. YESERA SUD",-64.56313,-21.46948,55,5,255,310,165,15,70,235
"Bolivia","Tarija","Gran Chaco","Caraparí","POSTA SANITARIA KEREIMBA RENDA (INDIGENA)",-64.10361,-22.10099,0,0,23,23,0,0,23,23
"Bolivia","Tarija","Gran Chaco","Caraparí","U.E. 15 DE ABRIL",-63.76043,-21.74331,25,5,180,205,77,2,96,173
"Bolivia","Tarija","Gran Chaco","Caraparí","U.E. 17 DE AGOSTO",-63.92107,-21.94912,20,1,72,92,16,2,53,69
"Bolivia","Tarija","Gran Chaco","Caraparí","U.E. 2 DE AGOSTO",-63.99053,-22.09679,60,4,224,284,32,5,183,215
"Bolivia","Tarija","Gran Chaco","Caraparí","U.E. 3 DE MAYO",-63.73976,-21.82526,723,46,3404,4127,1593,70,1695,3288
"Bolivia","Tarija","Gran Chaco","Caraparí","U.E. 6 DE AGOSTO",-63.72484,-21.77807,29,8,236,265,80,9,139,219
"Bolivia","Tarija","Gran Chaco","Caraparí","U.E. BERETY CHACO",-63.69269,-21.58313,43,3,221,264,65,5,148,213
"Bolivia","Tarija","Gran Chaco","Caraparí","U.E. BOLIVIA",-63.93956,-21.80327,10,0,168,178,82,2,84,166
"Bolivia","Tarija","Gran Chaco","Caraparí","U.E. BOLIVIA DE CARAPARI",-63.77484,-21.93113,0,8,103,103,46,3,46,92
"Bolivia","Tarija","Gran Chaco","Caraparí","U.E. CAMPO LARGO HITO 22",-63.95479,-22.02285,30,2,132,162,33,2,95,128
"Bolivia","Tarija","Gran Chaco","Caraparí","U.E. CAÑITAS",-63.90673,-21.88649,3,1,74,77,21,1,51,72
"Bolivia","Tarija","Gran Chaco","Caraparí","U.E. CELSO RAFFAELLI",-63.77841,-21.8849,136,6,508,644,246,11,245,491
"Bolivia","Tarija","Gran Chaco","Caraparí","U.E. EUSTAQUIO MENDEZ/FRAY QUEBRACHO",-63.88299,-21.70185,84,8,516,600,240,10,258,498
"Bolivia","Tarija","Gran Chaco","Caraparí","U.E. FRAY QUEBRACHO",-63.72994,-21.69252,109,7,413,522,185,13,208,393
"Bolivia","Tarija","Gran Chaco","Caraparí","U.E. JULIO RAMOS VALDEZ",-63.87885,-21.81146,79,5,361,440,142,10,204,346
"Bolivia","Tarija","Gran Chaco","Caraparí","U.E. LIDIA GALARZA",-63.72426,-21.68103,141,12,631,772,234,25,360,594
"Bolivia","Tarija","Gran Chaco","Caraparí","U.E. SAN ALBERTO",-63.80844,-21.91013,108,13,522,630,210,20,279,489
"Bolivia","Tarija","Gran Chaco","Caraparí","U.E. SAN JUAN",-63.84999,-21.98089,0,0,31,31,11,1,19,30
"Bolivia","Tarija","Gran Chaco","Caraparí","U.E. SAN NICOLAS",-64.10381,-22.10169,2,3,52,54,13,2,34,47
"Bolivia","Tarija","Gran Chaco","Caraparí","U.E. ZAPATERA NORTE",-63.82479,-21.55252,61,5,285,346,111,5,164,275
"Bolivia","Tarija","Gran Chaco","Villamontes","CASA DEL NOTARIO",-62.86723,-21.80463,14,0,30,44,10,0,20,30
"Bolivia","Tarija","Gran Chaco","Villamontes","CENTRO COMUNAL",-63.45503,-21.54227,84,7,297,381,88,10,192,280
"Bolivia","Tarija","Gran Chaco","Villamontes","KINDER COLORADOS DE BOLIVIA",-63.44756,-21.25988,136,7,521,657,246,10,258,504
"Bolivia","Tarija","Gran Chaco","Villamontes","SEDE SOCIAL DE LA COMUNIDAD",-63.15966,-21.41535,15,0,41,56,25,0,16,41
"Bolivia","Tarija","Gran Chaco","Villamontes","U.E. 27 DE MAYO",-63.39827,-21.13041,48,9,345,393,130,3,203,333
"Bolivia","Tarija","Gran Chaco","Villamontes","U.E. 27 DE MAYO",-63.36565,-21.1518,48,9,345,393,130,3,203,333
"Bolivia","Tarija","Gran Chaco","Villamontes","U.E. ADELA HOYOS",-63.46374,-21.26653,568,12,2111,2679,1303,35,761,2064
"Bolivia","Tarija","Gran Chaco","Villamontes","U.E. AGUARAGÜE",-63.57405,-21.22751,44,2,147,191,81,7,57,138
"Bolivia","Tarija","Gran Chaco","Villamontes","U.E. ALGARROBAL",-63.30728,-21.38963,27,1,123,150,14,3,105,119
"Bolivia","Tarija","Gran Chaco","Villamontes","U.E.ANTONIO JOSE DE SUCRE",-63.41752,-21.06529,31,3,170,201,67,10,90,157
"Bolivia","Tarija","Gran Chaco","Villamontes","U.E. ASAMBLEA DE DIOS",-63.46189,-21.27044,742,53,3006,3748,1552,71,1330,2882
"Bolivia","Tarija","Gran Chaco","Villamontes","U.E. CABO JUAN",-63.42142,-21.16265,95,12,497,592,222,10,253,475
"Bolivia","Tarija","Gran Chaco","Villamontes","U.E. CAPIRENDA",-63.00224,-21.09902,14,0,30,44,25,0,5,30
"Bolivia","Tarija","Gran Chaco","Villamontes","U.E. CAPIRENDITA",-63.43694,-21.29784,337,12,589,926,81,72,424,505
"Bolivia","Tarija","Gran Chaco","Villamontes","U.E. CENTRAL CUTAIQUI",-62.83306,-21.892,11,0,49,60,18,0,31,49
"Bolivia","Tarija","Gran Chaco","Villamontes","U.E. CHACO BOREAL",-62.62968,-21.56227,2,1,13,15,3,0,9,12
"Bolivia","Tarija","Gran Chaco","Villamontes","U.E. CHIMEO",-63.44035,-21.18806,19,4,249,268,68,5,172,240
"Bolivia","Tarija","Gran Chaco","Villamontes","U.E. COLORADOS DE BOLIVIA",-63.44739,-21.26013,825,44,3487,4312,1600,147,1696,3296
"Bolivia","Tarija","Gran Chaco","Villamontes","U.E. IBIBOBO",-62.99517,-21.5432,198,2,133,331,62,1,68,130
"Bolivia","Tarija","Gran Chaco","Villamontes","U.E. IBOPEITI",-63.3834,-21.29926,34,2,197,231,43,2,150,193
"Bolivia","Tarija","Gran Chaco","Villamontes","U.E. ISMAEL MONTES",-63.47746,-21.25815,512,24,2204,2716,1419,47,714,2133
"Bolivia","Tarija","Gran Chaco","Villamontes","U.E. JUANA AZURDUY DE PADILLA (V.M.)",-63.46507,-21.25878,558,31,2820,3378,1845,58,886,2731
"Bolivia","Tarija","Gran Chaco","Villamontes","U.E.  JULIO CREVAUX",-63.47588,-21.26414,764,16,2612,3376,1752,60,784,2536
"Bolivia","Tarija","Gran Chaco","Villamontes","U.E. LA ESMERALDA",-62.65346,-22.22636,12,0,25,37,11,0,14,25
"Bolivia","Tarija","Gran Chaco","Villamontes","U.E. NUEVA ESPERANZA",-62.73864,-21.84503,13,0,48,61,16,3,29,45
"Bolivia","Tarija","Gran Chaco","Villamontes","U.E. REBECA AGUIRRE",-63.33084,-21.00389,173,12,610,783,301,16,281,582
"Bolivia","Tarija","Gran Chaco","Villamontes","U.E. RESISTENCIA",-63.113,-21.5044,0,32,154,154,20,4,98,118
"Bolivia","Tarija","Gran Chaco","Villamontes","U.E. SAN ANTONIO (VILLA MONTES)",-63.47097,-21.27801,150,9,776,926,419,15,333,752
"Bolivia","Tarija","Gran Chaco","Villamontes","U.E. SAN ISIDRO LA VICTORIA",-62.75867,-22.14704,23,1,45,68,35,0,9,44
"Bolivia","Tarija","Gran Chaco","Villamontes","U.E. TENIENTE VICTOR ZEBALLOS CLAROS",-63.42403,-21.09695,57,11,345,402,129,11,194,323
"Bolivia","Tarija","Gran Chaco","Yacuiba","(CÁRCEL) CARCELETA PUBLICA",-63.61958,-21.87883,26,0,76,102,29,2,45,74
"Bolivia","Tarija","Gran Chaco","Yacuiba","ESC. 2 DE AGOSTO",-63.6631,-21.98295,291,32,1763,2054,834,72,825,1659
"Bolivia","Tarija","Gran Chaco","Yacuiba","ESCUELA 27 DE MAYO",-63.63179,-21.86089,25,4,217,242,90,9,114,204
"Bolivia","Tarija","Gran Chaco","Yacuiba","U.E. 12 DE AGOSTO",-63.62997,-21.90739,175,13,808,983,318,45,432,750
"Bolivia","Tarija","Gran Chaco","Yacuiba","U.E. 21 DE SEPTIEMBRE",-63.38381,-21.8469,37,3,131,168,76,6,46,122
"Bolivia","Tarija","Gran Chaco","Yacuiba","U.E. 27 DE MAYO",-63.63601,-21.93299,313,13,1107,1420,402,30,662,1064
"Bolivia","Tarija","Gran Chaco","Yacuiba","U.E. 4 DE MAYO",-63.55672,-21.71432,144,28,822,966,246,27,521,767
"Bolivia","Tarija","Gran Chaco","Yacuiba","U.E. ALCIDES D`ORBIGNI",-62.8343,-21.99477,184,11,334,518,45,15,263,308
"Bolivia","Tarija","Gran Chaco","Yacuiba","U.E. CAMPO GRANDE (GRAN CHACO)",-63.6561,-21.95966,324,33,1779,2103,805,57,884,1689
"Bolivia","Tarija","Gran Chaco","Yacuiba","U.E. CAÑON OCULTO",-63.61351,-21.97809,38,7,220,258,71,6,136,207
"Bolivia","Tarija","Gran Chaco","Yacuiba","U.E. CLUB DE LEONES (BÁSICO Y MEDIO)",-63.6776,-22.00842,967,29,4201,5168,2720,104,1348,4068
"Bolivia","Tarija","Gran Chaco","Yacuiba","U.E. CREVAUX SUD",-62.93186,-21.81382,227,7,600,827,116,23,454,570
"Bolivia","Tarija","Gran Chaco","Yacuiba","U.E. FERROVIARIA",-63.6751,-22.01609,451,15,1736,2187,1017,39,665,1682
"Bolivia","Tarija","Gran Chaco","Yacuiba","U.E. GERMAN BUSCH",-63.68483,-22.02006,369,14,1322,1691,789,29,490,1279
"Bolivia","Tarija","Gran Chaco","Yacuiba","U.E. HEROES DE BOQUERON",-63.60726,-21.6859,292,6,502,794,242,25,229,471
"Bolivia","Tarija","Gran Chaco","Yacuiba","U.E. HEROES DEL CHACO",-63.68172,-22.05065,1086,37,2919,4005,1380,60,1442,2822
"Bolivia","Tarija","Gran Chaco","Yacuiba","U.E. JOSE MANUEL BELGRANO (YACUIBA)",-63.6762,-22.01613,713,18,3055,3768,1888,64,1085,2973
"Bolivia","Tarija","Gran Chaco","Yacuiba","U.E. JUANA AZURDUY DE PADILLA (YACUIBA)",-63.67266,-22.00477,864,40,3561,4425,2125,120,1276,3401
"Bolivia","Tarija","Gran Chaco","Yacuiba","U.E. LA PURISIMA",-62.99116,-21.62585,35,0,90,125,17,0,73,90
"Bolivia","Tarija","Gran Chaco","Yacuiba","U.E. LICEO GRAN CHACO",-63.67698,-22.01581,538,19,2359,2897,1600,47,693,2293
"Bolivia","Tarija","Gran Chaco","Yacuiba","U.E. MARISCAL SUCRE",-63.66786,-21.99878,193,9,806,999,434,17,346,780
"Bolivia","Tarija","Gran Chaco","Yacuiba","U.E. MIGUEL ESTENSORO",-63.68021,-22.01661,1277,31,4464,5741,2800,94,1539,4339
"Bolivia","Tarija","Gran Chaco","Yacuiba","U.E. NACIONAL MIXTO EL PALMAR",-63.61583,-21.88011,371,23,1426,1797,756,47,600,1356
"Bolivia","Tarija","Gran Chaco","Yacuiba","U.E. NESTOR PAZ GALARZA",-63.67497,-21.99887,587,19,2316,2903,1276,96,925,2201
"Bolivia","Tarija","Gran Chaco","Yacuiba","U.E. OLIVERIO PELICHELLI",-63.67335,-22.02432,251,15,1090,1341,568,26,481,1049
"Bolivia","Tarija","Gran Chaco","Yacuiba","U.E. PROF. BAUTISTA JURADO",-63.55737,-21.8007,183,23,797,980,323,17,434,757
"Bolivia","Tarija","Gran Chaco","Yacuiba","U.E. SACHAPERA",-63.55339,-21.66175,55,14,607,662,150,24,419,569
"Bolivia","Tarija","Gran Chaco","Yacuiba","U.E. SAN FRANCISCO DE INTI",-63.58647,-21.81835,55,10,394,449,133,12,239,372
"Bolivia","Tarija","Gran Chaco","Yacuiba","U.E. SIMON BOLIVAR",-63.6829,-22.0522,1095,94,3863,4958,1415,130,2224,3639
"Bolivia","Tarija","Gran Chaco","Yacuiba","U.E. SUNCHAL",-63.49324,-21.68086,35,2,95,130,44,1,48,92
"Bolivia","Tarija","Gran Chaco","Yacuiba","U.E. TIERRAS NUEVAS",-63.56289,-21.74935,124,15,653,777,131,35,472,603
"Bolivia","Tarija","Gran Chaco","Yacuiba","U.E. TIMBOY TIGUAZU",-63.57601,-21.55468,32,4,170,202,34,6,126,160
"Bolivia","Tarija","Gran Chaco","Yacuiba","U.E. VILLA EL CARMEN",-63.57232,-21.78605,185,28,1001,1186,310,45,618,928
"Bolivia","Tarija","Gran Chaco","Yacuiba","U.E. YACUIBA",-63.67945,-21.99672,784,52,3662,4446,1964,126,1520,3484
"Bolivia","Tarija","Méndez","Tomayapo (El Puente)","CENTRO COMUNAL",-65.21614,-21.31723,24,3,170,194,83,3,81,164
"Bolivia","Tarija","Méndez","Tomayapo (El Puente)","NUCLEO ANDRES ZAMORA",-65.23907,-21.43847,18,3,120,138,51,2,64,115
"Bolivia","Tarija","Méndez","Tomayapo (El Puente)","SEDE CLUB DE MADRES",-65.24256,-21.46749,15,0,53,68,19,6,28,47
"Bolivia","Tarija","Méndez","Tomayapo (El Puente)","SEDE COMUNAL",-64.96433,-21.23611,58,8,254,312,134,7,105,239
"Bolivia","Tarija","Méndez","Tomayapo (El Puente)","U.E. 1O. DE JULIO",-65.20398,-21.23499,166,13,751,917,347,21,370,717
"Bolivia","Tarija","Méndez","Tomayapo (El Puente)","U.E. CHINCHILLA",-65.14574,-21.19778,10,0,60,70,18,1,41,59
"Bolivia","Tarija","Méndez","Tomayapo (El Puente)","U.E. CHORCOYA MENDEZ",-65.01444,-21.56835,78,10,175,253,30,5,130,160
"Bolivia","Tarija","Méndez","Tomayapo (El Puente)","U.E. CUMBRE DE SAMA",-64.95296,-21.48289,57,12,236,293,62,10,152,214
"Bolivia","Tarija","Méndez","Tomayapo (El Puente)","U.E. EDUARDO ABAROA",-65.11504,-21.35772,3,1,70,73,17,2,50,67
"Bolivia","Tarija","Méndez","Tomayapo (El Puente)","U.E. EL MOLINO",-64.95007,-21.39787,80,8,282,362,70,18,186,256
"Bolivia","Tarija","Méndez","Tomayapo (El Puente)","U.E. FRANZ TAMAYO",-64.96854,-21.48615,285,44,1112,1397,392,78,598,990
"Bolivia","Tarija","Méndez","Tomayapo (El Puente)","U.E. GERALDINO GUERRERO",-64.95905,-21.14464,94,3,280,374,145,11,121,266
"Bolivia","Tarija","Méndez","Tomayapo (El Puente)","U.E. HUARMACHI",-65.06249,-21.44367,22,0,131,153,74,5,52,126
"Bolivia","Tarija","Méndez","Tomayapo (El Puente)","U.E. HUERTA HUAYCO",-64.94923,-21.11442,35,2,87,122,27,6,52,79
"Bolivia","Tarija","Méndez","Tomayapo (El Puente)","U.E. IRCALAYA",-65.20068,-21.19576,14,1,48,62,15,1,31,46
"Bolivia","Tarija","Méndez","Tomayapo (El Puente)","U.E. JESUS ZAMORA",-65.22533,-21.37169,33,4,145,178,83,2,56,139
"Bolivia","Tarija","Méndez","Tomayapo (El Puente)","U.E. LIC. SEGUNDINO UGARTE DURAN",-65.04431,-21.27013,39,2,153,192,98,5,48,146
"Bolivia","Tarija","Méndez","Tomayapo (El Puente)","U.E. MONTE GRANDE",-65.08482,-21.24768,33,2,113,146,76,3,32,108
"Bolivia","Tarija","Méndez","Tomayapo (El Puente)","U.E. OBISPO EL CARMEN",-65.03886,-21.30891,38,2,81,119,48,4,27,75
"Bolivia","Tarija","Méndez","Tomayapo (El Puente)","U.E. PUEBLO NUEVO",-64.98272,-21.53179,115,15,236,351,36,14,171,207
"Bolivia","Tarija","Méndez","Tomayapo (El Puente)","U.E. SAN ANTONIO DE CURQUI",-65.07034,-21.49188,36,4,196,232,99,5,88,187
"Bolivia","Tarija","Méndez","Tomayapo (El Puente)","U.E. SAN ANTONIO (MENDEZ)",-64.965,-21.44068,67,8,235,302,60,29,138,198
"Bolivia","Tarija","Méndez","Tomayapo (El Puente)","U.E. SANTA ROSA",-65.05383,-21.13585,40,1,58,98,1,1,55,56
"Bolivia","Tarija","Méndez","Tomayapo (El Puente)","U.E. VILLA NUEVA",-64.9509,-21.35972,39,1,122,161,43,10,68,111
"Bolivia","Tarija","Méndez","Villa San Lorenzo","PUESTO DE SALUD JARCAS",-64.50289,-21.28495,4,0,66,70,19,3,44,63
"Bolivia","Tarija","Méndez","Villa San Lorenzo","U.E. 15 DE ABRIL ERQUIS",-64.79546,-21.46687,110,15,734,844,409,48,262,671
"Bolivia","Tarija","Méndez","Villa San Lorenzo","U.E. 1O. DE MAYO",-64.57595,-21.03652,59,8,134,193,24,7,95,119
"Bolivia","Tarija","Méndez","Villa San Lorenzo","U.E. ALTO DE CAJAS",-64.47047,-21.30705,29,2,70,99,40,4,24,64
"Bolivia","Tarija","Méndez","Villa San Lorenzo","U.E. ANGEL CALABI PASOLINNI",-64.76366,-21.49823,258,18,1513,1771,907,47,541,1448
"Bolivia","Tarija","Méndez","Villa San Lorenzo","U.E. BORDO EL MOLLAR",-64.76112,-21.42673,66,9,403,469,226,23,145,371
"Bolivia","Tarija","Méndez","Villa San Lorenzo","U.E. CARACHIMAYO CENTRO",-64.72285,-21.35113,153,23,433,586,207,34,169,376
"Bolivia","Tarija","Méndez","Villa San Lorenzo","U.E. CHAUPICANCHA",-64.66171,-21.34586,33,6,56,89,18,3,29,47
"Bolivia","Tarija","Méndez","Villa San Lorenzo","U.E. COCHAS",-64.8509,-21.37324,10,4,71,81,17,3,47,64
"Bolivia","Tarija","Méndez","Villa San Lorenzo","U.E. COLORADO NORTE",-64.78835,-21.17892,62,0,124,186,7,8,109,116
"Bolivia","Tarija","Méndez","Villa San Lorenzo","U.E. EL PAJONAL",-64.52412,-21.20756,23,0,61,84,28,4,29,57
"Bolivia","Tarija","Méndez","Villa San Lorenzo","U.E. EL PUESTO",-64.52888,-21.28559,30,1,57,87,10,6,40,50
"Bolivia","Tarija","Méndez","Villa San Lorenzo","U.E. EUSTAQUIO MENDEZ",-64.75005,-21.41892,943,72,3042,3985,1845,129,996,2841
"Bolivia","Tarija","Méndez","Villa San Lorenzo","U.E. EUSTAQUIO MENDEZ",-64.67755,-21.04951,943,72,3042,3985,1845,129,996,2841
"Bolivia","Tarija","Méndez","Villa San Lorenzo","U.E. EUSTAQUIO MENDEZ",-64.76018,-21.34489,943,72,3042,3985,1845,129,996,2841
"Bolivia","Tarija","Méndez","Villa San Lorenzo","U.E. HUANCOIRO",-64.85504,-21.19721,13,1,68,81,31,4,32,63
"Bolivia","Tarija","Méndez","Villa San Lorenzo","U.E. JUAN MISAEL SARACHO",-64.7941,-21.49765,47,7,407,454,257,17,126,383
"Bolivia","Tarija","Méndez","Villa San Lorenzo","U.E. JULIO SUCRE SELLA MENDEZ",-64.69686,-21.38795,95,9,360,455,248,12,91,339
"Bolivia","Tarija","Méndez","Villa San Lorenzo","U.E. LEON CANCHA",-64.71355,-21.17894,128,13,219,347,62,12,132,194
"Bolivia","Tarija","Méndez","Villa San Lorenzo","U.E. MANDOR GRANDE",-64.74651,-21.06744,29,1,25,54,13,1,10,23
"Bolivia","Tarija","Méndez","Villa San Lorenzo","U.E. NESTOR PAZ ZAMORA",-64.75089,-21.38968,114,24,499,613,269,22,184,453
"Bolivia","Tarija","Méndez","Villa San Lorenzo","U.E. OSVALDO GALVEZ",-64.80488,-21.4087,136,24,514,650,241,15,234,475
"Bolivia","Tarija","Méndez","Villa San Lorenzo","U.E. PEÑADERIA",-64.49856,-21.2275,3,3,67,70,25,7,32,57
"Bolivia","Tarija","Méndez","Villa San Lorenzo","U.E. RANCHO SUD",-64.7542,-21.4619,69,4,455,524,331,9,111,442
"Bolivia","Tarija","Méndez","Villa San Lorenzo","U.E. SAN LORENCITO",-64.47129,-21.25033,14,1,71,85,6,7,57,63
"Bolivia","Tarija","Méndez","Villa San Lorenzo","U.E. SAN PEDRO DE LAS PEÑAS",-64.65049,-21.14055,37,2,49,86,17,1,29,46
"Bolivia","Tarija","Méndez","Villa San Lorenzo","U.E. SERAPIO MARTINEZ",-64.74917,-21.44493,121,11,876,997,602,23,240,842
"Bolivia","Tarija","Méndez","Villa San Lorenzo","U.E. SIMON BOLIVAR",-64.7877,-21.50771,97,14,791,888,565,31,181,746
"Bolivia","Tarija","Méndez","Villa San Lorenzo","U.E. TARIJA CANCHA SUD",-64.76456,-21.41479,88,9,532,620,331,16,176,507
"Bolivia","Tarija","Méndez","Villa San Lorenzo","U.E. TOMATAS GRANDE",-64.78188,-21.3224,101,10,429,530,235,21,163,398
"Bolivia","Tarija","Méndez","Villa San Lorenzo","U.E. TRANCAS",-64.8347,-21.30479,44,3,127,171,65,12,47,112
"Bolivia","Tarija","Méndez","Villa San Lorenzo","U.E. TUCUMILLAS",-64.83385,-21.45885,18,2,104,122,16,3,83,99
"Bolivia","Cochabamba","Cercado","Cochabamba","UNIVERSIDAD CATOLICA",-66.14394,-17.37205,863,26,5636,6499,4383,97,1130,5513
"Bolivia","Cochabamba","Cercado","Cochabamba","UNIVERSIDAD UCATEC (EX CEIVO)",-66.13677,-17.37113,253,8,2127,2380,1606,38,475,2081
"Bolivia","Cochabamba","Chapare","Colomi","NUCLEO ESCOLAR CANDELARIA",-65.92474,-17.27441,156,31,1832,1988,331,88,1382,1713
"Bolivia","Cochabamba","Chapare","Colomi","NUCLEO ESCOLAR TABLAS MONTE",-65.99883,-17.0847,83,16,568,651,48,10,494,542
"Bolivia","Cochabamba","Chapare","Colomi","U.E. ROSARIO",-65.88084,-17.3183,3,3,87,90,36,1,47,83
"Bolivia","Cochabamba","Chapare","Colomi","UNIDAD EDUCATIVA CORANI PAMPA",-65.93583,-17.13022,106,19,1142,1248,205,41,877,1082
"Bolivia","Cochabamba","Chapare","Colomi","UNIDAD EDUCATIVA EL PALMAR",-65.74912,-17.18198,45,4,260,305,55,5,196,251
"Bolivia","Cochabamba","Chapare","Colomi","UNIDAD EDUCATIVA PARACTI (COLOMI)",-65.82558,-17.20783,60,5,516,576,172,25,314,486
"Bolivia","Cochabamba","Chapare","Colomi","UNIDAD EDUCATIVA PUCA MAYU (COLOMI)",-65.90272,-17.01873,1,0,8,9,0,0,8,8
"Bolivia","Cochabamba","Chapare","Colomi","UNIDAD EDUCATIVA SAMUEL FINA SAVIO",-65.8636,-17.34076,914,144,5977,6891,1880,370,3583,5463
"Bolivia","Cochabamba","Chapare","Sacaba","(CÁRCEL) PENITENCIARIA EL ABRA",-66.11572,-17.40493,65,1,223,288,56,4,162,218
"Bolivia","Cochabamba","Chapare","Sacaba","(CÁRCEL) PENITENCIARIA SAN PEDRO (SACABA)",-66.0414,-17.40583,51,2,105,156,21,3,79,100
"Bolivia","Cochabamba","Chapare","Sacaba","COLEGIO BOLIVIANO JAPONES",-66.09353,-17.37924,1004,54,7211,8215,4531,203,2423,6954
"Bolivia","Cochabamba","Chapare","Sacaba","COLEGIO FRANZ TAMAYO (CHIÑATA)",-65.98093,-17.43051,525,41,3978,4503,1427,154,2356,3783
"Bolivia","Cochabamba","Chapare","Sacaba","COLEGIO NATANIEL AGUIRRE",-65.83003,-17.37266,148,8,1266,1414,208,52,998,1206
"Bolivia","Cochabamba","Chapare","Sacaba","COLEGIO PUERTO MEJILLONES",-66.1301,-17.37218,576,26,4465,5041,2823,87,1529,4352
"Bolivia","Cochabamba","Chapare","Sacaba","COLEGIO QUINTANILLA",-66.10987,-17.3848,1591,97,10227,11818,5854,343,3933,9787
"Bolivia","Cochabamba","Chapare","Sacaba","COLEGIO RENE FERNANDEZ BECERRA",-65.91483,-17.42616,124,13,1040,1164,158,16,853,1011
"Bolivia","Cochabamba","Chapare","Sacaba","COLEGIO SEÑOR DE MAYO",-66.11799,-17.37354,919,33,6076,6995,4052,119,1872,5924
"Bolivia","Cochabamba","Chapare","Sacaba","ESCUELA 6 DE JUNIO - TACOPOCA",-66.02658,-17.41193,437,63,3749,4186,1461,150,2075,3536
"Bolivia","Cochabamba","Chapare","Sacaba","ESCUELA CARLOS PEREDO SANDOVAL",-66.05909,-17.3939,1065,98,7387,8452,3470,306,3513,6983
"Bolivia","Cochabamba","Chapare","Sacaba","ESCUELA COPACABANA",-66.10087,-17.39216,460,36,3588,4048,2090,106,1356,3446
"Bolivia","Cochabamba","Chapare","Sacaba","ESCUELA GERMAN BUSCH",-66.0383,-17.40434,745,56,4774,5519,2474,200,2044,4518
"Bolivia","Cochabamba","Chapare","Sacaba","ESCUELA GUADALUPE",-66.07703,-17.38369,843,31,5983,6826,3471,189,2292,5763
"Bolivia","Cochabamba","Chapare","Sacaba","ESCUELA JESUS TERCEROS",-66.12031,-17.38594,438,6,3210,3648,2324,71,809,3133
"Bolivia","Cochabamba","Chapare","Sacaba","ESCUELA MAN CESPED",-66.03825,-17.40714,911,69,6361,7272,3261,258,2773,6034
"Bolivia","Cochabamba","Chapare","Sacaba","ESCUELA NATALIO ARAUCO",-66.04586,-17.40147,675,49,4489,5164,2353,148,1939,4292
"Bolivia","Cochabamba","Chapare","Sacaba","ESCUELA RENE BARRIENTOS ORTUÑO (UCUCHI)",-65.92544,-17.4195,90,8,574,664,139,19,408,547
"Bolivia","Cochabamba","Chapare","Sacaba","INSTITUTO TECNICO SACABA (ITSA)",-66.04596,-17.40543,16,2,126,142,58,5,61,119
"Bolivia","Cochabamba","Chapare","Sacaba","LICEO DE SEÑORITAS SACABA",-66.04489,-17.40398,928,66,6075,7003,3243,194,2572,5815
"Bolivia","Cochabamba","Chapare","Sacaba","U.E. MARCELO QUIROGA SANTA CRUZ (PACATA)",-66.1184,-17.3762,15,1,161,176,104,2,54,158
"Bolivia","Cochabamba","Chapare","Sacaba","U.E. NUEVO AMANECER",-66.03468,-17.45286,29,11,603,632,130,48,414,544
"Bolivia","Cochabamba","Chapare","Sacaba","U.E. TUTIMAYU",-65.95177,-17.41679,49,16,878,927,269,27,566,835
"Bolivia","Cochabamba","Chapare","Sacaba","UNIDAD EDUCATIVA 27 DE AGOSTO",-66.05526,-17.41448,17,4,390,407,115,11,260,375
"Bolivia","Cochabamba","Chapare","Sacaba","UNIDAD EDUCATIVA BOLIVIANO BRITÁNICO",-66.02322,-17.40267,395,42,3050,3445,1205,108,1695,2900
"Bolivia","Cochabamba","Chapare","Sacaba","UNIDAD EDUCATIVA CEILAB",-66.073,-17.38945,14,2,167,181,110,7,48,158
"Bolivia","Cochabamba","Chapare","Sacaba","UNIDAD EDUCATIVA DEL VALLE",-66.1094,-17.38272,203,13,1838,2041,1097,42,686,1783
"Bolivia","Cochabamba","Chapare","Sacaba","UNIDAD EDUCATIVA EDMUNDO BOJANOWSKI",-66.12388,-17.37073,35,1,397,432,249,9,138,387
"Bolivia","Cochabamba","Chapare","Sacaba","UNIDAD EDUCATIVA ENTRE RIOS",-66.06012,-17.40147,9,3,167,176,50,10,104,154
"Bolivia","Cochabamba","Chapare","Sacaba","UNIDAD EDUCATIVA HERNÁN RIVERO FIORILO",-66.07921,-17.40404,177,17,1925,2102,859,57,992,1851
"Bolivia","Cochabamba","Chapare","Sacaba","UNIDAD EDUCATIVA ISRAELÍ EL ABRA",-66.10103,-17.40372,627,66,5585,6212,2018,217,3284,5302
"Bolivia","Cochabamba","Chapare","Sacaba","UNIDAD EDUCATIVA KANATA",-66.10153,-17.38585,89,3,708,797,560,16,129,689
"Bolivia","Cochabamba","Chapare","Sacaba","UNIDAD EDUCATIVA LARATI",-66.01265,-17.34382,30,6,773,803,93,11,663,756
"Bolivia","Cochabamba","Chapare","Sacaba","UNIDAD EDUCATIVA PAMPILLA",-66.0752,-17.18917,195,49,2082,2277,498,128,1407,1905
"Bolivia","Cochabamba","Chapare","Sacaba","UNIDAD EDUCATIVA RENÉ BARRIENTOS ORTUÑO",-66.11898,-17.37671,135,5,1137,1272,714,27,391,1105
"Bolivia","Cochabamba","Chapare","Sacaba","UNIDAD EDUCATIVA REPUBLICA DE ITALIA",-66.04491,-17.40258,156,15,1465,1621,637,34,779,1416
"Bolivia","Cochabamba","Chapare","Sacaba","UNIDAD EDUCATIVA ULINCATE",-65.98841,-17.4069,109,14,1042,1151,384,40,604,988
"Bolivia","Cochabamba","Chapare","Sacaba","UNIDAD EDUCATIVA VILLA GRACIELA",-66.13087,-17.37237,288,15,2428,2716,1496,43,874,2370
"Bolivia","Cochabamba","Chapare","Villa Tunari","COLEGIO FE Y ALEGRIA",-65.40147,-16.91353,164,18,1661,1825,199,43,1401,1600
"Bolivia","Cochabamba","Chapare","Villa Tunari","COLEGIO FRANCISCO VIGNAUD",-65.42472,-16.97513,119,5,521,640,170,7,339,509
"Bolivia","Cochabamba","Chapare","Villa Tunari","COLEGIO MIXTO TECNICO HUM. VILLA BOLIVAR",-65.74024,-16.62949,54,6,496,550,40,6,444,484
"Bolivia","Cochabamba","Chapare","Villa Tunari","COLEGIO NUEVA TACOPAYA",-65.67545,-16.56796,102,7,1124,1226,117,33,967,1084
"Bolivia","Cochabamba","Chapare","Villa Tunari","ESCUELA 27 DE MAYO",-65.30819,-16.74821,115,13,533,648,90,25,405,495
"Bolivia","Cochabamba","Chapare","Villa Tunari","ESCUELA CRISTAL MAYU",-65.64395,-17.00619,193,18,1595,1788,138,31,1408,1546
"Bolivia","Cochabamba","Chapare","Villa Tunari","ESCUELA ELIZARDO PEREZ",-65.64406,-16.73144,242,25,1966,2208,236,45,1660,1896
"Bolivia","Cochabamba","Chapare","Villa Tunari","ESCUELA LA ESTRELLA",-65.49522,-16.72417,47,3,573,620,49,17,504,553
"Bolivia","Cochabamba","Chapare","Villa Tunari","ESCUELA LA ESTRELLA (SAN GABRIEL)",-65.62708,-16.6753,281,4,2075,2356,163,37,1871,2034
"Bolivia","Cochabamba","Chapare","Villa Tunari","ESCUELA SAMUZABETI",-65.57269,-16.81616,201,12,2121,2322,133,49,1927,2060
"Bolivia","Cochabamba","Chapare","Villa Tunari","ESCUELA SAN ANTONIO DE VILLA TUNARI",-65.4173,-16.97306,359,17,1849,2208,607,44,1181,1788
"Bolivia","Cochabamba","Chapare","Villa Tunari","ESCUELA SAN JOSE (V.TUNARI)",-65.46657,-16.81087,152,5,1283,1435,69,17,1192,1261
"Bolivia","Cochabamba","Chapare","Villa Tunari","ESCUELA VILLA 14 DE SEPTIEMBRE",-65.34883,-16.84459,677,73,4890,5567,597,121,4099,4696
"Bolivia","Cochabamba","Chapare","Villa Tunari","NUCLEO ESCOLAR NUEVA AROMA",-65.82585,-16.56242,86,14,917,1003,60,4,839,899
"Bolivia","Cochabamba","Chapare","Villa Tunari","U. E. INDEPENDENCIA (VILLA TUNARI)",-65.79965,-16.4638,88,14,975,1063,41,13,907,948
"Bolivia","Cochabamba","Chapare","Villa Tunari","U.E. SAN BENITO",-65.5032,-16.53337,18,2,56,74,5,1,48,53
"Bolivia","Cochabamba","Chapare","Villa Tunari","U. E. SANTA ROSA DE LA BOCA",-64.7546,-15.93035,28,0,25,53,24,0,1,25
"Bolivia","Cochabamba","Chapare","Villa Tunari","UNIDAD EDUCATIVA 1RO DE MAYO",-65.42921,-16.64719,50,2,591,641,52,16,521,573
"Bolivia","Cochabamba","Chapare","Villa Tunari","UNIDAD EDUCATIVA 27 DE MAYO",-65.46113,-17.0208,18,1,326,344,12,2,311,323
"Bolivia","Cochabamba","Chapare","Villa Tunari","UNIDAD EDUCATIVA JATUN PAMPA",-65.5677,-17.00337,115,14,1017,1132,160,28,815,975
"Bolivia","Cochabamba","Chapare","Villa Tunari","UNIDAD EDUCATIVA MIXTA ETERAZAMA",-65.52284,-16.83394,535,52,4318,4853,672,112,3482,4154
"Bolivia","Cochabamba","Chapare","Villa Tunari","UNIDAD EDUCATIVA MOLETO ICOYA (V.TUNARI)",-65.8701,-16.4744,43,6,645,688,25,14,600,625
"Bolivia","Cochabamba","Chapare","Villa Tunari","UNIDAD EDUCATIVA PARACTITO",-65.46431,-17.03166,228,19,1648,1876,289,54,1286,1575
"Bolivia","Cochabamba","Chapare","Villa Tunari","UNIDAD EDUCATIVA PARACTI (VILLA TUNARI)",-65.82552,-17.20792,65,6,326,391,46,7,267,313
"Bolivia","Cochabamba","Chapare","Villa Tunari","UNIDAD EDUCATIVA PARAISO-TODO SANTOS",-65.29498,-16.90554,149,20,1507,1656,182,41,1264,1446
"Bolivia","Cochabamba","Chapare","Villa Tunari","UNIDAD EDUCATIVA SAN FRANCISCO KM 21",-65.33453,-16.76798,31,7,603,634,32,15,549,581
"Bolivia","Cochabamba","Chapare","Villa Tunari","UNIDAD EDUCATIVA SAN JOSE DE ANGOSTA",-65.90482,-16.42696,75,5,207,282,20,20,162,182
"Bolivia","Cochabamba","Chapare","Villa Tunari","UNIDAD EDUCATIVA SIMON RODRIGUEZ (EX PUCA MAYU (V. TUNARI))",-65.90272,-17.01873,65,9,501,566,44,12,436,480
"Bolivia","Cochabamba","Chapare","Villa Tunari","UNIDAD EDUCATIVA TOCOPILLA",-65.26644,-16.81101,33,7,378,411,22,10,339,361
"Bolivia","Cochabamba","Chapare","Villa Tunari","UNIDAD EDUCATIVA UNCIA",-65.73511,-16.52453,42,10,573,615,26,18,519,545
"Bolivia","Cochabamba","Chapare","Villa Tunari","UNIDAD EDUCATIVA VILLA NUEVA",-65.33994,-16.65689,21,1,314,335,27,10,276,303
"Bolivia","Cochabamba","Esteban Arce","Anzaldo","ESC. ESTEBAN ANDIA ESCOBAR - PACCHA PATA",-65.94566,-17.70326,29,6,157,186,29,7,115,144
"Bolivia","Cochabamba","Esteban Arce","Anzaldo","NUCLEO EDUCATIVO LA VIÑA",-65.85647,-17.96978,46,4,194,240,42,6,142,184
"Bolivia","Cochabamba","Esteban Arce","Anzaldo","U. E. SAN JOSE DE CALAZANS-LITORAL",-65.93351,-17.78299,405,93,2084,2489,570,102,1319,1889
"Bolivia","Cochabamba","Esteban Arce","Anzaldo","UNIDAD EDUCATIVA ALFAMAYU",-65.93799,-17.86563,9,1,68,77,2,2,63,65
"Bolivia","Cochabamba","Esteban Arce","Anzaldo","UNIDAD EDUCATIVA ARTURO SARMIENTO",-65.94575,-17.90018,47,3,252,299,31,16,202,233
"Bolivia","Cochabamba","Esteban Arce","Anzaldo","UNIDAD EDUCATIVA THAGO KASA",-65.82888,-17.89126,13,2,120,133,11,2,105,116
"Bolivia","Cochabamba","Esteban Arce","Arbieto","CENTRO EDUCATIVO GERMAN BUSCH - ARBIETO",-66.01723,-17.58551,372,33,1648,2020,467,62,1086,1553
"Bolivia","Cochabamba","Esteban Arce","Arbieto","ESCUELA SECCIONAL ARPITA",-66.07514,-17.56822,196,20,1007,1203,160,39,788,948
"Bolivia","Cochabamba","Esteban Arce","Arbieto","UNIDAD EDUCATIVA 6 DE JUNIO - MAMANACA",-66.05242,-17.58441,131,13,547,678,138,17,379,517
"Bolivia","Cochabamba","Esteban Arce","Arbieto","UNIDAD EDUCATIVA ANTONIO ARNEZ -ARANJUEZ",-65.97636,-17.5959,56,4,340,396,101,10,225,326
"Bolivia","Cochabamba","Esteban Arce","Arbieto","UNIDAD EDUCATIVA CARLOS CANELAS",-66.09542,-17.49024,262,40,2833,3095,515,128,2150,2665
"Bolivia","Cochabamba","Esteban Arce","Arbieto","UNIDAD ESCOLAR CASIMIRO LOPEZ T.",-66.08762,-17.51215,66,7,354,420,128,6,213,341
"Bolivia","Cochabamba","Esteban Arce","Sacabamba","ESCUELA ELISEO TORRICO - SACABAMBA",-65.77574,-17.81699,112,22,664,776,176,37,429,605
"Bolivia","Cochabamba","Esteban Arce","Sacabamba","ESCUELA SECCIONAL CHALLAQUE",-65.75699,-17.83179,32,5,228,260,57,14,152,209
"Bolivia","Cochabamba","Esteban Arce","Sacabamba","NUCLEO ESCOLAR QUEKOMA",-65.8235,-17.70307,46,10,263,309,22,8,223,245
"Bolivia","Cochabamba","Esteban Arce","Sacabamba","NUCLEO MATARANI",-65.80145,-17.80308,97,12,592,689,103,24,453,556
"Bolivia","Cochabamba","Esteban Arce","Sacabamba","UNIDAD EDUCATIVA APILLAPA",-65.85152,-17.76226,12,3,172,184,20,6,143,163
"Bolivia","Cochabamba","Esteban Arce","Tarata","COLEGIO MY. VICTOR USTARIZ",-66.02438,-17.60891,498,23,1636,2134,548,58,1007,1555
"Bolivia","Cochabamba","Esteban Arce","Tarata","ESCUELA ESTEBAN ARZE",-66.02402,-17.61324,206,25,1195,1401,327,46,797,1124
"Bolivia","Cochabamba","Esteban Arce","Tarata","ESCUELA LUIS TERRAZAS",-66.07424,-17.75421,36,3,182,218,7,6,166,173
"Bolivia","Cochabamba","Esteban Arce","Tarata","ESCUELA RENE BARRIENTOS O.",-66.02374,-17.61071,322,22,1254,1576,383,37,812,1195
"Bolivia","Cochabamba","Esteban Arce","Tarata","UNIDAD EDUCATIVA HUASA RANCHO",-65.96735,-17.61409,31,6,141,172,38,3,94,132
"Bolivia","Cochabamba","Esteban Arce","Tarata","UNIDAD EDUCATIVA HUAYCULI",-65.97934,-17.6437,87,8,537,624,59,14,456,515
"Bolivia","Cochabamba","Esteban Arce","Tarata","UNIDAD EDUCATIVA HUERTA MAYU",-66.11383,-17.63796,42,3,351,393,8,6,334,342
"Bolivia","Cochabamba","Germán Jordán","Cliza","COLEGIO JUAN DE DIOS BALDERRAMA",-65.93368,-17.59121,762,62,4482,5244,1702,131,2587,4289
"Bolivia","Cochabamba","Germán Jordán","Cliza","COLEGIO NACIONAL MIXTO UCUREÑA",-65.90669,-17.58086,264,29,2045,2309,630,42,1344,1974
"Bolivia","Cochabamba","Germán Jordán","Cliza","ESCUELA SUCRE",-65.9311,-17.59395,819,45,3548,4367,1273,112,2118,3391
"Bolivia","Cochabamba","Germán Jordán","Cliza","UNIDAD EDUCATIVA CHULLPAS",-65.94772,-17.60734,134,11,628,762,146,27,444,590
"Bolivia","Cochabamba","Germán Jordán","Cliza","UNIDAD EDUCATIVA HUASACALLE",-65.90952,-17.5931,75,13,537,612,151,11,362,513
"Bolivia","Cochabamba","Germán Jordán","Cliza","UNIDAD EDUCATIVA SANTA LUCIA",-65.9581,-17.58606,94,7,409,503,126,18,258,384
"Bolivia","Cochabamba","Germán Jordán","Toko","COLEGIO AMBROSINI",-65.92783,-17.62949,517,52,2421,2938,476,65,1828,2304
"Bolivia","Cochabamba","Germán Jordán","Toko","UNIDAD EDUCATIVA SICHES",-65.94588,-17.66759,37,8,206,243,29,8,161,190
"Bolivia","Cochabamba","Germán Jordán","Tolata","COLEGIO VICTOR ROSALES",-65.96407,-17.53315,426,35,1615,2041,526,66,988,1514
"Bolivia","Cochabamba","Germán Jordán","Tolata","ESCUELA SAN ISIDRO",-65.97154,-17.56319,110,14,348,458,82,14,238,320
"Bolivia","Cochabamba","Germán Jordán","Tolata","ESCUELA SANTA MARIA (CARCAJE)",-66.0082,-17.54546,427,25,1648,2075,692,64,867,1559
"Bolivia","Cochabamba","Mizque","Alalay","ESCUELA DR. DEMETRIO CANELAS",-65.60884,-17.76655,47,10,382,429,88,14,270,358
"Bolivia","Cochabamba","Mizque","Alalay","U. E. ABRAHAM FLORES VELASQUEZ",-65.69196,-17.72072,73,4,334,407,30,7,293,323
"Bolivia","Cochabamba","Mizque","Alalay","UNIDAD EDUCATIVA QUTURI",-65.5355,-17.7629,26,6,185,211,18,4,157,175
"Bolivia","Cochabamba","Mizque","Alalay","UNIDAD EDUCATIVA YANA KHAKHA",-65.60854,-17.85578,52,1,207,259,11,6,189,200
"Bolivia","Cochabamba","Mizque","Mizque","COLEGIO PEDRO IGNACIO RIVERO",-65.35332,-17.94529,629,74,4377,5006,1495,205,2603,4098
"Bolivia","Cochabamba","Mizque","Mizque","ESCUELA AGUADA",-65.30665,-18.00293,124,14,586,710,74,22,476,550
"Bolivia","Cochabamba","Mizque","Mizque","ESCUELA GUILLERMO VISCARRA",-65.30976,-17.91031,74,6,511,585,41,13,451,492
"Bolivia","Cochabamba","Mizque","Mizque","ESCUELA MIXTA DR. MARTIN CARDENAS",-65.54247,-18.22179,134,26,854,988,239,43,546,785
"Bolivia","Cochabamba","Mizque","Mizque","NUCLEO CENTRO SALVIA",-65.33526,-18.14982,22,4,248,270,16,9,219,235
"Bolivia","Cochabamba","Mizque","Mizque","NUCLEO ESCOLAR BETA RAQAY PAMPA",-65.38233,-18.19124,153,18,1127,1280,27,36,1046,1073
"Bolivia","Cochabamba","Mizque","Mizque","NUCLEO ESCOLAR LAGUNA GRANDE",-65.37489,-18.30198,104,19,827,931,40,18,750,790
"Bolivia","Cochabamba","Mizque","Mizque","NUCLEO JOSÉ CLAURE (U. E. SAN VICENTE)",-65.53803,-18.16495,61,3,353,414,23,8,319,342
"Bolivia","Cochabamba","Mizque","Mizque","SEDE CENTRAL CAMPESINA (KURI)",-65.45872,-17.83207,21,6,295,316,30,14,245,275
"Bolivia","Cochabamba","Mizque","Mizque","SEDE SINDICAL DE CHAHUARANI CHICO",-65.52352,-18.05988,7,8,211,218,13,10,180,193
"Bolivia","Cochabamba","Mizque","Mizque","SEDE SOCIAL DE TIPA TIPA",-65.26866,-18.09922,69,28,479,548,114,16,321,435
"Bolivia","Cochabamba","Mizque","Mizque","UNIDAD EDUCATIVA CAUTA",-65.43818,-18.09074,24,3,175,199,21,9,142,163
"Bolivia","Cochabamba","Mizque","Mizque","UNIDAD EDUCATIVA MOLINERO",-65.38817,-18.26225,56,9,299,355,17,14,259,276
"Bolivia","Cochabamba","Mizque","Mizque","UNIDAD EDUCATIVA SANTIAGO",-65.32516,-18.20377,20,8,313,333,14,10,281,295
"Bolivia","Cochabamba","Mizque","Mizque","UNIDAD EDUCATIVA THAGO THAGO",-65.3672,-17.9808,35,14,447,482,69,27,337,406
"Bolivia","Cochabamba","Mizque","Mizque","UNIDAD EDUCATIVA TIN TIN",-65.45436,-18.0311,114,18,699,813,135,23,523,658
"Bolivia","Cochabamba","Mizque","Mizque","UNIDAD EDUCATIVA UCHHAMA ALTA",-65.50367,-17.95332,9,0,139,148,5,1,133,138
"Bolivia","Cochabamba","Mizque","Vila Vila","ESCUELA HUMBERTO NOGALES",-65.62921,-17.98482,123,16,674,797,51,11,596,647
"Bolivia","Cochabamba","Mizque","Vila Vila","NUCLEO ESCOLAR SIQUIMIRA",-65.73359,-18.01842,37,3,386,423,12,4,367,379
"Bolivia","Cochabamba","Mizque","Vila Vila","NUCLEO ESCOLAR SIVINGANI",-65.68718,-17.91458,60,15,290,350,37,17,221,258
"Bolivia","Cochabamba","Mizque","Vila Vila","UNIDAD EDUCATIVA POCOTAICA",-65.78678,-17.93137,10,1,71,81,4,2,64,68
"Bolivia","Cochabamba","Punata","Cuchumuela (Villa Gualberto Villarroel)","ESCUELA CUCHU MUELA",-65.7948,-17.65219,64,9,578,642,225,20,324,549
"Bolivia","Cochabamba","Punata","Cuchumuela (Villa Gualberto Villarroel)","NUCLEO ESCOLAR YANA RUMI",-65.74833,-17.70206,36,8,256,292,26,7,215,241
"Bolivia","Cochabamba","Punata","Punata","ESCUELA ADELA ZAMUDIO",-65.83555,-17.54252,855,54,4243,5098,1989,207,1993,3982
"Bolivia","Cochabamba","Punata","Punata","ESCUELA ANDRES MARIA TORRICO",-65.8345,-17.54389,632,57,3452,4084,1480,160,1755,3235
"Bolivia","Cochabamba","Punata","Punata","LICEO JOSEFA M. GANDARILLAS (EX SUCRE)",-65.83789,-17.54791,650,47,3300,3950,1624,155,1474,3098
"Bolivia","Cochabamba","Punata","Punata","SEDE SINDICAL THACO",-65.82087,-17.55312,66,14,552,618,147,24,367,514
"Bolivia","Cochabamba","Punata","Punata","U. E. MANUEL A. VILLARROEL (EX BOLIVAR)",-65.83459,-17.54425,640,39,3571,4211,1654,165,1713,3367
"Bolivia","Cochabamba","Punata","Punata","U. E. RENE BARRIENTOS O. - LA VILLA",-65.81705,-17.51416,113,29,506,619,101,21,355,456
"Bolivia","Cochabamba","Punata","Punata","U. E. RUBEN FERRUFINO (CAMACHO RANCHO)",-65.84141,-17.56411,126,18,747,873,222,38,469,691
"Bolivia","Cochabamba","Punata","Punata","UNIDAD EDUCATIVA MAYOR ROCHA (YACANAHUYO",-65.84713,-17.55166,96,25,771,867,308,36,402,710
"Bolivia","Cochabamba","Punata","Punata","UNIDAD EDUCATIVA MOLLE HUMA",-65.8109,-17.52157,84,19,555,639,111,19,406,517
"Bolivia","Cochabamba","Punata","Punata","UNIDAD EDUCATIVA TAJAMAR",-65.86192,-17.55713,95,22,744,839,308,39,375,683
"Bolivia","Cochabamba","Punata","Punata","UNIDAD EDUCATIVA TAMBILLO CHICO",-65.8281,-17.57144,59,8,387,446,108,24,247,355
"Bolivia","Cochabamba","Punata","San Benito (Villa José Quintín Mendoza)","COLEGIO SIMON BOLIVAR (HUARICAYA)",-65.92278,-17.52582,142,22,999,1141,294,24,659,953
"Bolivia","Cochabamba","Punata","San Benito (Villa José Quintín Mendoza)","ESCUELA EXPERIMENTAL PARACAYA",-65.85702,-17.5135,329,44,2533,2862,688,93,1708,2396
"Bolivia","Cochabamba","Punata","San Benito (Villa José Quintín Mendoza)","U. E. 27 DE MAYO (EX JOSE B. PEREIRA)",-65.89712,-17.52321,441,46,3114,3555,1004,98,1966,2970
"Bolivia","Cochabamba","Punata","San Benito (Villa José Quintín Mendoza)","UNIDAD EDUCATIVA SUNCHU PAMPA",-65.91961,-17.55873,150,20,801,951,210,28,543,753
"Bolivia","Cochabamba","Punata","San Benito (Villa José Quintín Mendoza)","UNIDAD EDUCATIVA WAÑAKAHUA",-65.8343,-17.51407,46,6,518,564,130,22,360,490
"Bolivia","Cochabamba","Punata","Tacachi","UNIDAD EDUCATIVA TACACHI",-65.80265,-17.63962,88,6,471,559,178,24,263,441
"Bolivia","Cochabamba","Punata","Villa Rivero","COL TEC IND COMUNITARIO MARCELO QUIROGA",-65.87885,-17.60502,543,36,2422,2965,385,75,1926,2311
"Bolivia","Cochabamba","Punata","Villa Rivero","ESCUELA GUALBERTO VILLARROEL (V. RIVERO)",-65.81674,-17.61485,393,42,1776,2169,719,86,929,1648
"Bolivia","Cochabamba","Punata","Villa Rivero","UNIDAD EDUCATIVA MARTÍN CÁRDENAS HERMOSO",-65.86461,-17.62572,37,5,258,295,35,6,212,247
"Bolivia","Cochabamba","Quillacollo","Colcapirhua","COLEGIO MAX FERNANDEZ",-66.23126,-17.39577,720,28,5274,5994,2955,156,2135,5090
"Bolivia","Cochabamba","Quillacollo","Colcapirhua","ESCUELA JESUS LARA",-66.22623,-17.39318,575,25,4805,5380,2928,110,1742,4670
"Bolivia","Cochabamba","Quillacollo","Colcapirhua","INSTITUTO MARÍA CRISTINA",-66.21936,-17.39718,263,6,1638,1901,968,40,624,1592
"Bolivia","Cochabamba","Quillacollo","Colcapirhua","SEDE SOCIAL CALLAJ CHULLPA (COLCAPIRHUA)",-66.24318,-17.35337,57,8,449,506,213,22,206,419
"Bolivia","Cochabamba","Quillacollo","Colcapirhua","SEDE SOCIAL DE LA OTB MARTIN CARDENAS (EX COMPLEJO EL CARMEN)",-66.21273,-17.3792,36,3,223,259,118,5,97,215
"Bolivia","Cochabamba","Quillacollo","Colcapirhua","U. E. PROF. BENEDICTO DURÁN ORTÍZ",-66.22591,-17.38681,85,1,708,793,385,23,299,684
"Bolivia","Cochabamba","Quillacollo","Colcapirhua","UNIDAD EDUCATIVA DANIEL SALAMANCA",-66.24152,-17.38778,843,58,6585,7428,3511,198,2818,6329
"Bolivia","Cochabamba","Quillacollo","Colcapirhua","UNIDAD EDUCATIVA EL SAUSALITO",-66.21352,-17.38681,645,28,5005,5650,2809,167,2001,4810
"Bolivia","Cochabamba","Quillacollo","Colcapirhua","UNIDAD EDUCATIVA LA SAGRADA FAMILIA",-66.22238,-17.38265,120,14,1624,1744,904,36,670,1574
"Bolivia","Cochabamba","Quillacollo","Colcapirhua","UNIDAD EDUCATIVA SAN JOSÉ DE KAMI",-66.23543,-17.36735,574,43,4339,4913,1944,168,2184,4128
"Bolivia","Cochabamba","Quillacollo","Colcapirhua","UNIDAD EDUCATIVA SAN LORENZO",-66.24113,-17.38883,71,6,718,789,373,15,324,697
"Bolivia","Cochabamba","Quillacollo","Colcapirhua","UNIDAD EDUCATIVA SIMON BOLIVAR (SUMUNPAYA)",-66.23511,-17.40263,15,2,144,159,48,7,87,135
"Bolivia","Cochabamba","Quillacollo","Quillacollo","(CÁRCEL) PENAL SAN PABLO",-66.28239,-17.40005,34,1,107,141,40,1,65,105
"Bolivia","Cochabamba","Quillacollo","Quillacollo","CENTRO INTEGRAL NIÑO JESUS FE Y ALEGRIA",-66.25516,-17.38777,128,10,1113,1241,581,32,490,1071
"Bolivia","Cochabamba","Quillacollo","Quillacollo","CENTRO INTERNADO MISICUNI",-66.32189,-17.1263,21,7,289,310,76,12,194,270
"Bolivia","Cochabamba","Quillacollo","Quillacollo","COLEGIO CRISTINA PRADA",-66.27902,-17.39269,299,8,2508,2807,1593,68,839,2432
"Bolivia","Cochabamba","Quillacollo","Quillacollo","COLEGIO FRANZ TAMAYO",-66.28081,-17.38829,700,32,5075,5775,3034,106,1903,4937
"Bolivia","Cochabamba","Quillacollo","Quillacollo","COLEGIO NACIONAL CALAMA (NUEVA INFRAESTRUCTURA)",-66.27234,-17.41193,23,2,105,128,51,3,49,100
"Bolivia","Cochabamba","Quillacollo","Quillacollo","ESCUELA 12 DE SEPTIEMBRE",-66.27923,-17.41147,676,43,4621,5297,2097,118,2363,4460
"Bolivia","Cochabamba","Quillacollo","Quillacollo","ESCUELA ARTURO QUITÓN",-66.27569,-17.36401,446,34,3281,3727,1260,115,1872,3132
"Bolivia","Cochabamba","Quillacollo","Quillacollo","ESCUELA FELIX MARTINEZ",-66.2527,-17.38772,1055,244,9354,10409,4711,319,4080,8791
"Bolivia","Cochabamba","Quillacollo","Quillacollo","ESCUELA FIDELIA C. DE SANCHEZ",-66.28062,-17.39867,212,10,2271,2483,1508,45,708,2216
"Bolivia","Cochabamba","Quillacollo","Quillacollo","ESCUELA SIMÓN BOLIVAR",-66.27937,-17.3954,498,23,3673,4171,2084,107,1459,3543
"Bolivia","Cochabamba","Quillacollo","Quillacollo","ESCUELA TOMAS BATA",-66.28063,-17.40219,423,33,3703,4126,2039,113,1518,3557
"Bolivia","Cochabamba","Quillacollo","Quillacollo","INSTITUTO PARTICULAR QUILLACOLLO",-66.28365,-17.39573,410,21,3415,3825,2173,94,1127,3300
"Bolivia","Cochabamba","Quillacollo","Quillacollo","INSTITUTO TECNOLOGICO EL PASO",-66.2566,-17.34972,110,12,999,1109,376,28,583,959
"Bolivia","Cochabamba","Quillacollo","Quillacollo","KINDER MARISCAL JOSE BALLIVIAN",-66.26795,-17.40211,523,27,2359,2882,1182,62,1088,2270
"Bolivia","Cochabamba","Quillacollo","Quillacollo","LICEO AMÉRICA",-66.28165,-17.39895,617,25,4759,5376,3114,116,1504,4618
"Bolivia","Cochabamba","Quillacollo","Quillacollo","NORMAL SIMÓN RODRÍGUEZ (EX NUCLEO ESCOLAR PAUCARPATA)",-66.297,-17.36322,388,19,2532,2920,1087,96,1330,2417
"Bolivia","Cochabamba","Quillacollo","Quillacollo","TEOFILO VARGAS CANDIA B",-66.27607,-17.38605,493,23,4126,4619,2284,116,1703,3987
"Bolivia","Cochabamba","Quillacollo","Quillacollo","U. E. JOSE MIGUEL LANZA (ILLATACO)",-66.29857,-17.3701,149,17,1435,1584,441,45,932,1373
"Bolivia","Cochabamba","Quillacollo","Quillacollo","U. E. MILIVOY ETEROVIC MATENDA",-66.26927,-17.39382,272,13,1861,2133,1012,47,789,1801
"Bolivia","Cochabamba","Quillacollo","Quillacollo","U. E. RENE BARRIENOS ORTUÑO (MISICUNI)",-66.32351,-17.11721,45,14,504,549,141,30,319,460
"Bolivia","Cochabamba","Quillacollo","Quillacollo","UNIDAD EDUCATIVA BELLA VISTA",-66.28169,-17.32156,636,70,3889,4525,1131,194,2494,3625
"Bolivia","Cochabamba","Quillacollo","Quillacollo","UNIDAD EDUCATIVA EL PASO",-66.26698,-17.33861,973,78,6333,7306,2231,217,3807,6038
"Bolivia","Cochabamba","Quillacollo","Quillacollo","UNIDAD EDUCATIVA FLORA SALINAS HINOJOSA - AMALIA ECHALAR DE",-66.27919,-17.39159,0,0,16,16,10,0,6,16
"Bolivia","Cochabamba","Quillacollo","Quillacollo","UNIDAD EDUCATIVA HEROINAS",-66.27933,-17.40064,334,18,2434,2768,1302,77,1037,2339
"Bolivia","Cochabamba","Quillacollo","Quillacollo","UNIDAD EDUCATIVA IRONCOLLO",-66.28701,-17.36173,552,61,4171,4723,1610,151,2349,3959
"Bolivia","Cochabamba","Quillacollo","Quillacollo","UNIDAD EDUCATIVA LIRIUNI",-66.29985,-17.28487,10,3,188,198,29,9,147,176
"Bolivia","Cochabamba","Quillacollo","Quillacollo","UNIDAD EDUCATIVA MARIA AUXILIADORA",-66.24287,-17.32961,77,11,760,837,304,36,409,713
"Bolivia","Cochabamba","Quillacollo","Quillacollo","UNIDAD EDUCATIVA MARQUINA",-66.28875,-17.33999,365,39,2802,3167,907,135,1721,2628
"Bolivia","Cochabamba","Quillacollo","Quillacollo","UNIDAD EDUCATIVA MARTIN CARDENAS",-66.29568,-17.38804,153,9,1253,1406,565,63,616,1181
"Bolivia","Cochabamba","Quillacollo","Quillacollo","UNIDAD EDUCATIVA NESTOR ADRIAZOLA (EX COLEGIO NACIONAL CALAMA)",-66.28477,-17.39367,948,52,6841,7789,3587,252,2950,6537
"Bolivia","Cochabamba","Quillacollo","Quillacollo","UNIDAD EDUCATIVA VILLA DE URKUPIÑA",-66.28946,-17.4192,302,28,2780,3082,795,88,1869,2664
"Bolivia","Cochabamba","Quillacollo","Quillacollo","UNIDAD EDUCATIVA VILLA MODERNA",-66.2822,-17.3884,303,13,2050,2353,1045,43,949,1994
"Bolivia","Cochabamba","Quillacollo","Sipe Sipe","ESC. RENE BARRIENTOS ORTUÑO (ITAPAYA)",-66.32016,-17.58389,181,19,1139,1320,312,49,759,1071
"Bolivia","Cochabamba","Quillacollo","Sipe Sipe","ESCUELA BOLVIANA AMERICANA",-66.36395,-17.41975,293,40,2375,2668,635,90,1610,2245
"Bolivia","Cochabamba","Quillacollo","Sipe Sipe","ESCUELA SUCRE (SIPE SIPE)",-66.35757,-17.45498,881,88,6828,7709,2186,297,4257,6443
"Bolivia","Cochabamba","Quillacollo","Sipe Sipe","UNIDAD EDUCATIVA 3 DE ABRIL",-66.33532,-17.4215,112,16,1405,1517,447,54,888,1335
"Bolivia","Cochabamba","Quillacollo","Sipe Sipe","UNIDAD EDUCATIVA ANDRES UZEDA OCAMPO",-66.35824,-17.45489,65,7,469,534,146,11,305,451
"Bolivia","Cochabamba","Quillacollo","Sipe Sipe","UNIDAD EDUCATIVA CARAMARCA COLLPA",-66.305,-17.45254,68,28,586,654,176,21,361,537
"Bolivia","Cochabamba","Quillacollo","Sipe Sipe","UNIDAD EDUCATIVA  CAVILOMA",-66.34575,-17.43804,22,15,549,571,158,27,349,507
"Bolivia","Cochabamba","Quillacollo","Sipe Sipe","UNIDAD EDUCATIVA EDUARDO ABAROA",-66.34507,-17.56399,394,75,2474,2868,645,111,1643,2288
"Bolivia","Cochabamba","Quillacollo","Sipe Sipe","UNIDAD EDUCATIVA SAUCE RANCHO",-66.32941,-17.42615,735,72,4872,5607,1711,205,2884,4595
"Bolivia","Cochabamba","Quillacollo","Sipe Sipe","UNIDAD EDUCATIVA SUTICOLLO",-66.33573,-17.46679,417,25,2313,2730,1040,95,1153,2193
"Bolivia","Cochabamba","Quillacollo","Sipe Sipe","UNIDAD EDUCATIVA TORIBIO CLAURE",-66.37673,-17.44035,12,4,353,365,36,9,304,340
"Bolivia","Cochabamba","Quillacollo","Sipe Sipe","UNIDAD EDUCATIVA UCHU UCHU",-66.47109,-17.37553,14,0,440,454,4,21,415,419
"Bolivia","Cochabamba","Quillacollo","Sipe Sipe","UNIDAD EDUCATIVA VILOMA",-66.37477,-17.41203,225,26,1574,1799,283,54,1211,1494
"Bolivia","Cochabamba","Quillacollo","Tiquipaya","ALDEAS S.O.S",-66.19316,-17.35118,340,19,2682,3022,1473,101,1089,2562
"Bolivia","Cochabamba","Quillacollo","Tiquipaya","COLEGIO CRISTO NACIÓN (UE BOLIVIA JAPÓN)",-66.19818,-17.34682,21,0,94,115,71,0,23,94
"Bolivia","Cochabamba","Quillacollo","Tiquipaya","COLEGIO SAN MIGUEL (TIQUIPAYA)",-66.2195,-17.33651,688,45,4701,5389,2299,146,2211,4510
"Bolivia","Cochabamba","Quillacollo","Tiquipaya","COLEGIO SIMON BOLIVAR (TIQUIPAYA)",-66.22029,-17.33622,844,65,5884,6728,2635,209,2975,5610
"Bolivia","Cochabamba","Quillacollo","Tiquipaya","ESCUELA EUGENIA RAVASCO",-66.20742,-17.36253,152,16,1392,1544,776,26,574,1350
"Bolivia","Cochabamba","Quillacollo","Tiquipaya","ESCUELA ISAAC ATTIE",-66.1954,-17.36948,236,12,2034,2270,1278,47,697,1975
"Bolivia","Cochabamba","Quillacollo","Tiquipaya","ESCUELA SECCIONAL WARIPUCARA",-66.2721,-17.02783,16,0,101,117,4,2,95,99
"Bolivia","Cochabamba","Quillacollo","Tiquipaya","ESCUELA TORIBIO CLAURE",-66.20433,-17.34466,847,55,6649,7496,3403,202,2989,6392
"Bolivia","Cochabamba","Quillacollo","Tiquipaya","NUCLEO EDUCATIVO CHAPISIRCA",-66.14425,-17.14807,111,24,1001,1112,93,31,853,946
"Bolivia","Cochabamba","Quillacollo","Tiquipaya","UNIDAD EDUCATIVA CUATRO ESQUINAS",-66.23293,-17.35942,144,13,1279,1423,669,39,558,1227
"Bolivia","Cochabamba","Quillacollo","Tiquipaya","UNIDAD EDUCATIVA JESUS MAESTRO",-66.19382,-17.333,68,14,988,1056,412,35,527,939
"Bolivia","Cochabamba","Quillacollo","Tiquipaya","UNIDAD EDUCATIVA LIBERTAD",-66.19286,-17.34593,615,33,4959,5574,2443,159,2324,4767
"Bolivia","Cochabamba","Quillacollo","Tiquipaya","UNIDAD EDUCATIVA MONTECILLO",-66.34388,-16.97306,22,1,240,262,8,4,227,235
"Bolivia","Cochabamba","Quillacollo","Tiquipaya","UNIDAD EDUCATIVA NUESTRA SRA. DE ALTAGRACIA",-66.24353,-17.35297,47,5,335,382,156,15,159,315
"Bolivia","Cochabamba","Quillacollo","Vinto","ESCUELA ISMAEL MONTES",-66.32672,-17.3703,394,34,2914,3308,1177,162,1541,2718
"Bolivia","Cochabamba","Quillacollo","Vinto","ESCUELA MARTÍN CARDENAS",-66.31405,-17.40174,924,66,6104,7028,2607,210,3221,5828
"Bolivia","Cochabamba","Quillacollo","Vinto","ESCUELA MELCHOR CUADROS",-66.31646,-17.39582,1244,76,9163,10407,4501,378,4208,8709
"Bolivia","Cochabamba","Quillacollo","Vinto","NUCLEO ESCOLAR SIMON BOLIVAR (THIOMOKO)",-66.34605,-17.39735,86,21,839,925,136,44,638,774
"Bolivia","Cochabamba","Quillacollo","Vinto","UNIDAD EDUCATIVA ANOCARAIRE",-66.31851,-17.38117,411,55,3719,4130,1396,154,2114,3510
"Bolivia","Cochabamba","Quillacollo","Vinto","UNIDAD EDUCATIVA DAVID ARZABE",-66.31459,-17.39948,95,14,968,1063,359,45,550,909
"Bolivia","Cochabamba","Quillacollo","Vinto","UNIDAD EDUCATIVA KERAYA",-66.45165,-17.29583,30,3,286,316,13,5,265,278
"Bolivia","Cochabamba","Quillacollo","Vinto","UNIDAD EDUCATIVA REINO UNIDO",-66.33875,-17.38365,495,77,4437,4932,1328,227,2805,4133
"Bolivia","Cochabamba","Quillacollo","Vinto","UNIDAD EDUCATIVA SAGRADA FAMILIA",-66.31983,-17.39161,318,28,1980,2298,892,91,969,1861
"Bolivia","Cochabamba","Tapacarí","Tapacarí","ESCUELA  CHALLA GRANDE",-66.64311,-17.70757,43,17,344,387,107,30,190,297
"Bolivia","Cochabamba","Tapacarí","Tapacarí","ESCUELA CHUÑU CHUÑINI",-66.59262,-17.69916,7,2,420,427,28,6,384,412
"Bolivia","Cochabamba","Tapacarí","Tapacarí","ESCUELA MONSEÑOR ANGEL GELMI",-66.55774,-17.61193,80,12,464,544,17,13,422,439
"Bolivia","Cochabamba","Tapacarí","Tapacarí","NUCLEO ESCOLAR CHARAPAYA",-66.75413,-17.36775,41,1,233,274,8,4,220,228
"Bolivia","Cochabamba","Tapacarí","Tapacarí","NUCLEO ESCOLAR CONFITAL",-66.73165,-17.67827,43,10,397,440,37,20,330,367
"Bolivia","Cochabamba","Tapacarí","Tapacarí","U.E. ARASAYA",-66.59817,-17.4361,2,2,152,154,3,3,144,147
"Bolivia","Cochabamba","Tapacarí","Tapacarí","U.E. CHILLCA GRANDE",-66.63358,-17.59493,1,1,170,171,7,1,161,168
"Bolivia","Cochabamba","Tapacarí","Tapacarí","U.E. LACOLACONI",-66.83026,-17.65938,3,5,273,276,21,15,232,253
"Bolivia","Cochabamba","Tapacarí","Tapacarí","U.E. LACUYO",-66.68685,-17.63514,69,12,554,623,46,25,471,517
"Bolivia","Cochabamba","Tapacarí","Tapacarí","UNIDAD EDUCATIVA APHARUMIRI",-66.54695,-17.53054,17,0,184,201,0,9,175,175
"Bolivia","Cochabamba","Tapacarí","Tapacarí","UNIDAD EDUCATIVA CALLIRI",-66.48114,-17.53546,5,0,53,58,0,1,52,52
"Bolivia","Cochabamba","Tapacarí","Tapacarí","UNIDAD EDUCATIVA CENTRAL VILLA PEREIRA",-66.7868,-17.44669,80,20,532,612,43,24,445,488
"Bolivia","Cochabamba","Tapacarí","Tapacarí","UNIDAD EDUCATIVA CHULLPA K'ASA",-66.43821,-17.62975,23,0,184,207,13,6,165,178
"Bolivia","Cochabamba","Tapacarí","Tapacarí","UNIDAD EDUCATIVA JAPO K'ASA",-66.7634,-17.6955,84,9,749,833,60,24,656,716
"Bolivia","Cochabamba","Tapacarí","Tapacarí","UNIDAD EDUCATIVA KATARIRI",-66.51272,-17.63324,27,9,423,450,24,12,378,402
"Bolivia","Cochabamba","Tapacarí","Tapacarí","UNIDAD EDUCATIVA KJARKAS",-66.521,-17.69701,33,11,356,389,46,23,276,322
"Bolivia","Cochabamba","Tapacarí","Tapacarí","UNIDAD EDUCATIVA LLAVINI",-66.41062,-17.66616,20,1,327,347,47,11,268,315
"Bolivia","Cochabamba","Tapacarí","Tapacarí","UNIDAD EDUCATIVA NORBERTO JIMENEZ",-66.81584,-17.50673,119,17,391,510,42,23,309,351
"Bolivia","Cochabamba","Tapacarí","Tapacarí","UNIDAD EDUCATIVA RAMADAS",-66.47381,-17.55251,114,7,741,855,85,24,625,710
"Bolivia","Cochabamba","Tapacarí","Tapacarí","UNIDAD EDUCATIVA SAN ANTONIO",-66.83088,-17.54268,33,2,258,291,30,5,221,251
"Bolivia","Cochabamba","Tapacarí","Tapacarí","UNIDAD EDUCATIVA SUCRE",-66.62051,-17.5165,226,18,1465,1691,36,127,1284,1320
"Bolivia","Cochabamba","Tapacarí","Tapacarí","UNIDAD EDUCATIVA TUNAS VINTO-APHARUMIRI",-66.54695,-17.53053,75,6,514,589,10,25,473,483
"Bolivia","Cochabamba","Tapacarí","Tapacarí","UNIDAD EDUCATIVA WACA PLAYA",-66.48648,-17.45753,149,22,864,1013,55,23,764,819
"Bolivia","Cochabamba","Tiraque","Shinahota","ESCUELA GERMAN BUSCH",-65.24871,-16.99495,1092,99,6453,7545,1798,231,4325,6123
"Bolivia","Cochabamba","Tiraque","Shinahota","U.E. DEMETRIO CANELAS",-65.22605,-16.99467,10,3,249,259,23,3,220,243
"Bolivia","Cochabamba","Tiraque","Shinahota","U. E. MARCELO QUIROGA SANTA CRUZ",-65.22232,-17.07844,62,9,707,769,91,24,583,674
"Bolivia","Cochabamba","Tiraque","Shinahota","U.E. MARISCAL SUCRE",-65.2549,-16.99571,18,5,195,213,24,9,157,181
"Bolivia","Cochabamba","Tiraque","Shinahota","U.E. SAN LUIS",-65.28136,-16.95968,19,4,475,494,29,5,437,466
"Bolivia","Cochabamba","Tiraque","Shinahota","UNIDAD EDUCATIVA 4 DE ABRIL",-65.27142,-17.03861,15,1,326,341,16,8,301,317
"Bolivia","Cochabamba","Tiraque","Shinahota","UNIDAD EDUCATIVA CHURO GRANDE",-65.33322,-17.05208,12,1,222,234,11,4,206,217
"Bolivia","Cochabamba","Tiraque","Shinahota","UNIDAD EDUCATIVA IBUELO",-65.33987,-16.96962,400,29,1247,1647,203,24,991,1194
"Bolivia","Cochabamba","Tiraque","Shinahota","UNIDAD EDUCATIVA IVIRIZU VANDIOLA",-65.46212,-17.06077,61,9,388,449,55,11,313,368
"Bolivia","Cochabamba","Tiraque","Shinahota","UNIDAD EDUCATIVA MAJO PAMPA A",-65.36292,-17.03242,14,2,281,295,11,2,266,277
"Bolivia","Cochabamba","Tiraque","Shinahota","UNIDAD EDUCATIVA PUERTO AROMA",-65.17721,-17.12901,5,1,72,77,12,1,58,70
"Bolivia","Cochabamba","Tiraque","Shinahota","UNIDAD EDUCATIVA SAN ISIDRO",-65.32017,-16.99914,29,11,826,855,42,10,763,805
"Bolivia","Cochabamba","Tiraque","Tiraque","COLEGIO JUAN JOSE CARRASCO",-65.72145,-17.42393,833,150,5741,6574,1161,271,4159,5320
"Bolivia","Cochabamba","Tiraque","Tiraque","ESCUELA COTANI BAJO",-65.78638,-17.38104,64,13,802,866,119,80,590,709
"Bolivia","Cochabamba","Tiraque","Tiraque","ESCUELA KOARI (NUCLEO ESC. S. BOLIVAR)",-65.57632,-17.47923,174,19,1153,1327,119,62,953,1072
"Bolivia","Cochabamba","Tiraque","Tiraque","ESCUELA SECCIONAL PAIRUMANI",-65.48745,-17.4773,87,9,709,796,69,20,611,680
"Bolivia","Cochabamba","Tiraque","Tiraque","ESCUELA SECCIONAL SACABAMBILLA",-65.76513,-17.4795,40,7,367,407,54,25,281,335
"Bolivia","Cochabamba","Tiraque","Tiraque","NUCLEO ESCOLAR ILURI GRANDE",-65.82572,-17.39656,0,16,662,662,80,40,526,606
"Bolivia","Cochabamba","Tiraque","Tiraque","UNIDAD EDUCATIVA 3 DE AGOSTO",-65.46495,-17.54261,24,4,344,368,38,19,283,321
"Bolivia","Cochabamba","Tiraque","Tiraque","UNIDAD EDUCATIVA PALCA T",-65.77904,-17.41067,14,4,125,139,29,4,88,117
"Bolivia","Cochabamba","Tiraque","Tiraque","UNIDAD EDUCATIVA RODEO",-65.76229,-17.3932,26,17,307,333,40,21,229,269
"Bolivia","La Paz","Abel Iturralde","Ixiamas","ESC. ESPERANZA DEL MADIDI",-67.17106,-12.61393,46,4,130,176,58,0,68,126
"Bolivia","La Paz","Abel Iturralde","Ixiamas","ESC. GERMAN BUSCH",-68.12748,-13.76644,695,27,2273,2968,993,78,1175,2168
"Bolivia","La Paz","Abel Iturralde","Ixiamas","ESCUELA NUEVA IDIAMAS",-68.44615,-13.64052,7,0,10,17,2,0,8,10
"Bolivia","La Paz","Abel Iturralde","Ixiamas","ESCUELA PUERTO ARAONA",-67.77129,-12.52156,34,0,14,48,1,0,13,14
"Bolivia","La Paz","Abel Iturralde","Ixiamas","ESCUELA PUERTO PEREZ",-68.55753,-12.44095,85,0,134,219,111,2,21,132
"Bolivia","La Paz","Abel Iturralde","Ixiamas","ESCUELA TOMAS CATARI",-68.5165,-13.60102,16,1,110,126,11,1,97,108
"Bolivia","La Paz","Abel Iturralde","Ixiamas","ESCUELA VILLA FATIMA",-67.51065,-13.81614,4,0,25,29,16,0,9,25
"Bolivia","La Paz","Abel Iturralde","Ixiamas","ESC. UNIDAD EDUCATIVA DE TAHUA",-67.90891,-13.86159,19,0,107,126,50,1,56,106
"Bolivia","La Paz","Abel Iturralde","Ixiamas","SEDE DEL CARMEN DEL EMERO",-67.37585,-13.38387,10,0,65,75,61,0,4,65
"Bolivia","La Paz","Abel Iturralde","Ixiamas","U.E. MANURIMI",-67.69769,-12.04555,67,2,107,174,41,0,64,105
"Bolivia","La Paz","Abel Iturralde","Ixiamas","UNIDAD EDUCATIVA 10 DE ABRIL",-68.06606,-13.78335,3,2,72,75,39,2,29,68
"Bolivia","La Paz","Abel Iturralde","Ixiamas","UNIDAD EDUCATIVA EL TIGRE",-68.05921,-11.99998,23,0,53,76,31,1,21,52
"Bolivia","La Paz","Abel Iturralde","San Buenaventura","COL. TUMUPASA B",-67.88744,-14.14472,157,13,986,1143,414,22,537,951
"Bolivia","La Paz","Abel Iturralde","San Buenaventura","ESC. CHAUPY YACHAY HUASI",-68.05549,-14.21644,30,2,120,150,67,5,46,113
"Bolivia","La Paz","Abel Iturralde","San Buenaventura","ESCUELA JOSE MANUEL PANDO",-67.53542,-14.43845,580,38,2262,2842,941,71,1212,2153
"Bolivia","La Paz","Abel Iturralde","San Buenaventura","UNIDAD EDUCATIVA CENTRAL BUENA VISTA",-67.58383,-14.37968,32,4,157,189,52,3,98,150
"Bolivia","La Paz","Abel Iturralde","San Buenaventura","UNIDAD EDUCATIVA SAN MIGUEL",-67.52943,-14.4718,10,1,88,98,32,1,54,86
"Bolivia","La Paz","Aroma","Ayo Ayo","CASA DE GOBIERNO",-68.014,-17.18632,5,4,115,120,17,3,91,108
"Bolivia","La Paz","Aroma","Ayo Ayo","COL. AYO AYO",-68.00532,-17.09241,163,30,1714,1877,426,62,1196,1622
"Bolivia","La Paz","Aroma","Ayo Ayo","COLEGIO JOSÉ BALLIVIÁN",-68.08076,-17.17401,11,0,141,152,40,8,93,133
"Bolivia","La Paz","Aroma","Ayo Ayo","ESC. CALACACHI",-68.14827,-17.06024,45,10,492,537,194,13,275,469
"Bolivia","La Paz","Aroma","Ayo Ayo","ESC. FRANZ TAMAYO",-68.06002,-17.01099,73,15,789,862,230,22,522,752
"Bolivia","La Paz","Aroma","Ayo Ayo","ESC. STA. ROSA DE LIMA",-68.06953,-17.13371,46,6,282,328,75,7,194,269
"Bolivia","La Paz","Aroma","Calamarca","CASA DE GOBIERNO",-68.1799,-16.90021,80,6,1022,1102,295,65,656,951
"Bolivia","La Paz","Aroma","Calamarca","CASA DE GOBIERNO",-68.08315,-16.96971,80,6,1022,1102,295,65,656,951
"Bolivia","La Paz","Aroma","Calamarca","ESC. CENTRAL CHORITOTORA",-68.08884,-16.84568,47,18,404,451,52,18,316,368
"Bolivia","La Paz","Aroma","Calamarca","ESCUELA EDUARDO AVAROA",-68.16341,-16.85044,63,6,540,603,122,14,398,520
"Bolivia","La Paz","Aroma","Calamarca","PLAZA 14 DE SEPTIEMBRE",-68.11526,-16.90584,131,25,1422,1553,612,49,736,1348
"Bolivia","La Paz","Aroma","Calamarca","PLAZA 16 DE JULIO",-68.13773,-16.78787,43,5,470,513,120,30,315,435
"Bolivia","La Paz","Aroma","Calamarca","PLAZA 6 DE AGOSTO",-68.17797,-16.79795,70,22,1143,1213,325,50,746,1071
"Bolivia","La Paz","Aroma","Calamarca","PLAZA PRINCIPAL",-68.14911,-16.99117,49,9,497,546,150,22,316,466
"Bolivia","La Paz","Aroma","Calamarca","PLAZA TOTORANI",-68.17602,-16.96187,71,4,406,477,107,11,284,391
"Bolivia","La Paz","Aroma","Calamarca","U.E. JUAN JOSÉ TORREZ",-68.08725,-16.75592,32,16,439,471,109,20,294,403
"Bolivia","La Paz","Aroma","Calamarca","UNIDAD EDUCATIVA FRANZ TAMAYO",-68.1254,-16.85869,19,6,361,380,68,11,276,344
"Bolivia","La Paz","Aroma","Calamarca","UNIDAD EDUCATIVA SUCANAVI",-68.07444,-16.93009,5,3,139,144,46,6,84,130
"Bolivia","La Paz","Aroma","Collana","CASA SOCIAL",-68.23739,-16.84444,9,0,188,197,31,4,153,184
"Bolivia","La Paz","Aroma","Collana","SEDE SOCIAL",-68.28757,-16.88153,164,24,1652,1816,594,60,974,1568
"Bolivia","La Paz","Aroma","Collana","SEDE SOCIAL",-68.28442,-16.90426,164,24,1652,1816,594,60,974,1568
"Bolivia","La Paz","Aroma","Colquencha","ESC. LADISLAO CABRERA",-68.20877,-16.87736,80,13,743,823,172,32,526,698
"Bolivia","La Paz","Aroma","Colquencha","ESCUELA LITORAL",-68.22531,-16.95084,14,0,184,198,40,5,139,179
"Bolivia","La Paz","Aroma","Colquencha","PLAZA 15 DE AGOSTO",-68.24931,-16.93275,132,25,1862,1994,575,84,1178,1753
"Bolivia","La Paz","Aroma","Colquencha","SEDE SOCIAL",-68.27126,-16.91852,61,20,907,968,286,24,577,863
"Bolivia","La Paz","Aroma","Patacamaya","CASA DE GOBIERNO",-67.87502,-17.19816,27,2,300,327,48,8,242,290
"Bolivia","La Paz","Aroma","Patacamaya","COLEGIO 23 DE MARZO",-67.95469,-17.27477,20,0,487,507,90,11,386,476
"Bolivia","La Paz","Aroma","Patacamaya","COLEGIO FRANZ TAMAYO",-68.02139,-17.22715,53,16,546,599,109,17,404,513
"Bolivia","La Paz","Aroma","Patacamaya","ESC. ROBERTO PABON",-67.91753,-17.24177,967,89,6002,6969,1989,171,3753,5742
"Bolivia","La Paz","Aroma","Patacamaya","ESC. SECCIONAL JATUQUIRA",-67.85796,-17.26879,3,2,64,67,16,2,44,60
"Bolivia","La Paz","Aroma","Patacamaya","ESC. TAYPILLANGA",-67.90216,-17.30549,20,5,395,415,78,9,303,381
"Bolivia","La Paz","Aroma","Patacamaya","ESCUELA COLCHANI",-67.85081,-17.23891,3,15,432,435,85,21,311,396
"Bolivia","La Paz","Aroma","Patacamaya","NUCLEO EDUCATIVO BELEN IQUIACA",-67.94446,-17.1978,23,4,333,356,66,9,254,320
"Bolivia","La Paz","Aroma","Patacamaya","PLAZA 16 DE JULIO",-67.87547,-17.18134,28,3,398,426,80,12,303,383
"Bolivia","La Paz","Aroma","Patacamaya","SEDE MUNICIPAL",-67.82513,-17.22678,2,0,138,140,42,2,94,136
"Bolivia","La Paz","Aroma","Patacamaya","SEDE SOCIAL",-67.92398,-17.28475,43,11,434,477,94,15,314,408
"Bolivia","La Paz","Aroma","Patacamaya","SEDE SOCIAL",-67.9968,-17.24903,43,11,434,477,94,15,314,408
"Bolivia","La Paz","Aroma","Patacamaya","U.E. GERMAN BUSCH",-67.91753,-17.24177,40,5,484,524,210,11,258,468
"Bolivia","La Paz","Aroma","Patacamaya","UNIDAD EDUCATIVA MURUCHAPI",-67.82782,-17.13052,7,0,49,56,7,1,41,48
"Bolivia","La Paz","Aroma","Patacamaya","UNIDAD EDUCATIVA VISCACHANI",-67.9495,-17.17933,61,19,682,743,123,8,532,655
"Bolivia","La Paz","Aroma","Sica Sica (Villa Aroma)","CASA DE GOBIERNO",-67.8598,-17.34229,5,2,361,366,75,17,267,342
"Bolivia","La Paz","Aroma","Sica Sica (Villa Aroma)","COL. 6 DE JUNIO",-67.46742,-17.23661,2,0,151,153,0,0,151,151
"Bolivia","La Paz","Aroma","Sica Sica (Villa Aroma)","COLEGIO TAWANTINSUYO",-67.63738,-17.38684,11,2,371,382,79,8,282,361
"Bolivia","La Paz","Aroma","Sica Sica (Villa Aroma)","COL. NAL. SICA SICA",-67.7421,-17.33211,161,26,1285,1446,530,42,687,1217
"Bolivia","La Paz","Aroma","Sica Sica (Villa Aroma)","COL. TOMAS KATARI",-67.58031,-17.22041,2,3,305,307,21,7,274,295
"Bolivia","La Paz","Aroma","Sica Sica (Villa Aroma)","ESC. JOSE M. PANDO",-67.44505,-17.49286,61,3,447,508,87,4,353,440
"Bolivia","La Paz","Aroma","Sica Sica (Villa Aroma)","ESCUELA EDEN",-67.67335,-17.37538,276,32,2399,2675,700,96,1571,2271
"Bolivia","La Paz","Aroma","Sica Sica (Villa Aroma)","ESCUELA SIMON BOLIVAR",-67.5736,-17.39699,50,7,522,572,90,18,407,497
"Bolivia","La Paz","Aroma","Sica Sica (Villa Aroma)","PLAZA CANTON MACHACAMARCA",-67.59753,-17.45224,49,8,427,476,116,22,281,397
"Bolivia","La Paz","Aroma","Sica Sica (Villa Aroma)","PLAZA PRINCIPAL JARUMA",-67.57709,-17.26054,100,2,640,740,125,16,497,622
"Bolivia","La Paz","Aroma","Sica Sica (Villa Aroma)","PLAZA SAN FRANCISCO",-67.79234,-17.38375,27,1,222,249,40,1,180,220
"Bolivia","La Paz","Aroma","Sica Sica (Villa Aroma)","SEDE SOCIAL AYAMAYA",-67.7303,-17.3847,10,2,253,263,69,4,178,247
"Bolivia","La Paz","Aroma","Sica Sica (Villa Aroma)","UNIDAD EDUCATIVA BARTOLINA SISA A",-67.82572,-17.38552,17,1,191,208,34,1,155,189
"Bolivia","La Paz","Aroma","Sica Sica (Villa Aroma)","UNIDAD EDUCATIVA CHUACOLLO GRANDE",-67.6738,-17.2105,7,3,161,168,12,1,145,157
"Bolivia","La Paz","Aroma","Sica Sica (Villa Aroma)","UNIDAD EDUCATIVA CONANI",-67.52164,-17.43539,169,35,1726,1895,480,64,1147,1627
"Bolivia","La Paz","Aroma","Sica Sica (Villa Aroma)","UNIDAD EDUCATIVA PEDRO DOMINGO MURILLO",-67.51456,-17.48516,17,13,662,679,163,17,469,632
"Bolivia","La Paz","Aroma","Umala","CASA DE GOBIERNO",-67.9584,-17.4303,96,23,788,884,231,40,494,725
"Bolivia","La Paz","Aroma","Umala","CASA DE GOBIERNO",-68.03399,-17.33216,96,23,788,884,231,40,494,725
"Bolivia","La Paz","Aroma","Umala","COL. DE VENTILLA",-68.10613,-17.29234,21,5,312,333,68,9,230,298
"Bolivia","La Paz","Aroma","Umala","COL. NAL. MIXTO SAN JOSE",-67.93179,-17.39158,28,3,337,365,89,13,232,321
"Bolivia","La Paz","Aroma","Umala","ESCUELA SAN MIGUEL DE COPANI",-68.06709,-17.33392,32,8,248,280,45,14,181,226
"Bolivia","La Paz","Aroma","Umala","PLAZA 16 DE JULIO",-68.02159,-17.37343,77,9,478,555,133,18,318,451
"Bolivia","La Paz","Aroma","Umala","PLAZA HUARI BELEN 6 DE AGOSTO",-68.00945,-17.46336,69,2,428,497,79,6,341,420
"Bolivia","La Paz","Aroma","Umala","PLAZA VITUY VINTO",-68.17715,-17.36859,23,1,231,254,70,4,156,226
"Bolivia","La Paz","Aroma","Umala","SEDE SOCIAL",-68.11279,-17.35408,51,1,321,372,78,13,229,307
"Bolivia","La Paz","Aroma","Umala","U.E. KELLHUIRI",-68.15555,-17.32532,8,5,200,208,32,7,156,188
"Bolivia","La Paz","Aroma","Umala","UNIDAD EDUCATIVA LLANGA BELEN",-67.90632,-17.3479,35,4,238,273,89,8,137,226
"Bolivia","La Paz","Bautista Saavedra","Curva","CASA DE GOBIERNO",-69.03347,-15.10095,34,2,118,152,26,11,79,105
"Bolivia","La Paz","Bautista Saavedra","Curva","ESCUELA KAPNA",-68.90353,-14.95543,9,1,43,52,5,5,32,37
"Bolivia","La Paz","Bautista Saavedra","Curva","NUCLEO ESCOLAR UPINUAYA",-69.02789,-15.13118,18,4,86,104,13,2,67,80
"Bolivia","La Paz","Bautista Saavedra","Curva","RECINTO TAIPI CANUMA",-69.13345,-15.03614,0,0,189,189,18,2,169,187
"Bolivia","La Paz","Bautista Saavedra","Curva","SEDE COMUNAL",-68.87193,-14.87294,3,0,25,28,8,0,17,25
"Bolivia","La Paz","Bautista Saavedra","Curva","SEDE SOCIAL",-69.00313,-15.12604,65,8,255,320,52,25,170,222
"Bolivia","La Paz","Bautista Saavedra","Curva","SEDE SOCIAL",-69.00817,-15.12213,65,8,255,320,52,25,170,222
"Bolivia","La Paz","Bautista Saavedra","Curva","SEDE SOCIAL",-69.00968,-15.0953,65,8,255,320,52,25,170,222
"Bolivia","La Paz","Bautista Saavedra","General Juan José Pérez (Charazani)","CALLINSANI",-68.89539,-15.22253,22,8,153,175,21,4,120,141
"Bolivia","La Paz","Bautista Saavedra","General Juan José Pérez (Charazani)","CASA DE GOBIERNO",-68.94041,-15.13295,27,6,197,224,31,13,147,178
"Bolivia","La Paz","Bautista Saavedra","General Juan José Pérez (Charazani)","ESCUELA ATIQUE",-68.93712,-15.19225,7,3,64,71,7,1,53,60
"Bolivia","La Paz","Bautista Saavedra","General Juan José Pérez (Charazani)","ESCUELA CENTRAL MOYAPAMPA",-69.00706,-15.26653,22,2,132,154,28,11,91,119
"Bolivia","La Paz","Bautista Saavedra","General Juan José Pérez (Charazani)","ESCUELA CHARAZANI",-68.98535,-15.17054,116,31,590,706,130,41,388,518
"Bolivia","La Paz","Bautista Saavedra","General Juan José Pérez (Charazani)","ESCUELA GENERAL RAMON GONZALES",-69.0027,-15.19276,22,4,117,139,14,3,96,110
"Bolivia","La Paz","Bautista Saavedra","General Juan José Pérez (Charazani)","ESCUELA PAUJE YUYO",-68.45623,-15.05983,29,0,122,151,18,3,101,119
"Bolivia","La Paz","Bautista Saavedra","General Juan José Pérez (Charazani)","ESCUELA SECCIONAL CHARI",-69.041,-15.17468,0,4,141,141,13,8,116,129
"Bolivia","La Paz","Bautista Saavedra","General Juan José Pérez (Charazani)","ESCUELA SECCIONAL SIATHA",-68.68688,-15.20615,16,2,105,121,18,4,81,99
"Bolivia","La Paz","Bautista Saavedra","General Juan José Pérez (Charazani)","PLAZA 26 DE JULIO",-68.75932,-15.22727,16,3,91,107,15,9,64,79
"Bolivia","La Paz","Bautista Saavedra","General Juan José Pérez (Charazani)","PLAZA AMARKA",-69.05107,-15.22568,44,3,228,272,51,8,166,217
"Bolivia","La Paz","Bautista Saavedra","General Juan José Pérez (Charazani)","PLAZA PRINCIPAL AMARETE",-68.98066,-15.22867,121,26,1016,1137,156,49,785,941
"Bolivia","La Paz","Bautista Saavedra","General Juan José Pérez (Charazani)","SEDE SOCIAL",-69.00725,-15.14073,88,14,476,564,59,18,385,444
"Bolivia","La Paz","Bautista Saavedra","General Juan José Pérez (Charazani)","SEDE SOCIAL",-68.453,-15.13352,88,14,476,564,59,18,385,444
"Bolivia","La Paz","Bautista Saavedra","General Juan José Pérez (Charazani)","UNIDAD EDUCATIVA APACHETA",-69.12223,-15.14201,26,2,181,207,45,12,122,167
"Bolivia","La Paz","Bautista Saavedra","General Juan José Pérez (Charazani)","UNIDAD EDUCATIVA KALLURHUAYA",-68.84801,-15.1727,11,7,170,181,14,6,143,157
"Bolivia","La Paz","Camacho","Escoma","COLEGIO DON BOSCO",-69.1245,-15.64438,317,67,2520,2837,603,141,1709,2312
"Bolivia","La Paz","Camacho","Escoma","PLAZA 26 DE OCTUBRE",-69.15398,-15.6867,41,2,262,303,49,17,194,243
"Bolivia","La Paz","Camacho","Escoma","PLAZA PRINCIPAL",-69.16642,-15.65046,21,5,271,292,94,16,156,250
"Bolivia","La Paz","Camacho","Escoma","PLAZA PRINCIPAL DE COLLASUYO",-69.13799,-15.6649,1,2,121,122,30,0,89,119
"Bolivia","La Paz","Camacho","Humanata","COL. SAN FRANCISCO DE PADUA",-69.11379,-15.45604,246,62,1646,1892,381,165,1038,1419
"Bolivia","La Paz","Camacho","Humanata","COL. SANTA ANA DE CUTUCUTU",-69.18256,-15.43143,32,5,192,224,41,13,133,174
"Bolivia","La Paz","Camacho","Humanata","ESC. S.J. DE PACOLLO",-69.19728,-15.42445,13,1,220,233,58,7,154,212
"Bolivia","La Paz","Camacho","Mocomoco","COLEGIO CARIQUINA CHICO",-69.0692,-15.5392,21,3,133,154,24,9,97,121
"Bolivia","La Paz","Camacho","Mocomoco","COLEGIO TECNICO YOCARGUAYA",-69.0155,-15.58194,51,4,180,231,12,6,158,170
"Bolivia","La Paz","Camacho","Mocomoco","COL. SAN JOSE",-69.06486,-15.39754,19,7,352,371,84,15,246,330
"Bolivia","La Paz","Camacho","Mocomoco","COL. SAN LUIS WILA CALA",-69.04415,-15.35719,92,15,573,665,100,28,430,530
"Bolivia","La Paz","Camacho","Mocomoco","COL. TAJANI",-69.0649,-15.61726,37,14,438,475,105,30,289,394
"Bolivia","La Paz","Camacho","Mocomoco","ESC. QUILLIMA",-69.02345,-15.62034,14,0,363,377,73,14,276,349
"Bolivia","La Paz","Camacho","Mocomoco","ESC. SECCIONAL V. JACHATIRA",-69.03743,-15.53999,0,1,65,65,18,1,45,63
"Bolivia","La Paz","Camacho","Mocomoco","ESC. TUNTUNANI",-68.9683,-15.50293,24,3,102,126,18,2,79,97
"Bolivia","La Paz","Camacho","Mocomoco","ESC. UNIDAD EDUCATIVA PACAURES",-69.0611,-15.5844,67,25,528,595,83,21,399,482
"Bolivia","La Paz","Camacho","Mocomoco","NUCLEO ESCOLAR PUMANA",-69.02091,-15.51972,39,2,222,261,25,12,183,208
"Bolivia","La Paz","Camacho","Mocomoco","NÚCLEO ESCOLAR TAYPI AYCA",-69.08912,-15.5147,5,2,169,174,10,3,154,164
"Bolivia","La Paz","Camacho","Mocomoco","PLAZA MOCO MOCO",-68.99878,-15.45637,211,46,967,1178,262,78,581,843
"Bolivia","La Paz","Camacho","Mocomoco","PLAZA SANTIAGO DE ILAVE",-69.01241,-15.36129,79,19,464,543,75,23,347,422
"Bolivia","La Paz","Camacho","Mocomoco","SEDE SOCIAL",-69.08668,-15.61018,0,1,60,60,21,2,36,57
"Bolivia","La Paz","Camacho","Mocomoco","UNIDAD EDUCATIVA CAJCACHI",-69.0796,-15.59127,12,2,149,161,34,13,100,134
"Bolivia","La Paz","Camacho","Mocomoco","UNIDAD EDUCATIVA ITALAQUE",-69.04504,-15.47639,101,19,432,533,49,37,327,376
"Bolivia","La Paz","Camacho","Mocomoco","UNIDAD EDUCATIVA QUEÑI",-68.97206,-15.43503,56,8,199,255,60,15,116,176
"Bolivia","La Paz","Camacho","Puerto Acosta","COLEGIO NACIONAL MIXTO CHIÑAYA",-69.11092,-15.52736,89,24,447,536,102,29,292,394
"Bolivia","La Paz","Camacho","Puerto Acosta","COLEGIO NACIONAL SALLACUCHO",-69.20315,-15.49551,36,9,328,364,51,21,247,298
"Bolivia","La Paz","Camacho","Puerto Acosta","COL. NICOLAS ACOSTA",-69.25303,-15.53491,222,42,1690,1912,581,86,981,1562
"Bolivia","La Paz","Camacho","Puerto Acosta","ESC. COTA PATA",-69.21085,-15.61913,16,10,211,227,46,12,143,189
"Bolivia","La Paz","Camacho","Puerto Acosta","ESC. JUPANI",-69.25771,-15.49459,33,6,309,342,126,20,157,283
"Bolivia","La Paz","Camacho","Puerto Acosta","ESC. PUERTO BELEN",-69.28316,-15.59171,17,4,361,378,78,1,278,356
"Bolivia","La Paz","Camacho","Puerto Acosta","ESC. SECCIONAL CANCANANI",-69.10598,-15.479,9,2,56,65,4,0,50,54
"Bolivia","La Paz","Camacho","Puerto Acosta","ESCUELA CENTRO BELEN",-69.11071,-15.60047,19,6,232,251,68,10,148,216
"Bolivia","La Paz","Camacho","Puerto Acosta","ESCUELA CHACAHUARA",-69.31122,-15.49251,9,0,53,62,14,7,32,46
"Bolivia","La Paz","Camacho","Puerto Acosta","PLAZA PUERTO PARAJACHI",-69.20171,-15.62851,42,6,700,742,236,10,448,684
"Bolivia","La Paz","Camacho","Puerto Acosta","U.E. PARAJACHI II",-69.21049,-15.64598,12,0,147,159,41,6,100,141
"Bolivia","La Paz","Camacho","Puerto Acosta","UNIDAD EDUCATIVA CENTRO CALANGACHI",-69.25439,-15.63603,28,2,165,193,52,0,111,163
"Bolivia","La Paz","Camacho","Puerto Acosta","UNIDAD EDUCATIVA ORURILLO",-69.31892,-15.53868,9,2,144,153,58,8,76,134
"Bolivia","La Paz","Camacho","Puerto Carabuco","COLEGIO COTAÑANI",-68.96169,-15.61601,16,3,131,147,24,2,102,126
"Bolivia","La Paz","Camacho","Puerto Carabuco","COLEGIO MARTIN CARDENAS",-69.03745,-15.78911,215,25,1074,1289,355,64,630,985
"Bolivia","La Paz","Camacho","Puerto Carabuco","COLEGIO NACIONAL MIXTO CHUANI",-68.98556,-15.64204,33,7,347,380,75,23,242,317
"Bolivia","La Paz","Camacho","Puerto Carabuco","COLEGIO PASARANI",-68.9835,-15.57729,104,15,468,572,97,19,337,434
"Bolivia","La Paz","Camacho","Puerto Carabuco","ESC. MCAL. SUCRE",-68.96303,-15.6083,89,10,495,584,65,32,388,453
"Bolivia","La Paz","Camacho","Puerto Carabuco","ESC. S. M. DE YARICOA",-69.08703,-15.67951,28,8,232,260,50,22,152,202
"Bolivia","La Paz","Camacho","Puerto Carabuco","ESCUELA HUILACUNCA",-68.94692,-15.56903,62,19,296,358,53,13,211,264
"Bolivia","La Paz","Camacho","Puerto Carabuco","PLAZA PRINCIPAL COPUSQUIA",-68.95209,-15.66244,66,9,476,542,56,19,392,448
"Bolivia","La Paz","Camacho","Puerto Carabuco","PLAZA SISASANI",-68.98576,-15.81754,53,7,351,404,75,17,252,327
"Bolivia","La Paz","Camacho","Puerto Carabuco","UNID.EDU. URSULA GOYZUETA",-69.0638,-15.75902,216,37,1524,1740,381,83,1023,1404
"Bolivia","La Paz","Caranavi","Alto Beni","ESC. C. BELLA VISTA",-67.42459,-15.62154,67,6,483,550,130,30,317,447
"Bolivia","La Paz","Caranavi","Alto Beni","ESC. N. SARARIA",-67.51301,-15.39834,90,4,481,571,114,35,328,442
"Bolivia","La Paz","Caranavi","Alto Beni","ESCUELA CASERIO NUEVE",-67.39796,-15.59869,56,0,316,372,66,8,242,308
"Bolivia","La Paz","Caranavi","Alto Beni","ESCUELA PIQUENDO",-67.38728,-15.59628,95,6,638,733,128,28,476,604
"Bolivia","La Paz","Caranavi","Alto Beni","LOCAL AMAS DE CASA",-67.44894,-15.54566,31,7,227,258,60,3,157,217
"Bolivia","La Paz","Caranavi","Alto Beni","N. ESC. SAN ANTONIO",-67.17532,-15.6578,167,13,929,1096,154,21,741,895
"Bolivia","La Paz","Caranavi","Alto Beni","SEDE SOCIAL",-67.44275,-15.55506,107,14,577,684,138,15,410,548
"Bolivia","La Paz","Caranavi","Alto Beni","SEDE SOCIAL",-67.46413,-15.481,107,14,577,684,138,15,410,548
"Bolivia","La Paz","Caranavi","Alto Beni","UNIDAD EDUCATIVA PUENTE ALTO BENI",-67.3764,-15.56314,13,5,146,159,24,4,113,137
"Bolivia","La Paz","Caranavi","Alto Beni","UNIDAD EDUCATIVA VILLA EL PORVENIR",-67.24788,-15.60961,26,1,313,339,35,7,270,305
"Bolivia","La Paz","Caranavi","Alto Beni","UNIDAD EDUCATIVA VILLA LITORAL",-67.24664,-15.60868,20,4,266,286,22,11,229,251
"Bolivia","La Paz","Caranavi","Caranavi","COL. GUILLERMO MOLINA",-67.44241,-15.77615,204,14,911,1115,133,27,737,870
"Bolivia","La Paz","Caranavi","Caranavi","COL. JHON F. KENEDDY",-67.56451,-15.83448,1199,55,4839,6038,1946,141,2697,4643
"Bolivia","La Paz","Caranavi","Caranavi","COL. LOS ANDES",-67.57357,-15.75793,59,7,519,578,86,6,420,506
"Bolivia","La Paz","Caranavi","Caranavi","COL. MADRE MARIA FEDERICA",-67.56628,-15.83424,728,47,3533,4261,1531,105,1850,3381
"Bolivia","La Paz","Caranavi","Caranavi","COL. SAN LORENZO",-67.50715,-15.79369,95,5,903,998,129,23,746,875
"Bolivia","La Paz","Caranavi","Caranavi","ESC. CARRASCO LA RESERVA",-67.51271,-15.73402,199,20,1453,1652,153,38,1242,1395
"Bolivia","La Paz","Caranavi","Caranavi","ESC. C. DE CHOJNA",-67.56999,-15.95466,14,1,259,273,55,4,199,254
"Bolivia","La Paz","Caranavi","Caranavi","ESC. F. INCAHUARA",-67.59956,-15.97782,16,0,55,71,3,1,51,54
"Bolivia","La Paz","Caranavi","Caranavi","ESC. MSCAL. SANTA CRUZ",-67.4963,-15.74751,69,9,397,466,35,7,346,381
"Bolivia","La Paz","Caranavi","Caranavi","ESC. N. CHORO",-67.63139,-16.03343,23,2,133,156,36,4,91,127
"Bolivia","La Paz","Caranavi","Caranavi","ESC. P. DOMINGO MURILLO",-67.47856,-15.93649,263,19,1631,1894,334,55,1223,1557
"Bolivia","La Paz","Caranavi","Caranavi","ESC. SAN PEDRO",-67.61211,-16.00981,19,1,102,121,4,7,90,94
"Bolivia","La Paz","Caranavi","Caranavi","ESC. SECCIONAL SANTA ANA",-67.54862,-15.89038,73,9,367,440,57,10,291,348
"Bolivia","La Paz","Caranavi","Caranavi","ESC. SIMON BOLIVAR",-67.59677,-15.62007,162,19,770,932,136,33,582,718
"Bolivia","La Paz","Caranavi","Caranavi","ESC. TUPAC KATARI",-67.4232,-15.8093,84,8,484,568,66,13,397,463
"Bolivia","La Paz","Caranavi","Caranavi","ESCUELA CENTRAL VILLAMONTES",-67.31539,-15.8295,44,2,262,306,34,4,222,256
"Bolivia","La Paz","Caranavi","Caranavi","ESCUELA SIMON BOLIVAR DE SANTA FE",-67.62475,-15.80753,84,4,524,608,143,16,361,504
"Bolivia","La Paz","Caranavi","Caranavi","ESC. UYUNENSE",-67.58036,-15.86842,53,10,419,472,68,19,322,390
"Bolivia","La Paz","Caranavi","Caranavi","INSTITUTO AMERICANO",-67.56655,-15.8344,19,0,69,88,31,2,36,67
"Bolivia","La Paz","Caranavi","Caranavi","SEDE SOCIAL",-67.60384,-15.68305,170,6,1140,1310,137,75,922,1059
"Bolivia","La Paz","Caranavi","Caranavi","SEDE SOCIAL",-67.67484,-15.74946,170,6,1140,1310,137,75,922,1059
"Bolivia","La Paz","Caranavi","Caranavi","SEDE SOCIAL",-67.62841,-15.68759,170,6,1140,1310,137,75,922,1059
"Bolivia","La Paz","Caranavi","Caranavi","U. E. RENE ZENON PORTILLO CHAVARRIA",-67.54003,-15.77183,34,1,279,313,66,7,205,271
"Bolivia","La Paz","Caranavi","Caranavi","U.E. SUAZO",-67.56655,-15.8344,17,1,86,103,34,4,47,81
"Bolivia","La Paz","Caranavi","Caranavi","U.E. VENEZUELA",-67.56655,-15.8344,22,1,87,109,24,3,59,83
"Bolivia","La Paz","Caranavi","Caranavi","UNIDAD EDUCATIVA MANCHEGO",-67.60762,-15.852,15,1,163,178,60,2,100,160
"Bolivia","La Paz","Caranavi","Caranavi","UNIDAD EDUCATIVA NUEVA LLUSTA 2DA",-67.39731,-15.85297,51,3,317,368,38,7,269,307
"Bolivia","La Paz","Caranavi","Caranavi","UNIDAD EDUCATIVA SIMON BOLIVAR",-67.55769,-15.83356,647,26,2798,3445,1060,84,1628,2688
"Bolivia","La Paz","Franz Tamayo","Apolo","ESC. CENTRAL ATEN",-68.33105,-14.93176,44,8,245,289,139,17,81,220
"Bolivia","La Paz","Franz Tamayo","Apolo","ESC. CENTRAL INCA",-68.43272,-14.81314,49,6,240,289,75,11,148,223
"Bolivia","La Paz","Franz Tamayo","Apolo","ESC. MACHUA",-68.41223,-14.66684,25,7,162,187,56,13,86,142
"Bolivia","La Paz","Franz Tamayo","Apolo","ESC. MOJOS",-68.89278,-14.56084,2,2,25,27,5,1,17,22
"Bolivia","La Paz","Franz Tamayo","Apolo","ESC. NAZARIO PARDO VALLE",-68.51307,-14.63398,1132,137,4104,5236,2147,188,1632,3779
"Bolivia","La Paz","Franz Tamayo","Apolo","ESC. NAZARIO PARDO VALLE",-68.41825,-14.71928,1132,137,4104,5236,2147,188,1632,3779
"Bolivia","La Paz","Franz Tamayo","Apolo","ESC. PATA SAN ANTONIO",-68.65208,-14.56562,0,2,102,102,34,19,47,81
"Bolivia","La Paz","Franz Tamayo","Apolo","ESC. PUCHAHUI",-68.44442,-14.86157,75,6,378,453,168,16,188,356
"Bolivia","La Paz","Franz Tamayo","Apolo","ESC. SANTA CATALINA",-68.49142,-14.74016,99,15,363,462,130,23,195,325
"Bolivia","La Paz","Franz Tamayo","Apolo","ESCUELA CORREO",-68.44034,-14.95642,21,2,164,185,12,1,149,161
"Bolivia","La Paz","Franz Tamayo","Apolo","ESCUELA MUNAYPATA",-68.30943,-15.0214,50,5,222,272,78,4,135,213
"Bolivia","La Paz","Franz Tamayo","Apolo","UNIDADA EDUCATIVA TOREWA",-67.5419,-14.5968,45,0,21,66,8,1,12,20
"Bolivia","La Paz","Franz Tamayo","Apolo","UNIDAD EDUCATIVA INDIGENA TOREWA",-67.60982,-14.71774,15,0,18,33,3,1,14,17
"Bolivia","La Paz","Franz Tamayo","Pelechuco","ESC. CANTON SUCHES",-69.33424,-14.81951,38,3,173,211,78,7,85,163
"Bolivia","La Paz","Franz Tamayo","Pelechuco","ESC. COL. FRANZ TAMAYO",-69.27006,-15.06253,54,11,433,487,172,26,224,396
"Bolivia","La Paz","Franz Tamayo","Pelechuco","ESC. NAZARIO PARDO VALLE",-69.06972,-14.82036,100,13,606,706,249,34,310,559
"Bolivia","La Paz","Franz Tamayo","Pelechuco","ESC. PUINA",-69.13412,-14.61019,14,0,90,104,22,4,64,86
"Bolivia","La Paz","Franz Tamayo","Pelechuco","ESCUELA AGUA BLANCA",-69.10895,-14.8218,16,3,163,179,64,5,91,155
"Bolivia","La Paz","Franz Tamayo","Pelechuco","ESCUELA DE PUYO PUYO",-69.17246,-14.99942,13,2,171,184,106,3,60,166
"Bolivia","La Paz","Franz Tamayo","Pelechuco","ESCUELA SAN MIGUEL DE THAPI",-68.93021,-14.77682,19,0,103,122,63,4,36,99
"Bolivia","La Paz","Franz Tamayo","Pelechuco","ESCUELA SORAPATA",-68.97952,-14.79948,19,2,110,129,53,9,46,99
"Bolivia","La Paz","Franz Tamayo","Pelechuco","IGLESIA COPACABANA DE ANTIQUILLA",-69.28759,-14.88028,36,9,281,317,68,9,195,263
"Bolivia","La Paz","Franz Tamayo","Pelechuco","NUCLEO  EDUCATIVO HICHOCOLLO",-69.29661,-14.95523,12,2,220,232,70,14,134,204
"Bolivia","La Paz","Franz Tamayo","Pelechuco","SEDE DEL SINDICATO",-69.02939,-14.9247,73,2,278,351,81,27,168,249
"Bolivia","La Paz","General Jose Manuel","Catacora","ESC. THOLA COLLO",-69.55451,-17.23441,14,0,78,92,16,2,60,76
"Bolivia","La Paz","General Jose Manuel","Catacora","NUCLEO ESCOLAR CATACORA",-69.48728,-17.16064,40,0,187,227,37,6,144,181
"Bolivia","La Paz","General Jose Manuel","Catacora","NUCLEO ESCOLAR PAIRUMANI GRANDE",-69.4282,-17.32692,9,1,85,94,19,3,62,81
"Bolivia","La Paz","General Jose Manuel","Catacora","PLAZA 6 DE AGOSTO",-69.46824,-17.29597,7,1,84,91,6,0,77,83
"Bolivia","La Paz","General Jose Manuel","Santiago de Machaca","COLEGIO BAUTISTA SAAVEDRA",-69.25512,-17.206,42,0,100,142,10,1,89,99
"Bolivia","La Paz","General Jose Manuel","Santiago de Machaca","COLEGIO PEDRO KRAMER",-69.21403,-17.28709,14,0,49,63,13,1,35,48
"Bolivia","La Paz","General Jose Manuel","Santiago de Machaca","ESCUELA ATACUNI",-69.15105,-17.17518,5,0,54,59,2,0,52,54
"Bolivia","La Paz","General Jose Manuel","Santiago de Machaca","ESCUELA CENTRAL HUARI PHUJO",-69.04736,-17.13798,6,0,82,88,7,1,74,81
"Bolivia","La Paz","General Jose Manuel","Santiago de Machaca","ESCUELA SANTIAGO DE MACHACA",-69.19207,-17.06675,244,25,1208,1452,220,32,931,1151
"Bolivia","La Paz","General Jose Manuel","Santiago de Machaca","PLAZA VILLA EXALTACION",-69.27541,-17.24455,4,0,125,129,18,0,107,125
"Bolivia","La Paz","Gualberto Villarroel","Chacarilla","ESC. PUERTO AROMA",-68.16104,-17.46223,8,3,204,212,42,6,153,195
"Bolivia","La Paz","Gualberto Villarroel","Chacarilla","PLAZA CHACARILLA",-68.20435,-17.58085,53,1,279,332,47,10,221,268
"Bolivia","La Paz","Gualberto Villarroel","Chacarilla","PLAZA ROSAPATA",-68.10223,-17.49878,25,2,262,287,43,8,209,252
"Bolivia","La Paz","Gualberto Villarroel","Papel Pampa","CASA DE GOBIERNO",-67.82444,-17.66832,94,16,772,866,170,18,568,738
"Bolivia","La Paz","Gualberto Villarroel","Papel Pampa","CASA DE GOBIERNO",-67.76893,-17.81909,94,16,772,866,170,18,568,738
"Bolivia","La Paz","Gualberto Villarroel","Papel Pampa","ESC. TITUZA",-67.57115,-17.60931,9,2,88,97,17,3,66,83
"Bolivia","La Paz","Gualberto Villarroel","Papel Pampa","ESCUELA CIRCA CRUZANI",-67.62467,-17.71481,2,0,65,67,7,1,57,64
"Bolivia","La Paz","Gualberto Villarroel","Papel Pampa","ESCUELA COLQUE AMAYA ALTA",-67.78625,-17.57081,14,4,266,280,51,8,203,254
"Bolivia","La Paz","Gualberto Villarroel","Papel Pampa","PLAZA MOLLEBAMBA",-67.82986,-17.73928,55,7,622,677,123,15,477,600
"Bolivia","La Paz","Gualberto Villarroel","Papel Pampa","PLAZA PRINCIPAL UNO PATA",-67.71118,-17.69406,54,4,417,471,88,16,309,397
"Bolivia","La Paz","Gualberto Villarroel","Papel Pampa","PLAZA RIVERA ALTA",-67.66396,-17.59161,15,2,271,286,98,8,163,261
"Bolivia","La Paz","Gualberto Villarroel","Papel Pampa","SEDE SINDICAL",-67.6296,-17.74787,3,0,72,75,10,0,62,72
"Bolivia","La Paz","Gualberto Villarroel","Papel Pampa","SEDE SOCIAL CAYLLA CHURO",-67.56867,-17.6794,4,0,50,54,8,0,42,50
"Bolivia","La Paz","Gualberto Villarroel","Papel Pampa","UNIDAD EDUCATIVA PACOLLO",-67.8727,-17.78063,3,0,129,132,9,2,118,127
"Bolivia","La Paz","Gualberto Villarroel","Papel Pampa","UNIDAD EDUCATIVA SAN JOSE",-67.75399,-17.72414,25,4,183,208,53,2,124,177
"Bolivia","La Paz","Gualberto Villarroel","San Pedro de Curahuara","CASA COMUNAL",-68.05531,-17.53329,3,3,87,90,23,1,60,83
"Bolivia","La Paz","Gualberto Villarroel","San Pedro de Curahuara","CASA DE GOBIERNO",-68.04781,-17.65329,75,4,516,591,52,16,444,496
"Bolivia","La Paz","Gualberto Villarroel","San Pedro de Curahuara","COLEGIO HERNANDO SILES",-67.91642,-17.5809,79,6,530,609,52,21,451,503
"Bolivia","La Paz","Gualberto Villarroel","San Pedro de Curahuara","COLEGIO LUIS ESPINAL",-67.98427,-17.54257,46,1,377,423,30,2,344,374
"Bolivia","La Paz","Gualberto Villarroel","San Pedro de Curahuara","COLEGIO WISCO KARI",-67.96583,-17.72286,6,0,425,431,121,9,295,416
"Bolivia","La Paz","Gualberto Villarroel","San Pedro de Curahuara","ESC. CHILAGUALA",-68.01054,-17.47809,10,0,89,99,9,2,78,87
"Bolivia","La Paz","Gualberto Villarroel","San Pedro de Curahuara","ESC. JUAN CANCIO COLQUE",-68.10113,-17.65724,4,0,38,42,11,2,25,36
"Bolivia","La Paz","Gualberto Villarroel","San Pedro de Curahuara","PLAZA JANKO MARCA",-67.87048,-17.66836,0,0,397,397,0,4,393,393
"Bolivia","La Paz","Gualberto Villarroel","San Pedro de Curahuara","PLAZA PEDRO DOMINGO MURILLO",-67.87997,-17.63544,9,0,368,377,86,3,279,365
"Bolivia","La Paz","Gualberto Villarroel","San Pedro de Curahuara","PLAZA ROSARIO",-67.8949,-17.73604,4,0,313,317,5,20,288,293
"Bolivia","La Paz","Gualberto Villarroel","San Pedro de Curahuara","SEDE SINDICAL",-67.83096,-17.56285,0,2,88,88,5,3,78,83
"Bolivia","La Paz","Ingaví","Desaguadero","COL. BATALLON COLORADOS",-69.03388,-16.56696,310,26,2535,2845,1635,66,808,2443
"Bolivia","La Paz","Ingaví","Desaguadero","ESC. AZAFRANAL",-68.99149,-16.58226,27,3,289,316,90,6,190,280
"Bolivia","La Paz","Ingaví","Desaguadero","ESC. MCAL. ANDRES DE SANTA CRUZ",-68.95457,-16.58847,57,12,463,520,112,29,310,422
"Bolivia","La Paz","Ingaví","Desaguadero","UNIDAD EDUCATIVA SIMÓN BOLÍVAR",-68.93962,-16.63942,19,5,143,162,54,11,73,127
"Bolivia","La Paz","Ingaví","Guaqui","COLEGIO DANIEL SANCHEZ BUSTAMANTE",-68.83635,-16.59753,162,19,780,942,234,43,484,718
"Bolivia","La Paz","Ingaví","Guaqui","COL. TOMAS KATARI",-68.79683,-16.58405,165,47,1601,1766,335,59,1160,1495
"Bolivia","La Paz","Ingaví","Guaqui","ESC. ISMAEL MONTES",-68.85074,-16.59324,223,17,873,1096,281,41,534,815
"Bolivia","La Paz","Ingaví","Guaqui","UNIDAD EDUCATIVA WILACOLLO",-68.91432,-16.59871,17,4,168,185,38,9,117,155
"Bolivia","La Paz","Ingaví","Jesús de Machaca","COLEGIO CHAMA",-68.57966,-16.79505,17,6,292,309,78,10,198,276
"Bolivia","La Paz","Ingaví","Jesús de Machaca","COL. HOLANDA",-68.89614,-16.80193,38,7,415,453,110,18,280,390
"Bolivia","La Paz","Ingaví","Jesús de Machaca","COL. MEJILLONES",-68.80325,-16.82421,16,6,304,320,81,7,210,291
"Bolivia","La Paz","Ingaví","Jesús de Machaca","COL. REP. DE NORUEGA",-68.74157,-16.77844,31,15,376,407,98,8,255,353
"Bolivia","La Paz","Ingaví","Jesús de Machaca","ESC. FRANZ TAMAYO",-68.61249,-16.78762,0,2,107,107,22,3,80,102
"Bolivia","La Paz","Ingaví","Jesús de Machaca","ESC. NUCLEO CUIPA ESPANA DE MACHACA",-68.63845,-16.79134,4,6,273,277,27,9,231,258
"Bolivia","La Paz","Ingaví","Jesús de Machaca","ESC. SAN FELIPE DE CORPA",-68.8671,-16.67783,73,4,955,1028,135,36,780,915
"Bolivia","La Paz","Ingaví","Jesús de Machaca","ESC. SECC. KHONKHO",-68.67211,-16.7936,21,2,140,161,30,4,104,134
"Bolivia","La Paz","Ingaví","Jesús de Machaca","ESCUELA GERMAN BUSCH",-68.70154,-16.77555,22,4,334,356,62,9,259,321
"Bolivia","La Paz","Ingaví","Jesús de Machaca","PLAZA DEL PUEBLO",-68.76755,-16.77356,29,4,331,360,61,6,260,321
"Bolivia","La Paz","Ingaví","Jesús de Machaca","PLAZA PRINCIPAL",-68.80595,-16.74199,77,18,635,712,164,15,438,602
"Bolivia","La Paz","Ingaví","Jesús de Machaca","PLAZA VILLA ASUNCION DE MACHACA",-68.85337,-16.69936,27,2,378,405,95,6,275,370
"Bolivia","La Paz","Ingaví","Jesús de Machaca","POSTA SANITARIA",-68.63844,-16.84721,33,10,168,201,35,5,118,153
"Bolivia","La Paz","Ingaví","Jesús de Machaca","SEDE SOCIAL",-68.83674,-16.71817,33,7,428,461,93,24,304,397
"Bolivia","La Paz","Ingaví","Jesús de Machaca","SEDE SOCIAL",-68.5472,-16.81992,33,7,428,461,93,24,304,397
"Bolivia","La Paz","Ingaví","San Andrés de Machaca","COLEGIO BOLIVIANO JAPONES",-68.95058,-17.02766,46,3,171,217,17,3,148,165
"Bolivia","La Paz","Ingaví","San Andrés de Machaca","COLEGIO TUPAK KATARI DE CONCHACOLLO",-68.99821,-16.7345,10,1,257,267,59,5,192,251
"Bolivia","La Paz","Ingaví","San Andrés de Machaca","COL. VILLA PUSUMA ALTO MACHACA",-69.16449,-16.80326,23,3,153,176,17,2,131,148
"Bolivia","La Paz","Ingaví","San Andrés de Machaca","ESC. FRANZ TAMAYO",-69.09547,-16.73553,23,1,96,119,7,1,87,94
"Bolivia","La Paz","Ingaví","San Andrés de Machaca","ESC. LITORAL CHUNCARCOTA",-69.02103,-16.79199,9,3,127,136,23,6,95,118
"Bolivia","La Paz","Ingaví","San Andrés de Machaca","ESC. NUCLEO LAQUINAMAYA",-69.19246,-16.94843,43,3,238,281,47,3,185,232
"Bolivia","La Paz","Ingaví","San Andrés de Machaca","ESCUELA DE SAN ANDRES DE MACHACA",-68.96825,-16.95646,100,9,355,455,69,17,260,329
"Bolivia","La Paz","Ingaví","San Andrés de Machaca","PLAZA PRINCIPAL",-68.76829,-16.93683,21,8,169,190,51,4,106,157
"Bolivia","La Paz","Ingaví","San Andrés de Machaca","SEDE SOCIAL(COMUNIDAD MAURI)",-69.13435,-16.83909,10,1,110,120,16,0,93,109
"Bolivia","La Paz","Ingaví","San Andrés de Machaca","UNIDAD EDUCATIVA ANTAQUIRANI",-69.07945,-16.8683,4,1,79,83,20,1,57,77
"Bolivia","La Paz","Ingaví","San Andrés de Machaca","UNIDAD EDUCATIVA ROSA PATA ERBEN KALLA",-68.91935,-16.83392,9,1,143,152,27,7,108,135
"Bolivia","La Paz","Ingaví","Taraco","COL. NUCLEO FRAY JOSE ZAMPA",-68.82944,-16.43332,24,6,212,236,37,4,165,202
"Bolivia","La Paz","Ingaví","Taraco","COL. OVANDO CANDIA",-68.94234,-16.44834,40,16,562,602,90,30,426,516
"Bolivia","La Paz","Ingaví","Taraco","ESC. TARACO",-68.8576,-16.45572,158,24,1348,1506,269,60,995,1264
"Bolivia","La Paz","Ingaví","Taraco","SEDE SOCIAL",-68.79443,-16.43522,6,6,229,235,47,9,167,214
"Bolivia","La Paz","Ingaví","Tiahuanacu","COLEGIO JOSE BALLIVIAN",-68.74157,-16.44234,90,17,1170,1260,212,55,886,1098
"Bolivia","La Paz","Ingaví","Tiahuanacu","COLEGIO NACIONAL ARTURO POSNANSKI",-68.67873,-16.55647,311,56,3225,3536,900,175,2094,2994
"Bolivia","La Paz","Ingaví","Tiahuanacu","ESC. CENTRAL PILLAPI",-68.7683,-16.5035,57,13,957,1014,225,31,688,913
"Bolivia","La Paz","Ingaví","Viacha","CASA DE GOBIERNO",-68.25248,-16.80821,19,5,177,196,41,12,119,160
"Bolivia","La Paz","Ingaví","Viacha","COLEGIO BALLIVIAN",-68.29795,-16.65053,1101,111,8727,9828,3309,320,4987,8296
"Bolivia","La Paz","Ingaví","Viacha","COLEGIO JHONN F. KENNEDI",-68.17124,-16.77349,53,16,692,745,183,30,463,646
"Bolivia","La Paz","Ingaví","Viacha","COL. HACIA EL MAR",-68.24142,-16.75815,55,16,601,656,101,37,447,548
"Bolivia","La Paz","Ingaví","Viacha","COL. NAL. MIXTO CALAMA",-68.30962,-16.82777,32,14,398,430,93,17,274,367
"Bolivia","La Paz","Ingaví","Viacha","ESC. 18 DE NOVIEMBRE",-68.2989,-16.64955,463,43,3785,4248,1450,129,2163,3613
"Bolivia","La Paz","Ingaví","Viacha","ESC. ACHICA ARRIBA",-68.18732,-16.71439,48,6,767,815,179,47,535,714
"Bolivia","La Paz","Ingaví","Viacha","ESC. CENTRO TILATA",-68.23033,-16.58882,888,115,10123,11011,2890,388,6730,9620
"Bolivia","La Paz","Ingaví","Viacha","ESC. EVARISTO VALLE",-68.29871,-16.65074,563,69,5014,5577,1890,189,2866,4756
"Bolivia","La Paz","Ingaví","Viacha","ESC. SAN LUIS",-68.29977,-16.65029,379,32,3724,4103,1550,114,2028,3578
"Bolivia","La Paz","Ingaví","Viacha","ESC. VILIROCO",-68.24899,-16.61097,246,33,3367,3613,817,195,2322,3139
"Bolivia","La Paz","Ingaví","Viacha","PLAZA JOSE BALLIVIAN",-68.23183,-16.8031,20,5,309,329,87,11,206,293
"Bolivia","La Paz","Ingaví","Viacha","PLAZA PRINCIPAL",-68.42336,-16.81759,51,2,256,307,57,7,190,247
"Bolivia","La Paz","Ingaví","Viacha","SAN PEDRO DE CHONCHOCORO",-68.29809,-16.65042,18,0,111,129,62,1,48,110
"Bolivia","La Paz","Ingaví","Viacha","SEDE SOCIAL",-68.37337,-16.87176,4,4,160,164,37,6,113,150
"Bolivia","La Paz","Ingaví","Viacha","UNIDAD EDUCATIVA BATALLA DE INGAVI",-68.24085,-16.63196,15,3,58,73,20,1,34,54
"Bolivia","La Paz","Ingaví","Viacha","UNIDAD EDUCATIVA LITORAL",-68.29734,-16.85302,31,5,262,293,54,7,196,250
"Bolivia","La Paz","Ingaví","Viacha","UNIDAD EDUCATIVA TONCOPUJIO",-68.29401,-16.8719,6,4,160,166,18,4,134,152
"Bolivia","La Paz","Inquisivi","Cajuata","CASA DE GOBIERNO",-67.1912,-16.74741,128,24,1066,1194,132,26,884,1016
"Bolivia","La Paz","Inquisivi","Cajuata","CASA DE GOBIERNO",-67.26615,-16.62763,128,24,1066,1194,132,26,884,1016
"Bolivia","La Paz","Inquisivi","Cajuata","ESCUELA",-67.28862,-16.5991,62,11,374,436,60,10,293,353
"Bolivia","La Paz","Inquisivi","Cajuata","ESCUELA HUARITOLO",-67.20372,-16.72687,51,15,364,415,59,14,276,335
"Bolivia","La Paz","Inquisivi","Cajuata","UNIDAD EDUCATIVA CIRCUATA",-67.23114,-16.64647,97,18,808,905,155,35,600,755
"Bolivia","La Paz","Inquisivi","Cajuata","UNIDAD EDUCATIVA MIGUILLAS",-67.33664,-16.55579,55,5,357,412,25,1,326,351
"Bolivia","La Paz","Inquisivi","Cajuata","UNIDA EDUCATIVA CAJUATA",-67.17103,-16.69801,262,62,1722,1984,366,64,1230,1596
"Bolivia","La Paz","Inquisivi","Colquiri","CASA DE GOBIERNO",-66.98113,-17.55202,98,51,737,835,156,45,485,641
"Bolivia","La Paz","Inquisivi","Colquiri","CASA DE GOBIERNO",-66.90228,-17.38338,98,51,737,835,156,45,485,641
"Bolivia","La Paz","Inquisivi","Colquiri","CASA DE GOBIERNO",-66.93718,-17.58477,98,51,737,835,156,45,485,641
"Bolivia","La Paz","Inquisivi","Colquiri","COLEGIO ALTO DE LA ALIANZA",-66.8511,-17.5196,23,4,259,282,57,41,157,214
"Bolivia","La Paz","Inquisivi","Colquiri","COLEGIO SIMON BOLIVAR",-66.99767,-17.44226,62,12,553,615,114,31,396,510
"Bolivia","La Paz","Inquisivi","Colquiri","ESC. SIMON BOLIVAR",-66.9579,-17.54244,19,3,161,180,39,9,110,149
"Bolivia","La Paz","Inquisivi","Colquiri","ESCUELA ANICETO ARCE",-66.87982,-17.35054,24,9,205,229,37,7,152,189
"Bolivia","La Paz","Inquisivi","Colquiri","ESCUELA CAQUENA ENTRE RIOS",-67.00492,-17.32234,21,0,222,243,12,2,208,220
"Bolivia","La Paz","Inquisivi","Colquiri","ESCUELA CENTRAL UYUNI",-66.91545,-17.44477,39,37,280,319,68,20,155,223
"Bolivia","La Paz","Inquisivi","Colquiri","ESCUELA JOSE MIGUEL LANZA",-66.94537,-17.36096,80,19,618,698,119,13,467,586
"Bolivia","La Paz","Inquisivi","Colquiri","ESCUELA PIPINI",-66.92647,-17.48633,25,3,191,216,45,11,132,177
"Bolivia","La Paz","Inquisivi","Colquiri","ESCUELA SECCIONAL CHUALLA",-66.86385,-17.45984,11,0,157,168,31,4,122,153
"Bolivia","La Paz","Inquisivi","Colquiri","ESCUELA SECCIONAL CORIRI",-66.86787,-17.39233,15,3,92,107,14,4,71,85
"Bolivia","La Paz","Inquisivi","Colquiri","LADISLAO CABRERA",-67.13279,-17.38032,344,57,2869,3213,1250,153,1409,2659
"Bolivia","La Paz","Inquisivi","Colquiri","U.E. MARISCAL DE ZEPITA",-67.12341,-17.3896,174,29,1489,1663,602,68,790,1392
"Bolivia","La Paz","Inquisivi","Colquiri","UNIDAD EDUCATIVA MARQUIRIVI",-66.84624,-17.48428,16,0,205,221,37,3,165,202
"Bolivia","La Paz","Inquisivi","Ichoca","CASA DE GOBIERNO",-67.28601,-17.123,4,6,107,111,30,3,68,98
"Bolivia","La Paz","Inquisivi","Ichoca","ESC. CENTRAL LURUTA",-67.12575,-17.23102,29,3,156,185,43,3,107,150
"Bolivia","La Paz","Inquisivi","Ichoca","ESCUELA JOSE ANTONIO DE SUCRE",-67.30527,-17.25527,13,6,321,334,38,8,269,307
"Bolivia","La Paz","Inquisivi","Ichoca","ESCUELA PEDRO DOMINGO MURILLO",-67.25848,-17.18484,19,6,209,228,22,6,175,197
"Bolivia","La Paz","Inquisivi","Ichoca","ESCUELA REPUBLICA DE VENEZUELA",-67.08401,-17.15735,25,8,130,155,19,6,97,116
"Bolivia","La Paz","Inquisivi","Ichoca","UNIDAD EDUCATIVA",-67.18003,-17.14062,141,15,569,710,91,19,444,535
"Bolivia","La Paz","Inquisivi","Ichoca","UNIDAD EDUCATIVA GERMAN BUSCH",-67.17284,-17.24399,1,5,173,174,62,4,102,164
"Bolivia","La Paz","Inquisivi","Inquisivi","ESC. CENTRAL CAVARI",-66.99092,-17.07948,81,14,373,454,53,21,285,338
"Bolivia","La Paz","Inquisivi","Inquisivi","ESC. EDUARDO AVAROA",-66.922,-16.79497,77,8,374,451,24,12,330,354
"Bolivia","La Paz","Inquisivi","Inquisivi","ESC. PEDRO DOMINGO MURILLO",-67.13365,-16.87514,52,5,334,386,50,16,263,313
"Bolivia","La Paz","Inquisivi","Inquisivi","ESCUELA ELIODORO CAMACHO",-67.13739,-16.90743,149,13,777,926,244,39,481,725
"Bolivia","La Paz","Inquisivi","Inquisivi","ESCUELA SIMON BOLIVAR",-66.91412,-17.25326,67,37,245,312,39,15,154,193
"Bolivia","La Paz","Inquisivi","Inquisivi","PLAZA DE LA FERIA DE VILLA VICTORIA",-67.01423,-17.23652,15,0,86,101,10,1,75,85
"Bolivia","La Paz","Inquisivi","Inquisivi","PLAZA PRINCIPAL",-66.86905,-16.60352,126,5,576,702,50,8,513,563
"Bolivia","La Paz","Inquisivi","Inquisivi","PLAZA PRINCIPAL 16 DE JULIO",-66.94501,-16.51898,201,12,654,855,125,12,505,630
"Bolivia","La Paz","Inquisivi","Inquisivi","SEDE SOCIAL",-67.09277,-16.88889,26,2,80,106,28,1,49,77
"Bolivia","La Paz","Inquisivi","Inquisivi","SEDE SOCIAL",-67.08649,-16.69044,26,2,80,106,28,1,49,77
"Bolivia","La Paz","Inquisivi","Inquisivi","UNIDAD EDUCATIVA ESCOLA",-67.01402,-16.88219,79,8,446,525,57,11,370,427
"Bolivia","La Paz","Inquisivi","Inquisivi","UNIDAD EDUCATIVA KANAMARCA",-67.07207,-16.34529,44,3,212,256,25,4,180,205
"Bolivia","La Paz","Inquisivi","Inquisivi","UNIDAD EDUCATIVA MARISCAL SUCRE",-67.08443,-16.78866,13,2,140,153,22,3,113,135
"Bolivia","La Paz","Inquisivi","Inquisivi","UNIDAD EDUCATIVA SIGUAS",-66.93951,-17.17848,31,20,283,314,49,24,190,239
"Bolivia","La Paz","Inquisivi","Inquisivi","UNIDAD EDUCATIVA TUPAK KATARI",-67.07355,-16.99531,83,24,470,553,83,67,296,379
"Bolivia","La Paz","Inquisivi","Licoma Pampa","ESCUELA ELIODORO CAMACHO",-67.20383,-16.80501,149,25,821,970,134,37,625,759
"Bolivia","La Paz","Inquisivi","Licoma Pampa","ESCUELA MIXTA CHARAPAXI",-67.1801,-16.84146,29,1,175,204,16,4,154,170
"Bolivia","La Paz","Inquisivi","Quime","ESC. PONGO B2",-67.27655,-16.98723,18,7,192,210,34,9,142,176
"Bolivia","La Paz","Inquisivi","Quime","ESC. TEODOMIRO URQUIOLA",-67.21542,-16.97982,292,70,2265,2557,758,137,1300,2058
"Bolivia","La Paz","Inquisivi","Quime","ESCUELA HUAYNACOTA",-67.28345,-17.03332,0,1,26,26,10,0,15,25
"Bolivia","La Paz","Inquisivi","Quime","ESCUELA SIMON BOLIVAR",-67.33048,-16.93823,119,14,492,611,255,13,210,465
"Bolivia","La Paz","Inquisivi","Quime","ESCUELA U.E. TITIAMAYA",-67.1907,-16.92141,4,0,110,114,21,4,85,106
"Bolivia","La Paz","Inquisivi","Quime","UNIDAD EDUCATIVA CHOQUETANGA",-67.31809,-16.8389,49,16,412,461,116,16,264,380
"Bolivia","La Paz","Larecaja","Combaya","ESC. CENTRAL SOREJAYA",-68.76491,-15.8242,22,5,333,355,61,21,246,307
"Bolivia","La Paz","Larecaja","Combaya","ESC. NUCLEO TICAMBLAYA",-68.73175,-15.83537,23,18,186,209,46,8,114,160
"Bolivia","La Paz","Larecaja","Combaya","UNIDAD EDUCATIVA EDUARDO AVAROA",-68.7542,-15.80447,52,29,293,345,67,19,178,245
"Bolivia","La Paz","Larecaja","Combaya","UNIDAD EDUCATIVA HUAYCHO",-68.73401,-15.81383,17,6,170,187,7,10,147,154
"Bolivia","La Paz","Larecaja","Guanay","ESC. C. CRESPO",-67.8819,-15.50123,409,21,1763,2172,783,46,913,1696
"Bolivia","La Paz","Larecaja","Guanay","ESC. CENTRAL CARURA",-67.96386,-15.42661,72,9,465,537,127,8,321,448
"Bolivia","La Paz","Larecaja","Guanay","ESC. MARIAPU",-68.05544,-15.40095,5,1,72,77,54,2,15,69
"Bolivia","La Paz","Larecaja","Guanay","ESC. SAN JUAN DE CHALLANA",-67.86722,-15.50406,7,0,60,67,49,1,10,59
"Bolivia","La Paz","Larecaja","Guanay","ESC. SECC. DE POROMA",-67.876,-15.66636,33,3,156,189,32,1,120,152
"Bolivia","La Paz","Larecaja","Guanay","ESC. SECC. MIXTA LA FABULOSA",-68.24464,-16.07889,3,0,42,45,3,0,39,42
"Bolivia","La Paz","Larecaja","Guanay","ESC. SECC. TRAPICHEPONTE",-67.74178,-15.64004,42,3,182,224,36,3,140,176
"Bolivia","La Paz","Larecaja","Guanay","ESCUELA PABLO AMAYA",-68.21191,-15.97806,11,0,79,90,21,8,50,71
"Bolivia","La Paz","Larecaja","Guanay","ESCUELA PAJONAL VILAQUE",-68.05408,-15.41886,22,3,146,168,89,2,52,141
"Bolivia","La Paz","Larecaja","Guanay","LA AGUADA",-67.92878,-15.49115,25,0,181,206,108,1,72,180
"Bolivia","La Paz","Larecaja","Guanay","NUCLEO ESCOLAR DE AMAGUAYA",-68.25602,-15.95273,15,0,80,95,30,1,49,79
"Bolivia","La Paz","Larecaja","Guanay","SEDE SOCIAL",-67.85902,-15.60936,1,2,45,46,15,0,28,43
"Bolivia","La Paz","Larecaja","Guanay","SINDICATO",-68.22674,-16.06047,1,0,59,60,9,7,43,52
"Bolivia","La Paz","Larecaja","Guanay","UNIDAD EDUCATIVA ALTO CHIJINI",-67.88482,-15.41975,5,0,37,42,9,0,28,37
"Bolivia","La Paz","Larecaja","Guanay","UNIDAD EDUCATIVA BUENOS AIRES",-67.68906,-15.70198,32,3,222,254,67,3,149,216
"Bolivia","La Paz","Larecaja","Guanay","UNIDAD EDUCATIVA CANDELARIA",-67.94775,-15.4421,32,4,465,497,110,3,348,458
"Bolivia","La Paz","Larecaja","Guanay","UNIDAD EDUCATIVA NACIONAL GUANAY",-67.88155,-15.49581,457,27,1864,2321,823,65,949,1772
"Bolivia","La Paz","Larecaja","Guanay","UNIDAD EDUCATIVA YOLOSANI",-67.79774,-15.57438,14,1,82,96,20,2,59,79
"Bolivia","La Paz","Larecaja","Mapiri","COLEGIO 1º DE MAYO",-68.20412,-15.28964,95,6,534,629,195,12,321,516
"Bolivia","La Paz","Larecaja","Mapiri","ESC. 16 DE JULIO",-68.21772,-15.31103,466,39,1816,2282,756,63,958,1714
"Bolivia","La Paz","Larecaja","Mapiri","ESC. CENTRAL DE SANTA ROSA",-68.32465,-15.31801,497,19,1423,1920,510,44,850,1360
"Bolivia","La Paz","Larecaja","Mapiri","ESC. DE SARAMPIUNI",-68.22166,-15.3938,19,0,118,137,27,2,89,116
"Bolivia","La Paz","Larecaja","Mapiri","ESC. MONJE ZAPATA",-68.26091,-15.20526,98,6,419,517,112,17,284,396
"Bolivia","La Paz","Larecaja","Mapiri","ESCUELA CHIMATE",-68.1562,-15.3971,33,1,153,186,36,5,111,147
"Bolivia","La Paz","Larecaja","Mapiri","ESC. UNIDAD EDUCATIVA VILAQUE GRANDE",-68.1724,-15.3626,26,3,189,215,49,4,133,182
"Bolivia","La Paz","Larecaja","Quiabaya","ESC. MIXTA JULIO CORDERO",-68.70292,-15.63772,182,34,1025,1207,291,64,636,927
"Bolivia","La Paz","Larecaja","Sorata","COL. JUAN XXIII",-68.65056,-15.77354,235,59,1651,1886,550,74,968,1518
"Bolivia","La Paz","Larecaja","Sorata","ESC. CENTRAL CARAZANI",-68.76967,-15.73627,18,2,197,215,35,20,140,175
"Bolivia","La Paz","Larecaja","Sorata","ESC. CENTRAL CHEJE",-68.6847,-15.79368,39,1,292,331,23,5,263,286
"Bolivia","La Paz","Larecaja","Sorata","ESC. CENTRAL CHOJLLA",-68.35152,-15.8526,28,2,76,104,16,1,57,73
"Bolivia","La Paz","Larecaja","Sorata","ESC. CENTRAL DE YANI",-68.53834,-15.63402,96,12,601,697,382,36,171,553
"Bolivia","La Paz","Larecaja","Sorata","ESC. FERNANDO ELOY GUACHALLA",-68.65588,-15.80826,99,54,809,908,147,48,560,707
"Bolivia","La Paz","Larecaja","Sorata","ESC. NEMECIO AYALA",-68.7309,-15.713,31,8,181,212,35,8,130,165
"Bolivia","La Paz","Larecaja","Sorata","ESC. NUCLEO ABISPAYA",-68.69788,-15.7081,41,12,314,355,77,21,204,281
"Bolivia","La Paz","Larecaja","Sorata","ESC. NUCLEO COCOY",-68.44633,-15.78752,1,0,292,293,152,19,121,273
"Bolivia","La Paz","Larecaja","Sorata","ESC. NUCLEO LARIPATA",-68.66778,-15.75021,91,25,807,898,226,39,517,743
"Bolivia","La Paz","Larecaja","Sorata","ESC. NUCLEO SAN ANTONIO DE MILLIPA",-68.61856,-15.87464,15,7,790,805,229,22,532,761
"Bolivia","La Paz","Larecaja","Sorata","ESC. SECC. DE ANKOMA SUR",-68.5121,-15.74682,17,8,162,179,87,7,60,147
"Bolivia","La Paz","Larecaja","Sorata","ESC. SECCIONAL CHUSSI",-68.2317,-15.6224,2,1,166,168,28,1,136,164
"Bolivia","La Paz","Larecaja","Sorata","ESCUELA COMBILILI",-68.7889,-15.75265,8,0,83,91,33,6,44,77
"Bolivia","La Paz","Larecaja","Sorata","ESCUELA MACHACAMARCA",-68.78627,-15.72192,24,0,154,178,14,1,139,153
"Bolivia","La Paz","Larecaja","Sorata","ESCUELA PACOLLO",-68.64767,-15.85605,5,0,200,205,58,8,134,192
"Bolivia","La Paz","Larecaja","Sorata","ESCUELA SANTA MARIA",-68.21433,-15.58872,54,4,115,169,26,4,81,107
"Bolivia","La Paz","Larecaja","Sorata","ESC. UNIDAD EDUCATIVA OKARA",-68.3903,-15.67581,11,4,50,61,16,2,28,44
"Bolivia","La Paz","Larecaja","Sorata","H.A.M. DE SORATA",-68.64867,-15.77538,290,53,1733,2023,547,94,1039,1586
"Bolivia","La Paz","Larecaja","Tacacoma","COL. CENTRAL SAN AGUSTIN",-68.50902,-15.37926,75,11,346,421,77,18,240,317
"Bolivia","La Paz","Larecaja","Tacacoma","ESC. ANANEA",-68.6505,-15.5341,28,1,192,220,93,6,92,185
"Bolivia","La Paz","Larecaja","Tacacoma","ESC. CENTRAL CHUMISA",-68.65643,-15.58669,56,6,464,520,114,14,330,444
"Bolivia","La Paz","Larecaja","Tacacoma","ESCUELA PALLAYUNGA",-68.60498,-15.46068,60,1,212,272,48,10,153,201
"Bolivia","La Paz","Larecaja","Tacacoma","ESCUELA XVI DE JULIO",-68.64725,-15.59322,140,16,967,1107,467,54,430,897
"Bolivia","La Paz","Larecaja","Tacacoma","ESC. UNIDAD EDUCATIVA CAMILLAYA",-68.57066,-15.43699,17,3,81,98,24,1,53,77
"Bolivia","La Paz","Larecaja","Tacacoma","NUCLEO ESCOLAR INCACHACA",-68.47215,-15.32096,70,2,213,283,124,2,85,209
"Bolivia","La Paz","Larecaja","Tacacoma","PLAZA COLLABAMBA",-68.64456,-15.51472,19,2,111,130,67,7,35,102
"Bolivia","La Paz","Larecaja","Teoponte","COL. NAL. MIXTO TEOPONTE",-67.81804,-15.49505,263,23,1142,1405,404,22,693,1097
"Bolivia","La Paz","Larecaja","Teoponte","COL. NUCLEO TAJLIHUI",-67.70219,-15.67721,20,1,143,163,21,8,113,134
"Bolivia","La Paz","Larecaja","Teoponte","ESC.EDUARDO AVAROA",-67.64935,-15.67183,15,4,127,142,15,6,102,117
"Bolivia","La Paz","Larecaja","Teoponte","ESC. MIXTA TOMACHI",-67.73718,-15.47837,86,2,316,402,104,10,200,304
"Bolivia","La Paz","Larecaja","Teoponte","ESC.NUCLEO VILLA AROMA",-67.7086,-15.59438,33,4,371,404,56,10,301,357
"Bolivia","La Paz","Larecaja","Teoponte","NUCLEO RED UNO",-67.6581,-15.5712,12,1,59,71,4,2,52,56
"Bolivia","La Paz","Larecaja","Teoponte","SEDE SOCIAL",-67.60563,-15.41431,228,13,1044,1272,240,22,769,1009
"Bolivia","La Paz","Larecaja","Tipuani","ESC. 16 DE JULIO",-68.04258,-15.5816,225,7,651,876,204,10,430,634
"Bolivia","La Paz","Larecaja","Tipuani","ESC. EDUARDO AVAROA",-68.01199,-15.56615,478,18,1581,2059,646,37,880,1526
"Bolivia","La Paz","Larecaja","Tipuani","ESC. MIXTA GERMAN BUSCH",-68.00401,-15.56263,40,2,192,232,77,6,107,184
"Bolivia","La Paz","Larecaja","Tipuani","ESC. NESTOR PAZ ZAMORA",-68.0163,-15.51995,11,0,56,67,4,2,50,54
"Bolivia","La Paz","Larecaja","Tipuani","ESCUELA CHUQUINI",-68.08243,-15.61108,281,9,787,1068,198,15,565,763
"Bolivia","La Paz","Larecaja","Tipuani","UNIDAD EDUCATIVA PEDRO DOMINGO MURILLO",-68.10115,-15.59577,97,5,388,485,150,9,224,374
"Bolivia","La Paz","Loayza","Cairoma","COLEGIO GERMAN BUSCH",-67.54138,-16.90495,136,27,1065,1201,246,55,737,983
"Bolivia","La Paz","Loayza","Cairoma","COLEGIO LUIS ESPINAL",-67.57736,-16.92918,29,10,325,354,92,2,221,313
"Bolivia","La Paz","Loayza","Cairoma","ESCUELA DE SAYA",-67.54543,-16.71021,8,2,105,113,40,5,58,98
"Bolivia","La Paz","Loayza","Cairoma","ESCUELA TIENDA PATA",-67.50883,-16.886,14,1,126,140,38,5,82,120
"Bolivia","La Paz","Loayza","Cairoma","PLAZA LLOJA",-67.57372,-16.74774,22,1,184,206,10,1,172,182
"Bolivia","La Paz","Loayza","Cairoma","PLAZA TORRE PAMPA",-67.58032,-16.83131,63,8,346,409,67,10,261,328
"Bolivia","La Paz","Loayza","Cairoma","UNIDAD EDUCATIVA BARTOLINA SISA",-67.4908,-16.65928,23,0,118,141,13,8,97,110
"Bolivia","La Paz","Loayza","Cairoma","UNIDAD EDUCATIVA BOLIVAR",-67.54518,-16.87182,69,19,489,558,68,16,386,454
"Bolivia","La Paz","Loayza","Cairoma","UNIDAD EDUCATIVA BOLIVIA-VILOCO",-67.49796,-16.87398,159,5,706,865,165,22,514,679
"Bolivia","La Paz","Loayza","Cairoma","UNIDAD EDUCATIVA LIBERTAD",-67.56012,-16.81969,55,9,341,396,54,14,264,318
"Bolivia","La Paz","Loayza","Cairoma","UNIDAD EDUCATIVA SACANI",-67.61375,-16.94436,16,3,365,381,57,8,297,354
"Bolivia","La Paz","Loayza","Luribay","COLEGIO AZAMBO",-67.63184,-17.00489,29,4,371,400,66,13,288,354
"Bolivia","La Paz","Loayza","Luribay","COLEGIO VILLA LITORAL",-67.6229,-17.08772,37,2,383,420,47,8,326,373
"Bolivia","La Paz","Loayza","Luribay","COL. RVDO. VICTOR ARUAZO-PLAZA PRINCIPAL",-67.6609,-17.06249,88,10,630,718,135,19,466,601
"Bolivia","La Paz","Loayza","Luribay","ESCUELA ANQUIMOA",-67.66051,-16.99854,49,6,587,636,60,11,510,570
"Bolivia","La Paz","Loayza","Luribay","ESCUELA EL PORVENIR",-67.55268,-17.03213,44,3,617,661,107,12,495,602
"Bolivia","La Paz","Loayza","Luribay","ESCUELA MURMUNTANI",-67.5434,-17.08703,20,1,171,191,13,4,153,166
"Bolivia","La Paz","Loayza","Luribay","ESC. UNIDAD EDUCATIVA BRAVO",-67.68433,-16.95887,17,3,198,215,19,3,173,192
"Bolivia","La Paz","Loayza","Luribay","PLAZA 5 DE AGOSTO",-67.60162,-17.11526,64,5,422,486,57,11,349,406
"Bolivia","La Paz","Loayza","Luribay","PLAZA 6 DE AGOSTO",-67.68541,-17.13404,60,4,349,409,33,24,288,321
"Bolivia","La Paz","Loayza","Luribay","PLAZA TOTORA",-67.68784,-17.09565,5,0,90,95,11,0,79,90
"Bolivia","La Paz","Loayza","Luribay","UNIDAD EDUCATIVA COLLIRI",-67.7193,-17.04746,32,1,225,257,31,8,185,216
"Bolivia","La Paz","Loayza","Luribay","UNIDAD EDUCATIVA PEDRO DOMINGO MURILLO",-67.57441,-17.14605,88,8,596,684,94,3,491,585
"Bolivia","La Paz","Loayza","Luribay","UNIDAD EDUCATIVA POROMA",-67.54092,-17.17032,23,1,299,322,37,1,260,297
"Bolivia","La Paz","Loayza","Malla","ESCUELA SIMON BOLIVAR",-67.42189,-17.06216,3,0,99,102,3,2,94,97
"Bolivia","La Paz","Loayza","Malla","PLAZA 14 DE SEPTIEMBRE",-67.45062,-17.03962,13,2,408,421,55,5,346,401
"Bolivia","La Paz","Loayza","Malla","UNIDAD EDUCATIVA FRANZ TAMAYO",-67.49815,-16.9908,38,2,254,292,55,9,188,243
"Bolivia","La Paz","Loayza","Sapahaqui","ESCUELA EDUARDO AVAROA",-67.71152,-16.88625,43,2,413,456,44,5,362,406
"Bolivia","La Paz","Loayza","Sapahaqui","ESCUELA SIXILLA BAJA",-67.79269,-17.05937,0,1,325,325,42,2,280,322
"Bolivia","La Paz","Loayza","Sapahaqui","MURUHUTA",-67.83468,-17.10299,43,2,373,416,66,16,289,355
"Bolivia","La Paz","Loayza","Sapahaqui","PLAZA PRINCIPAL HUANCANE",-67.92168,-16.96859,13,2,321,334,52,5,262,314
"Bolivia","La Paz","Loayza","Sapahaqui","UNIDAD EDUCATIVA CHIVISIVI",-67.87543,-16.95139,49,7,565,614,86,4,468,554
"Bolivia","La Paz","Loayza","Sapahaqui","UNIDAD EDUCATIVA OCUIRI",-67.75996,-17.09802,21,0,228,249,20,6,202,222
"Bolivia","La Paz","Loayza","Sapahaqui","UNIDAD EDUCATIVA SAN MARCOS",-67.81051,-16.99369,192,11,1391,1583,215,51,1114,1329
"Bolivia","La Paz","Loayza","Sapahaqui","UNIDAD EDUCATIVA SAPAHAQUI",-67.95024,-16.88832,204,31,1625,1829,323,69,1202,1525
"Bolivia","La Paz","Loayza","Sapahaqui","UNIDAD EDUCATIVA TACOBAMBA",-67.93534,-16.89507,63,3,616,679,93,17,503,596
"Bolivia","La Paz","Loayza","Sapahaqui","UNIDAD EDUCATIVA URUPAYA",-67.86726,-16.83526,12,0,94,106,16,2,76,92
"Bolivia","La Paz","Loayza","Yaco","COLEGIO REPUBLICA VENEZUELA",-67.33579,-17.27501,43,5,589,632,169,21,394,563
"Bolivia","La Paz","Loayza","Yaco","ESCUELA CHALLOMA",-67.48557,-17.17411,22,2,235,257,12,5,216,228
"Bolivia","La Paz","Loayza","Yaco","ESCUELA UMALACO",-67.44422,-17.08424,4,1,74,78,8,1,64,72
"Bolivia","La Paz","Loayza","Yaco","PLAZA 14 DE SEPTIEMBRE",-67.37626,-17.18333,9,2,116,125,23,7,84,107
"Bolivia","La Paz","Loayza","Yaco","PLAZA CENTRAL",-67.33892,-17.17855,27,11,431,458,98,46,276,374
"Bolivia","La Paz","Loayza","Yaco","UNIDAD EDUCATIVA CHUCAMARCA",-67.45103,-17.09326,34,4,238,272,34,10,190,224
"Bolivia","La Paz","Loayza","Yaco","UNIDAD EDUCATIVA DANIEL GOMEZ GARCIA",-67.44017,-17.25055,36,7,284,320,50,20,207,257
"Bolivia","La Paz","Loayza","Yaco","UNIDAD EDUCATIVA GERMAN BUSCH",-67.34483,-17.1474,18,0,119,137,25,5,89,114
"Bolivia","La Paz","Loayza","Yaco","UNIDAD EDUCATIVA HURNUNI",-67.40517,-17.3487,12,1,240,252,87,5,147,234
"Bolivia","La Paz","Loayza","Yaco","UNIDAD EDUCATIVA SIMON BOLIVAR",-67.35043,-17.13314,0,7,137,137,38,5,87,125
"Bolivia","La Paz","Loayza","Yaco","UNIDAD EDUCATIVA YACO",-67.41138,-17.1584,84,13,368,452,78,25,252,330
"Bolivia","La Paz","Los Andes","Batallas","COLEGIO DON BOSCO",-68.46431,-16.31361,60,18,729,789,166,29,516,682
"Bolivia","La Paz","Los Andes","Batallas","COLEGIO TÉCNICO HUMANÍSTICO CHIRAPACA",-68.49313,-16.29834,21,4,406,427,136,16,250,386
"Bolivia","La Paz","Los Andes","Batallas","COL. FISCAL BOLIVIANO CUBANO",-68.52594,-16.30013,64,13,724,788,224,26,461,685
"Bolivia","La Paz","Los Andes","Batallas","COL. PEDRO DOMINGO MURILLO",-68.50931,-16.1562,62,11,535,597,213,23,288,501
"Bolivia","La Paz","Los Andes","Batallas","ESCUELA GENOVEVA RIOS",-68.53124,-16.30003,339,47,2937,3276,953,124,1813,2766
"Bolivia","La Paz","Los Andes","Batallas","PLAZA LA PAZ",-68.51289,-16.34104,36,4,566,602,193,19,350,543
"Bolivia","La Paz","Los Andes","Batallas","PLAZA PRINCIPAL",-68.54729,-16.10482,112,16,1192,1304,434,57,685,1119
"Bolivia","La Paz","Los Andes","Batallas","PLAZA PRINCIPAL",-68.46272,-16.2592,112,16,1192,1304,434,57,685,1119
"Bolivia","La Paz","Los Andes","Batallas","PLAZA TUPAC KATARI",-68.50398,-16.23213,75,17,642,717,150,35,440,590
"Bolivia","La Paz","Los Andes","Batallas","PLAZA TUQUIA",-68.46532,-16.21404,67,13,684,751,186,44,441,627
"Bolivia","La Paz","Los Andes","Batallas","PLAZA V. ASUNCION DE CALUYO",-68.51057,-16.32793,15,0,198,213,34,4,160,194
"Bolivia","La Paz","Los Andes","Batallas","SEDE SOCIAL",-68.56298,-16.25858,16,3,250,266,77,9,161,238
"Bolivia","La Paz","Los Andes","Laja","COL. PEDRO DOMINGO MURILLO",-68.38843,-16.53407,294,57,3397,3691,824,159,2357,3181
"Bolivia","La Paz","Los Andes","Laja","COL. TEC. HUMANISTICO TAMBILLO",-68.50755,-16.57151,56,13,515,571,151,28,323,474
"Bolivia","La Paz","Los Andes","Laja","ESC. QUINTUPATA",-68.50268,-16.62749,3,3,135,138,30,1,101,131
"Bolivia","La Paz","Los Andes","Laja","ESCUELA REPUBLICA DE IRAN",-68.30653,-16.52587,113,16,1084,1197,287,47,734,1021
"Bolivia","La Paz","Los Andes","Laja","MERCADO SAN JUAN",-68.46218,-16.69142,36,13,460,496,56,24,367,423
"Bolivia","La Paz","Los Andes","Laja","PLAZA CURVA PUCARA",-68.57091,-16.59581,22,12,579,601,99,21,447,546
"Bolivia","La Paz","Los Andes","Laja","PLAZA PRINCIPAL",-68.55198,-16.5294,38,22,1018,1056,176,53,767,943
"Bolivia","La Paz","Los Andes","Laja","PLAZA PRINCIPAL",-68.55477,-16.65492,38,22,1018,1056,176,53,767,943
"Bolivia","La Paz","Los Andes","Laja","PLAZA PRINCIPAL",-68.56635,-16.57367,38,22,1018,1056,176,53,767,943
"Bolivia","La Paz","Los Andes","Laja","U.E. CALLAMARCA",-68.57652,-16.6364,2,3,380,382,73,19,285,358
"Bolivia","La Paz","Los Andes","Laja","U.E. GUALBERTO VILLARROEL DE SACACANI",-68.50606,-16.68419,0,0,216,216,48,8,160,208
"Bolivia","La Paz","Los Andes","Laja","UNIDAD EDUCATIVA COPAJIRA",-68.44736,-16.59749,38,10,617,655,118,33,456,574
"Bolivia","La Paz","Los Andes","Pucarani","COLEGIO CHIARPATA",-68.52587,-16.35778,30,20,480,510,148,25,287,435
"Bolivia","La Paz","Los Andes","Pucarani","COLEGIO COHANA",-68.65945,-16.37055,25,16,685,710,136,25,508,644
"Bolivia","La Paz","Los Andes","Pucarani","COLEGIO MARIO GUTIERREZ",-68.5423,-16.40942,80,43,1028,1108,366,92,527,893
"Bolivia","La Paz","Los Andes","Pucarani","COLEGIO SAN SALVADOR",-68.37844,-16.37475,133,40,1707,1840,473,103,1091,1564
"Bolivia","La Paz","Los Andes","Pucarani","COL.NAL.CHOJÑA COLLO",-68.42926,-16.44215,17,9,393,410,128,35,221,349
"Bolivia","La Paz","Los Andes","Pucarani","ESC. CENTRAL CHIPAMAYA",-68.42702,-16.38573,34,7,457,491,140,21,289,429
"Bolivia","La Paz","Los Andes","Pucarani","ESC. JOSE SALMON BALLIVIAN",-68.47432,-16.39758,294,81,3005,3299,1094,162,1668,2762
"Bolivia","La Paz","Los Andes","Pucarani","ESCUELA ANTOFAGASTA",-68.33107,-16.42799,88,53,1728,1816,627,161,887,1514
"Bolivia","La Paz","Los Andes","Pucarani","ESCUELA CATAVI",-68.58923,-16.48189,61,22,675,736,193,30,430,623
"Bolivia","La Paz","Los Andes","Pucarani","ESCUELA CHOJASIVI",-68.69275,-16.44042,10,10,676,686,231,26,409,640
"Bolivia","La Paz","Los Andes","Pucarani","PLAZA 6 DE AGOSTO",-68.41537,-16.33457,120,31,1482,1602,323,63,1065,1388
"Bolivia","La Paz","Los Andes","Pucarani","PLAZA PRINCIPAL",-68.66112,-16.44403,67,16,725,792,110,11,588,698
"Bolivia","La Paz","Los Andes","Pucarani","PLAZA VILLA ROSARIO DE CORAPATA",-68.37347,-16.4377,72,22,920,992,390,47,461,851
"Bolivia","La Paz","Los Andes","Puerto Pérez","ESC. GUALBERTO VILLARROEL",-68.59356,-16.35726,65,6,453,518,151,26,270,421
"Bolivia","La Paz","Los Andes","Puerto Pérez","ESC. MIXTO 16 DE JULIO",-68.76075,-16.30686,62,27,874,936,173,36,638,811
"Bolivia","La Paz","Los Andes","Puerto Pérez","ESCUELA CENTRAL CASCACHI",-68.67452,-16.3437,37,13,518,555,91,35,379,470
"Bolivia","La Paz","Los Andes","Puerto Pérez","ESCUELA PUERTO PEREZ",-68.60112,-16.28587,90,20,1047,1137,243,26,758,1001
"Bolivia","La Paz","Los Andes","Puerto Pérez","ESCUELAS POPULARES DON BOSCO",-68.58698,-16.34699,28,2,314,342,91,9,212,303
"Bolivia","La Paz","Los Andes","Puerto Pérez","UNIDAD EDUCATIVA CUMANA",-68.63633,-16.34833,20,4,257,277,42,5,206,248
"Bolivia","La Paz","Manco Kapac","Copacabana","CENTRO DE SALUD SIRIPACA",-69.06173,-16.09907,39,7,243,282,25,3,208,233
"Bolivia","La Paz","Manco Kapac","Copacabana","COLEGIO CHALLA",-69.18937,-15.98997,64,12,938,1002,47,15,864,911
"Bolivia","La Paz","Manco Kapac","Copacabana","COL. NACIONAL MIXTO COPACABANA",-69.08396,-16.1632,569,57,3967,4536,1210,144,2556,3766
"Bolivia","La Paz","Manco Kapac","Copacabana","ESC. 16 DE JULIO",-69.0842,-16.20929,110,16,881,991,288,36,541,829
"Bolivia","La Paz","Manco Kapac","Copacabana","ESC. COL. TEC. HUMANISTICO HUACUYO",-69.03305,-16.17805,71,3,409,480,81,16,309,390
"Bolivia","La Paz","Manco Kapac","Copacabana","ESCUELA SECCIONAL SAMPAYA",-69.1012,-16.08231,44,7,321,365,47,15,252,299
"Bolivia","La Paz","Manco Kapac","Copacabana","ESCUELA VILLA ROSARIO",-68.98846,-16.14534,37,9,328,365,68,11,240,308
"Bolivia","La Paz","Manco Kapac","San Pedro de Tiquina","COLEGIO VILLA AMACARI",-68.86105,-16.25432,14,8,184,198,48,5,123,171
"Bolivia","La Paz","Manco Kapac","San Pedro de Tiquina","COL. SIMON BOLIVAR",-68.85252,-16.22503,260,19,1043,1303,306,53,665,971
"Bolivia","La Paz","Manco Kapac","San Pedro de Tiquina","ESC. MIXTA SAN PABLO DE TIQUINA",-68.84653,-16.21544,75,20,651,726,249,30,352,601
"Bolivia","La Paz","Manco Kapac","San Pedro de Tiquina","PLAZA 25 DE JUNIO",-68.88103,-16.26364,31,2,212,243,62,4,144,206
"Bolivia","La Paz","Manco Kapac","San Pedro de Tiquina","SEDE SOCIAL",-68.89336,-16.22142,52,8,303,355,55,7,233,288
"Bolivia","La Paz","Manco Kapac","Tito Yupanqui","COLEGIO NACIONAL MIXTO TITO YUPANQUI",-68.95449,-16.19247,122,25,653,775,215,21,392,607
"Bolivia","La Paz","Manco Kapac","Tito Yupanqui","ESCUELA HUATAPAMPA",-68.95433,-16.17676,14,1,165,179,39,8,117,156
"Bolivia","La Paz","Muñecas","Aucapata","COLEGIO 2 DE AGOSTO",-68.76146,-15.4182,101,10,391,492,52,22,307,359
"Bolivia","La Paz","Muñecas","Aucapata","ESCUELA DR. ANGEL GEMIO ERGUETA",-68.72099,-15.48481,66,2,169,235,51,16,100,151
"Bolivia","La Paz","Muñecas","Aucapata","IGLESIA SANTO DOMINGO",-68.72872,-15.4539,72,10,195,267,34,13,138,172
"Bolivia","La Paz","Muñecas","Aucapata","NUCLEO ESCOLAR YANAHUAYA",-68.6969,-15.45401,110,22,384,494,83,22,257,340
"Bolivia","La Paz","Muñecas","Aucapata","UNIDAD EDUCATIVA ROSARIO",-68.6216,-15.4223,168,12,489,657,91,20,366,457
"Bolivia","La Paz","Muñecas","Ayata","COL. NEMESIO ALIAGA BENAVENTE",-68.8305,-15.45652,245,60,811,1056,118,57,576,694
"Bolivia","La Paz","Muñecas","Ayata","ESC. SAN JUANITO",-68.75811,-15.3747,58,3,367,425,44,19,301,345
"Bolivia","La Paz","Muñecas","Ayata","ESCUELA CAMATA",-68.74616,-15.23502,79,17,385,464,72,18,278,350
"Bolivia","La Paz","Muñecas","Ayata","ESCUELA NUCLEO ELIZARDO PEREZ DE M.",-68.80567,-15.50827,81,30,444,525,97,28,289,386
"Bolivia","La Paz","Muñecas","Ayata","ESCUELA SAIHUANI",-68.77344,-15.44397,102,15,420,522,32,17,356,388
"Bolivia","La Paz","Muñecas","Ayata","ESCUELA SECCIONAL MULTIGRADO UPANI",-68.80933,-15.49444,52,5,276,328,7,29,235,242
"Bolivia","La Paz","Muñecas","Ayata","UNIDAD EDUCATIVA VILLA ROSARIO",-68.62227,-15.22997,0,3,87,87,13,3,68,81
"Bolivia","La Paz","Muñecas","Chuma","COLEGIO HUMANISTICO SOCOCONI",-68.87901,-15.7106,67,11,508,575,57,13,427,484
"Bolivia","La Paz","Muñecas","Chuma","COLEGIO POCOAYA",-68.91715,-15.4475,16,1,118,134,26,8,83,109
"Bolivia","La Paz","Muñecas","Chuma","CUSAHUAYA",-68.84715,-15.66148,7,3,206,213,14,3,186,200
"Bolivia","La Paz","Muñecas","Chuma","ESC. TIMUSI",-68.86244,-15.66374,31,1,266,297,35,7,223,258
"Bolivia","La Paz","Muñecas","Chuma","ESCUELA CENTRAL TITICACHI",-68.81434,-15.50673,63,10,409,472,88,21,290,378
"Bolivia","La Paz","Muñecas","Chuma","ESCUELA CHAJLAYA",-68.90194,-15.68445,57,5,535,592,104,20,406,510
"Bolivia","La Paz","Muñecas","Chuma","ESCUELA DE LUQUISANI",-68.81457,-15.51897,24,6,269,293,93,17,153,246
"Bolivia","La Paz","Muñecas","Chuma","ESCUELA DE TUILUNI",-68.92104,-15.48239,27,9,258,285,68,25,156,224
"Bolivia","La Paz","Muñecas","Chuma","ESCUELA MAXIMILIANO ORTIZ",-68.89848,-15.4816,252,37,830,1082,184,54,555,739
"Bolivia","La Paz","Muñecas","Chuma","ESCUELA PALOHUAYA",-68.8721,-15.63676,14,1,124,138,28,4,91,119
"Bolivia","La Paz","Muñecas","Chuma","PLAZA CAPAYQUE",-68.80988,-15.69481,13,4,212,225,18,9,181,199
"Bolivia","La Paz","Muñecas","Chuma","PLAZA JICHUHUAYA",-68.8353,-15.69286,13,0,104,117,20,1,83,103
"Bolivia","La Paz","Murillo","Achocalla","COLEGIO 16 DE AGOSTO",-68.17045,-16.55337,114,6,1115,1229,320,26,763,1083
"Bolivia","La Paz","Murillo","Achocalla","ESCUELA ASUNTA QUILLVIRI",-68.11919,-16.72616,81,18,1012,1093,238,67,689,927
"Bolivia","La Paz","Murillo","Achocalla","ESCUELA CHAÑOCAHUA",-68.14516,-16.63919,347,30,3694,4041,1028,129,2507,3535
"Bolivia","La Paz","Murillo","Achocalla","ESCUELA MARQUIRIVI",-68.15418,-16.5915,278,37,2011,2289,498,51,1425,1923
"Bolivia","La Paz","Murillo","Achocalla","ESCUELA VILLA CONCEPCION",-68.13874,-16.60526,28,9,522,550,101,27,385,486
"Bolivia","La Paz","Murillo","Achocalla","U. E.  ANTONIO DIAZ VILLAMIL",-68.16837,-16.57798,148,34,1803,1951,514,52,1203,1717
"Bolivia","La Paz","Murillo","Achocalla","U. E. RENE BARRIENTOS ORTUÑO",-68.1705,-16.56838,143,13,1235,1378,410,29,783,1193
"Bolivia","La Paz","Murillo","Achocalla","UNIDAD EDUCATIVA TUNI",-68.13835,-16.67672,26,2,348,374,69,7,270,339
"Bolivia","La Paz","Murillo","El Alto de La Paz","CENTRO EDUCATIVO CATOLICO MERCEDES",-68.2159,-16.56526,214,28,2435,2649,824,121,1462,2286
"Bolivia","La Paz","Murillo","El Alto de La Paz","COL 18 DE DICIEMBRE",-68.17837,-16.58624,338,27,3263,3601,1006,144,2086,3092
"Bolivia","La Paz","Murillo","El Alto de La Paz","COL 1RO DE MAYO",-68.19975,-16.53636,657,49,7853,8510,3644,396,3764,7408
"Bolivia","La Paz","Murillo","El Alto de La Paz","COL 25 DE JULIO",-68.18322,-16.58162,838,75,6599,7437,2202,295,4027,6229
"Bolivia","La Paz","Murillo","El Alto de La Paz","COL ATIPIRIS",-68.17815,-16.59096,321,40,2932,3253,866,149,1877,2743
"Bolivia","La Paz","Murillo","El Alto de La Paz","COL BASILL MILLER",-68.17461,-16.48812,230,19,2919,3149,1330,130,1440,2770
"Bolivia","La Paz","Murillo","El Alto de La Paz","COL BOLIVIA",-68.17217,-16.5416,467,46,4155,4622,1592,215,2302,3894
"Bolivia","La Paz","Murillo","El Alto de La Paz","COL CALAMA",-68.19262,-16.53144,626,52,7137,7763,2855,316,3914,6769
"Bolivia","La Paz","Murillo","El Alto de La Paz","COL EDUARDO AVAROA",-68.18268,-16.52774,319,22,2726,3045,1119,115,1470,2589
"Bolivia","La Paz","Murillo","El Alto de La Paz","COLEGIO 23 DE MARZO",-68.1777,-16.61965,770,87,6619,7389,1738,305,4489,6227
"Bolivia","La Paz","Murillo","El Alto de La Paz","COLEGIO 27 DE MAYO",-68.18954,-16.59973,595,88,5668,6263,1618,298,3664,5282
"Bolivia","La Paz","Murillo","El Alto de La Paz","COLEGIO 6 DE JUNIO",-68.20706,-16.55554,516,40,4530,5046,1597,147,2746,4343
"Bolivia","La Paz","Murillo","El Alto de La Paz","COLEGIO ADRIAN CASTILLO NAVA",-68.18089,-16.47932,842,92,8873,9715,3409,395,4977,8386
"Bolivia","La Paz","Murillo","El Alto de La Paz","COLEGIO ANDRES DE STA CRUZ",-68.21678,-16.48222,623,80,6837,7460,2609,386,3762,6371
"Bolivia","La Paz","Murillo","El Alto de La Paz","COLEGIO ANTONIO PAREDES CANDIA",-68.21078,-16.47959,918,144,10853,11771,3838,538,6333,10171
"Bolivia","La Paz","Murillo","El Alto de La Paz","COLEGIO BOLIVIA MAR",-68.19718,-16.58017,264,24,2518,2782,660,107,1727,2387
"Bolivia","La Paz","Murillo","El Alto de La Paz","COLEGIO DON BOSCO",-68.22162,-16.56328,746,78,7399,8145,2631,249,4441,7072
"Bolivia","La Paz","Murillo","El Alto de La Paz","COLEGIO FERNANDO NOGALES CASTRO",-68.23376,-16.52565,289,37,3484,3773,1511,133,1803,3314
"Bolivia","La Paz","Murillo","El Alto de La Paz","COLEGIO HUAYNA POTOSI",-68.18628,-16.47742,666,114,8029,8695,2771,410,4734,7505
"Bolivia","La Paz","Murillo","El Alto de La Paz","COLEGIO ILLIMANI",-68.20894,-16.54332,694,71,7226,7920,2297,267,4591,6888
"Bolivia","La Paz","Murillo","El Alto de La Paz","COLEGIO LUIS ESPINAL CAMPS",-68.22268,-16.52322,980,111,9286,10266,3175,314,5686,8861
"Bolivia","La Paz","Murillo","El Alto de La Paz","COLEGIO LUIS ESPINAL CAMPS (AEROPUERTO)",-68.19802,-16.51796,352,33,2977,3329,1046,156,1742,2788
"Bolivia","La Paz","Murillo","El Alto de La Paz","COLEGIO MARISCAL ANDRES DE SANTA CRUZ",-68.14963,-16.53367,133,16,1349,1482,748,42,543,1291
"Bolivia","La Paz","Murillo","El Alto de La Paz","COLEGIO MARTIN CARDENAS",-68.20902,-16.5227,1058,70,9815,10873,4851,385,4509,9360
"Bolivia","La Paz","Murillo","El Alto de La Paz","COLEGIO M QUIROGA SANTA CRUZ",-68.20879,-16.48692,295,158,4768,5063,1919,264,2427,4346
"Bolivia","La Paz","Murillo","El Alto de La Paz","COLEGIO NESTOR PAZ",-68.23247,-16.54344,495,45,4940,5435,1684,272,2939,4623
"Bolivia","La Paz","Murillo","El Alto de La Paz","COLEGIO PARTICULAR SAN MIGUEL",-68.21574,-16.49355,224,15,2154,2378,1059,100,980,2039
"Bolivia","La Paz","Murillo","El Alto de La Paz","COLEGIO PUERTO DEL ROSARIO",-68.19044,-16.54459,1107,83,10673,11780,4517,402,5671,10188
"Bolivia","La Paz","Murillo","El Alto de La Paz","COLEGIO PUERTO DEL ROSARIO",-68.19044,-16.54459,1107,83,10673,11780,4517,402,5671,10188
"Bolivia","La Paz","Murillo","El Alto de La Paz","COLEGIO SAN JOSE",-68.17645,-16.48123,876,111,10039,10915,4092,467,5369,9461
"Bolivia","La Paz","Murillo","El Alto de La Paz","COLEGIO WALTER ALPIRE 1ER PATIO",-68.21351,-16.49505,515,36,4904,5419,2435,204,2229,4664
"Bolivia","La Paz","Murillo","El Alto de La Paz","COLEGIO WALTER ALPIRE 2DO PATIO",-68.21351,-16.49505,233,30,3092,3325,1664,90,1308,2972
"Bolivia","La Paz","Murillo","El Alto de La Paz","COL ESPAÑA",-68.19041,-16.58716,1083,87,9120,10203,2893,393,5747,8640
"Bolivia","La Paz","Murillo","El Alto de La Paz","COL GRAN BRETAÑA",-68.18764,-16.49338,490,42,5632,6122,2556,229,2805,5361
"Bolivia","La Paz","Murillo","El Alto de La Paz","COL HEROES DEL PACIFICO",-68.15602,-16.52656,396,13,4315,4711,2896,119,1287,4183
"Bolivia","La Paz","Murillo","El Alto de La Paz","COL LIBERTADOR S. BOLIVAR",-68.17521,-16.52682,462,34,4467,4929,1991,177,2265,4256
"Bolivia","La Paz","Murillo","El Alto de La Paz","COL MUTUAL LA PAZ",-68.19092,-16.55765,361,43,4042,4403,1871,136,1992,3863
"Bolivia","La Paz","Murillo","El Alto de La Paz","COL PUERTO MEJILLONES",-68.15205,-16.52655,788,41,7782,8570,5150,204,2387,7537
"Bolivia","La Paz","Murillo","El Alto de La Paz","COL RAFAEL MENDOZA",-68.19506,-16.49104,492,48,4903,5395,2342,267,2246,4588
"Bolivia","La Paz","Murillo","El Alto de La Paz","COL. REPUBLICA DE ITALIA",-68.1873,-16.5898,215,25,2000,2215,636,91,1248,1884
"Bolivia","La Paz","Murillo","El Alto de La Paz","COL ROTARY CHUQUIAGO MARCA",-68.16711,-16.53573,1011,81,8411,9422,3437,350,4543,7980
"Bolivia","La Paz","Murillo","El Alto de La Paz","COL SANTA MARIA DE LOS ANGELES",-68.17751,-16.49472,613,57,6809,7422,3221,351,3180,6401
"Bolivia","La Paz","Murillo","El Alto de La Paz","COL SAN VICENTE DE PAUL",-68.20663,-16.50516,720,71,7407,8127,2690,299,4347,7037
"Bolivia","La Paz","Murillo","El Alto de La Paz","COL. TEC. HUMANISTICO JOSE BALLIVIAN",-68.1784,-16.48976,313,42,3459,3772,1487,184,1746,3233
"Bolivia","La Paz","Murillo","El Alto de La Paz","COL TOPATER",-68.19929,-16.5635,482,35,5105,5587,1886,196,2988,4874
"Bolivia","La Paz","Murillo","El Alto de La Paz","COL TUNARI",-68.19628,-16.49841,1276,134,13812,15088,5846,623,7209,13055
"Bolivia","La Paz","Murillo","El Alto de La Paz","COL VICENTE TEJADA",-68.15522,-16.51924,558,55,5652,6210,2603,228,2766,5369
"Bolivia","La Paz","Murillo","El Alto de La Paz","ESC BALLIVIAN",-68.17644,-16.49026,328,44,3921,4249,1573,201,2103,3676
"Bolivia","La Paz","Murillo","El Alto de La Paz","ESC BOLIVAR MUNICIPAL",-68.18821,-16.53657,303,36,3647,3950,1409,147,2055,3464
"Bolivia","La Paz","Murillo","El Alto de La Paz","ESC ELIZARDO PEREZ",-68.1898,-16.48761,428,43,4525,4953,1912,218,2352,4264
"Bolivia","La Paz","Murillo","El Alto de La Paz","ESC JUVENAL MARIACA",-68.17067,-16.49689,715,55,7081,7796,3574,293,3159,6733
"Bolivia","La Paz","Murillo","El Alto de La Paz","ESC LIBERTAD EN LAS AMERICAS",-68.15623,-16.53351,767,73,7221,7988,3007,258,3883,6890
"Bolivia","La Paz","Murillo","El Alto de La Paz","ESC LOS ANDES",-68.18398,-16.49493,304,34,3283,3587,1507,147,1595,3102
"Bolivia","La Paz","Murillo","El Alto de La Paz","ESC LUIS ESPINAL CAMPS",-68.16608,-16.4796,245,31,2568,2813,916,116,1505,2421
"Bolivia","La Paz","Murillo","El Alto de La Paz","ESC PRIMAVERA",-68.1945,-16.53725,174,13,1555,1729,685,64,793,1478
"Bolivia","La Paz","Murillo","El Alto de La Paz","ESC TARAPACA",-68.18806,-16.60872,554,71,5829,6383,1548,243,3967,5515
"Bolivia","La Paz","Murillo","El Alto de La Paz","ESCUELA 16 DE FEBRERO",-68.22742,-16.50302,661,95,7448,8109,2757,268,4328,7085
"Bolivia","La Paz","Murillo","El Alto de La Paz","ESCUELA BRASIL",-68.20975,-16.49082,456,38,5008,5464,2223,211,2536,4759
"Bolivia","La Paz","Murillo","El Alto de La Paz","ESCUELA GUAQUI",-68.17409,-16.47567,563,74,6164,6727,2203,301,3586,5789
"Bolivia","La Paz","Murillo","El Alto de La Paz","ESCUELA JUAN CARLOS FLORES BEDREGAL",-68.22012,-16.50096,693,95,7769,8462,3069,266,4339,7408
"Bolivia","La Paz","Murillo","El Alto de La Paz","ESCUELA JUAN CARLOS FLORES BEDREGAL",-68.22012,-16.50096,693,95,7769,8462,3069,266,4339,7408
"Bolivia","La Paz","Murillo","El Alto de La Paz","ESCUELA JUAN JOSE TORREZ",-68.17109,-16.47051,363,55,4053,4416,1349,196,2453,3802
"Bolivia","La Paz","Murillo","El Alto de La Paz","ESCUELA RAFAEL PABON",-68.17429,-16.46312,305,75,4175,4480,1240,279,2581,3821
"Bolivia","La Paz","Murillo","El Alto de La Paz","ESCUELA RAUL SALMON DE LA BARRA",-68.21005,-16.49883,282,31,3411,3693,1445,154,1781,3226
"Bolivia","La Paz","Murillo","El Alto de La Paz","ESCUELA REPUBLICA DE CHINA POPULAR",-68.23643,-16.50772,422,72,4824,5246,1516,168,3068,4584
"Bolivia","La Paz","Murillo","El Alto de La Paz","ESCUELA TEJADA TRIANGULAR",-68.15996,-16.52431,273,22,2802,3075,1340,107,1333,2673
"Bolivia","La Paz","Murillo","El Alto de La Paz","ESCUELA TUPAC KATARI",-68.19848,-16.48532,330,45,3613,3943,1557,150,1861,3418
"Bolivia","La Paz","Murillo","El Alto de La Paz","INSTITUTO EDUCATIVO JESUS DE NAZARETH",-68.21307,-16.52458,459,45,4099,4558,1855,130,2069,3924
"Bolivia","La Paz","Murillo","El Alto de La Paz","SEDE SOCIAL JUNTA VECINAL",-68.19644,-16.54614,155,21,1394,1549,521,34,818,1339
"Bolivia","La Paz","Murillo","El Alto de La Paz","SEDE VECINAL",-68.1711,-16.51802,39,3,471,510,281,18,169,450
"Bolivia","La Paz","Murillo","El Alto de La Paz","U.E. AMIGOS DEL CHACO",-68.20364,-16.52415,86,11,1048,1134,424,31,582,1006
"Bolivia","La Paz","Murillo","El Alto de La Paz","U.E. CRISTAL",-68.20247,-16.59457,68,12,1343,1411,390,32,909,1299
"Bolivia","La Paz","Murillo","El Alto de La Paz","U.E. FUERZA AEREA ARGENTINA",-68.25346,-16.49715,66,16,934,1000,283,46,589,872
"Bolivia","La Paz","Murillo","El Alto de La Paz","U.E. GRAL. ARMANDO ESCOBAR URIA",-68.15063,-16.52961,145,3,1622,1767,1077,52,490,1567
"Bolivia","La Paz","Murillo","El Alto de La Paz","U.E. OSCAR ALFARO",-68.23621,-16.48713,444,61,4838,5282,1745,229,2803,4548
"Bolivia","La Paz","Murillo","El Alto de La Paz","UE PARTICULAR INTERANDINO BOLIVIANO",-68.18138,-16.49701,34,2,196,230,99,8,87,186
"Bolivia","La Paz","Murillo","El Alto de La Paz","U.E. SAN ANDRES",-68.15803,-16.53902,165,13,1751,1916,724,56,958,1682
"Bolivia","La Paz","Murillo","El Alto de La Paz","U.E. TOKIO",-68.17825,-16.47219,254,22,2749,3003,901,195,1631,2532
"Bolivia","La Paz","Murillo","El Alto de La Paz","U. E. VILLA ADELA YUNGUYO",-68.21577,-16.52021,380,45,3453,3833,1447,167,1794,3241
"Bolivia","La Paz","Murillo","El Alto de La Paz","U. E. VILLA ADELA YUNGUYO",-68.21643,-16.51679,380,45,3453,3833,1447,167,1794,3241
"Bolivia","La Paz","Murillo","El Alto de La Paz","UNIDAD EDUCATIVA 12 DE OCTUBRE",-68.1631,-16.51261,455,32,4604,5059,2562,138,1872,4434
"Bolivia","La Paz","Murillo","El Alto de La Paz","UNIDAD EDUCATIVA 25 DE JULIO",-68.21799,-16.50818,450,53,4141,4591,1412,204,2472,3884
"Bolivia","La Paz","Murillo","El Alto de La Paz","UNIDAD EDUCATIVA 3 DE MAYO",-68.21262,-16.54766,509,72,5791,6300,1877,199,3643,5520
"Bolivia","La Paz","Murillo","El Alto de La Paz","UNIDAD EDUCATIVA 6 DE JUNIO",-68.22369,-16.53518,476,42,4617,5093,1571,163,2841,4412
"Bolivia","La Paz","Murillo","El Alto de La Paz","UNIDAD EDUCATIVA ADELA ZAMUDIO",-68.19314,-16.52711,174,19,2157,2331,883,87,1168,2051
"Bolivia","La Paz","Murillo","El Alto de La Paz","UNIDAD EDUCATIVA  ALTO DE LA ALIANZA",-68.18938,-16.52214,340,31,3555,3895,1476,146,1902,3378
"Bolivia","La Paz","Murillo","El Alto de La Paz","UNIDAD EDUCATIVA ANDRES BELLO",-68.16715,-16.51139,109,16,1031,1140,577,26,412,989
"Bolivia","La Paz","Murillo","El Alto de La Paz","UNIDAD EDUCATIVA ANDRES BELLO (U. E. 16 DE JULIO)",-68.16715,-16.51139,72,3,577,649,357,16,201,558
"Bolivia","La Paz","Murillo","El Alto de La Paz","UNIDAD EDUCATIVA ANICETO ARCE",-68.18877,-16.55329,177,30,1945,2122,776,62,1077,1853
"Bolivia","La Paz","Murillo","El Alto de La Paz","UNIDAD EDUCATIVA BAUTISTA SAAVEDRA",-68.23381,-16.48594,839,109,8195,9034,3042,352,4692,7734
"Bolivia","La Paz","Murillo","El Alto de La Paz","UNIDAD EDUCATIVA BRASILIA",-68.15981,-16.51867,424,31,4386,4810,2189,148,2018,4207
"Bolivia","La Paz","Murillo","El Alto de La Paz","UNIDAD EDUCATIVA CARLOS PALENQUE",-68.18768,-16.52626,334,21,3284,3618,1331,154,1778,3109
"Bolivia","La Paz","Murillo","El Alto de La Paz","UNIDAD EDUCATIVA DONOZO TORRES",-68.15047,-16.52236,360,20,3654,4014,2192,105,1337,3529
"Bolivia","La Paz","Murillo","El Alto de La Paz","UNIDAD EDUCATIVA ECOLOGICO LOS PINOS",-68.17538,-16.5999,506,47,4661,5167,1207,202,3205,4412
"Bolivia","La Paz","Murillo","El Alto de La Paz","UNIDAD EDUCATIVA EDUARDO AVAROA I",-68.29729,-16.49421,45,17,638,683,201,27,393,594
"Bolivia","La Paz","Murillo","El Alto de La Paz","UNIDAD EDUCATIVA EVA PERON",-68.15955,-16.50945,437,35,4267,4704,2171,150,1911,4082
"Bolivia","La Paz","Murillo","El Alto de La Paz","UNIDAD EDUCATIVA FRANZ TAMAYO",-68.25333,-16.50809,484,54,5632,6116,1700,232,3646,5346
"Bolivia","La Paz","Murillo","El Alto de La Paz","UNIDAD EDUCATIVA GRAN PODER",-68.19362,-16.55863,261,18,2224,2485,850,91,1265,2115
"Bolivia","La Paz","Murillo","El Alto de La Paz","UNIDAD EDUCATIVA ILLIMANI",-68.18507,-16.46561,441,56,4632,5073,1563,258,2755,4318
"Bolivia","La Paz","Murillo","El Alto de La Paz","UNIDAD EDUCATIVA INGAVI",-68.1793,-16.46868,421,55,4620,5041,1480,261,2824,4304
"Bolivia","La Paz","Murillo","El Alto de La Paz","UNIDAD EDUCATIVA INTEGRACION",-68.16405,-16.50175,310,25,2597,2907,1405,84,1083,2488
"Bolivia","La Paz","Murillo","El Alto de La Paz","UNIDAD EDUCATIVA JUAN CAPRILES",-68.15948,-16.5062,357,36,3402,3759,1632,96,1638,3270
"Bolivia","La Paz","Murillo","El Alto de La Paz","UNIDAD EDUCATIVA JUAN JOSE TORRES",-68.2122,-16.53901,522,59,5218,5740,1935,197,3027,4962
"Bolivia","La Paz","Murillo","El Alto de La Paz","UNIDAD EDUCATIVA LA PAZ",-68.20005,-16.52881,340,34,2798,3138,1226,106,1432,2658
"Bolivia","La Paz","Murillo","El Alto de La Paz","UNIDAD EDUCATIVA MARISCAL ANTONIO JOSE E",-68.22196,-16.47654,638,73,6087,6725,1994,312,3708,5702
"Bolivia","La Paz","Murillo","El Alto de La Paz","UNIDAD EDUCATIVA MERCEDES ELIO DE RIVERO",-68.23167,-16.55686,300,46,3477,3777,973,116,2342,3315
"Bolivia","La Paz","Murillo","El Alto de La Paz","UNIDAD EDUCATIVA NORUEGA",-68.19359,-16.4826,559,75,5561,6120,2065,300,3121,5186
"Bolivia","La Paz","Murillo","El Alto de La Paz","UNIDAD EDUCATIVA PABLO ZARATE VILLCA",-68.19443,-16.47187,23,4,403,426,126,22,251,377
"Bolivia","La Paz","Murillo","El Alto de La Paz","UNIDAD EDUCATIVA PROGRESO",-68.25311,-16.47828,449,97,5662,6111,1942,284,3339,5281
"Bolivia","La Paz","Murillo","El Alto de La Paz","UNIDAD EDUCATIVA REP. DEL URUGUAY",-68.27645,-16.51882,40,8,550,590,228,17,297,525
"Bolivia","La Paz","Murillo","El Alto de La Paz","UNIDAD EDUCATIVA REPUBLICA DE CUBA",-68.18736,-16.52857,425,64,5159,5584,1716,234,3145,4861
"Bolivia","La Paz","Murillo","El Alto de La Paz","UNIDAD EDUCATIVA REPUBLICA DE CUBA",-68.20181,-16.47474,425,64,5159,5584,1716,234,3145,4861
"Bolivia","La Paz","Murillo","El Alto de La Paz","UNIDAD EDUCATIVA REPUBLICA DE FRANCIA",-68.19515,-16.5501,686,64,6429,7115,2256,285,3824,6080
"Bolivia","La Paz","Murillo","El Alto de La Paz","UNIDAD EDUCATIVA SAN JUAN DE CALAMA",-68.19692,-16.52204,346,42,3643,3989,1473,121,2007,3480
"Bolivia","La Paz","Murillo","El Alto de La Paz","UNIDAD EDUCATIVA SAN LUIS",-68.20049,-16.54089,468,45,4851,5319,1876,169,2761,4637
"Bolivia","La Paz","Murillo","El Alto de La Paz","UNIDAD EDUCATIVA SAN ROQUE",-68.27818,-16.47489,1063,189,11300,12363,3640,629,6842,10482
"Bolivia","La Paz","Murillo","El Alto de La Paz","UNIDAD EDUCATIVA SANTA ROSA DE LIMA",-68.1677,-16.45551,179,21,1769,1948,504,121,1123,1627
"Bolivia","La Paz","Murillo","El Alto de La Paz","UNIDAD EDUCATIVA SANTIAGO I",-68.16467,-16.52485,481,31,4108,4589,1971,154,1952,3923
"Bolivia","La Paz","Murillo","El Alto de La Paz","UNIDAD EDUCATIVA TECNICA YUNGUYO",-68.22483,-16.49496,393,59,4853,5246,1809,184,2801,4610
"Bolivia","La Paz","Murillo","El Alto de La Paz","UNIDAD EDUCATIVA THE STRONGEST",-68.19981,-16.47943,191,23,2072,2263,743,113,1193,1936
"Bolivia","La Paz","Murillo","El Alto de La Paz","UNIDAD EDUCATIVA TUPAC AMARU",-68.20243,-16.57245,208,15,2137,2345,642,88,1392,2034
"Bolivia","La Paz","Murillo","El Alto de La Paz","UNIDAD EDUCATIVA UNION EUROPEA",-68.17921,-16.53997,1265,109,12979,14244,6059,474,6337,12396
"Bolivia","La Paz","Murillo","El Alto de La Paz","UNIDAD EDUCATIVA VILLA ALEMANIA",-68.20655,-16.51637,345,28,3017,3362,1348,116,1525,2873
"Bolivia","La Paz","Murillo","El Alto de La Paz","UNIDAD EDUCATIVA VILLA COOPERATIVA",-68.22495,-16.47322,415,83,4399,4814,1389,197,2730,4119
"Bolivia","La Paz","Murillo","El Alto de La Paz","UNID. EDUC.  M. QUIROGA SANTA CRUZ",-68.17841,-16.5187,242,32,2762,3004,1151,116,1463,2614
"Bolivia","La Paz","Murillo","Mecapaca","COLEGIO 6 DE JUNIO",-67.93151,-16.8046,5,0,270,275,38,1,231,269
"Bolivia","La Paz","Murillo","Mecapaca","COL. SAN SIMON DE AYACUCHO",-67.98664,-16.8034,67,9,353,420,77,13,254,331
"Bolivia","La Paz","Murillo","Mecapaca","ESCUELA EL PALOMAR",-68.00471,-16.7009,76,18,1072,1148,237,33,784,1021
"Bolivia","La Paz","Murillo","Mecapaca","ESCUELA HUARICANA ALTO",-67.93894,-16.73059,45,9,794,839,130,14,641,771
"Bolivia","La Paz","Murillo","Mecapaca","ESCUELA JANKOSUNI",-67.87069,-16.79541,8,0,252,260,29,1,222,251
"Bolivia","La Paz","Murillo","Mecapaca","ESCUELA SANTIAGO DE COLLANA",-67.96983,-16.66847,40,5,599,639,97,12,485,582
"Bolivia","La Paz","Murillo","Mecapaca","ESCUELA SIMONA MANZANEDA",-68.01966,-16.66984,204,17,1878,2082,571,49,1241,1812
"Bolivia","La Paz","Murillo","Mecapaca","PLAZA PRINCIPAL HUAJCHILLA",-68.05293,-16.62848,128,7,1429,1557,477,40,905,1382
"Bolivia","La Paz","Murillo","Mecapaca","UNIDAD EDUCATIVA LLUTO",-68.02113,-16.59331,20,11,267,287,35,21,200,235
"Bolivia","La Paz","Murillo","Mecapaca","UNIDAD EDUCATIVA MILLOCATO",-67.9091,-16.73255,19,2,315,334,37,5,271,308
"Bolivia","La Paz","Murillo","Mecapaca","UNID. EDUC. CONDOR DE LOS ANDES",-68.06098,-16.73627,14,4,336,350,38,9,285,323
"Bolivia","La Paz","Murillo","Nuestra Señora de La Paz","CANCHA DEPORTIVA",-68.108,-16.50108,488,31,4394,4882,2337,98,1928,4265
"Bolivia","La Paz","Murillo","Nuestra Señora de La Paz","CANCHA DEPORTIVA",-68.09735,-16.52828,488,31,4394,4882,2337,98,1928,4265
"Bolivia","La Paz","Murillo","Nuestra Señora de La Paz","(CÁRCEL) COF MIRAFLORES",-68.11906,-16.50092,19,1,37,56,24,0,12,36
"Bolivia","La Paz","Murillo","Nuestra Señora de La Paz","(CÁRCEL) COF OBRAJES",-68.10977,-16.52685,49,0,91,140,55,3,33,88
"Bolivia","La Paz","Murillo","Nuestra Señora de La Paz","(CÁRCEL) PANOPTICO",-68.13491,-16.50283,288,4,491,779,238,16,233,471
"Bolivia","La Paz","Murillo","Nuestra Señora de La Paz","C. E. ADVENTISTA BELLO HORIZONTE",-68.14233,-16.50962,49,3,276,325,170,4,99,269
"Bolivia","La Paz","Murillo","Nuestra Señora de La Paz","CENTRO DE CAPACITACION INTI PAXSI",-68.09966,-16.56521,147,20,1528,1675,906,25,577,1483
"Bolivia","La Paz","Murillo","Nuestra Señora de La Paz","COL. AMERICAN SCHOOL",-68.13224,-16.49319,174,5,1645,1819,1132,28,480,1612
"Bolivia","La Paz","Murillo","Nuestra Señora de La Paz","COL. AMOR DE DIOS",-68.11962,-16.51487,492,14,3097,3589,2449,48,586,3035
"Bolivia","La Paz","Murillo","Nuestra Señora de La Paz","COL. CANADA",-68.14336,-16.50653,338,23,3090,3428,1674,84,1309,2983
"Bolivia","La Paz","Murillo","Nuestra Señora de La Paz","COL. CARACAS",-68.10925,-16.49185,164,19,2109,2273,854,71,1165,2019
"Bolivia","La Paz","Murillo","Nuestra Señora de La Paz","COL. CERVANTES",-68.12268,-16.49229,241,5,2333,2574,1925,28,375,2300
"Bolivia","La Paz","Murillo","Nuestra Señora de La Paz","COL. COPACABANA",-68.116,-16.49115,615,41,6023,6638,3634,164,2184,5818
"Bolivia","La Paz","Murillo","Nuestra Señora de La Paz","COL. CRISTO REY",-68.11716,-16.49006,472,38,5029,5501,2771,162,2058,4829
"Bolivia","La Paz","Murillo","Nuestra Señora de La Paz","COL DANIEL SANCHEZ BUSTAMANTE",-68.14701,-16.50356,951,63,7627,8578,3660,200,3704,7364
"Bolivia","La Paz","Murillo","Nuestra Señora de La Paz","COL DANIEL SANCHEZ BUSTAMANTE",-68.14701,-16.50356,951,63,7627,8578,3660,200,3704,7364
"Bolivia","La Paz","Murillo","Nuestra Señora de La Paz","COLEGIO 6 DE JUNIO",-68.10533,-16.52268,749,37,7987,8736,5501,162,2287,7788
"Bolivia","La Paz","Murillo","Nuestra Señora de La Paz","COLEGIO  ADOLFO  COSTA DU RELS",-68.12815,-16.47907,937,107,9552,10489,3476,413,5556,9032
"Bolivia","La Paz","Murillo","Nuestra Señora de La Paz","COLEGIO AMORETTI",-68.12887,-16.51681,359,35,2687,3046,1965,62,625,2590
"Bolivia","La Paz","Murillo","Nuestra Señora de La Paz","COLEGIO ANTONIO DIAZ VILLAMIL",-68.13431,-16.49114,416,9,3298,3714,2229,59,1001,3230
"Bolivia","La Paz","Murillo","Nuestra Señora de La Paz","COLEGIO AVE MARIA",-68.11795,-16.47431,999,85,8459,9458,5018,223,3133,8151
"Bolivia","La Paz","Murillo","Nuestra Señora de La Paz","COLEGIO AVE MARIA",-68.11795,-16.47431,999,85,8459,9458,5018,223,3133,8151
"Bolivia","La Paz","Murillo","Nuestra Señora de La Paz","COLEGIO BOLIVAR",-68.13287,-16.50506,219,4,1926,2145,1410,37,475,1885
"Bolivia","La Paz","Murillo","Nuestra Señora de La Paz","COLEGIO CANADIENSE",-68.1338,-16.50349,138,5,1267,1405,932,10,320,1252
"Bolivia","La Paz","Murillo","Nuestra Señora de La Paz","COLEGIO DELIA GAMBARTE",-68.10197,-16.50602,214,14,1670,1884,661,96,899,1560
"Bolivia","La Paz","Murillo","Nuestra Señora de La Paz","COLEGIO DON BOSCO",-68.10194,-16.50008,480,37,4722,5202,2385,178,2122,4507
"Bolivia","La Paz","Murillo","Nuestra Señora de La Paz","COLEGIO FRANCIA",-68.1449,-16.48456,167,10,1655,1822,966,63,616,1582
"Bolivia","La Paz","Murillo","Nuestra Señora de La Paz","COLEGIO FRANCO BOLIVIANO",-68.07697,-16.53309,1454,27,9591,11045,7542,152,1870,9412
"Bolivia","La Paz","Murillo","Nuestra Señora de La Paz","COLEGIO GERMAN BUSCH",-68.14012,-16.4923,301,12,2679,2980,1835,71,761,2596
"Bolivia","La Paz","Murillo","Nuestra Señora de La Paz","COLEGIO HOLANDA",-68.15083,-16.49805,1282,103,11070,12352,5057,312,5598,10655
"Bolivia","La Paz","Murillo","Nuestra Señora de La Paz","COLEGIO HOLANDA",-68.15083,-16.49805,1282,103,11070,12352,5057,312,5598,10655
"Bolivia","La Paz","Murillo","Nuestra Señora de La Paz","COLEGIO IGNACIO CALDERON",-68.14203,-16.51064,448,30,4516,4964,2644,88,1754,4398
"Bolivia","La Paz","Murillo","Nuestra Señora de La Paz","COLEGIO IRENE NAVA",-68.11196,-16.46699,777,50,6498,7275,3348,174,2926,6274
"Bolivia","La Paz","Murillo","Nuestra Señora de La Paz","COLEGIO ITALIA",-68.16149,-16.49363,477,40,4954,5431,2332,142,2440,4772
"Bolivia","La Paz","Murillo","Nuestra Señora de La Paz","COLEGIO ITALIA",-68.16149,-16.49363,477,40,4954,5431,2332,142,2440,4772
"Bolivia","La Paz","Murillo","Nuestra Señora de La Paz","COLEGIO JERUSALEM",-68.10326,-16.50195,347,31,3295,3642,1462,119,1683,3145
"Bolivia","La Paz","Murillo","Nuestra Señora de La Paz","COLEGIO LUIS ALBERTO PABON",-68.13418,-16.49122,164,5,1608,1772,1018,58,527,1545
"Bolivia","La Paz","Murillo","Nuestra Señora de La Paz","COLEGIO MAX TOLEDO",-68.15351,-16.49414,694,62,6847,7541,3709,171,2905,6614
"Bolivia","La Paz","Murillo","Nuestra Señora de La Paz","COLEGIO MAX TOLEDO",-68.15351,-16.49414,694,62,6847,7541,3709,171,2905,6614
"Bolivia","La Paz","Murillo","Nuestra Señora de La Paz","COLEGIO NUESTRA SEÑORA DE FATIMA",-68.12103,-16.47554,260,12,2429,2689,1246,104,1067,2313
"Bolivia","La Paz","Murillo","Nuestra Señora de La Paz","COLEGIO RENE BARRIENTOS",-68.07787,-16.53858,404,10,2490,2894,2055,34,391,2446
"Bolivia","La Paz","Murillo","Nuestra Señora de La Paz","COLEGIO SAINT PETERS",-68.13634,-16.50428,171,36,1737,1908,1289,23,389,1678
"Bolivia","La Paz","Murillo","Nuestra Señora de La Paz","COLEGIO SAN IGNACIO",-68.09715,-16.53659,826,10,2927,3753,2340,40,537,2877
"Bolivia","La Paz","Murillo","Nuestra Señora de La Paz","COLEGIO SAN LUIS",-68.13464,-16.51359,570,27,6069,6639,3939,105,1998,5937
"Bolivia","La Paz","Murillo","Nuestra Señora de La Paz","COLEGIO SERGIO VILLEGAS",-68.09919,-16.51187,512,46,4716,5228,2035,165,2470,4505
"Bolivia","La Paz","Murillo","Nuestra Señora de La Paz","COLEGIO SIMON RODRIGUEZ",-68.12112,-16.47591,493,28,3834,4327,2054,80,1672,3726
"Bolivia","La Paz","Murillo","Nuestra Señora de La Paz","COLEGIO TOPATER",-68.10408,-16.49198,320,28,3267,3587,1508,93,1638,3146
"Bolivia","La Paz","Murillo","Nuestra Señora de La Paz","COLEGIO VILLARROEL",-68.14117,-16.49612,378,19,3172,3550,1967,79,1107,3074
"Bolivia","La Paz","Murillo","Nuestra Señora de La Paz","COLEGIO VILLARROEL",-68.14117,-16.4961,378,19,3172,3550,1967,79,1107,3074
"Bolivia","La Paz","Murillo","Nuestra Señora de La Paz","COL. EXPERIMENTAL HUGO DAVILA",-68.11927,-16.49929,531,19,4620,5151,3472,84,1045,4517
"Bolivia","La Paz","Murillo","Nuestra Señora de La Paz","COL. FELIPE 2DO. GUZMAN",-68.12112,-16.50593,420,4,2238,2658,1689,44,501,2190
"Bolivia","La Paz","Murillo","Nuestra Señora de La Paz","COL. FRANZ TAMAYO",-68.15231,-16.49047,621,43,6283,6904,3522,133,2585,6107
"Bolivia","La Paz","Murillo","Nuestra Señora de La Paz","COL. GREGORIO REYNOLDS",-68.13242,-16.51624,403,12,3564,3967,2513,106,933,3446
"Bolivia","La Paz","Murillo","Nuestra Señora de La Paz","COL. GUILLEN PINTO",-68.15572,-16.487,440,59,4970,5410,2167,111,2633,4800
"Bolivia","La Paz","Murillo","Nuestra Señora de La Paz","COL. HERSCHELL",-68.10605,-16.52725,639,23,4356,4995,3064,89,1180,4244
"Bolivia","La Paz","Murillo","Nuestra Señora de La Paz","COL. LORETTO",-68.07858,-16.5454,368,7,2531,2899,2168,35,321,2489
"Bolivia","La Paz","Murillo","Nuestra Señora de La Paz","COL. LUIS ESPINAL CAMPS",-68.14557,-16.52328,759,79,7471,8230,2797,297,4298,7095
"Bolivia","La Paz","Murillo","Nuestra Señora de La Paz","COL. LUIS VELASCO FLORES",-68.15797,-16.46071,80,21,1440,1520,428,37,954,1382
"Bolivia","La Paz","Murillo","Nuestra Señora de La Paz","COL. MARIA AUXILIADORA",-68.13763,-16.50292,224,14,2250,2474,1613,56,567,2180
"Bolivia","La Paz","Murillo","Nuestra Señora de La Paz","COL. MARIEN GARTEN",-68.16064,-16.49042,436,33,4756,5192,2232,115,2376,4608
"Bolivia","La Paz","Murillo","Nuestra Señora de La Paz","COL. NACIONAL AYACUCHO",-68.13404,-16.49409,257,5,1650,1907,1077,41,527,1604
"Bolivia","La Paz","Murillo","Nuestra Señora de La Paz","COL. SAN FRANCISCO",-68.13798,-16.49661,221,12,1804,2025,1268,48,476,1744
"Bolivia","La Paz","Murillo","Nuestra Señora de La Paz","COL. SAN JAVIER",-68.15145,-16.48675,205,9,2253,2458,1500,62,682,2182
"Bolivia","La Paz","Murillo","Nuestra Señora de La Paz","COL. SAN MARTIN",-68.14119,-16.49969,265,16,2143,2408,1349,50,728,2077
"Bolivia","La Paz","Murillo","Nuestra Señora de La Paz","COL. SANTA ANA",-68.13152,-16.49671,156,6,1384,1540,1065,15,298,1363
"Bolivia","La Paz","Murillo","Nuestra Señora de La Paz","COL SERGIO ALMARAZ",-68.11177,-16.49919,439,19,4025,4464,2262,126,1618,3880
"Bolivia","La Paz","Murillo","Nuestra Señora de La Paz","COMPLEJO DEPORTIVO CAMIRI",-68.11738,-16.47857,228,7,2261,2489,1551,40,663,2214
"Bolivia","La Paz","Murillo","Nuestra Señora de La Paz","COMPLEJO DEPORTIVO SAN LUIS",-68.13494,-16.5137,93,3,1118,1211,817,26,272,1089
"Bolivia","La Paz","Murillo","Nuestra Señora de La Paz","COOP. EDUCACIONAL SAN MARCOS LTDA",-68.13071,-16.49973,110,2,910,1020,639,19,250,889
"Bolivia","La Paz","Murillo","Nuestra Señora de La Paz","DIR DISTRITAL DE EDUCACION",-68.12583,-16.49939,296,13,2235,2531,1636,30,556,2192
"Bolivia","La Paz","Murillo","Nuestra Señora de La Paz","E.N.S.A.F.",-68.11926,-16.50412,249,6,2128,2377,1691,26,405,2096
"Bolivia","La Paz","Murillo","Nuestra Señora de La Paz","ESC. ABRAHAM LINCOLN",-68.14679,-16.47846,294,31,3303,3597,1529,109,1634,3163
"Bolivia","La Paz","Murillo","Nuestra Señora de La Paz","ESC. ALCIDES ARGUEDAS",-68.141,-16.50126,135,4,1163,1298,738,23,398,1136
"Bolivia","La Paz","Murillo","Nuestra Señora de La Paz","ESC. ALFREDO VARGAS",-68.12498,-16.48322,504,22,4654,5158,2764,167,1701,4465
"Bolivia","La Paz","Murillo","Nuestra Señora de La Paz","ESC. ALONZO DE MENDOZA",-68.12307,-16.50274,109,1,849,958,645,17,186,831
"Bolivia","La Paz","Murillo","Nuestra Señora de La Paz","ESC. ALONZO DE MENDOZA (U.E. BICHITO DE LUZ)",-68.12307,-16.50274,423,6,3195,3618,2488,82,619,3107
"Bolivia","La Paz","Murillo","Nuestra Señora de La Paz","ESC. ALTO TEMBLADERANI",-68.14673,-16.51458,152,13,1316,1468,444,41,818,1262
"Bolivia","La Paz","Murillo","Nuestra Señora de La Paz","ESC. CHUCURA",-68.10157,-16.27567,2,4,62,64,12,7,39,51
"Bolivia","La Paz","Murillo","Nuestra Señora de La Paz","ESC. CLUB DE LEONES",-68.15932,-16.49451,805,66,8556,9361,4139,267,4084,8223
"Bolivia","La Paz","Murillo","Nuestra Señora de La Paz","ESC. CLUB DE LEONES",-68.15932,-16.49451,805,66,8556,9361,4139,267,4084,8223
"Bolivia","La Paz","Murillo","Nuestra Señora de La Paz","ESC ECUADOR",-68.12662,-16.50871,403,12,2193,2596,1785,23,373,2158
"Bolivia","La Paz","Murillo","Nuestra Señora de La Paz","ESC. EDUARDO AVAROA",-68.14451,-16.49651,583,31,5181,5764,3038,133,1979,5017
"Bolivia","La Paz","Murillo","Nuestra Señora de La Paz","ESC. EDUCACIONAL LUIS  ERNEST",-68.15179,-16.46655,154,9,1860,2014,1069,52,730,1799
"Bolivia","La Paz","Murillo","Nuestra Señora de La Paz","ESC. FRANCISCO DE MIRANDA",-68.09369,-16.53112,429,42,4542,4971,1991,133,2376,4367
"Bolivia","La Paz","Murillo","Nuestra Señora de La Paz","ESC. GENOVEVA RIOS",-68.10799,-16.50161,561,34,5280,5841,2583,163,2500,5083
"Bolivia","La Paz","Murillo","Nuestra Señora de La Paz","ESC. GIL TAPIA RADA",-68.15082,-16.45705,358,52,4327,4685,2055,118,2102,4157
"Bolivia","La Paz","Murillo","Nuestra Señora de La Paz","ESC. GRAL. JOSE MANUEL PANDO",-68.14954,-16.50061,155,13,1820,1975,940,41,826,1766
"Bolivia","La Paz","Murillo","Nuestra Señora de La Paz","ESC IND PEDRO DOMINGO MURILLO",-68.15194,-16.47472,542,44,4544,5086,2448,135,1917,4365
"Bolivia","La Paz","Murillo","Nuestra Señora de La Paz","ESC. JOSE SANTOS",-68.14185,-16.53238,349,40,3453,3802,1248,124,2041,3289
"Bolivia","La Paz","Murillo","Nuestra Señora de La Paz","ESC. LADISLAO CABRERA",-68.14954,-16.50061,568,44,5104,5672,2501,170,2389,4890
"Bolivia","La Paz","Murillo","Nuestra Señora de La Paz","ESC LA MERCED",-68.11915,-16.46617,692,74,6376,7068,2523,180,3599,6122
"Bolivia","La Paz","Murillo","Nuestra Señora de La Paz","ESC. LIMANIPATA 10 DE JUNIO",-68.14423,-16.4425,113,14,1442,1555,421,35,972,1393
"Bolivia","La Paz","Murillo","Nuestra Señora de La Paz","ESC. MCAL SANTA CRUZ",-68.13808,-16.49557,78,3,660,738,412,12,233,645
"Bolivia","La Paz","Murillo","Nuestra Señora de La Paz","ESC. MSCAL ANDRES DE SANTA CRUZ",-67.67603,-15.76266,25,3,205,230,41,2,159,200
"Bolivia","La Paz","Murillo","Nuestra Señora de La Paz","ESC MSCAL ANTONIO JOSE DE SUCRE",-68.07882,-16.48678,57,21,722,779,183,12,506,689
"Bolivia","La Paz","Murillo","Nuestra Señora de La Paz","ESC NATALIA PALACIOS",-68.13138,-16.49431,311,20,2708,3019,1921,49,718,2639
"Bolivia","La Paz","Murillo","Nuestra Señora de La Paz","ESC. NICOLAS  FERNANDEZ NARANJO",-68.1405,-16.48321,803,90,8289,9092,3687,219,4293,7980
"Bolivia","La Paz","Murillo","Nuestra Señora de La Paz","ESC PABLO ITURRI",-68.10268,-16.45948,620,60,5124,5744,1729,178,3157,4886
"Bolivia","La Paz","Murillo","Nuestra Señora de La Paz","ESC PANAMA",-68.12434,-16.49475,450,7,3456,3906,2736,68,645,3381
"Bolivia","La Paz","Murillo","Nuestra Señora de La Paz","ESC. REMBERTO TAPIA",-68.14641,-16.50409,399,42,4556,4955,2112,146,2256,4368
"Bolivia","La Paz","Murillo","Nuestra Señora de La Paz","ESC. REPUBLICA DEL PERU",-68.12861,-16.50675,102,1,588,690,452,9,126,578
"Bolivia","La Paz","Murillo","Nuestra Señora de La Paz","ESC. RURAL CANAVIRI",-68.13701,-16.17418,26,8,187,213,54,2,123,177
"Bolivia","La Paz","Murillo","Nuestra Señora de La Paz","ESC. SAGRADO CORAZON DE JESUS",-68.14336,-16.50653,683,56,7063,7746,2748,200,4059,6807
"Bolivia","La Paz","Murillo","Nuestra Señora de La Paz","ESC. SAN JOSE",-68.12814,-16.52707,348,21,3872,4220,2099,95,1657,3756
"Bolivia","La Paz","Murillo","Nuestra Señora de La Paz","ESC. SAN MARTIN",-68.11597,-16.49783,666,42,6132,6798,3862,233,1995,5857
"Bolivia","La Paz","Murillo","Nuestra Señora de La Paz","ESC. SAN MIGUEL",-68.14462,-16.54603,51,6,488,539,115,13,354,469
"Bolivia","La Paz","Murillo","Nuestra Señora de La Paz","ESC SANTA ROSA DE LIMA",-68.03819,-16.53689,448,63,5381,5829,1329,192,3797,5126
"Bolivia","La Paz","Murillo","Nuestra Señora de La Paz","ESC. SERGIO SUAREZ",-68.13206,-16.48701,670,57,6254,6924,2747,164,3286,6033
"Bolivia","La Paz","Murillo","Nuestra Señora de La Paz","ESCUELA 13 DE JUNIO CHINCHAYA",-68.08366,-16.48442,56,18,653,709,132,19,484,616
"Bolivia","La Paz","Murillo","Nuestra Señora de La Paz","ESCUELA 6 DE AGOSTO",-68.11748,-16.49531,236,18,2365,2601,1569,49,729,2298
"Bolivia","La Paz","Murillo","Nuestra Señora de La Paz","ESCUELA AGUSTIN ASPIAZU",-68.12946,-16.50753,447,11,3167,3614,2455,62,639,3094
"Bolivia","La Paz","Murillo","Nuestra Señora de La Paz","ESCUELA ALTO ACHUMANI",-68.05845,-16.51433,618,46,6259,6877,3573,129,2511,6084
"Bolivia","La Paz","Murillo","Nuestra Señora de La Paz","ESCUELA CALLAPA (PLAZA DE CALLAPA)",-68.09043,-16.49957,140,13,1291,1431,327,55,896,1223
"Bolivia","La Paz","Murillo","Nuestra Señora de La Paz","ESCUELA CHASQUIPAMPA",-68.04555,-16.54921,1021,79,10620,11641,4104,312,6125,10229
"Bolivia","La Paz","Murillo","Nuestra Señora de La Paz","ESCUELA CIUDAD DEL NIÑO",-68.09786,-16.49375,223,18,2315,2538,1129,111,1057,2186
"Bolivia","La Paz","Murillo","Nuestra Señora de La Paz","ESCUELA ELOY ALVAREZ PLATA",-68.14813,-16.48382,157,2,1559,1716,1077,35,445,1522
"Bolivia","La Paz","Murillo","Nuestra Señora de La Paz","ESCUELA JOHN F. KENNEDY",-68.1515,-16.47704,139,5,1301,1440,764,29,503,1267
"Bolivia","La Paz","Murillo","Nuestra Señora de La Paz","ESCUELA JUAN PABLO II",-68.1031,-16.53394,318,14,2822,3140,2154,39,615,2769
"Bolivia","La Paz","Murillo","Nuestra Señora de La Paz","ESCUELA PEDRO POVEDA",-68.11266,-16.5103,408,22,3418,3826,1789,96,1511,3300
"Bolivia","La Paz","Murillo","Nuestra Señora de La Paz","ESCUELA PEDRO POVEDA",-68.11266,-16.5103,408,22,3418,3826,1789,96,1511,3300
"Bolivia","La Paz","Murillo","Nuestra Señora de La Paz","ESCUELA PILOTO NACIONES UNIDAS",-68.1187,-16.49925,132,7,1191,1323,877,20,287,1164
"Bolivia","La Paz","Murillo","Nuestra Señora de La Paz","ESCUELA REPUBLICA DE JAPON",-68.14366,-16.51144,634,47,5956,6590,2582,191,3136,5718
"Bolivia","La Paz","Murillo","Nuestra Señora de La Paz","ESCUELA REPUBLICA DE JAPON",-68.14366,-16.51144,634,47,5956,6590,2582,191,3136,5718
"Bolivia","La Paz","Murillo","Nuestra Señora de La Paz","ESCUELA REPUBLICA DEL BRASIL",-68.14114,-16.49013,263,13,2453,2716,1571,57,812,2383
"Bolivia","La Paz","Murillo","Nuestra Señora de La Paz","ESCUELA ROSEMARI DE BARRIENTOS",-68.08743,-16.52519,1191,18,7850,9041,6275,101,1456,7731
"Bolivia","La Paz","Murillo","Nuestra Señora de La Paz","ESCUELA SANTA ROSA LA FLORIDA",-68.09236,-16.54617,605,19,3640,4245,2534,57,1030,3564
"Bolivia","La Paz","Murillo","Nuestra Señora de La Paz","ESCUELA SUPERIOR DE FORMACIÓN DE MAESTROS SIMON BOLIVAR",-68.11337,-16.51854,255,16,2820,3075,1843,70,891,2734
"Bolivia","La Paz","Murillo","Nuestra Señora de La Paz","ESCUELA VICTOR PAZ ESTENSORO",-68.08412,-16.51657,324,24,2934,3258,1563,77,1270,2833
"Bolivia","La Paz","Murillo","Nuestra Señora de La Paz","ESC. WALTER STRAUB",-68.06351,-16.54204,534,13,4299,4833,2707,135,1444,4151
"Bolivia","La Paz","Murillo","Nuestra Señora de La Paz","FACULTAD DE TECNOLOGIA (U.M.S.A)",-68.12685,-16.50758,216,3,1075,1291,883,17,172,1055
"Bolivia","La Paz","Murillo","Nuestra Señora de La Paz","INSTITUTO AMERICANO",-68.13234,-16.50628,518,32,4253,4771,3290,107,824,4114
"Bolivia","La Paz","Murillo","Nuestra Señora de La Paz","INSTITUTO AMERICANO",-68.13234,-16.50628,518,32,4253,4771,3290,107,824,4114
"Bolivia","La Paz","Murillo","Nuestra Señora de La Paz","INSTITUTO AMERICANO OBRAJES",-68.10566,-16.52666,469,17,4081,4550,3137,79,848,3985
"Bolivia","La Paz","Murillo","Nuestra Señora de La Paz","INSTITUTO DOMINGO SAVIO",-68.08488,-16.53951,377,11,1687,2064,1337,26,313,1650
"Bolivia","La Paz","Murillo","Nuestra Señora de La Paz","INSTITUTO MENDEZ ARCOS",-68.13995,-16.5042,356,10,3726,4082,2767,62,887,3654
"Bolivia","La Paz","Murillo","Nuestra Señora de La Paz","KINDER. BOLIVIA",-68.14942,-16.45182,203,20,2238,2441,942,57,1219,2161
"Bolivia","La Paz","Murillo","Nuestra Señora de La Paz","KINDER FLORA PEREZ DE SAAVEDRA",-68.14472,-16.48339,137,18,1613,1750,895,50,650,1545
"Bolivia","La Paz","Murillo","Nuestra Señora de La Paz","KINDER NAZARIO PARDO",-68.12493,-16.51608,213,8,1861,2074,1047,61,745,1792
"Bolivia","La Paz","Murillo","Nuestra Señora de La Paz","LICEO BOLIVIA",-68.13096,-16.51116,181,6,1296,1477,1035,31,224,1259
"Bolivia","La Paz","Murillo","Nuestra Señora de La Paz","LICEO LA PAZ",-68.13188,-16.50126,184,2,1210,1394,881,24,303,1184
"Bolivia","La Paz","Murillo","Nuestra Señora de La Paz","LICEO TEC.H. NUESTRA SRA DE LA PAZ",-68.13543,-16.49124,220,4,1729,1949,1161,41,523,1684
"Bolivia","La Paz","Murillo","Nuestra Señora de La Paz","PARQUE MIRADOR KILLI KILLI",-68.12752,-16.49444,269,19,2437,2706,1555,89,774,2329
"Bolivia","La Paz","Murillo","Nuestra Señora de La Paz","PLAZA DANIEL RODRIGUEZ",-68.09914,-16.53118,240,9,2405,2645,1329,54,1013,2342
"Bolivia","La Paz","Murillo","Nuestra Señora de La Paz","POLIFUNCIONAL SAN ISIDRO (IGLESIA SAN ISIDRO)",-68.107,-16.51307,176,17,1566,1742,814,47,688,1502
"Bolivia","La Paz","Murillo","Nuestra Señora de La Paz","SEDE JUNTA VECINAL",-68.11436,-16.50176,47,8,587,634,247,6,326,573
"Bolivia","La Paz","Murillo","Nuestra Señora de La Paz","SEDE SOCIAL CAJA FERROVIARIA",-68.15063,-16.44667,111,11,1350,1461,414,30,895,1309
"Bolivia","La Paz","Murillo","Nuestra Señora de La Paz","SEDE SOCIAL CARPANI",-68.0458,-16.45051,42,27,491,533,34,10,420,454
"Bolivia","La Paz","Murillo","Nuestra Señora de La Paz","SEDE SOCIAL DE CUSICANCHA",-68.16608,-16.48517,113,15,1205,1318,476,49,665,1141
"Bolivia","La Paz","Murillo","Nuestra Señora de La Paz","SEDE SOCIAL PLAN AUTOPISTA",-68.14625,-16.45818,164,16,1598,1762,775,45,762,1537
"Bolivia","La Paz","Murillo","Nuestra Señora de La Paz","SEDE SOCIAL PURA PURA",-68.15314,-16.47277,222,7,2201,2423,1105,64,1025,2130
"Bolivia","La Paz","Murillo","Nuestra Señora de La Paz","SEDE SOCIAL VILLA LITORAL",-68.10748,-16.50479,91,15,1008,1099,466,22,505,971
"Bolivia","La Paz","Murillo","Nuestra Señora de La Paz","SEMINARIO NAZARENO",-68.09364,-16.55968,101,1,554,655,427,8,118,545
"Bolivia","La Paz","Murillo","Nuestra Señora de La Paz","TECNICO AYACUCHO",-68.12161,-16.48541,1357,58,11903,13260,8561,237,3047,11608
"Bolivia","La Paz","Murillo","Nuestra Señora de La Paz","TECNICO AYACUCHO",-68.12161,-16.48541,1357,58,11903,13260,8561,237,3047,11608
"Bolivia","La Paz","Murillo","Nuestra Señora de La Paz","U. E. ABRAHAM REYES (FE Y ALEGRIA)",-68.16405,-16.48898,555,58,5865,6420,2519,167,3121,5640
"Bolivia","La Paz","Murillo","Nuestra Señora de La Paz","U. E. ANDINA",-68.11532,-16.46878,252,16,1986,2238,1079,39,852,1931
"Bolivia","La Paz","Murillo","Nuestra Señora de La Paz","U.E. CARLOS SALINAS",-68.13042,-16.4982,60,2,503,563,326,14,161,487
"Bolivia","La Paz","Murillo","Nuestra Señora de La Paz","U.E. EL PEDREGAL (URB. PEDREGAL)",-68.05286,-16.54382,86,10,1091,1177,375,35,671,1046
"Bolivia","La Paz","Murillo","Nuestra Señora de La Paz","U. E. FF. AA. DE LA NACIÓN",-68.08987,-16.52197,358,17,2923,3281,1732,76,1098,2830
"Bolivia","La Paz","Murillo","Nuestra Señora de La Paz","U.E. FILADELFIA",-68.16099,-16.50017,53,11,763,816,279,36,437,716
"Bolivia","La Paz","Murillo","Nuestra Señora de La Paz","U.E. GRAN BRETAÑA",-68.10885,-16.5197,10,0,76,86,43,1,32,75
"Bolivia","La Paz","Murillo","Nuestra Señora de La Paz","U. E. KINDER CAROLA IÑIGUEZ (FE Y ALEGRIA)",-68.16422,-16.48865,188,10,1615,1803,658,32,915,1573
"Bolivia","La Paz","Murillo","Nuestra Señora de La Paz","U. E. PANTALEON DALENCE",-68.14204,-16.51047,165,10,1890,2055,1199,44,637,1836
"Bolivia","La Paz","Murillo","Nuestra Señora de La Paz","U.E. SAN ANDRÉS",-68.07038,-16.53759,348,11,2701,3049,2009,59,622,2631
"Bolivia","La Paz","Murillo","Nuestra Señora de La Paz","U.E. WALDO BALLIVIAN",-68.11192,-16.5086,461,24,5077,5538,2780,169,2104,4884
"Bolivia","La Paz","Murillo","Nuestra Señora de La Paz","UNIDAD EDUCATIVA 24 DE JUNIO",-68.10389,-16.49494,554,47,5633,6187,2554,215,2817,5371
"Bolivia","La Paz","Murillo","Nuestra Señora de La Paz","UNIDAD EDUCATIVA ARABE DE EGIPTO",-68.1409,-16.4971,150,13,1683,1833,1044,26,600,1644
"Bolivia","La Paz","Murillo","Nuestra Señora de La Paz","UNIDAD EDUCATIVA CARLOS MEDINACELLI",-68.14066,-16.51231,484,20,4452,4936,2561,134,1737,4298
"Bolivia","La Paz","Murillo","Nuestra Señora de La Paz","UNIDAD EDUCATIVA CRISTIANA VIDA NUEVA",-68.11804,-16.48913,257,13,2715,2972,1681,66,955,2636
"Bolivia","La Paz","Murillo","Nuestra Señora de La Paz","UNIDAD EDUCATIVA FABRIL 18 DE MAYO",-68.14603,-16.49241,321,14,2914,3235,1856,67,977,2833
"Bolivia","La Paz","Murillo","Nuestra Señora de La Paz","UNIDAD EDUCATIVA FABRIL 18 DE MAYO",-68.14603,-16.49241,321,14,2914,3235,1856,67,977,2833
"Bolivia","La Paz","Murillo","Nuestra Señora de La Paz","UNIDAD EDUCATIVA JUPAPINA",-68.0744,-16.58935,144,11,1176,1320,524,40,601,1125
"Bolivia","La Paz","Murillo","Nuestra Señora de La Paz","UNIDAD EDUCATIVA LITORAL A",-68.151,-16.47124,374,23,3347,3721,1673,96,1555,3228
"Bolivia","La Paz","Murillo","Nuestra Señora de La Paz","UNIDAD EDUCATIVA LOS PINOS",-68.07632,-16.54179,663,13,4322,4985,3695,100,514,4209
"Bolivia","La Paz","Murillo","Nuestra Señora de La Paz","UNIDAD EDUCATIVA MALLASA",-68.08762,-16.57032,169,17,1674,1843,775,36,846,1621
"Bolivia","La Paz","Murillo","Nuestra Señora de La Paz","UNIDAD EDUCATIVA PRIVADA LA PAZ",-68.14587,-16.4988,151,12,1459,1610,796,35,616,1412
"Bolivia","La Paz","Murillo","Nuestra Señora de La Paz","UNIDAD EDUCATIVA PRIVADA LA PAZ",-68.14587,-16.4988,151,12,1459,1610,796,35,616,1412
"Bolivia","La Paz","Murillo","Nuestra Señora de La Paz","UNIDAD EDUCATIVA PUERTO RICO",-68.13956,-16.51244,345,30,3573,3918,1885,120,1538,3423
"Bolivia","La Paz","Murillo","Nuestra Señora de La Paz","UNIDAD EDUCATIVA REPUBLICA DE CHINA",-68.1278,-16.4945,300,16,2812,3112,1704,69,1023,2727
"Bolivia","La Paz","Murillo","Nuestra Señora de La Paz","UNIDAD EDUCATIVA REPUBLICA DE CUBA",-68.13556,-16.50287,334,14,2639,2973,1903,50,672,2575
"Bolivia","La Paz","Murillo","Nuestra Señora de La Paz","UNIDAD EDUCATIVA ROSARIO (URB. EL ROSARIO)",-68.11529,-16.52871,24,1,507,531,284,11,211,495
"Bolivia","La Paz","Murillo","Nuestra Señora de La Paz","UNIDAD EDUCATIVA SAN JOSE (U. E. MANUEL B. MARIACA)",-68.15286,-16.48993,284,15,3352,3636,1943,70,1324,3267
"Bolivia","La Paz","Murillo","Nuestra Señora de La Paz","UNIDAD EDUCATIVA VALLE HERMOSO",-68.10799,-16.4883,256,23,3022,3278,1358,80,1561,2919
"Bolivia","La Paz","Murillo","Nuestra Señora de La Paz","UNIDAD EDUCATIVA VILLA HARCA",-68.04404,-16.09133,35,6,291,326,101,13,171,272
"Bolivia","La Paz","Murillo","Nuestra Señora de La Paz","UNID. EDUC. 20 DE OCTUBRE N° 1",-68.16086,-16.46114,107,21,1283,1390,354,30,878,1232
"Bolivia","La Paz","Murillo","Nuestra Señora de La Paz","UNID EDUCATIVA BETESTA",-68.04996,-16.54382,227,25,2750,2977,952,99,1674,2626
"Bolivia","La Paz","Murillo","Nuestra Señora de La Paz","UNID. EDUC. HUGO BANZER SUAREZ",-68.14326,-16.51199,178,15,1665,1843,909,28,713,1622
"Bolivia","La Paz","Murillo","Nuestra Señora de La Paz","UNID. EDUC. JAIME ESCALANTE",-68.14835,-16.51145,414,55,3784,4198,1398,106,2225,3623
"Bolivia","La Paz","Murillo","Nuestra Señora de La Paz","UNID. EDUC. JOAQUIN HERNANN",-68.02591,-16.54834,95,25,1081,1176,172,19,865,1037
"Bolivia","La Paz","Murillo","Nuestra Señora de La Paz","UNID. EDUC. JORGE VARGAS",-68.13081,-16.53269,213,11,2192,2405,1060,93,1028,2088
"Bolivia","La Paz","Murillo","Nuestra Señora de La Paz","UNID. EDUC. RAUL SALMON DE LA BARRA",-68.1396,-16.52271,293,31,2955,3248,1034,97,1793,2827
"Bolivia","La Paz","Murillo","Palca","COL PEDRO DOMINGO MURILLO",-67.95261,-16.56124,247,50,1923,2170,259,95,1519,1778
"Bolivia","La Paz","Murillo","Palca","ESCUELA CAYIMBAYA",-67.75253,-16.71384,53,15,595,648,162,31,387,549
"Bolivia","La Paz","Murillo","Palca","ESCUELA COHONI",-67.83873,-16.7112,152,46,1329,1481,147,76,1060,1207
"Bolivia","La Paz","Murillo","Palca","ESCUELA COTAÑA",-67.71759,-16.72519,50,6,542,592,76,14,446,522
"Bolivia","La Paz","Murillo","Palca","ESCUELA QUILLIHUAYA",-67.90135,-16.66606,107,17,935,1042,111,29,778,889
"Bolivia","La Paz","Murillo","Palca","ESCUELA TAHUAPALCA",-67.87465,-16.72088,39,12,498,537,54,15,417,471
"Bolivia","La Paz","Murillo","Palca","ESCUELA TIRATA",-67.78961,-16.76238,29,0,257,286,25,0,232,257
"Bolivia","La Paz","Murillo","Palca","UNIDAD EDUCATIVA UNI",-67.9979,-16.5432,46,13,755,801,73,34,635,708
"Bolivia","La Paz","Nor Yungas","Coripata","CASA CULTURAL SAN JUAN DE CORIPATA",-67.56571,-16.25786,39,7,498,537,70,9,412,482
"Bolivia","La Paz","Nor Yungas","Coripata","COLEGIO ANDRES DE SANTA CRUZ",-67.64132,-16.27026,284,34,2254,2538,856,133,1231,2087
"Bolivia","La Paz","Nor Yungas","Coripata","COLEGIO FRAZ TAMAYO FE Y ALEGRIA",-67.6668,-16.28096,146,12,1020,1166,419,58,531,950
"Bolivia","La Paz","Nor Yungas","Coripata","COLEGIO SANTIAGO TOCORONI",-67.55057,-16.26809,112,8,907,1019,193,32,674,867
"Bolivia","La Paz","Nor Yungas","Coripata","ESCUELA CAPITAN LUIS REVERO SANCHEZ",-67.60426,-16.31971,709,67,4092,4801,1462,156,2407,3869
"Bolivia","La Paz","Nor Yungas","Coripata","ESCUELA MILLUHUAYA ALTO",-67.61317,-16.37393,74,6,735,809,194,20,515,709
"Bolivia","La Paz","Nor Yungas","Coroico","CASA DE GOBIERNO",-67.7733,-16.11081,68,5,472,540,145,24,298,443
"Bolivia","La Paz","Nor Yungas","Coroico","COL. TEC. HUM. CRUZ LOMA",-67.6988,-16.19916,89,10,853,942,226,32,585,811
"Bolivia","La Paz","Nor Yungas","Coroico","ESC. FELIX REYES ORTIZ",-67.72715,-16.18757,363,35,1842,2205,754,80,973,1727
"Bolivia","La Paz","Nor Yungas","Coroico","ESCUELA FRANZ TAMAYO",-67.73856,-16.14407,84,9,487,571,133,13,332,465
"Bolivia","La Paz","Nor Yungas","Coroico","ESCUELA JHON F. KENNEDY",-67.68882,-16.07204,53,7,513,566,96,17,393,489
"Bolivia","La Paz","Nor Yungas","Coroico","ESCUELA PACOLLO",-67.79175,-16.20483,104,8,633,737,148,25,452,600
"Bolivia","La Paz","Nor Yungas","Coroico","ESCUELA SANTA ROSA DE QUILO QUILO",-67.81871,-16.03682,57,8,706,763,111,19,568,679
"Bolivia","La Paz","Nor Yungas","Coroico","ESCUELA UNDUAVI",-67.90942,-16.31096,7,1,58,65,13,4,40,53
"Bolivia","La Paz","Nor Yungas","Coroico","U.E. YOLOSA",-67.74015,-16.23356,62,6,424,486,129,9,280,409
"Bolivia","La Paz","Nor Yungas","Coroico","UNIDAD EDUCATIVA PUENTE ARMAS",-67.64138,-16.03312,78,4,441,519,77,11,349,426
"Bolivia","La Paz","Nor Yungas","Coroico","UNIDAD EDU. SAN PEDRO",-67.72571,-16.19051,361,40,2079,2440,833,77,1129,1962
"Bolivia","La Paz","Omasuyos","Achacachi","CASA DE GOBIERNO",-68.81913,-16.16913,61,26,744,805,206,33,479,685
"Bolivia","La Paz","Omasuyos","Achacachi","COLEGIO ANTOFAGASTA",-68.69424,-15.9962,48,14,695,743,198,24,459,657
"Bolivia","La Paz","Omasuyos","Achacachi","COLEGIO FRANZ TAMAYO",-68.74367,-15.92973,63,26,882,945,209,41,606,815
"Bolivia","La Paz","Omasuyos","Achacachi","COLEGIO MARISCAL SANTA CRUZ",-68.68538,-16.04263,489,72,3710,4199,1320,204,2114,3434
"Bolivia","La Paz","Omasuyos","Achacachi","COLEGIO OMASUYOS",-68.68598,-16.04657,386,76,3572,3958,1253,182,2061,3314
"Bolivia","La Paz","Omasuyos","Achacachi","COLEGIO SIMON BOLIVAR",-68.59965,-16.0757,16,3,403,419,121,33,246,367
"Bolivia","La Paz","Omasuyos","Achacachi","COLEGIO SUÑASIVI",-68.64019,-15.98684,84,14,641,725,140,49,438,578
"Bolivia","La Paz","Omasuyos","Achacachi","ESC. SIMON BOLIVIAR",-68.69108,-16.04526,299,80,2719,3018,969,141,1529,2498
"Bolivia","La Paz","Omasuyos","Achacachi","ESCUELA AJLLATA GRANDE",-68.7886,-16.02371,96,37,1289,1385,515,50,687,1202
"Bolivia","La Paz","Omasuyos","Achacachi","ESCUELA APLICACION HUARIZATA",-68.66218,-15.97352,191,40,1450,1641,508,89,813,1321
"Bolivia","La Paz","Omasuyos","Achacachi","ESCUELA APURAYA",-68.74739,-16.0668,49,18,759,808,190,33,518,708
"Bolivia","La Paz","Omasuyos","Achacachi","ESCUELA BELEN",-68.70184,-16.01776,49,11,490,539,112,22,345,457
"Bolivia","La Paz","Omasuyos","Achacachi","ESCUELA CENTRAL CASAMAYA",-68.59995,-16.04042,32,6,354,386,85,27,236,321
"Bolivia","La Paz","Omasuyos","Achacachi","ESCUELA KILLOSA",-68.70744,-15.93228,10,0,126,136,35,7,84,119
"Bolivia","La Paz","Omasuyos","Achacachi","ESCUELA VILLA LIPE",-68.75453,-16.05257,55,17,672,727,166,40,449,615
"Bolivia","La Paz","Omasuyos","Achacachi","ESCUELA WALATA CHICO",-68.65627,-15.93059,31,6,260,291,60,5,189,249
"Bolivia","La Paz","Omasuyos","Achacachi","NUCLEO ECOLAR MURUMAMANI",-68.69246,-15.90919,19,2,499,518,84,14,399,483
"Bolivia","La Paz","Omasuyos","Achacachi","NUCLEO EDUCATIVO TAHARI",-68.6852,-15.95393,8,2,421,429,138,17,264,402
"Bolivia","La Paz","Omasuyos","Achacachi","NÚCLEO ESCOLAR CHALLUYO",-68.61758,-15.99023,20,14,435,455,91,21,309,400
"Bolivia","La Paz","Omasuyos","Achacachi","NUCLEO TACAMARA",-68.61773,-16.02135,88,17,831,919,193,51,570,763
"Bolivia","La Paz","Omasuyos","Achacachi","PLAZA VILLA ASUNCION DE CORPAPUTO",-68.55613,-16.0707,65,14,503,568,115,20,354,469
"Bolivia","La Paz","Omasuyos","Ancoraimes","COLEGIO CAJIATA",-68.85471,-15.91954,4,4,324,328,32,11,277,309
"Bolivia","La Paz","Omasuyos","Ancoraimes","COLEGIO MACAMACA",-68.94691,-15.83644,37,6,663,700,116,22,519,635
"Bolivia","La Paz","Omasuyos","Ancoraimes","ESCUELA FRANZ TAMAYO",-68.90729,-15.89587,186,29,1152,1338,298,74,751,1049
"Bolivia","La Paz","Omasuyos","Ancoraimes","ESCUELA SECCIONAL CHIÑAJA",-68.83353,-15.76956,1,2,94,95,14,2,76,90
"Bolivia","La Paz","Omasuyos","Ancoraimes","ESCUELA SOTALAYA",-68.83341,-15.92723,3,8,316,319,53,8,247,300
"Bolivia","La Paz","Omasuyos","Ancoraimes","ESCUELA TURRINI",-68.89091,-15.87126,14,3,288,302,67,10,208,275
"Bolivia","La Paz","Omasuyos","Ancoraimes","MOROCOLLO PLAZA PRINCIPAL",-68.88557,-15.91232,103,23,909,1012,222,49,615,837
"Bolivia","La Paz","Omasuyos","Ancoraimes","NUCLEO ESCOLAR DE PATAPATANI",-68.82576,-15.78231,5,1,109,114,17,1,90,107
"Bolivia","La Paz","Omasuyos","Ancoraimes","PLAZA 14 DE FEBRERO",-68.81345,-15.88548,95,10,955,1050,184,37,724,908
"Bolivia","La Paz","Omasuyos","Ancoraimes","SEDE SOCIAL CHOJÑAPATA",-68.87042,-15.79118,7,0,97,104,20,1,76,96
"Bolivia","La Paz","Omasuyos","Ancoraimes","SEDE SOCIAL INKA CATURAPI",-68.82888,-15.76071,20,8,285,305,105,3,169,274
"Bolivia","La Paz","Omasuyos","Ancoraimes","TEC. HUMANISTA POCOATA GRANDE",-68.79222,-15.94282,31,13,597,628,138,24,422,560
"Bolivia","La Paz","Omasuyos","Chúa Cocani","CASA DE GOBIERNO",-68.76876,-16.1837,53,7,480,533,162,14,297,459
"Bolivia","La Paz","Omasuyos","Chúa Cocani","ESCUELA CHUA COCANI",-68.74966,-16.18941,150,11,725,875,265,31,418,683
"Bolivia","La Paz","Omasuyos","Chúa Cocani","ESCUELA CORPACHILAYA",-68.71874,-16.19794,39,5,330,369,120,10,195,315
"Bolivia","La Paz","Omasuyos","Chúa Cocani","UNIDAD EDUCATIVA COMPI",-68.7893,-16.17562,55,21,704,759,166,32,485,651
"Bolivia","La Paz","Omasuyos","Huarina","CASA DE GOBIERNO",-68.57069,-16.24477,46,2,380,426,78,6,294,372
"Bolivia","La Paz","Omasuyos","Huarina","ESCUELA APUVILLQUE MOROCOLLO",-68.64399,-16.13322,38,12,312,350,75,23,202,277
"Bolivia","La Paz","Omasuyos","Huarina","ESCUELA BERNABE LEDEZMA",-68.54478,-16.12266,57,13,574,631,182,26,353,535
"Bolivia","La Paz","Omasuyos","Huarina","ESCUELA MARISCAL DE SANTA CRUZ",-68.60149,-16.19093,305,49,2169,2474,705,103,1312,2017
"Bolivia","La Paz","Omasuyos","Huarina","ESCUELA UNIDAD EDUCATIVAO COROMATA BAJA",-68.56112,-16.15195,35,8,323,358,113,11,191,304
"Bolivia","La Paz","Omasuyos","Huatajata","COLEGIO NACIONAL MIXTO HUATAJATA",-68.70113,-16.2081,170,26,1382,1552,536,51,769,1305
"Bolivia","La Paz","Omasuyos","Huatajata","ESCUELA SANCA JAHUIRA",-68.66814,-16.21417,28,13,329,357,111,14,191,302
"Bolivia","La Paz","Omasuyos","Santiago de Huata","COLEGIO CENTRAL POREJONI",-68.83286,-16.10552,36,14,329,365,51,7,257,308
"Bolivia","La Paz","Omasuyos","Santiago de Huata","COLEGIO SANTIAGO DE HUATA",-68.81879,-16.05531,191,71,1619,1810,532,94,922,1454
"Bolivia","La Paz","Omasuyos","Santiago de Huata","ESCUELA WATARI",-68.86102,-16.07956,25,5,189,214,44,13,127,171
"Bolivia","La Paz","Omasuyos","Santiago de Huata","PLAZA WICHI WICHI",-68.87871,-16.09691,51,9,541,592,125,17,390,515
"Bolivia","La Paz","Pacajes","Calacoto","COL. ANTOFAGASTA",-69.04382,-17.42133,14,3,179,193,46,5,125,171
"Bolivia","La Paz","Pacajes","Calacoto","COL. CAMACHO",-68.75751,-17.42726,66,2,156,222,28,2,124,152
"Bolivia","La Paz","Pacajes","Calacoto","COLEGIO FRANZ TAMAYO",-68.85695,-17.30775,27,0,223,250,51,3,169,220
"Bolivia","La Paz","Pacajes","Calacoto","COLEGIO HEROES DEL PACIFICO",-68.76153,-17.86703,6,1,125,131,25,0,99,124
"Bolivia","La Paz","Pacajes","Calacoto","COLEGIO PLAYA VINTO",-68.91974,-17.76429,15,3,107,122,14,1,89,103
"Bolivia","La Paz","Pacajes","Calacoto","COL. HUARISCATA",-68.80087,-17.83315,26,0,142,168,13,1,128,141
"Bolivia","La Paz","Pacajes","Calacoto","COL. J. SARCO KRAMER",-68.81659,-17.42351,39,3,135,174,34,2,96,130
"Bolivia","La Paz","Pacajes","Calacoto","ESC. LAGUNA BLANCA",-68.61784,-17.6079,7,0,127,134,18,3,106,124
"Bolivia","La Paz","Pacajes","Calacoto","ESC. N. LERCO",-68.47871,-17.5797,32,2,205,237,42,6,155,197
"Bolivia","La Paz","Pacajes","Calacoto","ESC. PABLO LAVADENS",-68.63289,-17.28291,97,4,445,542,114,18,309,423
"Bolivia","La Paz","Pacajes","Calacoto","ESCUELA ACHAVICO",-68.92034,-17.41066,5,1,56,61,8,2,45,53
"Bolivia","La Paz","Pacajes","Calacoto","ESCUELA PLAYA VERDE",-68.56482,-17.37746,19,2,185,204,30,4,149,179
"Bolivia","La Paz","Pacajes","Calacoto","ESC. ULLOMA",-68.49041,-17.4915,10,2,181,191,50,2,127,177
"Bolivia","La Paz","Pacajes","Calacoto","PLAZA AUDIENCIA",-68.6291,-17.47268,19,3,368,387,72,2,291,363
"Bolivia","La Paz","Pacajes","Calacoto","PLAZA CHALLUYO",-69.03053,-17.35813,22,4,113,135,33,3,73,106
"Bolivia","La Paz","Pacajes","Calacoto","PLAZA PRINCIPAL",-68.91343,-17.47115,30,2,110,140,10,3,95,105
"Bolivia","La Paz","Pacajes","Calacoto","SEDE SOCIAL MAX TOLEDO",-68.68167,-17.2371,33,1,149,182,34,3,111,145
"Bolivia","La Paz","Pacajes","Caquiaviri","COL. CALLA LLALLAGUA",-68.68002,-16.92397,34,0,142,176,14,5,123,137
"Bolivia","La Paz","Pacajes","Caquiaviri","ESC. ACHIRI",-69.00089,-17.21467,226,17,874,1100,226,27,604,830
"Bolivia","La Paz","Pacajes","Caquiaviri","ESC. ANTAQUIRA VILLA BELEN",-68.66805,-17.08638,41,2,279,320,66,4,207,273
"Bolivia","La Paz","Pacajes","Caquiaviri","ESC. CALAMA QUINTAVI",-68.86324,-17.26844,5,0,32,37,12,0,20,32
"Bolivia","La Paz","Pacajes","Caquiaviri","ESC. CAQUIAVIRI",-68.60491,-17.02134,202,23,908,1110,210,31,644,854
"Bolivia","La Paz","Pacajes","Caquiaviri","ESC. CENTRAL",-68.57354,-16.90038,44,3,320,364,54,11,252,306
"Bolivia","La Paz","Pacajes","Caquiaviri","ESC. CHOJNA PAMPA DE VICHAYA",-68.71049,-17.12527,2,0,103,105,29,0,74,103
"Bolivia","La Paz","Pacajes","Caquiaviri","ESC. JIHUACUTA",-68.78035,-17.1179,46,8,336,382,62,14,252,314
"Bolivia","La Paz","Pacajes","Caquiaviri","ESC. VILLA CHOCOROSI",-68.84946,-17.14096,32,4,213,245,80,5,124,204
"Bolivia","La Paz","Pacajes","Caquiaviri","NUCLEO ESCOLAR VICHAYA",-68.66454,-16.85874,37,5,342,379,98,9,230,328
"Bolivia","La Paz","Pacajes","Caquiaviri","PLAZA 14 DE SEPTIEMBRE",-68.71069,-16.90587,18,4,262,280,37,3,218,255
"Bolivia","La Paz","Pacajes","Caquiaviri","PLAZA SAN MIGUEL",-68.7556,-17.03869,37,3,318,355,80,10,225,305
"Bolivia","La Paz","Pacajes","Caquiaviri","SEDE SOCIAL",-68.94909,-17.09862,20,2,62,82,25,1,34,59
"Bolivia","La Paz","Pacajes","Charaña","COLEGIO EDUARDO AVAROA",-69.44685,-17.59194,183,9,599,782,218,16,356,574
"Bolivia","La Paz","Pacajes","Charaña","COL. TEC. HUMANISTICO TOPATER",-69.10415,-17.43627,5,0,72,77,26,2,44,70
"Bolivia","La Paz","Pacajes","Charaña","ESC. CHINOCAVI",-69.33294,-17.72286,14,1,84,98,14,1,68,82
"Bolivia","La Paz","Pacajes","Charaña","ESC. EDUARDO AVAROA",-69.24786,-17.5377,3,0,42,45,14,2,26,40
"Bolivia","La Paz","Pacajes","Charaña","ESC. GUALBERTO VILLARROEL",-69.11758,-17.51751,5,1,51,56,8,2,40,48
"Bolivia","La Paz","Pacajes","Charaña","ESC. RIO BLANCO",-69.07213,-17.8919,25,3,136,161,61,5,67,128
"Bolivia","La Paz","Pacajes","Charaña","ESC. SICUANI CONDOROCA",-69.46599,-17.4963,26,1,123,149,19,1,102,121
"Bolivia","La Paz","Pacajes","Comanche","COLEGIO COMANCHE",-68.42522,-16.95766,138,18,938,1076,244,38,638,882
"Bolivia","La Paz","Pacajes","Comanche","COL. TOCOPILLA CANTUYO",-68.50373,-16.83876,24,3,324,348,68,10,243,311
"Bolivia","La Paz","Pacajes","Comanche","ESC. KELLA KELLA",-68.41179,-16.9197,5,2,126,131,53,3,68,121
"Bolivia","La Paz","Pacajes","Comanche","SEDE SOCIAL",-68.46437,-17.07932,37,6,289,326,84,5,194,278
"Bolivia","La Paz","Pacajes","Comanche","SEDE SOCIAL",-68.54688,-16.92686,37,6,289,326,84,5,194,278
"Bolivia","La Paz","Pacajes","Coro Coro","CASA DE  GOBIERNO",-68.49454,-17.2455,21,3,279,300,73,12,191,264
"Bolivia","La Paz","Pacajes","Coro Coro","COL. CANCASILLA",-68.60786,-17.10883,18,2,121,139,36,3,80,116
"Bolivia","La Paz","Pacajes","Coro Coro","COLEGIO JOSE MANUEL PANDO",-68.49117,-17.2136,37,8,389,426,93,17,271,364
"Bolivia","La Paz","Pacajes","Coro Coro","COL. JAYUMA LLALLAGUA",-68.48241,-17.29913,9,2,128,137,37,2,87,124
"Bolivia","La Paz","Pacajes","Coro Coro","ESC. PEDRO DOMINGO MURILLO",-68.2065,-17.1975,0,2,191,191,30,9,150,180
"Bolivia","La Paz","Pacajes","Coro Coro","ESC. SECCIONAL ANCO AQUE",-68.19199,-17.17361,1,7,331,332,91,7,226,317
"Bolivia","La Paz","Pacajes","Coro Coro","ESC. TOPOHOCO",-68.24099,-17.16903,19,14,316,335,58,18,226,284
"Bolivia","La Paz","Pacajes","Coro Coro","ESC. VICENTA JUARISTE EGUINO",-68.45507,-17.1773,244,9,1228,1472,313,58,848,1161
"Bolivia","La Paz","Pacajes","Coro Coro","NUCLEO ESC. CENTRAL ENEQUELLA",-68.15412,-17.14132,32,3,297,329,77,4,213,290
"Bolivia","La Paz","Pacajes","Coro Coro","PLAZA APOSTOL SANTIAGO",-68.13311,-17.18174,37,17,289,326,70,16,186,256
"Bolivia","La Paz","Pacajes","Coro Coro","PLAZA CANTON ROSAPATA",-68.58238,-17.21777,30,2,136,166,29,4,101,130
"Bolivia","La Paz","Pacajes","Coro Coro","PLAZA MEJILLONES",-68.50258,-17.08385,50,6,279,329,79,5,189,268
"Bolivia","La Paz","Pacajes","Coro Coro","PLAZA PRINCIPAL",-68.64835,-17.14039,33,4,194,227,34,9,147,181
"Bolivia","La Paz","Pacajes","Nazacara de Pacajes","PLAZA PRINCIPAL",-68.76462,-16.93795,56,3,275,331,49,7,216,265
"Bolivia","La Paz","Pacajes","Santiago de Callapa","COL.TECNICO HUMANISTICO TUPAC AMARU",-68.33572,-17.34924,37,5,161,198,39,6,111,150
"Bolivia","La Paz","Pacajes","Santiago de Callapa","ESC. HUAYLLAPANTA",-68.26348,-17.27865,9,3,86,95,27,3,53,80
"Bolivia","La Paz","Pacajes","Santiago de Callapa","ESC. HUICHURAYA",-68.43911,-17.33394,15,2,115,130,30,3,80,110
"Bolivia","La Paz","Pacajes","Santiago de Callapa","ESC. N. CANUHUTA",-68.47823,-17.42123,50,2,291,341,65,4,220,285
"Bolivia","La Paz","Pacajes","Santiago de Callapa","ESC. POQUEVILLQUE",-68.27715,-17.32858,17,1,118,135,23,4,90,113
"Bolivia","La Paz","Pacajes","Santiago de Callapa","ESCUELA LIBERTADOR SIMON BOLIVIAR",-68.2121,-17.43119,12,1,150,162,41,2,106,147
"Bolivia","La Paz","Pacajes","Santiago de Callapa","ESCUELA ROMERO PAMPA",-68.23565,-17.35947,23,4,231,254,75,7,145,220
"Bolivia","La Paz","Pacajes","Santiago de Callapa","PLAZA 29 DE JUNIO",-68.18311,-17.36895,17,6,273,290,67,14,186,253
"Bolivia","La Paz","Pacajes","Santiago de Callapa","PLAZA SANTIAGO DE CALLAPA",-68.35594,-17.4794,145,11,449,594,113,19,306,419
"Bolivia","La Paz","Pacajes","Santiago de Callapa","PLAZA VILLA PUCHUNI",-68.31937,-17.2838,24,4,169,193,52,5,108,160
"Bolivia","La Paz","Pacajes","Santiago de Callapa","P. S. FRANCISCO YARIBAY",-68.41264,-17.24828,54,0,225,279,44,3,178,222
"Bolivia","La Paz","Pacajes","Santiago de Callapa","UNIDAD EDUCATIVA HUAJRUMA",-68.39203,-17.57708,7,0,76,83,31,1,44,75
"Bolivia","La Paz","Pacajes","Waldo Ballivián","PATIO HISTORICO TUMARAPI",-68.18797,-17.08567,68,9,919,987,207,35,668,875
"Bolivia","La Paz","Sur Yungas","Chulumani (Villa de la Libertad)","CASA DE GOBIERNO",-67.58398,-16.3884,66,11,536,602,122,10,393,515
"Bolivia","La Paz","Sur Yungas","Chulumani (Villa de la Libertad)","COLEGIO AGUSTIN ASPIAZU",-67.52634,-16.40942,810,48,4209,5019,1510,168,2483,3993
"Bolivia","La Paz","Sur Yungas","Chulumani (Villa de la Libertad)","COLEGIO GRAL.ARMANDO ESCOBAR URIA",-67.51199,-16.43177,85,6,648,733,237,18,387,624
"Bolivia","La Paz","Sur Yungas","Chulumani (Villa de la Libertad)","COLEGIO JUAN RAMOS DE TAGMA",-67.47916,-16.37452,88,9,756,844,250,29,468,718
"Bolivia","La Paz","Sur Yungas","Chulumani (Villa de la Libertad)","ESC. COLOPAMPA",-67.53527,-16.28799,6,3,136,142,20,1,112,132
"Bolivia","La Paz","Sur Yungas","Chulumani (Villa de la Libertad)","PLAZA PRINCIPAL",-67.50503,-16.44271,29,6,445,474,80,14,345,425
"Bolivia","La Paz","Sur Yungas","Chulumani (Villa de la Libertad)","U.E. TÉCNICO HUMANÍSTICO PASTO PATA",-67.47044,-16.36745,95,11,725,820,263,24,427,690
"Bolivia","La Paz","Sur Yungas","Chulumani (Villa de la Libertad)","UNIDAD EDUCATIVA HUANCANE",-67.53661,-16.3786,238,18,1579,1817,437,64,1060,1497
"Bolivia","La Paz","Sur Yungas","Irupana (Villa de Lanza)","CANCHA DE UNION HUIRI",-67.35191,-16.30181,41,9,450,491,47,13,381,428
"Bolivia","La Paz","Sur Yungas","Irupana (Villa de Lanza)","COLEGIO TTE.CNL. RAFAEL PABON",-67.79365,-16.57078,221,27,865,1086,328,28,482,810
"Bolivia","La Paz","Sur Yungas","Irupana (Villa de Lanza)","COL. NUCLEO ROSARIO",-67.6368,-16.65357,19,3,178,197,41,5,129,170
"Bolivia","La Paz","Sur Yungas","Irupana (Villa de Lanza)","ESC. CENTRAL LA PLAZUELA",-67.40361,-16.52655,50,2,273,323,69,5,197,266
"Bolivia","La Paz","Sur Yungas","Irupana (Villa de Lanza)","ESC. T.C. RAFAEL PABON",-67.34905,-16.49079,26,2,170,196,28,5,135,163
"Bolivia","La Paz","Sur Yungas","Irupana (Villa de Lanza)","ESC. VICTOR CENTELLAS",-67.4448,-16.42614,48,15,330,378,123,8,184,307
"Bolivia","La Paz","Sur Yungas","Irupana (Villa de Lanza)","ESC. VICTORIO LANZA",-67.43213,-16.40116,62,8,553,615,134,76,335,469
"Bolivia","La Paz","Sur Yungas","Irupana (Villa de Lanza)","PLAZA 25 DE JULIO",-67.70308,-16.60368,49,15,342,391,64,9,254,318
"Bolivia","La Paz","Sur Yungas","Irupana (Villa de Lanza)","U. E. AGUSTIN ASPIAZU",-67.45403,-16.47174,471,54,2962,3433,978,111,1819,2797
"Bolivia","La Paz","Sur Yungas","Irupana (Villa de Lanza)","U.E. CHICALOMA",-67.4781,-16.4439,100,29,730,830,232,28,441,673
"Bolivia","La Paz","Sur Yungas","Irupana (Villa de Lanza)","U.E. CURIHUATI",-67.53439,-16.62459,12,1,102,114,31,1,69,100
"Bolivia","La Paz","Sur Yungas","Irupana (Villa de Lanza)","U.E. NUCLEO ALEJANDRO PEREZ",-67.39616,-16.48061,11,1,119,130,22,5,91,113
"Bolivia","La Paz","Sur Yungas","Irupana (Villa de Lanza)","U.E. SIQUILJARA",-67.43041,-16.4995,4,0,49,53,7,5,37,44
"Bolivia","La Paz","Sur Yungas","Irupana (Villa de Lanza)","UNIDAD EDUCATIVA TACA",-67.59009,-16.6741,14,23,247,261,51,9,164,215
"Bolivia","La Paz","Sur Yungas","La Asunta","CASA DE GOBIERNO",-67.16822,-16.02656,74,7,437,511,130,12,288,418
"Bolivia","La Paz","Sur Yungas","La Asunta","CASA DE GOBIERNO",-67.42729,-16.3161,74,7,437,511,130,12,288,418
"Bolivia","La Paz","Sur Yungas","La Asunta","COLEGIO LAS MERCEDES",-67.34164,-16.28541,156,24,1110,1266,239,16,831,1070
"Bolivia","La Paz","Sur Yungas","La Asunta","COLEGIO PEDRO DOMINGO MURILLO",-67.17278,-15.99563,156,30,1193,1349,296,29,838,1134
"Bolivia","La Paz","Sur Yungas","La Asunta","ESC. BATALLON COLORADOS",-67.23377,-16.24007,61,6,344,405,63,14,261,324
"Bolivia","La Paz","Sur Yungas","La Asunta","ESC. PEDRO DOMINGO MURILLO",-67.23003,-16.17662,70,18,594,664,97,20,459,556
"Bolivia","La Paz","Sur Yungas","La Asunta","ESC. RENE BARRIENTOS ORTUNO",-67.19631,-16.12306,868,75,4955,5823,1599,235,3046,4645
"Bolivia","La Paz","Sur Yungas","La Asunta","ESCUELA PUERTO RICO",-67.23912,-15.91417,169,22,904,1073,268,26,588,856
"Bolivia","La Paz","Sur Yungas","La Asunta","ESC. YANAMAYU",-67.24638,-16.25433,66,11,479,545,94,12,362,456
"Bolivia","La Paz","Sur Yungas","La Asunta","PLAZA 5 DE AGOSTO",-67.32188,-16.29534,92,8,686,778,130,23,525,655
"Bolivia","La Paz","Sur Yungas","La Asunta","PLAZA PRINCIPAL",-67.28065,-16.28432,17,10,498,515,92,19,377,469
"Bolivia","La Paz","Sur Yungas","La Asunta","PLAZA PRINCIPAL PICHARI",-67.1724,-16.03647,33,1,172,205,28,1,142,170
"Bolivia","La Paz","Sur Yungas","La Asunta","SEDE SOCIAL 16 DE JULIO",-67.21876,-15.98921,94,13,604,698,66,18,507,573
"Bolivia","La Paz","Sur Yungas","La Asunta","SEDE SOCIAL CHARIA",-67.17044,-16.06197,76,6,627,703,139,17,465,604
"Bolivia","La Paz","Sur Yungas","La Asunta","SEDE SOCIAL - ESC. FISCAL CALIZAYA",-67.17819,-16.20132,102,15,857,959,287,34,521,808
"Bolivia","La Paz","Sur Yungas","La Asunta","U.E. SANTA ROSA",-67.29982,-16.29054,34,3,420,454,42,13,362,404
"Bolivia","La Paz","Sur Yungas","La Asunta","UNIDAD EDUCATIVA CENTRAL QUINUNI",-67.12872,-16.24596,180,33,1240,1420,297,44,866,1163
"Bolivia","La Paz","Sur Yungas","La Asunta","UNIDAD EDUCATIVA NUEVOS HORIZONTES",-67.0814,-16.07017,59,9,353,412,79,9,256,335
"Bolivia","La Paz","Sur Yungas","La Asunta","UNIDAD EDUCATIVA SIGUANI GRANDE",-67.1498,-16.02148,157,12,782,939,155,15,600,755
"Bolivia","La Paz","Sur Yungas","Palos Blancos","COLEGIO GRAL.JUAN JOSE TORREZ",-67.15504,-15.43328,93,8,438,531,95,18,317,412
"Bolivia","La Paz","Sur Yungas","Palos Blancos","COLEGIO INICUA ALTO",-67.21655,-15.49705,240,26,1316,1556,198,42,1050,1248
"Bolivia","La Paz","Sur Yungas","Palos Blancos","ESC. CENTRAL SAPECHO",-67.33434,-15.55851,175,12,932,1107,202,28,690,892
"Bolivia","La Paz","Sur Yungas","Palos Blancos","ESC. FRANZ TAMAYO",-66.97848,-15.79254,129,7,568,697,93,28,440,533
"Bolivia","La Paz","Sur Yungas","Palos Blancos","ESC. MAPURICHUQUI",-67.38571,-15.53334,13,0,104,117,10,2,92,102
"Bolivia","La Paz","Sur Yungas","Palos Blancos","ESC. REMOLINOS",-67.10275,-15.70205,20,4,165,185,28,2,131,159
"Bolivia","La Paz","Sur Yungas","Palos Blancos","ESC. SAN MIGUEL DE HUACHI",-67.13039,-15.67505,117,7,556,673,148,21,380,528
"Bolivia","La Paz","Sur Yungas","Palos Blancos","ESC. SANTA ANA DE MOSETENES",-67.42593,-15.51087,61,13,519,580,101,17,388,489
"Bolivia","La Paz","Sur Yungas","Palos Blancos","ESC. SECC. PUERTO CARMEN",-67.10754,-15.72647,76,3,513,589,53,15,442,495
"Bolivia","La Paz","Sur Yungas","Palos Blancos","ESCUELA 13 DE MAYO",-67.05286,-15.7359,75,8,370,445,70,7,285,355
"Bolivia","La Paz","Sur Yungas","Palos Blancos","ESCUELA COCOCHI",-67.03598,-15.76373,76,4,517,593,46,9,458,504
"Bolivia","La Paz","Sur Yungas","Palos Blancos","ESCUELA UNIDAD EDUCATIVA POPOY",-67.16382,-15.64156,87,4,507,594,91,11,401,492
"Bolivia","La Paz","Sur Yungas","Palos Blancos","ESC. UNI. EDUCATIVA PALOS BLANCOS",-67.24989,-15.58425,754,39,3769,4523,1274,160,2296,3570
"Bolivia","La Paz","Sur Yungas","Yanacachi","AGENCIA CANTONAL",-67.67539,-16.40772,18,2,195,213,43,5,145,188
"Bolivia","La Paz","Sur Yungas","Yanacachi","ESC. EDUARDO AVAROA",-67.77512,-16.40746,84,5,727,811,161,19,542,703
"Bolivia","La Paz","Sur Yungas","Yanacachi","ESCUELA PUENTE VILLA",-67.64563,-16.40512,125,7,605,730,113,27,458,571
"Bolivia","La Paz","Sur Yungas","Yanacachi","UNIDAD ED. FELIX ERNESTO MOSCOSO",-67.73924,-16.39802,105,20,837,942,162,40,615,777
"Bolivia","Oruro","Abaroa","Challapata","CASA COMUNAL",-66.867,-18.81626,4,3,52,56,17,4,28,45
"Bolivia","Oruro","Abaroa","Challapata","COL. NEMECIO BARRIENTOS",-66.41433,-18.8165,93,52,1851,1944,183,92,1524,1707
"Bolivia","Oruro","Abaroa","Challapata","COL. SIMON BOLIVAR",-66.2065,-19.07044,133,23,724,857,184,53,464,648
"Bolivia","Oruro","Abaroa","Challapata","ESC. ELIZARDO PEREZ",-66.63439,-18.78513,35,5,201,236,65,11,120,185
"Bolivia","Oruro","Abaroa","Challapata","ESC. GUALBERTO VILLARROEL",-66.17815,-19.14781,57,6,487,544,131,30,320,451
"Bolivia","Oruro","Abaroa","Challapata","ESC. GUALBERTO VILLARROEL",-66.17815,-19.14781,57,6,487,544,131,30,320,451
"Bolivia","Oruro","Abaroa","Challapata","IGLESIA",-66.75696,-18.90541,77,27,481,558,134,26,294,428
"Bolivia","Oruro","Abaroa","Challapata","U.E. ANTOFAGASTA",-66.76142,-18.9058,156,18,984,1140,464,54,448,912
"Bolivia","Oruro","Abaroa","Challapata","U. E. CHIRITAMBO",-66.49629,-18.74333,6,0,37,43,9,8,20,29
"Bolivia","Oruro","Abaroa","Challapata","U. E. CHURACANI",-66.6879,-18.88193,17,3,190,207,94,8,85,179
"Bolivia","Oruro","Abaroa","Challapata","U. E. COCHUYO",-66.19255,-19.04616,15,6,176,191,26,12,132,158
"Bolivia","Oruro","Abaroa","Challapata","U. E. CRUCE AGUAS CALIENTES",-66.59532,-18.75354,23,16,336,359,105,23,192,297
"Bolivia","Oruro","Abaroa","Challapata","U. E. EDUARDO AVAROA",-66.77432,-18.89956,455,46,2647,3102,1299,159,1143,2442
"Bolivia","Oruro","Abaroa","Challapata","U.E. GERMAN BUSCH",-66.64656,-18.83978,15,3,175,190,77,13,82,159
"Bolivia","Oruro","Abaroa","Challapata","U.E. HUANCANE",-66.87584,-18.70498,33,7,353,386,153,32,161,314
"Bolivia","Oruro","Abaroa","Challapata","U.E. MONS. RICARDO BENI MORO",-66.77174,-18.89699,218,23,1153,1371,559,63,508,1067
"Bolivia","Oruro","Abaroa","Challapata","U. E. REPUBLICA ARGENTINA",-66.77376,-18.89994,480,63,2859,3339,1366,218,1212,2578
"Bolivia","Oruro","Abaroa","Challapata","U. E. SAN JUAN DE DIOS",-66.77537,-18.89861,375,36,2256,2631,1116,125,979,2095
"Bolivia","Oruro","Abaroa","Challapata","U. E. WILAÑEQUE",-66.87421,-18.79802,5,2,63,68,14,4,43,57
"Bolivia","Oruro","Abaroa","Santuario de Quillacas","COL. NAL. MIXTO SEVARUYO",-66.8639,-19.36308,91,17,762,853,194,30,521,715
"Bolivia","Oruro","Abaroa","Santuario de Quillacas","ESC. SORAGA",-66.81366,-19.37804,29,1,236,265,30,4,201,231
"Bolivia","Oruro","Abaroa","Santuario de Quillacas","U.E. SANTUARIO DE QUILLACAS",-66.9434,-19.23514,100,14,679,779,171,16,478,649
"Bolivia","Oruro","Carangas","Choque Cota","ESC. JOSE BALLIVIAN",-67.89426,-18.09751,147,10,493,640,85,13,385,470
"Bolivia","Oruro","Carangas","Choque Cota","U.E. GERMAN BUSCH",-67.9801,-18.24933,16,0,63,79,8,0,55,63
"Bolivia","Oruro","Carangas","Corque","COL.  JOSE TRIFIRO",-67.68045,-18.34875,433,22,1058,1491,262,38,736,998
"Bolivia","Oruro","Carangas","Corque","COL. QUITA QUITA",-67.59264,-18.57433,20,1,125,145,28,1,95,123
"Bolivia","Oruro","Carangas","Corque","ESC. CENTRAL ANDAPATA LUPE",-67.7664,-18.57256,23,2,134,157,41,1,90,131
"Bolivia","Oruro","Carangas","Corque","ESC. ELIZARDO PEREZ",-67.96458,-18.42258,4,0,192,196,39,1,152,191
"Bolivia","Oruro","Carangas","Corque","ESC. GERMAN BUSCH",-67.63393,-18.19181,3,0,124,127,39,2,83,122
"Bolivia","Oruro","Carangas","Corque","ESC. RAFAEL PABON",-67.86765,-18.61046,5,2,314,319,77,8,227,304
"Bolivia","Oruro","Carangas","Corque","ESC. SECCIONAL VILLA NUEVA",-67.52446,-18.50015,2,0,90,92,10,1,79,89
"Bolivia","Oruro","Carangas","Corque","ESC. SECCIONAL VILLA REMEDIOS",-67.53616,-18.34178,12,9,103,115,15,2,77,92
"Bolivia","Oruro","Carangas","Corque","NUCLEO JANCOCALA",-67.63593,-18.40875,19,3,119,138,29,4,83,112
"Bolivia","Oruro","Carangas","Corque","PROYECTO CRISTIAN CHILDRENS",-67.89956,-18.54068,37,4,348,385,73,7,264,337
"Bolivia","Oruro","Carangas","Corque","U. E. CONDORIRI",-67.87078,-18.28468,3,0,143,146,14,5,124,138
"Bolivia","Oruro","Carangas","Corque","U. E. EDUARDO AVAROA",-67.93131,-18.25961,8,2,108,116,23,2,81,104
"Bolivia","Oruro","Carangas","Corque","U.E. FRANZ TAMAYO",-67.92997,-18.34328,2,0,199,201,11,1,187,198
"Bolivia","Oruro","Carangas","Corque","U. E. FRANZ TAMAYO - VILLA ESPERANZA.-",-67.79691,-18.69382,37,2,227,264,37,2,186,223
"Bolivia","Oruro","Carangas","Corque","U.E. HUAYLLAPACHA",-67.78386,-18.20815,11,0,109,120,9,1,99,108
"Bolivia","Oruro","Carangas","Corque","U.E. HUAYLLOCO",-67.60744,-18.62654,41,3,157,198,34,4,116,150
"Bolivia","Oruro","Carangas","Corque","U.E. ISMAEL MONTES",-67.63055,-18.2567,9,0,123,132,27,2,94,121
"Bolivia","Oruro","Carangas","Corque","U.E. VILLA COPACABANA",-67.58656,-18.33602,23,1,205,228,63,4,137,200
"Bolivia","Oruro","Carangas","Corque","U.E. VILLA TARUCACHI",-67.69584,-18.17327,33,2,135,168,15,3,115,130
"Bolivia","Oruro","Cercado","Caracollo","CASA COMUNAL",-67.36098,-17.5586,27,6,232,259,52,6,168,220
"Bolivia","Oruro","Cercado","Caracollo","ESC. ARCA DE NOE",-67.14415,-17.53467,27,5,221,248,52,9,155,207
"Bolivia","Oruro","Cercado","Caracollo","ESC. CASIMIRO OLAÑETA",-67.71239,-17.75884,15,6,98,113,23,1,68,91
"Bolivia","Oruro","Cercado","Caracollo","ESC. CENTRAL HORENCO",-67.08439,-17.67966,41,13,508,549,114,30,351,465
"Bolivia","Oruro","Cercado","Caracollo","ESC. ELIZARDO PEREZ",-67.23847,-17.7678,25,6,325,350,76,20,223,299
"Bolivia","Oruro","Cercado","Caracollo","ESC. GUALBERTO VILLARROEL",-67.60866,-17.84485,2,1,156,158,48,7,100,148
"Bolivia","Oruro","Cercado","Caracollo","ESC. MARISCAL SUCRE",-67.21998,-17.63756,576,68,4543,5119,1534,200,2741,4275
"Bolivia","Oruro","Cercado","Caracollo","ESC. RENE BERNAL ESCALANTE",-67.26373,-17.41522,26,8,227,253,35,9,175,210
"Bolivia","Oruro","Cercado","Caracollo","ESC. SECCIONAL ANCOTANGA",-67.41176,-17.80681,10,3,108,118,45,1,59,104
"Bolivia","Oruro","Cercado","Caracollo","ESC. TUPAC KATARI",-67.32282,-17.67462,4,0,35,39,4,1,30,34
"Bolivia","Oruro","Cercado","Caracollo","PLAZA 21 DE SEPTIEMBRE",-67.63667,-17.79293,11,1,182,193,52,1,128,180
"Bolivia","Oruro","Cercado","Caracollo","U. E. ADELA ZAMUDIO B",-67.61005,-17.79552,0,1,66,66,14,0,51,65
"Bolivia","Oruro","Cercado","Caracollo","U.E. ALEMANIA",-67.29485,-17.58746,66,8,484,550,117,23,336,453
"Bolivia","Oruro","Cercado","Caracollo","U.E. AYACUCHO",-67.32822,-17.88792,52,11,267,319,94,12,150,244
"Bolivia","Oruro","Cercado","Caracollo","U.E. FLORENCIO ALVARADO",-67.67155,-17.89358,10,6,203,213,49,6,142,191
"Bolivia","Oruro","Cercado","Caracollo","U.E. JAIME LAREDO UNZUETA",-67.29126,-17.76572,3,5,55,58,12,0,38,50
"Bolivia","Oruro","Cercado","Caracollo","U.E. LITORAL",-67.21841,-17.63715,141,11,632,773,202,35,384,586
"Bolivia","Oruro","Cercado","Caracollo","U.E. MARISCAL SUCRE B",-67.49707,-17.77807,134,14,707,841,232,28,433,665
"Bolivia","Oruro","Cercado","Caracollo","U.E. MAX FERNANDEZ",-67.10453,-17.55754,38,3,436,474,98,9,326,424
"Bolivia","Oruro","Cercado","Caracollo","U.E. OTTO SAUCEDO RIVERA",-67.3471,-17.80727,20,2,156,176,70,8,76,146
"Bolivia","Oruro","Cercado","Caracollo","U.ESC. MARCELO QUIROGA SANTA CRUZ",-67.3585,-17.954,25,1,192,217,43,1,147,190
"Bolivia","Oruro","Cercado","Caracollo","U.E. SEBASTIAN PAGADOR",-67.32516,-17.52224,40,5,342,382,68,12,257,325
"Bolivia","Oruro","Cercado","Caracollo","U.E. SIMON BOLIVAR PRIMARIO",-67.65617,-17.79859,45,6,342,387,105,28,203,308
"Bolivia","Oruro","Cercado","Caracollo","U. E. VICTOR PAZ ESTENSORO",-67.22767,-17.52121,18,1,83,101,33,3,46,79
"Bolivia","Oruro","Cercado","El Choro","ESC. GUALBERTO VILLARROEL",-67.1244,-18.28041,30,8,229,259,83,5,133,216
"Bolivia","Oruro","Cercado","El Choro","ESC. JOSE BALLIVIAN",-67.23971,-18.07711,100,12,470,570,107,20,331,438
"Bolivia","Oruro","Cercado","El Choro","ESC. SEBASTIAN  PAGADOR",-67.11596,-18.35524,115,12,573,688,132,41,388,520
"Bolivia","Oruro","Cercado","El Choro","PLAZA PRINCIPAL",-67.16006,-18.20486,43,3,241,284,73,13,152,225
"Bolivia","Oruro","Cercado","El Choro","U. E. SAN FELIPE DE CHAITAVI",-67.19747,-18.2947,13,2,164,177,56,6,100,156
"Bolivia","Oruro","Cercado","Oruro","(CÁRCEL) PENAL SAN PEDRO.-",-67.11382,-17.94748,51,5,177,228,87,2,83,170
"Bolivia","Oruro","Cercado","Oruro","CEMEI.-",-67.10611,-17.95222,62,3,565,627,374,17,171,545
"Bolivia","Oruro","Cercado","Oruro","CENTRO DE ALFABETIZACION HUAJARA III.-",-67.09458,-17.94664,52,7,453,505,213,16,217,430
"Bolivia","Oruro","Cercado","Oruro","CENTRO DE MADRES VILLA DORINA.-  (U.ESC. GTANJA CAPACHOS)",-67.0959,-17.93653,51,2,529,580,219,21,287,506
"Bolivia","Oruro","Cercado","Oruro","CENTRO EDUCATIVO ALCIRA CARDONA.-",-67.13569,-17.98138,301,20,2236,2537,1192,72,952,2144
"Bolivia","Oruro","Cercado","Oruro","CENTRO EDUCATIVO LUIS ESPINAL.-",-67.10418,-17.97677,133,6,1049,1182,638,39,366,1004
"Bolivia","Oruro","Cercado","Oruro","COL. ANICETO ARCE.-",-67.10963,-17.95758,239,11,1749,1988,1161,39,538,1699
"Bolivia","Oruro","Cercado","Oruro","COL. DONATO VASQUEZ",-67.11268,-17.96753,167,16,1394,1561,1032,28,318,1350
"Bolivia","Oruro","Cercado","Oruro","COLEGIO JESUS MARIA FE Y ALEGRIA.-",-67.1079,-17.95973,127,4,1082,1209,843,11,224,1067
"Bolivia","Oruro","Cercado","Oruro","COL. IGNACIO LEON.-",-67.11066,-17.96957,271,9,2057,2328,1535,47,466,2001
"Bolivia","Oruro","Cercado","Oruro","COL. JORGE OBLITAS.-",-67.11667,-17.97098,218,5,1470,1688,1017,48,400,1417
"Bolivia","Oruro","Cercado","Oruro","COL. MARCOS BELTRAN AVILA.-",-67.12161,-17.98581,323,13,1753,2076,949,52,739,1688
"Bolivia","Oruro","Cercado","Oruro","COL. MIXTO SAN JOSE.-",-67.1077,-17.96691,108,5,902,1010,553,19,325,878
"Bolivia","Oruro","Cercado","Oruro","COL. NAL. ANTONIO JOSE DE SAINZ.-",-67.11235,-17.97625,296,9,1926,2222,1206,61,650,1856
"Bolivia","Oruro","Cercado","Oruro","COL. NAL. JUAN MISAEL SARACHO.-",-67.10977,-17.96565,212,7,1694,1906,1283,34,370,1653
"Bolivia","Oruro","Cercado","Oruro","COL. NAL. MIXTO BOLIVIA.-",-67.11076,-17.96816,635,27,3246,3881,1758,98,1363,3121
"Bolivia","Oruro","Cercado","Oruro","COL. NAL. MIXTO CARMEN GUZMAN DE MIER",-67.09805,-17.96961,716,42,5553,6269,2944,258,2309,5253
"Bolivia","Oruro","Cercado","Oruro","COL.NAL.MIXTO MEJILLONES (V. CHALLACOLLO)",-67.13516,-18.00865,237,14,1290,1527,473,85,718,1191
"Bolivia","Oruro","Cercado","Oruro","COL. NAL. SIMON BOLIVAR.-",-67.11548,-17.97176,308,12,2228,2536,1608,43,565,2173
"Bolivia","Oruro","Cercado","Oruro","COL. PARTICULAR ANGLO AMERICANO.-",-67.12007,-17.96936,288,12,2233,2521,1432,66,723,2155
"Bolivia","Oruro","Cercado","Oruro","COL. PARTICULAR BOLIVIA JAPON-.",-67.11596,-17.96645,200,11,1473,1673,1003,28,431,1434
"Bolivia","Oruro","Cercado","Oruro","COL. PARTICULAR LA SALLE.-",-67.12745,-17.98239,341,18,2698,3039,1614,99,967,2581
"Bolivia","Oruro","Cercado","Oruro","COL. PARTICULAR NACIONES UNIDAS.-",-67.11937,-17.9807,108,9,691,799,354,96,232,586
"Bolivia","Oruro","Cercado","Oruro","COL. PARTICULAR REEKIE.-",-67.1146,-17.97336,196,8,1654,1850,1229,34,383,1612
"Bolivia","Oruro","Cercado","Oruro","ESC. FRANZ TAMAYO (LOS PINOS).-",-67.13069,-17.9254,133,17,1159,1292,421,34,687,1108
"Bolivia","Oruro","Cercado","Oruro","ESC. JACINTO RODRIGUEZ (LA AURORA).-",-67.12757,-17.91296,359,22,3129,3488,1641,108,1358,2999
"Bolivia","Oruro","Cercado","Oruro","ESC. JUAN PABLO.-",-67.13759,-17.97069,435,34,2906,3341,1374,92,1406,2780
"Bolivia","Oruro","Cercado","Oruro","ESC. MIXTA FERROVIARIA.-",-67.1043,-17.96417,438,23,3645,4083,2496,74,1052,3548
"Bolivia","Oruro","Cercado","Oruro","FAC. DE DERECHO (ESC. 10 DE FEBRERO)",-67.10728,-17.96463,88,5,716,804,515,7,189,704
"Bolivia","Oruro","Cercado","Oruro","FACULTAD DE AGRONOMIA-.",-67.1356,-17.99495,136,3,827,963,371,25,428,799
"Bolivia","Oruro","Cercado","Oruro","FACULTAD DE MEDICINA.-",-67.11997,-17.95705,285,15,2294,2579,1257,93,929,2186
"Bolivia","Oruro","Cercado","Oruro","FACULTAD TECNICA.-",-67.10745,-17.95388,269,18,2399,2668,1640,56,685,2325
"Bolivia","Oruro","Cercado","Oruro","FUNDACION INFOCAL.-",-67.13299,-17.97652,157,9,1200,1357,648,28,515,1163
"Bolivia","Oruro","Cercado","Oruro","INICIAL CARMEN GUZMAN DE MIER-.",-67.09798,-17.96936,51,4,407,458,217,16,170,387
"Bolivia","Oruro","Cercado","Oruro","INST. DE APRENDIZAJE INDUSTRIAL - I.A.I.",-67.10339,-17.95443,432,26,3789,4221,2091,115,1557,3648
"Bolivia","Oruro","Cercado","Oruro","INST. NORMAL SUPERIOR ANGEL MENDOZA J.",-67.11544,-17.95136,279,16,2280,2559,1330,74,860,2190
"Bolivia","Oruro","Cercado","Oruro","KINDER CHIRIPUJIO-.",-67.13878,-17.97487,58,5,317,375,161,6,145,306
"Bolivia","Oruro","Cercado","Oruro","KINDER EDITH ZAMORA DE PAZ",-67.06566,-17.59109,91,7,642,733,310,10,315,625
"Bolivia","Oruro","Cercado","Oruro","KINDER JUANCITO PINTO.-",-67.1338,-17.97651,222,23,1612,1834,865,51,673,1538
"Bolivia","Oruro","Cercado","Oruro","LICEO ANTOFAGASTA.-",-67.11086,-17.95904,130,3,1109,1239,753,28,325,1078
"Bolivia","Oruro","Cercado","Oruro","LICEO TEC. HUMANISTICO ADOLFO BALLIVIAN",-67.11545,-17.97227,124,6,997,1121,697,20,274,971
"Bolivia","Oruro","Cercado","Oruro","U.E. ABY AYALA  (MAGDALENA POSTEL II)",-67.0858,-17.96687,34,1,402,436,203,13,185,388
"Bolivia","Oruro","Cercado","Oruro","U. E. ALTO ORURO-.",-67.11981,-17.97776,90,7,657,747,270,35,345,615
"Bolivia","Oruro","Cercado","Oruro","U.E. BOLIVIA VINTO.-",-67.06182,-17.97608,590,73,4246,4836,1541,406,2226,3767
"Bolivia","Oruro","Cercado","Oruro","U. E. CARMELA CERRUTO-.",-67.12911,-17.98492,75,6,423,498,206,18,193,399
"Bolivia","Oruro","Cercado","Oruro","U. E. EDUARDO AVAROA",-67.10896,-17.96172,202,10,1711,1913,1309,44,348,1657
"Bolivia","Oruro","Cercado","Oruro","U. E. EJERCITO NACIONAL.-",-67.11467,-17.94708,452,31,3461,3913,1885,105,1440,3325
"Bolivia","Oruro","Cercado","Oruro","U.E. EL CARMEN",-67.06756,-17.97467,128,12,1135,1263,479,51,593,1072
"Bolivia","Oruro","Cercado","Oruro","U. E. GUIDO VILLAGOMEZ.-",-67.12384,-17.95729,193,15,1750,1943,819,66,850,1669
"Bolivia","Oruro","Cercado","Oruro","U. E. HIJOS DEL SOL II",-67.14334,-17.97866,68,5,293,361,98,75,115,213
"Bolivia","Oruro","Cercado","Oruro","U.E. HUAJARA",-67.09364,-17.94298,389,44,3361,3750,1680,121,1516,3196
"Bolivia","Oruro","Cercado","Oruro","U. E. JESUS DE NAZARETH.-",-67.09926,-17.98237,425,41,3179,3604,1434,156,1548,2982
"Bolivia","Oruro","Cercado","Oruro","U. E. JOHN F. KENNEDY",-67.11703,-17.95129,448,28,3490,3938,1760,138,1564,3324
"Bolivia","Oruro","Cercado","Oruro","U. E. JOSE IGNACIO DE SANJINEZ.-",-67.11224,-17.97953,442,20,3127,3569,1909,88,1110,3019
"Bolivia","Oruro","Cercado","Oruro","U. E. JOSE MARIA SIERRA GALVARRO.-",-67.10973,-17.97574,491,26,3831,4322,2450,94,1261,3711
"Bolivia","Oruro","Cercado","Oruro","U. E. JUAN VELEZ DE CORDOBA (INCA POZO).",-67.12063,-17.94589,175,19,1556,1731,634,72,831,1465
"Bolivia","Oruro","Cercado","Oruro","U. E. KANTUTA II (JOSERMO MURILLO)-.",-67.10438,-17.94779,283,49,2285,2568,969,131,1136,2105
"Bolivia","Oruro","Cercado","Oruro","U.E. LOS ANGELES DE NAZARIA IGNACIA",-67.0696,-17.97254,133,9,952,1085,306,36,601,907
"Bolivia","Oruro","Cercado","Oruro","U. E. LUIS MARIO CAREAGA.-",-67.06567,-17.59111,652,57,3966,4618,1685,131,2093,3778
"Bolivia","Oruro","Cercado","Oruro","U.E. MARCELO QUIROGA SANTA CRUZ",-67.11663,-17.93236,43,5,649,692,291,15,338,629
"Bolivia","Oruro","Cercado","Oruro","U.E. MARIA  DE NAZARETH",-67.0949,-17.98389,194,22,1558,1752,566,97,873,1439
"Bolivia","Oruro","Cercado","Oruro","U. E. MCAL. ANDRES DE SANTA CRUZ.-",-67.11391,-17.95798,361,25,2527,2888,1422,83,997,2419
"Bolivia","Oruro","Cercado","Oruro","U. E. MCAL. ANTONIO JOSE DE SUCRE.-",-67.11536,-17.96788,328,16,2490,2818,1720,42,712,2432
"Bolivia","Oruro","Cercado","Oruro","U.E. MEJILLONES II(SECUNDARIO)",-67.13734,-18.00333,59,5,340,399,118,28,189,307
"Bolivia","Oruro","Cercado","Oruro","U. E. MISAEL PACHECO LOMA.-",-67.10031,-17.96391,194,6,1567,1761,932,47,582,1514
"Bolivia","Oruro","Cercado","Oruro","U. E. MOVIMIENTO SIN TECHO",-67.07934,-17.97713,507,61,3764,4271,947,165,2591,3538
"Bolivia","Oruro","Cercado","Oruro","U.E. NAL. MIXTO HUAJARA SECUNDARIO",-67.09364,-17.94298,106,13,924,1030,362,114,435,797
"Bolivia","Oruro","Cercado","Oruro","U.E. NIÑO QUIRQUINCHO FELIZ",-67.03982,-17.97784,188,23,1463,1651,551,113,776,1327
"Bolivia","Oruro","Cercado","Oruro","U. E. ORURO OTAWA (SECUNDARIA)",-67.10309,-17.97182,213,17,1686,1899,905,40,724,1629
"Bolivia","Oruro","Cercado","Oruro","U. E. OSCAR UNZAGA DE LA VEGA.-",-67.11453,-17.94222,446,43,3640,4086,1752,198,1647,3399
"Bolivia","Oruro","Cercado","Oruro","U. E. OSCAR UNZAGA DE LA VEGA II",-67.1145,-17.9421,183,15,1168,1351,558,42,553,1111
"Bolivia","Oruro","Cercado","Oruro","U.E. PARTICULAR ARRIETA",-67.11098,-17.9635,27,1,301,328,215,8,77,292
"Bolivia","Oruro","Cercado","Oruro","U.E. SAN LUIS",-67.07831,-17.93586,49,8,414,463,126,49,231,357
"Bolivia","Oruro","Cercado","Oruro","U. E. SANTA ROSA.-",-67.07967,-17.97144,339,24,2098,2437,1054,111,909,1963
"Bolivia","Oruro","Cercado","Oruro","U. ESC. BENEMERITOS DE LA PATRIA.-",-67.12161,-17.98581,230,14,1568,1798,698,61,795,1493
"Bolivia","Oruro","Cercado","Oruro","U. ESC. DIOS ES AMOR.-",-67.09901,-17.98909,99,20,887,986,317,30,520,837
"Bolivia","Oruro","Cercado","Oruro","U. ESC. EL KASSO - EL PROGRESO.-",-67.08046,-17.97144,32,7,281,313,85,10,179,264
"Bolivia","Oruro","Cercado","Oruro","U. ESC. EL PATICO.-",-67.08788,-17.93559,16,8,270,286,96,15,151,247
"Bolivia","Oruro","Cercado","Oruro","U. ESC. FRANCISCO FAJARDO.-",-67.10979,-17.95128,248,10,2030,2278,1172,75,773,1945
"Bolivia","Oruro","Cercado","Oruro","U. ESC. HIJOS DEL SOL (PLAN 500)",-67.14334,-17.97866,325,13,1820,2145,727,53,1027,1754
"Bolivia","Oruro","Cercado","Oruro","U. ESC. KANTUTA.-",-67.10198,-17.94742,586,69,4563,5149,2098,302,2094,4192
"Bolivia","Oruro","Cercado","Oruro","U. ESC. LUIS LLOSA - ESPAÑA.-",-67.10973,-17.96015,100,0,987,1087,700,20,267,967
"Bolivia","Oruro","Cercado","Oruro","U. ESC. MELVIN JONES",-67.11378,-17.94639,254,17,1955,2209,1168,79,691,1859
"Bolivia","Oruro","Cercado","Oruro","U. ESC. ORURO OTAWA (PRIMARIA)",-67.10278,-17.97236,290,24,2604,2894,1561,61,958,2519
"Bolivia","Oruro","Cercado","Oruro","U. ESC. SAN IGNACIO DE LOYOLA.-",-67.10327,-17.97707,621,33,4667,5288,2581,131,1922,4503
"Bolivia","Oruro","Cercado","Oruro","U. ESC. SAN ISIDRO",-67.08199,-17.9849,202,34,1756,1958,632,83,1007,1639
"Bolivia","Oruro","Cercado","Oruro","U. ESC. SAN JUAN DE DIOS.-",-67.0648,-17.98498,65,13,664,729,214,27,410,624
"Bolivia","Oruro","Cercado","Oruro","U. ESC. SANTA ANA I  ARENALES.-",-67.08875,-17.9662,47,4,504,551,213,16,271,484
"Bolivia","Oruro","Cercado","Oruro","U. ESC. SEBASTIAN PAGADOR(PRIMARIO)",-67.10513,-17.96682,190,15,1580,1770,1041,41,483,1524
"Bolivia","Oruro","Cercado","Oruro","U. ESC. URU URU.-",-67.13344,-17.97674,319,9,2200,2519,1130,91,970,2100
"Bolivia","Oruro","Cercado","Oruro","U.E. SOCAMANI-.",-67.04722,-17.96745,107,22,857,964,258,58,519,777
"Bolivia","Oruro","Cercado","Oruro","U.E. TOMAS BARRON.-",-67.11607,-17.93777,926,88,7014,7940,3184,304,3438,6622
"Bolivia","Oruro","Cercado","Oruro","U. E. VIRGEN DEL MAR II.-",-67.0981,-17.95885,251,26,2376,2627,1278,131,941,2219
"Bolivia","Oruro","Cercado","Oruro","U.E. VIRGEN DEL MAR III",-67.0981,-17.95885,37,1,142,179,91,2,48,139
"Bolivia","Oruro","Cercado","Soracachi","COL. EDUARDO AVAROA",-66.93476,-17.90583,31,5,480,511,160,23,292,452
"Bolivia","Oruro","Cercado","Soracachi","COL. NAL. IRUMA",-66.95744,-17.82625,34,6,354,388,112,21,215,327
"Bolivia","Oruro","Cercado","Soracachi","COL. NAL. MIXTO SORACACHI",-67.04009,-17.80021,98,19,844,942,298,59,468,766
"Bolivia","Oruro","Cercado","Soracachi","ESC. CACHI CACHI",-66.90673,-17.92398,25,14,298,323,108,14,162,270
"Bolivia","Oruro","Cercado","Soracachi","ESC. CARLOS BELTRAN MORALES",-66.74974,-17.84505,41,3,283,324,38,8,234,272
"Bolivia","Oruro","Cercado","Soracachi","ESC. CENTRAL PARIA",-67.02174,-17.82162,67,14,696,763,216,40,426,642
"Bolivia","Oruro","Cercado","Soracachi","ESC. ELIZARDO PEREZ",-66.92491,-17.94757,15,3,244,259,59,18,164,223
"Bolivia","Oruro","Cercado","Soracachi","ESC. LITORAL",-66.8653,-17.87313,10,0,189,199,20,4,165,185
"Bolivia","Oruro","Cercado","Soracachi","ESC. MULTIGRADO CULLCUPAMPA",-66.84515,-17.81123,33,5,221,254,56,24,136,192
"Bolivia","Oruro","Cercado","Soracachi","ESC. SECCIONAL CONDORCHINOCA",-66.92383,-17.81707,21,6,259,280,47,10,196,243
"Bolivia","Oruro","Cercado","Soracachi","ESC. SECCIONAL SAN JUAN PAMPA",-67.02293,-17.80466,40,5,292,332,130,11,146,276
"Bolivia","Oruro","Cercado","Soracachi","ESC. SIMON BOLIVAR",-66.95678,-17.63055,69,7,335,404,87,17,224,311
"Bolivia","Oruro","Cercado","Soracachi","ESC. SIMON BOLIVAR",-66.93806,-17.64721,69,7,335,404,87,17,224,311
"Bolivia","Oruro","Cercado","Soracachi","PLAZA DE TOLAPALCA",-66.839,-17.85507,43,8,321,364,62,17,234,296
"Bolivia","Oruro","Cercado","Soracachi","PLAZA TENIENTE BULLAIN",-67.00915,-17.9779,42,17,867,909,266,49,535,801
"Bolivia","Oruro","Cercado","Soracachi","U. E. CALAPATA",-67.07857,-17.81657,8,2,225,233,66,9,148,214
"Bolivia","Oruro","Cercado","Soracachi","U.E. EDUARDO AVAROA",-66.95867,-18.05556,45,6,486,531,120,17,343,463
"Bolivia","Oruro","Cercado","Soracachi","U.E. FRANZ TAMAYO",-67.03432,-17.68199,23,6,120,143,34,7,73,107
"Bolivia","Oruro","Cercado","Soracachi","U. E. JATITA",-67.15078,-17.74948,22,3,199,221,51,2,143,194
"Bolivia","Oruro","Cercado","Soracachi","U. E. K'ASA HUASA",-67.01914,-18.04029,16,11,232,248,90,15,116,206
"Bolivia","Oruro","Cercado","Soracachi","U. E. MCAL. ANTONIO JOSE DE SUCRE",-66.99371,-17.6637,6,0,134,140,43,9,82,125
"Bolivia","Oruro","Cercado","Soracachi","U. ESC. SIMON BOLIVAR",-66.88591,-17.77803,22,7,211,233,48,9,147,195
"Bolivia","Oruro","Ladislao Cabrera","Pampa Aullagas","ESC. FRANZ TAMAYO",-67.14696,-19.40474,3,0,140,143,47,7,86,133
"Bolivia","Oruro","Ladislao Cabrera","Pampa Aullagas","ESC. MARIA SANCHEZ FERNANDEZ",-67.06307,-19.19442,136,26,960,1096,279,42,613,892
"Bolivia","Oruro","Ladislao Cabrera","Pampa Aullagas","U.E. GUALBERTO VILLARROEL",-67.06329,-19.28214,28,2,268,296,90,7,169,259
"Bolivia","Oruro","Ladislao Cabrera","Salinas de Garcí Mendoza","COL. ANTOFAGASTA",-67.73315,-19.52218,55,6,465,520,110,17,332,442
"Bolivia","Oruro","Ladislao Cabrera","Salinas de Garcí Mendoza","COL. FRANZ TAMAYO",-67.67596,-19.63522,228,15,1143,1371,351,61,716,1067
"Bolivia","Oruro","Ladislao Cabrera","Salinas de Garcí Mendoza","ESC. AMERICA SAN MARTIN",-67.59932,-19.27503,46,3,198,244,49,7,139,188
"Bolivia","Oruro","Ladislao Cabrera","Salinas de Garcí Mendoza","ESC. CENTRAL PUQUI",-67.37225,-19.57412,45,6,349,394,54,12,277,331
"Bolivia","Oruro","Ladislao Cabrera","Salinas de Garcí Mendoza","ESC. ILDEFONSO MURGUIA",-67.94785,-19.71597,7,3,54,61,4,0,47,51
"Bolivia","Oruro","Ladislao Cabrera","Salinas de Garcí Mendoza","ESC. VILLA ESPERANZA",-67.28278,-19.39601,21,2,183,204,47,9,125,172
"Bolivia","Oruro","Ladislao Cabrera","Salinas de Garcí Mendoza","PLAZA PRINCIPAL",-67.76024,-19.25545,6,3,161,167,104,4,50,154
"Bolivia","Oruro","Ladislao Cabrera","Salinas de Garcí Mendoza","U.E. BOLIVIA LUCA",-67.8995,-19.59013,17,1,73,90,9,1,62,71
"Bolivia","Oruro","Ladislao Cabrera","Salinas de Garcí Mendoza","U. E. CONCEPCION DE BELEN",-67.88071,-19.19479,26,1,86,112,46,4,35,81
"Bolivia","Oruro","Ladislao Cabrera","Salinas de Garcí Mendoza","U.E. GERMAN BUSCH",-67.57353,-19.85675,4,0,41,45,11,2,28,39
"Bolivia","Oruro","Ladislao Cabrera","Salinas de Garcí Mendoza","U.E. OTTO SAUCEDO RIVERA",-67.42625,-19.13229,142,12,754,896,232,43,467,699
"Bolivia","Oruro","Litoral","Cruz de Machacamarca","AMB. COMITE CIVICO",-68.34784,-18.80327,1,0,78,79,18,2,58,76
"Bolivia","Oruro","Litoral","Cruz de Machacamarca","CASA COMUNAL",-68.05518,-18.69846,5,0,97,102,40,2,55,95
"Bolivia","Oruro","Litoral","Cruz de Machacamarca","ESC. CRUZ DE MACHACAMARCA",-67.75741,-18.74025,12,11,192,204,83,1,97,180
"Bolivia","Oruro","Litoral","Cruz de Machacamarca","ESC. TCNL. RAFAEL PABON.-",-68.27777,-18.77197,0,0,119,119,29,1,89,118
"Bolivia","Oruro","Litoral","Escara","CASA COMUNAL",-68.16998,-18.85891,5,2,82,87,34,2,44,78
"Bolivia","Oruro","Litoral","Escara","CASA DEL NOTARIO",-68.20262,-18.80862,0,2,155,155,54,2,97,151
"Bolivia","Oruro","Litoral","Escara","U.E. FRANZ TAMAYO",-68.16997,-18.85826,37,32,317,354,137,5,143,280
"Bolivia","Oruro","Litoral","Esmeralda","ESC. SEBASTIAN PAGADOR",-68.25356,-18.88226,8,1,185,193,77,0,107,184
"Bolivia","Oruro","Litoral","Esmeralda","IGLESIA",-67.93938,-18.92884,10,2,182,192,65,1,114,179
"Bolivia","Oruro","Litoral","Esmeralda","IGLESIA",-68.28327,-18.84608,10,2,182,192,65,1,114,179
"Bolivia","Oruro","Litoral","Esmeralda","U.E. PEDRO DOMINGO MURILLO",-68.20913,-18.91374,1,0,118,119,53,0,65,118
"Bolivia","Oruro","Litoral","Huachacalla","ESC. FE Y ALEGRIA",-68.26381,-18.79456,313,3,341,654,125,9,204,329
"Bolivia","Oruro","Litoral","Yunguyo de Litoral","ESC. JOSE BALLIVIAN",-68.31896,-18.85273,32,0,94,126,43,6,45,88
"Bolivia","Oruro","Mejillones","Carangas","ESC. ELIODORO VILLAZON",-68.62348,-18.93954,29,0,139,168,61,1,77,138
"Bolivia","Oruro","Mejillones","La Rivera","U.E. LA RIVERA",-68.63965,-19.0056,0,3,250,250,124,2,121,245
"Bolivia","Oruro","Mejillones","Todos Santos","U.E. EDUARDO AVAROA",-68.7207,-19.0161,62,5,192,254,63,3,121,184
"Bolivia","Oruro","Nor Carangas","Huayllamarca (Santiago de Huayllamarca)","COL. CHOJÑOHUMA",-67.99887,-17.75547,10,5,118,128,23,2,88,111
"Bolivia","Oruro","Nor Carangas","Huayllamarca (Santiago de Huayllamarca)","COL. LLANQUERA",-67.69202,-17.98834,75,4,423,498,106,12,301,407
"Bolivia","Oruro","Nor Carangas","Huayllamarca (Santiago de Huayllamarca)","ESC. GERMAN BUSCH",-67.63836,-18.05427,24,2,140,164,59,4,75,134
"Bolivia","Oruro","Nor Carangas","Huayllamarca (Santiago de Huayllamarca)","ESC. JESUS BELEN",-68.02042,-17.79224,4,0,119,123,34,2,83,117
"Bolivia","Oruro","Nor Carangas","Huayllamarca (Santiago de Huayllamarca)","ESC. TUNUPA",-67.88644,-17.80342,30,2,197,227,51,6,138,189
"Bolivia","Oruro","Nor Carangas","Huayllamarca (Santiago de Huayllamarca)","PLAZA PRINCIPAL",-67.9429,-17.83473,103,16,685,788,153,23,493,646
"Bolivia","Oruro","Nor Carangas","Huayllamarca (Santiago de Huayllamarca)","U. E. MEJILLONES",-67.91051,-17.86477,16,0,125,141,27,5,93,120
"Bolivia","Oruro","Nor Carangas","Huayllamarca (Santiago de Huayllamarca)","U.E. PEDRO DOMINGO MURILLO",-67.8089,-17.91016,27,7,298,325,89,3,199,288
"Bolivia","Oruro","Nor Carangas","Huayllamarca (Santiago de Huayllamarca)","U. E. SAN MIGUEL",-67.74892,-17.9582,17,7,392,409,123,12,250,373
"Bolivia","Oruro","Nor Carangas","Huayllamarca (Santiago de Huayllamarca)","U.E. SEBASTIAN PAGADOR",-67.85006,-17.99825,24,0,125,149,30,1,94,124
"Bolivia","Oruro","Pantaleón Dalence","Machacamarca","COL. P. D. MURILLO.-",-67.01683,-18.17177,247,32,1563,1810,542,53,936,1478
"Bolivia","Oruro","Pantaleón Dalence","Machacamarca","ESC. ADOLFO MIER",-67.00506,-18.10496,30,1,194,224,68,8,117,185
"Bolivia","Oruro","Pantaleón Dalence","Machacamarca","ESC. GERMAN BUSCH",-66.96426,-18.16933,89,9,398,487,130,14,245,375
"Bolivia","Oruro","Pantaleón Dalence","Villa Huanuni","COL. AYACUCHO",-66.84127,-18.28592,584,47,3859,4443,1144,193,2475,3619
"Bolivia","Oruro","Pantaleón Dalence","Villa Huanuni","ESC. DANIEL SANCHEZ BUSTAMANTE",-66.81483,-18.27406,27,2,130,157,47,9,72,119
"Bolivia","Oruro","Pantaleón Dalence","Villa Huanuni","ESC. EDUARDO AVAROA",-66.83648,-18.28687,514,57,4060,4574,1162,179,2662,3824
"Bolivia","Oruro","Pantaleón Dalence","Villa Huanuni","ESC. FRANZ TAMAYO",-66.84327,-18.28328,342,39,2940,3282,823,133,1945,2768
"Bolivia","Oruro","Pantaleón Dalence","Villa Huanuni","ESC. HUALLATIRI",-66.57692,-18.26101,29,3,189,218,31,3,152,183
"Bolivia","Oruro","Pantaleón Dalence","Villa Huanuni","ESC. OSCAR ALFARO",-66.84819,-18.07138,32,6,247,279,119,10,112,231
"Bolivia","Oruro","Pantaleón Dalence","Villa Huanuni","PLAZA PRINCIPAL",-66.74792,-18.36819,24,1,249,273,50,8,190,240
"Bolivia","Oruro","Pantaleón Dalence","Villa Huanuni","U.E. 12 DE ABRIL",-66.83877,-18.28987,121,6,358,479,134,18,200,334
"Bolivia","Oruro","Pantaleón Dalence","Villa Huanuni","U.E. MARISCAL SUCRE DE TARUCAMARCA",-66.74748,-18.27423,2,2,90,92,8,6,74,82
"Bolivia","Oruro","Pantaleón Dalence","Villa Huanuni","U.E. TAYAQUIRA",-66.68075,-18.28287,22,9,324,346,45,6,264,309
"Bolivia","Oruro","Pantaleón Dalence","Villa Huanuni","U.E. VENEZUELA",-66.83852,-18.28969,42,1,237,279,122,7,107,229
"Bolivia","Oruro","Pantaleón Dalence","Villa Huanuni","U.E. VICTOR MANUEL AYLLON",-66.79549,-18.15128,41,3,230,271,72,16,139,211
"Bolivia","Oruro","Poopó","Antequera (Bolívar)","ESC. MARISCAL ANTONIO JOSE DE SUCRE",-66.75814,-18.60952,11,2,137,148,42,5,88,130
"Bolivia","Oruro","Poopó","Antequera (Bolívar)","ESC. SEBASTIAN PAGADOR",-66.84234,-18.47896,136,19,1065,1201,557,51,438,995
"Bolivia","Oruro","Poopó","Antequera (Bolívar)","PLAZA 2 DE FEBRERO",-66.74583,-18.57221,14,5,141,155,58,8,70,128
"Bolivia","Oruro","Poopó","Paza","COL. JUAN LECHIN OQUENDO",-66.87602,-18.49693,82,7,534,616,201,17,309,510
"Bolivia","Oruro","Poopó","Paza","COL. OSCAR UNZAGA DE LA VEGA",-66.9222,-18.59495,145,16,849,994,337,42,454,791
"Bolivia","Oruro","Poopó","Paza","COL. URMIRI",-66.87689,-18.57802,15,1,117,132,68,1,47,115
"Bolivia","Oruro","Poopó","Paza","ESC. MARISCAL SUCRE.-",-66.75761,-18.69305,114,18,758,872,216,76,448,664
"Bolivia","Oruro","Poopó","Paza","U.E. GUILLERMO GUTIERREZ",-66.88187,-18.52423,23,7,261,284,100,6,148,248
"Bolivia","Oruro","Poopó","Poopó (Villa Poopó)","ESC. EDUARDO AVAROA",-66.99586,-18.28933,26,5,114,140,29,8,72,101
"Bolivia","Oruro","Poopó","Poopó (Villa Poopó)","ESC. ISMAEL MONTES",-66.96783,-18.37966,276,47,2328,2604,760,113,1408,2168
"Bolivia","Oruro","Poopó","Poopó (Villa Poopó)","ESC. MARISCAL SUCRE",-66.82631,-18.37954,13,2,111,124,22,7,80,102
"Bolivia","Oruro","Poopó","Poopó (Villa Poopó)","ESC. PUÑACA",-67.01503,-18.40687,5,0,55,60,5,3,47,52
"Bolivia","Oruro","Poopó","Poopó (Villa Poopó)","PLAZA SIMON BOLIVAR",-66.85959,-18.29434,75,10,414,489,112,20,272,384
"Bolivia","Oruro","Poopó","Poopó (Villa Poopó)","U.E. GERMAN BUSCH",-66.96021,-18.49657,0,0,49,49,11,2,36,47
"Bolivia","Oruro","Poopó","Poopó (Villa Poopó)","U.E. LIBERTADOR SIMON BOLIVAR",-66.97563,-18.45356,5,5,106,111,16,0,85,101
"Bolivia","Oruro","Sabaya","Chipaya","ESC. PUENTE TOPATER",-67.91399,-19.03246,41,1,114,155,11,5,97,108
"Bolivia","Oruro","Sabaya","Chipaya","ESC. SAN IGNACIO",-68.0725,-19.09496,20,0,70,90,6,1,63,69
"Bolivia","Oruro","Sabaya","Chipaya","U.E. SANTA ANA",-68.08934,-19.04418,227,9,411,638,129,8,265,394
"Bolivia","Oruro","Sabaya","Coipasa","U.E. COIPASA",-68.27831,-19.2763,36,3,346,382,186,4,153,339
"Bolivia","Oruro","Sabaya","Sabaya","CASA COMUNAL",-68.73852,-18.73852,1,0,167,168,118,0,49,167
"Bolivia","Oruro","Sabaya","Sabaya","CASA COMUNAL",-68.47369,-19.00466,1,0,167,168,118,0,49,167
"Bolivia","Oruro","Sabaya","Sabaya","CASA DEL NOTARIO",-68.5004,-19.06247,14,0,91,105,61,1,29,90
"Bolivia","Oruro","Sabaya","Sabaya","ESC. EDUARDO AVAROA",-68.87798,-19.03987,0,4,30,30,8,4,14,22
"Bolivia","Oruro","Sabaya","Sabaya","ESC. FELIX FERNANDEZ",-68.52093,-18.96744,4,0,97,101,67,0,30,97
"Bolivia","Oruro","Sabaya","Sabaya","ESC. FRANZ TAMAYO",-68.35445,-19.19073,0,2,298,298,183,4,109,292
"Bolivia","Oruro","Sabaya","Sabaya","ESC. FRANZ TAMAYO",-68.31431,-18.76981,0,2,298,298,183,4,109,292
"Bolivia","Oruro","Sabaya","Sabaya","ESC. GERMAN BUSCH",-68.61129,-18.82781,11,0,201,212,80,2,119,199
"Bolivia","Oruro","Sabaya","Sabaya","ESC. GUALBERTO VILLARROEL",-68.78839,-18.57318,2,3,107,109,35,2,67,102
"Bolivia","Oruro","Sabaya","Sabaya","ESC. ILDEFONSO MURGUIA",-68.89094,-18.69991,8,1,199,207,104,1,93,197
"Bolivia","Oruro","Sabaya","Sabaya","ESC. JOSE MARIA EGUES CUELLAR",-68.37302,-19.01429,145,8,404,549,192,20,184,376
"Bolivia","Oruro","Sabaya","Sabaya","ESC. JOSE MARIA MONTAÑO",-68.53316,-18.90277,2,0,113,115,92,0,21,113
"Bolivia","Oruro","Sabaya","Sabaya","ESC. JOSE MERIDA MONTAÑO",-68.64622,-18.70486,15,0,103,118,78,1,24,102
"Bolivia","Oruro","Sabaya","Sabaya","ESC. PITACOLLO",-68.59029,-19.05312,3,1,85,88,14,0,70,84
"Bolivia","Oruro","Sabaya","Sabaya","ESC. SEBASTIAN  PAGADOR",-68.37182,-19.01886,0,3,154,154,105,1,45,150
"Bolivia","Oruro","Sabaya","Sabaya","ESC. VERALINES",-68.55422,-19.20341,4,0,121,125,90,2,29,119
"Bolivia","Oruro","Sabaya","Sabaya","IGLESIA",-68.80792,-18.79146,0,0,54,54,32,0,22,54
"Bolivia","Oruro","Sabaya","Sabaya","PLAZA 25 DE JULIO MIRAFLORES",-68.54026,-18.65128,0,0,33,33,20,0,13,33
"Bolivia","Oruro","Sabaya","Sabaya","PLAZA SIMON BOLIVAR",-68.52158,-18.8665,12,0,67,79,41,0,26,67
"Bolivia","Oruro","Sabaya","Sabaya","U. E.  CONCEPCION COMUJO",-68.38916,-19.21006,2,1,104,106,67,0,36,103
"Bolivia","Oruro","Sabaya","Sabaya","U.E. JOSE ANTONIO ARCE",-68.68381,-18.44296,24,0,126,150,80,0,46,126
"Bolivia","Oruro","Sabaya","Sabaya","U.E. LIBERTADOR SIMON BOLIVAR",-68.61559,-19.27332,69,5,224,293,121,13,85,206
"Bolivia","Oruro","Sabaya","Sabaya","U.E. MARIA EVANS CUELLAR",-68.34265,-19.09297,6,0,120,126,96,1,23,119
"Bolivia","Oruro","Sabaya","Sabaya","U.E. PEDRO DOMINGO MURILLO",-68.53796,-18.92385,3,0,138,141,90,2,46,136
"Bolivia","Oruro","Sajama","Curahuara de Carangas","COL. BOLIVIA",-68.97609,-18.13643,46,4,160,206,74,7,75,149
"Bolivia","Oruro","Sajama","Curahuara de Carangas","ESC. EDUARDO SAGARNAGA",-68.41264,-17.84149,592,39,1589,2181,355,73,1122,1477
"Bolivia","Oruro","Sajama","Curahuara de Carangas","U.E. HACIA EL MAR",-68.83837,-18.00538,7,0,67,74,17,0,50,67
"Bolivia","Oruro","Sajama","Curahuara de Carangas","U.E. LITORAL B",-68.93645,-18.2223,29,1,148,177,56,6,85,141
"Bolivia","Oruro","Sajama","Turco","CASA COMUNAL",-68.94479,-18.53836,11,0,57,68,18,0,39,57
"Bolivia","Oruro","Sajama","Turco","ESC. CENTRAL TURCO",-68.19347,-18.18156,204,16,956,1160,212,23,705,917
"Bolivia","Oruro","Sajama","Turco","ESC. GUALBERTO VILLARROEL - IRUNI.-",-68.5331,-18.60372,2,0,40,42,6,0,34,40
"Bolivia","Oruro","Sajama","Turco","ESC. WALBERTO VILLARROEL",-68.62778,-18.34289,5,0,31,36,6,1,24,30
"Bolivia","Oruro","Sajama","Turco","NUCLEO ESCOLAR TITIRI",-68.33176,-18.38792,23,0,73,96,6,6,61,67
"Bolivia","Oruro","Sajama","Turco","U.E. ASUNCION DE HUAJRIRE",-68.37857,-18.21539,1,0,21,22,5,1,15,20
"Bolivia","Oruro","Sajama","Turco","U.E. EDUARDO AVAROA",-67.94069,-18.01298,21,1,96,117,16,2,77,93
"Bolivia","Oruro","Sajama","Turco","U.E. PEDRO DOMINGO MURILLO A",-68.71188,-18.17634,64,5,377,441,59,10,303,362
"Bolivia","Oruro","Sajama","Turco","U.E. PORVENIR",-68.94597,-18.35423,43,1,283,326,108,13,161,269
"Bolivia","Oruro","San Pedro De Totora","San Pedro de Totora","COL. NAL. CALAZAYA",-68.29729,-17.66094,64,7,295,359,30,6,252,282
"Bolivia","Oruro","San Pedro De Totora","San Pedro de Totora","COMEDOR ESCOLAR",-68.31258,-17.89262,17,1,100,117,29,4,66,95
"Bolivia","Oruro","San Pedro De Totora","San Pedro de Totora","ESC. CENTRAL SORA SORA",-68.10621,-17.9355,13,2,223,236,24,4,193,217
"Bolivia","Oruro","San Pedro De Totora","San Pedro de Totora","ESC. FRANZ TAMAYO",-68.09863,-17.82198,10,1,185,195,30,3,151,181
"Bolivia","Oruro","San Pedro De Totora","San Pedro de Totora","ESC. LITORAL DE CULTA.-",-68.03839,-17.97308,29,0,197,226,18,9,170,188
"Bolivia","Oruro","San Pedro De Totora","San Pedro de Totora","ESC. MARQUIRIVI",-67.9737,-17.95451,13,0,69,82,26,2,41,67
"Bolivia","Oruro","San Pedro De Totora","San Pedro de Totora","U.E. CENTRO REVITO",-68.02218,-17.91033,7,0,76,83,18,2,56,74
"Bolivia","Oruro","San Pedro De Totora","San Pedro de Totora","U.E. ROMEROCOTA",-68.25556,-17.92027,0,2,77,77,4,14,57,61
"Bolivia","Oruro","San Pedro De Totora","San Pedro de Totora","U.E. SEBASTIAN PAGADOR",-68.28579,-17.79087,14,1,127,141,13,1,112,125
"Bolivia","Oruro","San Pedro De Totora","San Pedro de Totora","U.E. TOTORA",-68.14532,-17.7922,149,17,789,938,119,46,607,726
"Bolivia","Oruro","San Pedro De Totora","San Pedro de Totora","U.E. VINO HUTA",-68.2402,-17.8328,12,1,132,144,14,2,115,129
"Bolivia","Oruro","Saucarí","Toledo","CASA COMUNAL",-67.42073,-18.08936,27,0,115,142,41,3,71,112
"Bolivia","Oruro","Saucarí","Toledo","CASA COMUNAL",-67.00774,-18.14512,27,0,115,142,41,3,71,112
"Bolivia","Oruro","Saucarí","Toledo","CASA COMUNAL CENTRAL MOLLOCO",-67.49101,-18.40378,4,4,77,81,14,1,58,72
"Bolivia","Oruro","Saucarí","Toledo","CASA DEL NOTARIO",-67.58843,-18.20439,13,0,67,80,18,1,48,66
"Bolivia","Oruro","Saucarí","Toledo","COL. NACIONAL TOLEDO",-67.4108,-18.1808,250,14,998,1248,299,37,648,947
"Bolivia","Oruro","Saucarí","Toledo","ESC. EDUARDO AVAROA",-67.58844,-18.20436,10,1,95,105,26,17,51,77
"Bolivia","Oruro","Saucarí","Toledo","ESC. ELIZARDO PEREZ 1",-67.28907,-18.29798,32,2,137,169,31,5,99,130
"Bolivia","Oruro","Saucarí","Toledo","ESC. GERMAN BUSCH 1",-67.54126,-18.26623,31,1,139,170,54,5,79,133
"Bolivia","Oruro","Saucarí","Toledo","ESC. GERMAN BUSCH II",-67.40559,-18.50244,1,0,123,124,24,5,94,118
"Bolivia","Oruro","Saucarí","Toledo","ESC. ISAC PORTO CARRERA",-67.59666,-18.02896,38,2,149,187,28,2,117,145
"Bolivia","Oruro","Saucarí","Toledo","ESC. M. M. VACA GUZMAN.-",-67.2721,-17.47592,70,5,282,352,87,9,181,268
"Bolivia","Oruro","Saucarí","Toledo","ESC. PUMASARA",-67.35503,-18.6561,21,0,120,141,19,3,98,117
"Bolivia","Oruro","Saucarí","Toledo","U.E. ANTONIO JOSE DE SUCRE",-67.51073,-18.37418,10,0,38,48,11,0,27,38
"Bolivia","Oruro","Saucarí","Toledo","U.E. BARTOLINA SISA",-67.46616,-18.43586,6,1,101,107,21,2,77,98
"Bolivia","Oruro","Saucarí","Toledo","U.E. FRANZ TAMAYO",-67.59203,-18.1406,5,0,45,50,16,2,27,43
"Bolivia","Oruro","Saucarí","Toledo","U. E. GUALBERTO VILLARROEL",-67.49483,-17.94513,17,2,121,138,27,1,91,118
"Bolivia","Oruro","Saucarí","Toledo","U.E. MARCELO QUIROGA SANTA CRUZ",-67.40546,-18.39192,20,1,61,81,9,0,51,60
"Bolivia","Oruro","Saucarí","Toledo","U.E. OTTO SAUCEDO",-67.5033,-18.48854,5,2,125,130,31,2,90,121
"Bolivia","Oruro","Saucarí","Toledo","U. ESC. TIJLLACAHUA",-67.46854,-17.94667,19,0,69,88,26,3,40,66
"Bolivia","Oruro","Sebastian Pagador","Santiago de Huari","COL. MIXTO GUALBERTO VILLARROEL",-66.77557,-19.00875,215,27,1528,1743,585,126,790,1375
"Bolivia","Oruro","Sebastian Pagador","Santiago de Huari","ESC. CAICO BOLIVAR",-66.75815,-19.25462,9,1,88,97,39,1,47,86
"Bolivia","Oruro","Sebastian Pagador","Santiago de Huari","ESC. CALACOTA",-66.46594,-19.14192,8,0,69,77,16,3,50,66
"Bolivia","Oruro","Sebastian Pagador","Santiago de Huari","ESC. CASTILLA HUMA",-66.71346,-19.14007,38,4,229,267,86,9,130,216
"Bolivia","Oruro","Sebastian Pagador","Santiago de Huari","ESC. CONDO K",-66.8055,-19.17203,14,2,140,154,67,3,68,135
"Bolivia","Oruro","Sebastian Pagador","Santiago de Huari","ESC. LLAPALLAPANI",-66.81982,-19.01081,17,2,117,134,25,6,84,109
"Bolivia","Oruro","Sebastian Pagador","Santiago de Huari","ESC. VICHAJ LUPE",-66.7529,-19.25462,42,1,245,287,68,12,164,232
"Bolivia","Oruro","Sebastian Pagador","Santiago de Huari","NUCLEO ESCOLAR BOLIVIA",-66.74451,-19.15185,14,1,284,298,50,3,230,280
"Bolivia","Oruro","Sebastian Pagador","Santiago de Huari","NUCLEO MARCA LAGUNILLAS",-66.27309,-19.23056,34,7,472,506,107,23,335,442
"Bolivia","Oruro","Sebastian Pagador","Santiago de Huari","U. E. LUCUMPAYA",-66.69658,-19.29461,8,0,57,65,10,1,46,56
"Bolivia","Oruro","Sebastian Pagador","Santiago de Huari","U.E. NAZACARA",-66.48449,-19.15744,0,3,121,121,41,7,70,111
"Bolivia","Oruro","Sebastian Pagador","Santiago de Huari","U.E. SAN PEDRO DE CONDO",-66.74747,-19.04341,105,9,553,658,205,24,315,520
"Bolivia","Oruro","Sebastian Pagador","Santiago de Huari","U. E. URMIRI DE QUILLACAS",-66.72021,-19.22743,39,3,211,250,43,4,161,204
"Bolivia","Oruro","Sebastian Pagador","Santiago de Huari","U. E. VILLA VERDE",-66.76753,-19.11843,23,3,130,153,43,2,82,125
"Bolivia","Oruro","Sur Carangas","Andamarca (Santiago de Andamarca)","ESC. SEBASTIAN PAGADOR",-67.50749,-18.77982,183,24,688,871,200,12,452,652
"Bolivia","Oruro","Sur Carangas","Andamarca (Santiago de Andamarca)","U.E. MEJILLONES",-67.50016,-18.87049,84,25,540,624,111,8,396,507
"Bolivia","Oruro","Sur Carangas","Andamarca (Santiago de Andamarca)","U.E. ORINOCA",-67.25661,-18.96682,110,3,804,914,64,11,726,790
"Bolivia","Oruro","Sur Carangas","Belén de Andamarca","COL. TEC. HUMANISTICO SIMON BOLIVAR",-67.64007,-18.8171,46,7,330,376,123,7,193,316
"Bolivia","Oruro","Sur Carangas","Belén de Andamarca","ESC. ANICETO ARCE",-67.75741,-18.74025,0,4,178,178,36,5,133,169
"Bolivia","Oruro","Sur Carangas","Belén de Andamarca","ESC. ELIZARDO PEREZ",-67.67679,-18.76107,11,0,101,112,20,3,78,98
"Bolivia","Oruro","Sur Carangas","Belén de Andamarca","U.E. BOLIVIA",-67.69051,-18.75176,16,7,183,199,38,9,129,167
"Bolivia","Oruro","Tomas Barrón","Eucaliptus","COL. NAL. EUCALIPTUS",-67.51264,-17.59574,6,1,62,68,11,0,50,61
"Bolivia","Oruro","Tomas Barrón","Eucaliptus","ESC. HUANCAROMA",-67.49158,-17.66445,18,0,121,139,18,0,103,121
"Bolivia","Oruro","Tomas Barrón","Eucaliptus","ESC. MARISCAL ANTONIO JOSE DE SUCRE",-67.39827,-17.62614,24,4,167,191,19,3,141,160
"Bolivia","Oruro","Tomas Barrón","Eucaliptus","ESC. TUPAC KATARI",-67.45214,-17.5953,4,2,200,204,36,6,156,192
"Bolivia","Oruro","Tomas Barrón","Eucaliptus","U.E. BENEDETO VINCENTI",-67.50977,-17.59444,216,21,1308,1524,381,32,874,1255
"Bolivia","Oruro","Tomas Barrón","Eucaliptus","U.E. MACHACAMARCA",-67.35824,-17.64213,10,0,105,115,11,4,90,101
"Bolivia","Oruro","Tomas Barrón","Eucaliptus","U.E. QUELCATA",-67.48569,-17.56117,56,13,325,381,55,8,249,304
"Bolivia","Pando","Abuná","Ingavi (Humaita)","U.E. DERREPENTE",-66.94105,-10.93787,0,0,68,68,37,12,19,56
"Bolivia","Pando","Abuná","Ingavi (Humaita)","U.E. HUMAITA",-66.44747,-10.82152,119,2,372,491,178,7,185,363
"Bolivia","Pando","Abuná","Ingavi (Humaita)","U.E. INGAVI",-66.82959,-10.95218,44,4,99,143,43,3,49,92
"Bolivia","Pando","Abuná","Ingavi (Humaita)","U.E. LAS AMALIAS",-66.79862,-10.97642,5,0,25,30,1,1,23,24
"Bolivia","Pando","Abuná","Santa Rosa del Abun","U.E. ABUNA",-67.45408,-10.60663,141,5,236,377,114,8,109,223
"Bolivia","Pando","Abuná","Santa Rosa del Abun","U.E. AUGUSTO GUTIERREZ BANZER",-67.35876,-10.85149,1,0,80,81,20,2,58,78
"Bolivia","Pando","Abuná","Santa Rosa del Abun","U.E. GENOVEVA RÍOS",-67.42355,-10.9903,63,5,223,286,45,2,171,216
"Bolivia","Pando","Abuná","Santa Rosa del Abun","U.E. PEDRO DOMINGO MURRILLO",-67.32189,-10.64891,16,0,100,116,8,0,92,100
"Bolivia","Pando","Abuná","Santa Rosa del Abun","U.E.  ZACARIAS MORENO",-67.48418,-10.87283,41,0,203,244,127,2,74,201
"Bolivia","Pando","Federico Román","Nuevo Manoa (Nueva Esperanza)","U.E. GRAL. FEDERICO ROMÁN",-65.50873,-10.47329,103,1,148,251,95,2,50,145
"Bolivia","Pando","Federico Román","Nuevo Manoa (Nueva Esperanza)","U.E. LA GRAN CRUZ",-65.40121,-10.36206,19,2,61,80,7,1,51,58
"Bolivia","Pando","Federico Román","Nuevo Manoa (Nueva Esperanza)","U.E.  MANUEL ESTREMADOIRO MARTINEZ",-65.34017,-10.05819,213,1,270,483,159,3,107,266
"Bolivia","Pando","Federico Román","Nuevo Manoa (Nueva Esperanza)","U.E.  MONTE SINAI",-65.31994,-10.25371,30,9,137,167,11,6,111,122
"Bolivia","Pando","Federico Román","Nuevo Manoa (Nueva Esperanza)","U.E. RUFINO CHAO",-65.59814,-10.53096,44,3,52,96,30,0,19,49
"Bolivia","Pando","Federico Román","Santos Mercado","19 DE OCTUBRE",-66.15702,-10.52243,181,2,367,548,177,6,182,359
"Bolivia","Pando","Federico Román","Santos Mercado","U.E. 11 DE SEPTIEMBRE",-66.40456,-10.258,54,1,170,224,50,2,117,167
"Bolivia","Pando","Federico Román","Santos Mercado","U.E.  23 DE MARZO",-66.30795,-10.4217,116,5,347,463,169,9,164,333
"Bolivia","Pando","Federico Román","Villa Nueva (Loma Alta)","U.E.  ANDRES IDAGUA",-65.96667,-10.79472,161,6,476,637,216,7,247,463
"Bolivia","Pando","Federico Román","Villa Nueva (Loma Alta)","U.E. ENAREVENA",-66.10579,-10.57579,9,0,51,60,28,0,23,51
"Bolivia","Pando","Federico Román","Villa Nueva (Loma Alta)","U.E. JUANA AZURDUY DE PADILLA",-66.15096,-10.79327,39,3,77,116,31,0,43,74
"Bolivia","Pando","Federico Román","Villa Nueva (Loma Alta)","U.E.  ROBERTO GONZALES",-65.88841,-10.6848,57,5,184,241,76,1,102,178
"Bolivia","Pando","Madre De Dios","El Sena","U.E.  2 DE AGOSTO",-67.05062,-11.45478,6,4,71,77,51,2,14,65
"Bolivia","Pando","Madre De Dios","El Sena","U.E. 4 DE AGOSTO",-67.01925,-12.17563,26,1,86,112,26,1,58,84
"Bolivia","Pando","Madre De Dios","El Sena","U.E. DE PEKIN",-67.65797,-12.00184,43,1,72,115,43,1,27,70
"Bolivia","Pando","Madre De Dios","El Sena","U.E. EL SENA",-67.24951,-11.48288,498,19,1417,1915,740,25,633,1373
"Bolivia","Pando","Madre De Dios","El Sena","U.E. EL TURI (RIO MANURAPE)",-67.28406,-11.69199,4,2,46,50,27,4,13,40
"Bolivia","Pando","Madre De Dios","El Sena","U.E. LAS MERCEDES",-67.27101,-11.87276,7,2,73,80,35,1,35,70
"Bolivia","Pando","Madre De Dios","El Sena","U.E. PALMA REAL",-67.72301,-11.65824,67,2,174,241,89,5,78,167
"Bolivia","Pando","Madre De Dios","El Sena","U.E. REMANSO",-67.29217,-11.76813,6,1,66,72,20,0,45,65
"Bolivia","Pando","Madre De Dios","El Sena","U.E. SAN FRANCISCO",-67.31672,-12.17345,50,5,166,216,53,6,102,155
"Bolivia","Pando","Madre De Dios","El Sena","U.E. SANTA ELENA",-67.48461,-11.78688,17,2,62,79,17,0,43,60
"Bolivia","Pando","Madre De Dios","El Sena","U.E. SANTA ROSA",-67.38081,-12.04853,30,0,54,84,25,0,29,54
"Bolivia","Pando","Madre De Dios","Puerto Gonzalo Moreno","U.E. 2 DE AGOSTO",-66.41665,-11.36894,29,1,141,170,44,4,92,136
"Bolivia","Pando","Madre De Dios","Puerto Gonzalo Moreno","U.E. AGUA DULCE",-66.20935,-11.00872,71,0,134,205,61,2,71,132
"Bolivia","Pando","Madre De Dios","Puerto Gonzalo Moreno","U.E. LUZ EN EL CAMINO",-66.17489,-11.08213,419,13,992,1411,426,29,524,950
"Bolivia","Pando","Madre De Dios","Puerto Gonzalo Moreno","U.E. MIRAFLORES",-66.40204,-11.10459,33,2,168,201,37,2,127,164
"Bolivia","Pando","Madre De Dios","Puerto Gonzalo Moreno","U.E. PEDRO HERRERA",-66.13277,-11.03917,184,5,501,685,266,7,223,489
"Bolivia","Pando","Madre De Dios","Puerto Gonzalo Moreno","U.E.  PORTACHUELO DIOS ES AMOR",-66.26447,-11.31525,108,8,329,437,50,4,267,317
"Bolivia","Pando","Madre De Dios","San Lorenzo","ESCUELA EDUARDO ABAROA",-66.95135,-11.30087,11,0,74,85,50,1,23,73
"Bolivia","Pando","Madre De Dios","San Lorenzo","U.E. 21 DE SEPTIEMBRE",-66.93037,-11.5493,9,0,60,69,24,0,36,60
"Bolivia","Pando","Madre De Dios","San Lorenzo","U.E.  24 DE SEPTIEMBRE",-66.9321,-11.72435,248,13,785,1033,256,13,503,759
"Bolivia","Pando","Madre De Dios","San Lorenzo","U.E. 27 DE MAYO",-66.81934,-11.2835,19,5,144,163,35,5,99,134
"Bolivia","Pando","Madre De Dios","San Lorenzo","U.E. 6 DE AGOSTO",-66.80107,-11.51633,0,0,118,118,0,1,117,117
"Bolivia","Pando","Madre De Dios","San Lorenzo","U.E.  6 DE JUNIO",-66.84736,-11.30354,9,1,62,71,2,0,59,61
"Bolivia","Pando","Madre De Dios","San Lorenzo","U.E.  BRUNO RACUA",-66.98441,-11.34711,12,0,81,93,38,6,37,75
"Bolivia","Pando","Madre De Dios","San Lorenzo","U.E. DE IBERIA",-66.74494,-11.69689,11,1,30,41,9,0,20,29
"Bolivia","Pando","Madre De Dios","San Lorenzo","U.E. DE ROSARIO",-66.93926,-12.29388,33,0,52,85,27,0,25,52
"Bolivia","Pando","Madre De Dios","San Lorenzo","U.E.  FEDERICO HECKER",-66.9248,-12.17911,27,0,70,97,31,1,38,69
"Bolivia","Pando","Madre De Dios","San Lorenzo","U.E. GALILEA",-66.56686,-11.41806,34,5,146,180,39,7,95,134
"Bolivia","Pando","Madre De Dios","San Lorenzo","U.E.  GENOVEVA RIOS",-66.80064,-11.27083,23,0,55,78,29,3,23,52
"Bolivia","Pando","Madre De Dios","San Lorenzo","U.E. GREGORIA DESTRE MATURANA",-66.5792,-11.1674,19,2,165,184,58,2,103,161
"Bolivia","Pando","Madre De Dios","San Lorenzo","U.E. NUEVO HORIZONTE",-66.67747,-11.44474,1,0,43,44,20,1,22,42
"Bolivia","Pando","Madre De Dios","San Lorenzo","U.E. PTO. COPACABANA",-66.68026,-11.54849,99,1,113,212,57,9,46,103
"Bolivia","Pando","Madre De Dios","San Lorenzo","U.E.  SOLEDAD",-66.9871,-11.57613,66,2,173,239,73,2,96,169
"Bolivia","Pando","Madre De Dios","San Lorenzo","U.E. VISTA ALEGRE",-66.6041,-11.3245,35,2,202,237,97,4,99,196
"Bolivia","Pando","Manuripi","Filadelfia","U.E. ALTA GRACIA",-68.25834,-11.60331,89,1,39,128,3,0,35,38
"Bolivia","Pando","Manuripi","Filadelfia","U.E. BUYUYO",-68.80491,-11.61425,14,1,127,141,33,4,89,122
"Bolivia","Pando","Manuripi","Filadelfia","U.E. CHIVE",-68.58688,-12.39163,93,9,220,313,105,8,98,203
"Bolivia","Pando","Manuripi","Filadelfia","U.E. CURICHON",-68.56036,-12.00636,24,4,101,125,48,0,49,97
"Bolivia","Pando","Manuripi","Filadelfia","U.E. DE HOLANDA",-68.71101,-11.76399,46,2,185,231,56,8,119,175
"Bolivia","Pando","Manuripi","Filadelfia","U.E. DE LA CRUZ",-68.10158,-11.98084,7,0,32,39,9,1,22,31
"Bolivia","Pando","Manuripi","Filadelfia","U.E. FILADELFIA",-68.74851,-11.32842,105,3,346,451,156,5,182,338
"Bolivia","Pando","Manuripi","Filadelfia","U.E.  FLORIDA",-68.63426,-12.19954,7,1,90,97,34,0,55,89
"Bolivia","Pando","Manuripi","Filadelfia","U.E.  JUANCITO PINTO",-68.98754,-11.87768,51,4,208,259,82,3,119,201
"Bolivia","Pando","Manuripi","Filadelfia","U.E. LUZ DE AMERICA",-68.6104,-12.12153,10,1,114,124,52,4,57,109
"Bolivia","Pando","Manuripi","Filadelfia","U.E. NUEVA ALIANZA",-68.35039,-11.37201,57,1,288,345,126,4,157,283
"Bolivia","Pando","Manuripi","Filadelfia","U.E. NUEVA EMPRESA",-68.81753,-11.49919,57,5,326,383,131,3,187,318
"Bolivia","Pando","Manuripi","Filadelfia","U.E. SAN ANTONIO",-68.58239,-12.04789,4,1,48,52,16,0,31,47
"Bolivia","Pando","Manuripi","Filadelfia","U.E. UCIA",-68.97458,-11.75343,14,5,67,81,5,0,57,62
"Bolivia","Pando","Manuripi","Filadelfia","U.E. VILLA AMERICA",-68.49368,-11.61459,14,1,93,107,44,3,45,89
"Bolivia","Pando","Manuripi","Filadelfia","U.E. VILLA BELLA",-68.72463,-11.44835,30,3,131,161,73,1,54,127
"Bolivia","Pando","Manuripi","Puerto Rico","U.E. BATRAJA",-67.32244,-11.29704,27,4,216,243,105,5,102,207
"Bolivia","Pando","Manuripi","Puerto Rico","U.E. DE LAS ARENAS",-67.69072,-11.58415,195,0,21,216,4,0,17,21
"Bolivia","Pando","Manuripi","Puerto Rico","U.E. DE PALESTINA",-67.09533,-11.03269,21,0,56,77,25,0,31,56
"Bolivia","Pando","Manuripi","Puerto Rico","U.E.  GERMAN BUSCH",-67.17651,-11.30694,0,7,396,396,151,57,181,332
"Bolivia","Pando","Manuripi","Puerto Rico","U.E. HIROSHIMA",-67.83469,-11.39288,7,0,24,31,17,1,6,23
"Bolivia","Pando","Manuripi","Puerto Rico","U.E.  LA SALLE EMETERIO RUIZ",-67.5565,-11.10394,735,18,1582,2317,735,42,787,1522
"Bolivia","Pando","Manuripi","Puerto Rico","U.E.  LOS MANDARINOS",-67.44718,-11.24423,1,2,28,29,11,2,13,24
"Bolivia","Pando","Manuripi","Puerto Rico","U.E. MANCHESTER",-67.999,-11.47539,39,0,59,98,41,0,18,59
"Bolivia","Pando","Manuripi","Puerto Rico","U.E.  SAN ANTONIO",-67.39052,-11.29652,7,0,85,92,15,3,67,82
"Bolivia","Pando","Manuripi","Puerto Rico","U.E.  SILVERIO ROJAS GONZALES",-66.75974,-11.58043,13,2,96,109,37,0,57,94
"Bolivia","Pando","Manuripi","San Pedro","U.E.  12 DE ABRIL",-66.18632,-10.82638,120,2,155,275,90,3,60,150
"Bolivia","Pando","Manuripi","San Pedro","U.E. FORTALEZA",-66.32966,-10.84701,140,0,177,317,77,1,99,176
"Bolivia","Pando","Manuripi","San Pedro","U.E.  JORGE HAENSEL",-66.44067,-10.94822,20,2,135,155,86,1,46,132
"Bolivia","Pando","Nicolás Suárez","Bella Flor","ESC. SANTA ELENA",-67.82802,-11.04349,7,0,11,18,6,0,5,11
"Bolivia","Pando","Nicolás Suárez","Bella Flor","U.E. BUENA VISTA",-67.67737,-11.09413,45,1,80,125,46,1,32,78
"Bolivia","Pando","Nicolás Suárez","Bella Flor","U.E. DE FLORIDA",-67.63081,-11.11081,5,0,18,23,1,0,17,18
"Bolivia","Pando","Nicolás Suárez","Bella Flor","U.E.  HUGO ANTEQUERA",-67.89793,-11.08514,94,4,320,414,178,9,129,307
"Bolivia","Pando","Nicolás Suárez","Bella Flor","U.E. JORGE BENITO VERA",-67.27247,-10.31881,154,2,277,431,132,7,136,268
"Bolivia","Pando","Nicolás Suárez","Bella Flor","U.E.  KM. 35 DE KARAMANU",-68.34393,-11.14225,62,5,251,313,84,6,156,240
"Bolivia","Pando","Nicolás Suárez","Bella Flor","U.E.  KM. 60 DE SAN ANTONIO",-68.09121,-11.16999,48,4,143,191,50,0,89,139
"Bolivia","Pando","Nicolás Suárez","Bella Flor","U.E. MAPAJO",-67.6199,-10.62717,30,1,69,99,32,0,36,68
"Bolivia","Pando","Nicolás Suárez","Bella Flor","U.E. SANTA LOURDES",-68.47906,-11.13931,23,0,103,126,50,2,51,101
"Bolivia","Pando","Nicolás Suárez","Bella Flor","U.E. SIMON BOLÍVAR",-67.61858,-10.90335,15,0,142,157,37,5,100,137
"Bolivia","Pando","Nicolás Suárez","Bolpebra (Mukden)","U.E. BIOCEANICA",-69.37039,-11.13272,45,1,123,168,74,1,47,121
"Bolivia","Pando","Nicolás Suárez","Bolpebra (Mukden)","U.E. DE BOLPEBRA",-69.56477,-10.94741,21,2,76,97,25,4,45,70
"Bolivia","Pando","Nicolás Suárez","Bolpebra (Mukden)","U.E. DE MUKDEN",-69.02858,-11.1877,48,3,222,270,168,6,45,213
"Bolivia","Pando","Nicolás Suárez","Bolpebra (Mukden)","U.E. DE YAMINAHUA",-69.42874,-10.93892,21,0,57,78,16,4,37,53
"Bolivia","Pando","Nicolás Suárez","Bolpebra (Mukden)","U.E.  GENOVEVA RIOS",-69.06962,-11.28025,62,3,218,280,111,3,101,212
"Bolivia","Pando","Nicolás Suárez","Bolpebra (Mukden)","U.E. NUEVA CANAÁN",-69.22169,-11.14435,49,0,74,123,26,3,45,71
"Bolivia","Pando","Nicolás Suárez","Bolpebra (Mukden)","U.E. SAN MIGUEL",-69.48006,-10.95564,4,0,12,16,0,0,12,12
"Bolivia","Pando","Nicolás Suárez","Bolpebra (Mukden)","U.E.  SANTA LUCIA",-69.01627,-11.25383,21,0,101,122,55,6,40,95
"Bolivia","Pando","Nicolás Suárez","Bolpebra (Mukden)","U.E. TRES ESTRELLAS",-69.27618,-11.33935,15,0,65,80,28,1,36,64
"Bolivia","Pando","Nicolás Suárez","Cobija","CARCEL PUBLICA (VILLA BUSCH)",-68.78143,-11.08489,37,2,131,168,61,4,64,125
"Bolivia","Pando","Nicolás Suárez","Cobija","KINDER VICTOR LEON ARUETA (VACA DIEZ MEDIO)",-68.76038,-11.02101,82,1,280,362,195,7,77,272
"Bolivia","Pando","Nicolás Suárez","Cobija","U. E. 11 DE OCTUBRE",-68.75275,-11.01869,404,10,1729,2133,1009,47,663,1672
"Bolivia","Pando","Nicolás Suárez","Cobija","U. E.  AMERICA",-68.75782,-11.01896,121,6,541,662,353,20,162,515
"Bolivia","Pando","Nicolás Suárez","Cobija","U. E. COBIJA",-68.77015,-11.03708,761,16,2513,3274,1543,61,893,2436
"Bolivia","Pando","Nicolás Suárez","Cobija","U.E. DE BELLA VISTA",-68.78143,-11.08489,184,9,920,1104,462,21,428,890
"Bolivia","Pando","Nicolás Suárez","Cobija","U.E. DEFENSORES DEL ACRE",-68.76064,-11.02505,535,21,2110,2645,1216,46,827,2043
"Bolivia","Pando","Nicolás Suárez","Cobija","U.E. GERMAN BUSCH",-67.17651,-11.30694,190,7,954,1144,543,18,386,929
"Bolivia","Pando","Nicolás Suárez","Cobija","U. E. INSTITUTO AMERICANO",-68.75738,-11.02217,161,3,694,855,454,19,218,672
"Bolivia","Pando","Nicolás Suárez","Cobija","U. E. JOSÉ MANUEL PANDO",-68.75738,-11.02217,546,28,2464,3010,1387,72,977,2364
"Bolivia","Pando","Nicolás Suárez","Cobija","U. E. JUANA AZURDUY DE PADILLA",-68.77395,-11.03823,194,1,502,696,318,8,175,493
"Bolivia","Pando","Nicolás Suárez","Cobija","U. E. MANUELA ROJAS",-68.77524,-11.03517,367,15,1822,2189,1158,57,592,1750
"Bolivia","Pando","Nicolás Suárez","Cobija","U.E. MARIANO BAPTISTA (EDIFICIO SEDUCA)",-68.7578,-11.02304,233,4,916,1149,592,44,276,868
"Bolivia","Pando","Nicolás Suárez","Cobija","U. E. MARISCAL SUCRE",-68.75624,-11.01813,615,21,2466,3081,1265,66,1114,2379
"Bolivia","Pando","Nicolás Suárez","Cobija","U.E. NUEVA ESPERANZA",-68.88235,-11.1152,16,0,84,100,53,3,28,81
"Bolivia","Pando","Nicolás Suárez","Cobija","U. E. ROGELIA MENACHO DE BALCAZAR",-68.74956,-11.01224,356,17,1672,2028,967,50,638,1605
"Bolivia","Pando","Nicolás Suárez","Cobija","U. E. SIMON BOLIVAR",-68.78709,-11.03764,170,6,1195,1365,638,33,518,1156
"Bolivia","Pando","Nicolás Suárez","Cobija","U. E. SOFIA CALPIÑEIRO",-68.75566,-11.01603,564,11,2347,2911,1518,65,753,2271
"Bolivia","Pando","Nicolás Suárez","Cobija","U. E. VACA DIEZ (INTERMEDIO)",-68.76405,-11.02211,136,156,842,978,394,19,273,667
"Bolivia","Pando","Nicolás Suárez","Cobija","U. E. VACA DIEZ (MEDIO)",-68.76039,-11.02054,166,0,576,742,379,20,177,556
"Bolivia","Pando","Nicolás Suárez","Cobija","U.E. VILLA CRUZ",-68.77383,-11.03098,595,19,2955,3550,1735,84,1117,2852
"Bolivia","Pando","Nicolás Suárez","Porvenir","U.E. BRUNO RACUA",-68.68311,-11.23532,288,9,1125,1413,462,29,625,1087
"Bolivia","Pando","Nicolás Suárez","Porvenir","U.E.  GUTEMBERT CRUZ",-68.84592,-11.22069,33,1,191,224,108,1,81,189
"Bolivia","Pando","Nicolás Suárez","Porvenir","U.E. MONS. SANTISTEBAN",-68.68311,-11.23532,264,9,953,1217,435,13,496,931
"Bolivia","Pando","Nicolás Suárez","Porvenir","U.E. VILLA BELLA",-68.724,-11.2168,95,4,584,679,245,9,326,571
"Bolivia","Potosí","Alonso de Ibáñez","Caripuyo","ESC. CATARI",-66.557,-18.152,21,0,100,121,10,5,85,95
"Bolivia","Potosí","Alonso de Ibáñez","Caripuyo","ESC. CHAICURIRI",-66.63818,-18.22252,25,1,104,129,19,1,83,102
"Bolivia","Potosí","Alonso de Ibáñez","Caripuyo","ESC. CHALVIRI",-66.51712,-18.19005,37,11,160,197,15,8,126,141
"Bolivia","Potosí","Alonso de Ibáñez","Caripuyo","ESC. CHOJLLA",-66.58522,-18.208,10,2,277,287,13,32,230,243
"Bolivia","Potosí","Alonso de Ibáñez","Caripuyo","ESC. COTANA",-66.57648,-18.09925,113,25,466,579,55,13,373,428
"Bolivia","Potosí","Alonso de Ibáñez","Caripuyo","ESC. EDUARDO AVAROA",-66.47403,-18.2329,187,65,815,1002,109,38,603,712
"Bolivia","Potosí","Alonso de Ibáñez","Caripuyo","ESC. HUANACHACA",-66.53834,-18.10201,15,3,141,156,5,2,131,136
"Bolivia","Potosí","Alonso de Ibáñez","Caripuyo","ESC. HUANACOMA",-66.49527,-18.15723,23,19,376,399,76,20,261,337
"Bolivia","Potosí","Alonso de Ibáñez","Caripuyo","ESC. JANCKO JANCKO",-66.59177,-18.17574,66,4,311,377,50,29,228,278
"Bolivia","Potosí","Alonso de Ibáñez","Caripuyo","ESC. JUNTAVI",-66.50504,-18.23312,53,7,401,454,11,11,372,383
"Bolivia","Potosí","Alonso de Ibáñez","Sacaca (Villa de Sacaca)","COL. JOSE ALONZO DE IBAÑEZ",-66.38387,-18.06966,512,52,1970,2482,779,146,993,1772
"Bolivia","Potosí","Alonso de Ibáñez","Sacaca (Villa de Sacaca)","ESC. CARCOMA",-66.31796,-17.98507,92,0,491,583,16,1,474,490
"Bolivia","Potosí","Alonso de Ibáñez","Sacaca (Villa de Sacaca)","ESC. CHARCA",-66.309,-18.29,22,3,230,252,121,6,100,221
"Bolivia","Potosí","Alonso de Ibáñez","Sacaca (Villa de Sacaca)","ESC. COLLOMA",-66.34437,-18.3256,15,3,105,120,32,5,65,97
"Bolivia","Potosí","Alonso de Ibáñez","Sacaca (Villa de Sacaca)","ESC. DE OVEJERIA",-66.23547,-18.14605,46,5,701,747,88,27,581,669
"Bolivia","Potosí","Alonso de Ibáñez","Sacaca (Villa de Sacaca)","ESC. ITURATA",-66.2449,-18.01211,27,3,260,287,18,10,229,247
"Bolivia","Potosí","Alonso de Ibáñez","Sacaca (Villa de Sacaca)","ESC. JARUMA",-66.49641,-18.05654,14,8,309,323,125,18,158,283
"Bolivia","Potosí","Alonso de Ibáñez","Sacaca (Villa de Sacaca)","ESC. LAYTOCO",-66.30727,-18.14706,21,0,276,297,4,8,264,268
"Bolivia","Potosí","Alonso de Ibáñez","Sacaca (Villa de Sacaca)","ESC. LAYUPAMPA",-66.40737,-17.99987,41,25,439,480,52,23,339,391
"Bolivia","Potosí","Alonso de Ibáñez","Sacaca (Villa de Sacaca)","ESC. SILLU SILLU",-66.46011,-18.09924,3,4,440,443,22,9,405,427
"Bolivia","Potosí","Alonso de Ibáñez","Sacaca (Villa de Sacaca)","ESC. VILA SIRCA",-66.32172,-18.34239,28,4,115,143,36,6,69,105
"Bolivia","Potosí","Alonso de Ibáñez","Sacaca (Villa de Sacaca)","ESC. VILA VILA",-66.34768,-18.15004,27,3,623,650,28,26,566,594
"Bolivia","Potosí","Alonso de Ibáñez","Sacaca (Villa de Sacaca)","SACANI",-66.18929,-18.09043,10,0,373,383,19,7,347,366
"Bolivia","Potosí","Alonso de Ibáñez","Sacaca (Villa de Sacaca)","TARHUA CHAPI",-66.40738,-18.19324,65,24,565,630,54,27,460,514
"Bolivia","Potosí","Alonso de Ibáñez","Sacaca (Villa de Sacaca)","U.E. BOLIVIA",-66.41556,-18.09067,5,2,174,179,1,9,162,163
"Bolivia","Potosí","Alonso de Ibáñez","Sacaca (Villa de Sacaca)","U.E. CAMACACHI",-66.3724,-18.11655,0,1,90,90,0,0,89,89
"Bolivia","Potosí","Alonso de Ibáñez","Sacaca (Villa de Sacaca)","U.E. JAYU JAYU",-66.37892,-18.16083,2,10,155,157,4,5,136,140
"Bolivia","Potosí","Alonso de Ibáñez","Sacaca (Villa de Sacaca)","U.E. LLAPA LLAPA",-66.3597,-18.09612,2,2,82,84,6,1,73,79
"Bolivia","Potosí","Antonio Quijarro","Porco","ESC. AGUA CASTILLA",-65.99281,-19.76802,148,16,1148,1296,844,43,245,1089
"Bolivia","Potosí","Antonio Quijarro","Porco","U.E. ANTONIO QUIJARRO DE CARMA",-65.83518,-19.78734,27,1,128,155,109,6,12,121
"Bolivia","Potosí","Antonio Quijarro","Porco","U.E. CONCEPCION DE CHAQUILLA",-66.17165,-19.915,5,0,89,94,44,1,44,88
"Bolivia","Potosí","Antonio Quijarro","Porco","U.E. GUALBERTO VILLARROEL DE CHICHUYO",-65.97169,-19.90254,22,1,113,135,62,5,45,107
"Bolivia","Potosí","Antonio Quijarro","Porco","U.E. JOSE MARIA LINARES",-65.98714,-19.79856,161,13,1042,1203,729,31,269,998
"Bolivia","Potosí","Antonio Quijarro","Porco","U.E. SAN ANTONIO DE TORCUYO",-65.79976,-19.77843,3,2,100,103,72,4,22,94
"Bolivia","Potosí","Antonio Quijarro","Porco","U.E. SAN GABRIEL DE CONDORIRI",-65.92919,-19.74775,33,1,117,150,92,1,23,115
"Bolivia","Potosí","Antonio Quijarro","Porco","U.E. SAN JOSE DE TOPALA",-65.90455,-19.80483,17,0,117,134,76,6,35,111
"Bolivia","Potosí","Antonio Quijarro","Porco","U.E. SANTA MARIA DE CHURCUITA",-65.81611,-19.84111,24,2,119,143,82,3,32,114
"Bolivia","Potosí","Antonio Quijarro","Porco","U.E. SANTA ROSA",-65.98714,-19.79856,199,23,1244,1443,841,46,334,1175
"Bolivia","Potosí","Antonio Quijarro","Tomave","COL. ELIZARDO PEREZ A",-66.31324,-20.14378,65,19,573,638,221,23,310,531
"Bolivia","Potosí","Antonio Quijarro","Tomave","COL. SIMON RODRIGUEZ CARREÑO",-66.13405,-20.04367,35,2,184,219,96,6,80,176
"Bolivia","Potosí","Antonio Quijarro","Tomave","COL. TOMAS FRIAS",-66.53149,-20.0643,129,33,438,567,224,21,160,384
"Bolivia","Potosí","Antonio Quijarro","Tomave","ESC. MARISCAL SUCRE",-66.7066,-19.74305,75,14,394,469,179,21,180,359
"Bolivia","Potosí","Antonio Quijarro","Tomave","U.E. 10 DE NOVIEMBRE",-66.5676,-20.21303,20,1,115,135,46,3,65,111
"Bolivia","Potosí","Antonio Quijarro","Tomave","U.E. 1RO. DE MAYO",-66.39316,-20.35149,27,3,142,169,60,8,71,131
"Bolivia","Potosí","Antonio Quijarro","Tomave","U.E. 31 DE OCTUBRE",-66.34953,-19.78253,14,1,128,142,77,5,45,122
"Bolivia","Potosí","Antonio Quijarro","Tomave","U.E. DANIEL CAMPOS",-66.2225,-20.26551,37,8,144,181,55,6,75,130
"Bolivia","Potosí","Antonio Quijarro","Tomave","U.E. EDUARDO ABAROA",-66.17575,-19.98652,14,3,133,147,58,5,67,125
"Bolivia","Potosí","Antonio Quijarro","Tomave","U.E. ELIZARDO PEREZ",-66.19482,-20.41101,12,1,98,110,40,4,53,93
"Bolivia","Potosí","Antonio Quijarro","Tomave","U.E. FRANZ TAMAYO",-66.16724,-20.0438,89,5,498,587,222,14,257,479
"Bolivia","Potosí","Antonio Quijarro","Tomave","U.E. FRANZ TAMAYO",-66.38166,-20.09554,89,5,498,587,222,14,257,479
"Bolivia","Potosí","Antonio Quijarro","Tomave","U.E. FRANZ TAMAYO",-66.26527,-19.82753,89,5,498,587,222,14,257,479
"Bolivia","Potosí","Antonio Quijarro","Tomave","U.E. GERMAN BUSCH",-66.04766,-20.07577,39,1,267,306,71,13,182,253
"Bolivia","Potosí","Antonio Quijarro","Tomave","U.E. GERMAN BUSCH",-66.26482,-19.89234,39,1,267,306,71,13,182,253
"Bolivia","Potosí","Antonio Quijarro","Tomave","U.E. JUANA AZURDUY DE PADILLA",-66.36832,-20.50186,7,1,35,42,14,2,18,32
"Bolivia","Potosí","Antonio Quijarro","Tomave","U.E. JULIO LAREDO",-66.17559,-20.12856,23,3,125,148,19,2,101,120
"Bolivia","Potosí","Antonio Quijarro","Tomave","U.E. MARISCAL DE AYACUCHO",-66.56905,-19.69648,43,6,115,158,63,6,40,103
"Bolivia","Potosí","Antonio Quijarro","Tomave","U.E. MARISCAL JOSE DE SUCRE",-66.12498,-20.07338,129,18,499,628,242,14,225,467
"Bolivia","Potosí","Antonio Quijarro","Tomave","U.E. RAFAEL PABON",-66.09256,-20.00132,22,4,86,108,25,5,52,77
"Bolivia","Potosí","Antonio Quijarro","Tomave","U.E. RICARDO CRUZ",-65.92126,-20.07895,67,3,164,231,47,11,103,150
"Bolivia","Potosí","Antonio Quijarro","Tomave","U.E. SIMON BOLIVAR",-66.24822,-19.90882,11,3,266,277,36,26,201,237
"Bolivia","Potosí","Antonio Quijarro","Tomave","U.E. SIMON BOLIVAR",-66.22723,-19.87498,11,3,266,277,36,26,201,237
"Bolivia","Potosí","Antonio Quijarro","Tomave","U.E. TOMAS FRIAS",-66.30714,-19.96937,27,15,191,218,78,4,94,172
"Bolivia","Potosí","Antonio Quijarro","Uyuni (Thola Pampa)","SUB SEDE UNIV. ECONOMIA",-66.82623,-20.46294,301,33,1661,1962,712,68,848,1560
"Bolivia","Potosí","Antonio Quijarro","Uyuni (Thola Pampa)","U.E.ALTO ALIANZA",-66.43998,-19.54232,4,0,36,40,23,4,9,32
"Bolivia","Potosí","Antonio Quijarro","Uyuni (Thola Pampa)","U.E. ANTONIO QUIJARRO",-66.82595,-20.45747,654,41,3074,3728,1678,139,1216,2894
"Bolivia","Potosí","Antonio Quijarro","Uyuni (Thola Pampa)","U.E. EDUARDO AVAROA",-66.85102,-20.36443,21,3,241,262,149,12,77,226
"Bolivia","Potosí","Antonio Quijarro","Uyuni (Thola Pampa)","U.E. FRANZ TAMAYO",-66.92651,-20.11757,23,4,160,183,94,11,51,145
"Bolivia","Potosí","Antonio Quijarro","Uyuni (Thola Pampa)","U.E. GERMAN BUSCH",-66.93522,-20.30083,48,4,339,387,183,13,139,322
"Bolivia","Potosí","Antonio Quijarro","Uyuni (Thola Pampa)","U.E. GUALBERTO VILLARROEL",-67.06178,-19.53462,61,10,312,373,161,28,113,274
"Bolivia","Potosí","Antonio Quijarro","Uyuni (Thola Pampa)","U.E. JAIME DE ZUDAÑES",-66.82595,-20.45747,736,45,3224,3960,1718,113,1348,3066
"Bolivia","Potosí","Antonio Quijarro","Uyuni (Thola Pampa)","U.E. JUANA AZURDUY DE PADILLA",-67.0053,-19.61859,9,1,94,103,50,2,41,91
"Bolivia","Potosí","Antonio Quijarro","Uyuni (Thola Pampa)","U.E. JUAN SANJINEZ",-67.16636,-19.68052,63,42,490,553,250,15,183,433
"Bolivia","Potosí","Antonio Quijarro","Uyuni (Thola Pampa)","U.E. KATARINA KRSUL",-66.81326,-19.52889,120,26,718,838,476,27,189,665
"Bolivia","Potosí","Antonio Quijarro","Uyuni (Thola Pampa)","U.E. MARISCAL BRAUN",-66.68245,-19.51538,31,5,316,347,137,20,154,291
"Bolivia","Potosí","Antonio Quijarro","Uyuni (Thola Pampa)","U.E. MARISCAL DE AYACUCHO",-66.3906,-20.81844,36,8,177,213,57,9,103,160
"Bolivia","Potosí","Antonio Quijarro","Uyuni (Thola Pampa)","U.E. POTOSI",-66.82595,-20.45747,233,24,1350,1583,706,71,549,1255
"Bolivia","Potosí","Antonio Quijarro","Uyuni (Thola Pampa)","U.E. PULACAYO A",-66.70123,-20.39232,34,7,219,253,105,11,96,201
"Bolivia","Potosí","Antonio Quijarro","Uyuni (Thola Pampa)","U.E. RICARDO RODRIGUEZ",-66.89848,-19.89956,52,11,279,331,126,13,129,255
"Bolivia","Potosí","Antonio Quijarro","Uyuni (Thola Pampa)","U.E. RIO MULATO",-66.77838,-19.69697,71,20,437,508,213,16,188,401
"Bolivia","Potosí","Antonio Quijarro","Uyuni (Thola Pampa)","U.E. UYUNI A",-66.81758,-20.45736,321,27,1851,2172,1044,65,715,1759
"Bolivia","Potosí","Charcas","San Pedro de Buena Vista","COLEG. NAL. CHARCAS",-65.981,-18.26995,855,167,2189,3044,517,100,1405,1922
"Bolivia","Potosí","Charcas","San Pedro de Buena Vista","ESC. ARAKANI",-65.94547,-18.44892,1,2,156,157,0,2,152,152
"Bolivia","Potosí","Charcas","San Pedro de Buena Vista","ESC. CHIRO CKASA",-66.18792,-18.26068,267,58,1164,1431,257,92,757,1014
"Bolivia","Potosí","Charcas","San Pedro de Buena Vista","ESC. IPOTE",-65.76811,-18.33076,1,0,73,74,0,1,72,72
"Bolivia","Potosí","Charcas","San Pedro de Buena Vista","ESC. MARTIN CALA",-65.68661,-18.55701,9,0,194,203,2,1,191,193
"Bolivia","Potosí","Charcas","San Pedro de Buena Vista","ESC. MOSCARI",-66.00932,-18.36224,218,11,526,744,13,4,498,511
"Bolivia","Potosí","Charcas","San Pedro de Buena Vista","ESC. ÑEQUETA",-66.21066,-18.28477,153,60,516,669,76,20,360,436
"Bolivia","Potosí","Charcas","San Pedro de Buena Vista","ESC. QUINAMARA",-65.843,-18.236,160,3,269,429,11,23,232,243
"Bolivia","Potosí","Charcas","San Pedro de Buena Vista","ESC. SAN MARCOS",-65.71427,-18.49057,105,0,617,722,5,0,612,617
"Bolivia","Potosí","Charcas","San Pedro de Buena Vista","ESC. SAPACARI",-66.24672,-18.3837,62,10,163,225,40,7,106,146
"Bolivia","Potosí","Charcas","San Pedro de Buena Vista","ESC. SECCIONAL ESKENCACHI",-66.164,-18.427,95,40,424,519,65,18,301,366
"Bolivia","Potosí","Charcas","San Pedro de Buena Vista","ESC. SORA SORA",-66.272,-18.19449,3,1,62,65,12,1,48,60
"Bolivia","Potosí","Charcas","San Pedro de Buena Vista","ESC. TORACARI",-66.13522,-18.13033,246,30,559,805,158,29,342,500
"Bolivia","Potosí","Charcas","San Pedro de Buena Vista","ESCUELA SECCIONAL COTA COTA",-66.21744,-18.34191,23,2,268,291,20,5,241,261
"Bolivia","Potosí","Charcas","San Pedro de Buena Vista","NUCLEO EDUCATIVO BANDURIRI",-66.0399,-18.15632,7,4,358,365,11,7,336,347
"Bolivia","Potosí","Charcas","San Pedro de Buena Vista","NUCLEO ESCOLAR MICANI",-65.83389,-18.3693,114,12,917,1031,13,3,889,902
"Bolivia","Potosí","Charcas","Toro Toro","ESC. PALLA PALLA",-65.52338,-18.32186,55,3,412,467,16,6,387,403
"Bolivia","Potosí","Charcas","Toro Toro","ESC. SECCIONAL",-65.77195,-18.19173,36,2,390,426,13,4,371,384
"Bolivia","Potosí","Charcas","Toro Toro","ESC. SECCIONAL AÑAHUANI",-65.64471,-18.23354,64,9,350,414,17,7,317,334
"Bolivia","Potosí","Charcas","Toro Toro","ESC. SECCIONAL CARASI",-65.68874,-18.31779,142,7,453,595,39,12,395,434
"Bolivia","Potosí","Charcas","Toro Toro","ESC. TORO TORO",-65.79198,-18.02429,451,37,1814,2265,347,77,1353,1700
"Bolivia","Potosí","Charcas","Toro Toro","ESC. TORO TORO",-65.76296,-18.13375,451,37,1814,2265,347,77,1353,1700
"Bolivia","Potosí","Charcas","Toro Toro","ESC. YAMBATA",-65.91856,-18.05247,61,3,282,343,25,8,246,271
"Bolivia","Potosí","Charcas","Toro Toro","NUCLEO POCO SUCO",-65.73625,-18.25639,49,4,257,306,11,6,236,247
"Bolivia","Potosí","Chayanta","Colquechaca","COLEG. TOMAS CATARI",-66.0375,-18.8177,642,157,1752,2394,211,131,1253,1464
"Bolivia","Potosí","Chayanta","Colquechaca","ESC. AYOMA",-66.14678,-18.86896,185,45,452,637,69,28,310,379
"Bolivia","Potosí","Chayanta","Colquechaca","ESC. CENTRAL ULUCHI",-66.14444,-18.95846,166,47,864,1030,150,65,602,752
"Bolivia","Potosí","Chayanta","Colquechaca","ESC. GUADALUPE",-65.79741,-18.69036,143,4,555,698,21,2,528,549
"Bolivia","Potosí","Chayanta","Colquechaca","ESC. GUALBERTO VILLARROEL TITIRI",-65.97601,-18.97547,31,3,145,176,7,6,129,136
"Bolivia","Potosí","Chayanta","Colquechaca","ESC. JACINTO PINTO DE PHUTINA",-66.21133,-18.83524,207,13,637,844,88,19,517,605
"Bolivia","Potosí","Chayanta","Colquechaca","ESC. JAIME MENDOZA",-66.20398,-18.9043,69,8,674,743,66,95,505,571
"Bolivia","Potosí","Chayanta","Colquechaca","ESC. JAMANCHIRI",-65.8834,-18.70837,29,3,141,170,5,13,120,125
"Bolivia","Potosí","Chayanta","Colquechaca","ESC. JUNIN",-66.00296,-18.69715,269,44,893,1162,355,84,410,765
"Bolivia","Potosí","Chayanta","Colquechaca","ESC. MARCELO QUIRVES",-66.05211,-18.97724,110,50,338,448,69,39,180,249
"Bolivia","Potosí","Chayanta","Colquechaca","ESC. MEJILLONES DE CAYARANI",-65.94516,-18.74131,32,2,279,311,17,47,213,230
"Bolivia","Potosí","Chayanta","Colquechaca","ESC. ROSARIO",-65.97795,-18.77202,59,26,418,477,41,17,334,375
"Bolivia","Potosí","Chayanta","Colquechaca","ESC. SALINAS",-66.11065,-19.01487,69,28,711,780,101,33,549,650
"Bolivia","Potosí","Chayanta","Colquechaca","ESC. S.BOLIVAR CHOQUECAYARA",-66.23908,-18.92873,35,19,208,243,46,22,121,167
"Bolivia","Potosí","Chayanta","Colquechaca","ESC. SECCIONAL SALINAS DE MACHA",-66.11683,-18.9747,41,0,150,191,22,11,117,139
"Bolivia","Potosí","Chayanta","Colquechaca","OFIC. CORREGIMIENTO",-65.84781,-18.56566,231,17,484,715,37,11,419,456
"Bolivia","Potosí","Chayanta","Colquechaca","TOMAYCURI",-65.90958,-18.85932,153,26,508,661,118,26,338,456
"Bolivia","Potosí","Chayanta","Colquechaca","U.E. AYACUCHO DE SICUTA",-65.80147,-18.59073,19,6,238,257,4,6,222,226
"Bolivia","Potosí","Chayanta","Colquechaca","U.E. MILLURI",-66.15628,-18.90602,4,1,100,104,14,10,75,89
"Bolivia","Potosí","Chayanta","Colquechaca","U.E. ROBERTO ALVARADO",-66.0021,-18.70359,235,50,881,1116,414,68,349,763
"Bolivia","Potosí","Chayanta","Ocurí","COLEGIO DANIEL SALAMANCA",-65.79628,-18.8428,338,62,843,1181,256,60,465,721
"Bolivia","Potosí","Chayanta","Ocurí","COL. NAC. MARCELO QUIROGA SANTA CRUZ",-65.79628,-18.8428,364,40,850,1214,226,91,493,719
"Bolivia","Potosí","Chayanta","Ocurí","ESC. KARA KARA",-65.70093,-18.81138,102,33,337,439,84,21,199,283
"Bolivia","Potosí","Chayanta","Ocurí","ESC. MARAGUA",-65.77851,-18.95468,268,32,515,783,171,59,253,424
"Bolivia","Potosí","Chayanta","Ocurí","ESC ROCO ROCO",-65.84806,-18.79057,17,2,84,101,8,4,70,78
"Bolivia","Potosí","Chayanta","Ocurí","ESC. SECCIONAL MARCOMA",-65.65381,-18.95084,87,22,326,413,90,19,195,285
"Bolivia","Potosí","Chayanta","Ocurí","ESC. SIMON BOLIVAR DE PEANA",-65.785,-18.719,54,6,366,420,31,16,313,344
"Bolivia","Potosí","Chayanta","Ocurí","ESC. YURIMATA",-65.69332,-18.93946,63,18,237,300,55,13,151,206
"Bolivia","Potosí","Chayanta","Ocurí","U.E. CHAUPI LOMA",-65.77997,-19.00577,3,2,65,68,15,11,37,52
"Bolivia","Potosí","Chayanta","Ocurí","U.E. COLLPA",-65.82913,-18.99837,10,13,158,168,25,7,113,138
"Bolivia","Potosí","Chayanta","Pocoata","ESC. ACHACANA",-66.15985,-18.5925,100,2,465,565,12,18,433,445
"Bolivia","Potosí","Chayanta","Pocoata","ESC. CACHUYO",-66.04868,-18.71111,39,17,260,299,39,14,190,229
"Bolivia","Potosí","Chayanta","Pocoata","ESC. CAMPAYA",-66.30963,-18.75883,68,12,1019,1087,84,12,911,995
"Bolivia","Potosí","Chayanta","Pocoata","ESC. CENTRAL JACHATAJO",-66.07078,-18.51748,67,17,231,298,11,8,195,206
"Bolivia","Potosí","Chayanta","Pocoata","ESC. CENTRAL VILLA ALCARAPI",-66.28011,-18.8248,19,0,329,348,16,12,301,317
"Bolivia","Potosí","Chayanta","Pocoata","ESC. CHAYALA",-66.04488,-18.53314,164,6,291,455,22,5,258,280
"Bolivia","Potosí","Chayanta","Pocoata","ESC. COLLANA TUICA",-66.20734,-18.60429,29,12,373,402,17,7,337,354
"Bolivia","Potosí","Chayanta","Pocoata","ESC. COLLPA CKASA",-66.118,-18.49396,36,4,235,271,40,7,184,224
"Bolivia","Potosí","Chayanta","Pocoata","ESC. HUANCARANI",-66.13522,-18.73722,146,56,638,784,133,34,415,548
"Bolivia","Potosí","Chayanta","Pocoata","ESC. JARANA",-66.12551,-18.6998,65,27,342,407,54,20,241,295
"Bolivia","Potosí","Chayanta","Pocoata","ESC. KAPARANCHO",-66.06309,-18.63861,19,7,126,145,19,7,93,112
"Bolivia","Potosí","Chayanta","Pocoata","ESC.PACOTANCA",-66.25257,-18.74593,33,2,97,130,6,0,89,95
"Bolivia","Potosí","Chayanta","Pocoata","ESC. PEDRO GUTIERREZ",-66.1626,-18.69938,484,118,1818,2302,559,146,995,1554
"Bolivia","Potosí","Chayanta","Pocoata","ESC. SAN MIGUEL DE KARI",-66.26031,-18.59378,3,3,385,388,42,14,326,368
"Bolivia","Potosí","Chayanta","Pocoata","ESC. SAYI",-66.22854,-18.75826,4,0,174,178,5,12,157,162
"Bolivia","Potosí","Chayanta","Pocoata","ESC. SECCIONAL SENAJO",-66.14663,-18.49398,16,5,77,93,30,4,38,68
"Bolivia","Potosí","Chayanta","Pocoata","ESC. SECCIONAL TURBERIA",-66.07927,-18.6298,118,18,531,649,47,59,407,454
"Bolivia","Potosí","Chayanta","Pocoata","ESC SECCIONAL YAHUACO",-66.02201,-18.5216,14,5,83,97,13,10,55,68
"Bolivia","Potosí","Chayanta","Pocoata","ESC. TOMOYO",-66.134,-18.463,41,1,187,228,34,5,147,181
"Bolivia","Potosí","Chayanta","Pocoata","ESC. VILA VILA",-66.27483,-18.82087,10,3,323,333,26,6,288,314
"Bolivia","Potosí","Chayanta","Pocoata","NUCLEO ESCOLAR JUAN DE ARROZ PATA",-66.17729,-18.4751,8,5,104,112,25,7,67,92
"Bolivia","Potosí","Chayanta","Pocoata","NUCLEO ESCOLAR KESIMPUCU",-66.05427,-18.56416,13,27,399,412,73,33,266,339
"Bolivia","Potosí","Chayanta","Ravelo","COL. JOSE ALONSO DE IBAÑEZ",-65.60184,-18.87419,28,27,252,280,21,9,195,216
"Bolivia","Potosí","Chayanta","Ravelo","ESC. ANTORA",-65.64693,-18.75318,72,21,278,350,52,30,175,227
"Bolivia","Potosí","Chayanta","Ravelo","ESC. CENTRAL 1º DE MAYO",-65.67611,-18.87961,78,9,235,313,36,19,171,207
"Bolivia","Potosí","Chayanta","Ravelo","ESC. CENTRAL RODEO HUAYLLAS",-65.59853,-18.7994,107,36,358,465,67,14,241,308
"Bolivia","Potosí","Chayanta","Ravelo","ESC. CENTRAL SAUCY MAYU",-65.55036,-18.78822,65,20,359,424,59,17,263,322
"Bolivia","Potosí","Chayanta","Ravelo","ESC. CHALLUMA",-65.54932,-18.85223,9,8,119,128,12,6,93,105
"Bolivia","Potosí","Chayanta","Ravelo","ESC. CHIPIRINA",-65.4499,-18.80882,23,1,101,124,19,10,71,90
"Bolivia","Potosí","Chayanta","Ravelo","ESC. HUAYCOMA",-65.48942,-18.58409,75,23,189,264,34,19,113,147
"Bolivia","Potosí","Chayanta","Ravelo","ESC. LACAYANI",-65.57085,-18.71785,52,30,271,323,37,14,190,227
"Bolivia","Potosí","Chayanta","Ravelo","ESC. LAMPHASUNI",-65.43322,-18.60605,18,1,116,134,7,9,99,106
"Bolivia","Potosí","Chayanta","Ravelo","ESC. M. ASCENCIO PADILLA",-65.50803,-18.80719,378,54,1383,1761,459,96,774,1233
"Bolivia","Potosí","Chayanta","Ravelo","ESC. MOROTO",-65.51731,-18.72289,13,9,77,90,2,4,62,64
"Bolivia","Potosí","Chayanta","Ravelo","ESC. PITANTORA",-65.6319,-18.70022,99,5,266,365,14,20,227,241
"Bolivia","Potosí","Chayanta","Ravelo","ESC. SASANTA",-65.48589,-18.85652,35,3,243,278,52,13,175,227
"Bolivia","Potosí","Chayanta","Ravelo","ESC. SECCIONAL MOKO KOTANI",-65.55286,-18.6043,65,14,132,197,7,5,106,113
"Bolivia","Potosí","Chayanta","Ravelo","ESC. SECCIONAL MOLLE MOLLE",-65.5581,-18.99458,68,52,444,512,55,19,318,373
"Bolivia","Potosí","Chayanta","Ravelo","ESC. SECC. LUQUI PAMPA",-65.71329,-18.71529,44,5,98,142,19,17,57,76
"Bolivia","Potosí","Chayanta","Ravelo","ESC. SECC TEJA MOLINO",-65.56034,-18.51546,71,1,151,222,21,11,118,139
"Bolivia","Potosí","Chayanta","Ravelo","ESC. S. YURUBAMBA",-65.45452,-18.86363,56,20,340,396,71,17,232,303
"Bolivia","Potosí","Chayanta","Ravelo","ESC. TOMOYO",-65.58306,-18.92324,76,38,316,392,50,27,201,251
"Bolivia","Potosí","Chayanta","Ravelo","TOROCA",-65.49248,-18.66342,22,2,146,168,6,7,131,137
"Bolivia","Potosí","Chayanta","Ravelo","U.E. JANINA",-65.67776,-18.77756,20,4,199,219,75,14,106,181
"Bolivia","Potosí","Cornelio Saavedra","Betanzos","CENTRAL ELIZARDO PEREZ",-66.42453,-18.54064,89,16,368,457,74,19,259,333
"Bolivia","Potosí","Cornelio Saavedra","Betanzos","COLEG. R. BOHORQUEZ",-65.44724,-19.55169,334,54,1686,2020,865,95,672,1537
"Bolivia","Potosí","Cornelio Saavedra","Betanzos","ESC. ALONZO DE IBAÑEZ",-65.45937,-19.3632,65,11,395,460,90,12,282,372
"Bolivia","Potosí","Cornelio Saavedra","Betanzos","ESC. ANCO MAYU",-65.26953,-19.413,16,0,70,86,3,1,66,69
"Bolivia","Potosí","Cornelio Saavedra","Betanzos","ESC. BLAS S. DE PEDRO",-65.27425,-19.36944,35,1,110,145,25,9,75,100
"Bolivia","Potosí","Cornelio Saavedra","Betanzos","ESC. BUEY TAMBO",-65.33926,-19.56878,74,7,312,386,93,22,190,283
"Bolivia","Potosí","Cornelio Saavedra","Betanzos","ESC. CAMALI",-65.00764,-19.49642,84,17,443,527,54,15,357,411
"Bolivia","Potosí","Cornelio Saavedra","Betanzos","ESC. CENTRAL OTUYO",-65.23023,-19.48659,82,13,295,377,49,8,225,274
"Bolivia","Potosí","Cornelio Saavedra","Betanzos","ESC. CENTRAL TECOYA",-65.4239,-19.50207,302,112,1167,1469,243,57,755,998
"Bolivia","Potosí","Cornelio Saavedra","Betanzos","ESC. CENTRAL VILA VILA",-65.33044,-19.34779,94,6,376,470,70,37,263,333
"Bolivia","Potosí","Cornelio Saavedra","Betanzos","ESC. DE HUANO HUANO",-64.985,-19.61366,48,10,125,173,27,8,80,107
"Bolivia","Potosí","Cornelio Saavedra","Betanzos","ESC. DE MAMAHOTA",-65.48484,-19.48434,36,12,238,274,27,6,193,220
"Bolivia","Potosí","Cornelio Saavedra","Betanzos","ESC. DE MARIACA",-65.35322,-19.41788,67,12,240,307,19,8,201,220
"Bolivia","Potosí","Cornelio Saavedra","Betanzos","ESC. ELIZARDO PEREZ",-65.3391,-19.44707,38,15,182,220,37,7,123,160
"Bolivia","Potosí","Cornelio Saavedra","Betanzos","ESC. GERMAN BUSH",-65.54766,-19.82024,47,8,340,387,151,26,155,306
"Bolivia","Potosí","Cornelio Saavedra","Betanzos","ESC. MEDIA LUNA",-64.77518,-19.76643,16,0,70,86,4,2,64,68
"Bolivia","Potosí","Cornelio Saavedra","Betanzos","ESC. MODESTO OMISTE",-65.44724,-19.55169,347,41,1391,1738,664,70,616,1280
"Bolivia","Potosí","Cornelio Saavedra","Betanzos","ESC. POCO POCO",-65.01298,-19.36994,139,8,527,666,109,20,390,499
"Bolivia","Potosí","Cornelio Saavedra","Betanzos","ESC. POTOBAMBA",-65.3583,-19.2998,58,0,241,299,21,2,218,239
"Bolivia","Potosí","Cornelio Saavedra","Betanzos","ESC. POTONGO ALTO",-65.24026,-19.39199,9,0,65,74,0,2,63,63
"Bolivia","Potosí","Cornelio Saavedra","Betanzos","ESC. SECCIONAL DE SAN PEDRO DE COLILA",-65.12701,-19.44642,21,1,132,153,8,2,121,129
"Bolivia","Potosí","Cornelio Saavedra","Betanzos","ESC. TARIJA CUCHU",-65.33474,-19.49068,66,17,317,383,67,21,212,279
"Bolivia","Potosí","Cornelio Saavedra","Betanzos","ESC. TAURI CANCHA",-65.31977,-19.59806,203,60,1079,1282,541,55,423,964
"Bolivia","Potosí","Cornelio Saavedra","Betanzos","ESC. TIRISPAYA",-65.40837,-19.27494,45,2,229,274,2,12,213,215
"Bolivia","Potosí","Cornelio Saavedra","Betanzos","ESC. TRAPICHE ALTA",-65.5425,-19.42349,20,1,144,164,66,3,74,140
"Bolivia","Potosí","Cornelio Saavedra","Betanzos","ESC. TROJA PAMPA",-64.96799,-19.44878,21,8,189,210,11,6,164,175
"Bolivia","Potosí","Cornelio Saavedra","Betanzos","ESC. UNZAGA DE LA VEGA",-65.18517,-19.4238,71,7,515,586,128,22,358,486
"Bolivia","Potosí","Cornelio Saavedra","Betanzos","ESC. URIFAYA",-64.92088,-19.48255,4,1,235,239,12,2,220,232
"Bolivia","Potosí","Cornelio Saavedra","Betanzos","ESC. VILLA IMPERIAL",-65.37331,-19.54539,84,49,314,398,56,13,196,252
"Bolivia","Potosí","Cornelio Saavedra","Betanzos","ESC. VIÑA QUEMADA",-64.85901,-19.42301,15,9,102,117,26,6,61,87
"Bolivia","Potosí","Cornelio Saavedra","Betanzos","KINDER VILLA IMPERIAL",-65.44724,-19.55169,162,42,949,1111,381,65,461,842
"Bolivia","Potosí","Cornelio Saavedra","Chaquí","COL. VILLA IMPERIAL",-65.57073,-19.62471,140,30,512,652,232,72,178,410
"Bolivia","Potosí","Cornelio Saavedra","Chaquí","ESC. ANDRES DE SANTA CRUZ",-65.56108,-19.58838,306,52,1152,1458,563,97,440,1003
"Bolivia","Potosí","Cornelio Saavedra","Chaquí","ESC. C. CHIUTALUYO",-65.51266,-19.63994,135,37,351,486,137,63,114,251
"Bolivia","Potosí","Cornelio Saavedra","Chaquí","ESC. CENTRAL EL PALOMAR",-65.41072,-19.65163,57,5,169,226,28,6,130,158
"Bolivia","Potosí","Cornelio Saavedra","Chaquí","ESC. CHARCA FLORIDA",-65.41967,-19.71643,34,1,103,137,26,4,72,98
"Bolivia","Potosí","Cornelio Saavedra","Chaquí","ESC. CHICO CHICO",-65.53385,-19.67762,130,41,320,450,72,23,184,256
"Bolivia","Potosí","Cornelio Saavedra","Chaquí","ESC. DON DIEGO",-65.60049,-19.50195,66,13,469,535,311,29,116,427
"Bolivia","Potosí","Cornelio Saavedra","Chaquí","ESC. RODERO",-65.51254,-19.56043,34,11,166,200,70,14,71,141
"Bolivia","Potosí","Cornelio Saavedra","Chaquí","ESC. SAN ANTONIO",-65.44303,-19.60513,90,13,228,318,95,16,104,199
"Bolivia","Potosí","Cornelio Saavedra","Tacobamba","COL. GUALBERTO VILLARROEL",-65.54424,-19.31846,46,8,213,259,133,17,55,188
"Bolivia","Potosí","Cornelio Saavedra","Tacobamba","ESC. ANCOMA",-65.63528,-19.13348,58,2,258,316,20,0,236,256
"Bolivia","Potosí","Cornelio Saavedra","Tacobamba","ESC. CAJAS ALTA",-65.63494,-19.29129,60,0,163,223,74,14,75,149
"Bolivia","Potosí","Cornelio Saavedra","Tacobamba","ESC. CENTRAL MACHACAMARCA",-65.54421,-19.37108,10,0,55,65,32,4,19,51
"Bolivia","Potosí","Cornelio Saavedra","Tacobamba","ESC. CHALLVIRI",-65.63294,-19.32677,47,5,210,257,116,14,75,191
"Bolivia","Potosí","Cornelio Saavedra","Tacobamba","ESC. C. MIGMA",-65.65115,-19.21268,95,13,197,292,84,16,84,168
"Bolivia","Potosí","Cornelio Saavedra","Tacobamba","ESC. GENOVEVA RIOS",-65.54977,-19.32013,57,16,221,278,90,5,110,200
"Bolivia","Potosí","Cornelio Saavedra","Tacobamba","ESC. HUAJCHI BAJO",-65.58374,-19.20394,38,1,67,105,17,3,46,63
"Bolivia","Potosí","Cornelio Saavedra","Tacobamba","ESC. JURUNA",-65.426,-19.219,50,5,284,334,21,10,248,269
"Bolivia","Potosí","Cornelio Saavedra","Tacobamba","ESC. RODEO",-65.58909,-19.07606,70,2,182,252,16,12,152,168
"Bolivia","Potosí","Cornelio Saavedra","Tacobamba","ESC. SECCIONAL TRAPICHE BAJO",-65.53699,-19.41847,12,1,69,81,26,4,38,64
"Bolivia","Potosí","Cornelio Saavedra","Tacobamba","ESC. SIMON BOLIVAR",-65.54227,-19.34671,22,2,44,66,21,3,18,39
"Bolivia","Potosí","Cornelio Saavedra","Tacobamba","ESC. TACOBAMBA",-65.55141,-19.20102,264,64,550,814,131,32,323,454
"Bolivia","Potosí","Cornelio Saavedra","Tacobamba","ESC. YAGUACARI",-65.60043,-19.04875,20,2,86,106,20,3,61,81
"Bolivia","Potosí","Cornelio Saavedra","Tacobamba","UNID. EDU. FRANZ TAMAYO",-65.44989,-19.16096,37,2,266,303,16,6,242,258
"Bolivia","Potosí","Daniel Campos","Llica","U.E. BERNABE LEDEZMA",-68.29847,-19.99556,13,0,66,79,8,1,57,65
"Bolivia","Potosí","Daniel Campos","Llica","U.E. CANQUELLA",-68.2532,-20.08167,14,0,65,79,19,0,46,65
"Bolivia","Potosí","Daniel Campos","Llica","U.E. ELIZARDO PEREZ",-68.10056,-19.62237,4,1,54,58,6,2,45,51
"Bolivia","Potosí","Daniel Campos","Llica","U.E. FRANZ TAMAYO",-68.2407,-19.86069,240,14,1053,1293,326,24,689,1015
"Bolivia","Potosí","Daniel Campos","Llica","U.E. HUANAQUE",-68.33338,-20.01662,24,4,89,113,13,0,72,85
"Bolivia","Potosí","Daniel Campos","Llica","U.E. MANUAL ANTONIO AGUIRRE",-68.30267,-20.11507,23,1,70,93,10,1,58,68
"Bolivia","Potosí","Daniel Campos","Llica","U.E. PALAYA",-68.13572,-19.80343,15,3,95,110,16,1,75,91
"Bolivia","Potosí","Daniel Campos","Llica","U.E. PEDRO GARCIA IGNACIO",-68.48859,-19.71477,16,3,62,78,19,0,40,59
"Bolivia","Potosí","Daniel Campos","Llica","U.E. VILLQUE",-68.10628,-19.66033,3,1,33,36,4,0,28,32
"Bolivia","Potosí","Daniel Campos","Tahua","ESC. JARUMA",-67.945,-19.77135,9,0,24,33,1,0,23,24
"Bolivia","Potosí","Daniel Campos","Tahua","ESC. TAMANCASA",-68.00201,-19.72284,5,0,27,32,5,2,20,25
"Bolivia","Potosí","Daniel Campos","Tahua","U.E. ANICETO ARCE",-67.9101,-19.7663,2,0,20,22,3,0,17,20
"Bolivia","Potosí","Daniel Campos","Tahua","U.E. BERNABE LEDEZMA",-67.80781,-19.82589,7,4,60,67,6,0,50,56
"Bolivia","Potosí","Daniel Campos","Tahua","U.E. CAQUENA",-67.76733,-19.84044,17,1,78,95,34,3,40,74
"Bolivia","Potosí","Daniel Campos","Tahua","U.E. FRANZ TAMAYO",-68.02673,-20.63319,1,2,120,121,37,1,80,117
"Bolivia","Potosí","Daniel Campos","Tahua","U.E. GERMAN BUSCH",-67.66147,-19.91329,4,0,35,39,10,1,24,34
"Bolivia","Potosí","Daniel Campos","Tahua","U.E. JOHN F. KENNEDY",-67.69619,-19.891,30,5,178,208,35,5,133,168
"Bolivia","Potosí","Enrique Baldivieso","San Agustín","ESC. SAN AGUSTIN",-67.6795,-21.1566,67,6,223,290,70,6,141,211
"Bolivia","Potosí","Enrique Baldivieso","San Agustín","ESC. VICTOR PAZ ESTENSORO",-67.35812,-21.51948,10,0,132,142,40,3,89,129
"Bolivia","Potosí","Enrique Baldivieso","San Agustín","U.E. 1RO DE MAYO",-67.23789,-21.70214,4,0,89,93,8,0,81,89
"Bolivia","Potosí","Enrique Baldivieso","San Agustín","U.E. ELIZARDO PEREZ",-67.18568,-21.72287,10,1,78,88,15,1,61,76
"Bolivia","Potosí","Enrique Baldivieso","San Agustín","U.E. LITORAL",-67.59641,-21.40281,36,4,223,259,109,5,105,214
"Bolivia","Potosí","General Bernardino B","Acacio","ESC. CHURITACA",-65.98965,-18.1063,78,7,417,495,12,9,389,401
"Bolivia","Potosí","General Bernardino B","Acacio","ESC. JOSE RIVERO",-66.05407,-18.02672,206,21,746,952,223,27,475,698
"Bolivia","Potosí","General Bernardino B","Acacio","ESC. PIRIQUINA",-66.01617,-18.0789,49,9,233,282,15,4,205,220
"Bolivia","Potosí","General Bernardino B","Acacio","ESC. TACONI DE CAINE",-66.00538,-17.94402,14,2,81,95,9,0,70,79
"Bolivia","Potosí","General Bernardino B","Acacio","ESC. TACONI YAMBATA",-65.94917,-18.04741,72,5,165,237,1,2,157,158
"Bolivia","Potosí","General Bernardino B","Acacio","ESC. TUQUIZA",-66.00704,-18.02213,41,11,208,249,15,5,177,192
"Bolivia","Potosí","General Bernardino B","Arampampa","ESC. ARAMPAMPA",-66.08163,-17.87692,50,14,225,275,54,27,130,184
"Bolivia","Potosí","General Bernardino B","Arampampa","ESC. CALACHUA",-66.12383,-17.98363,17,0,121,138,2,2,117,119
"Bolivia","Potosí","General Bernardino B","Arampampa","ESC. CATACORA",-66.15216,-17.94774,43,1,94,137,5,0,88,93
"Bolivia","Potosí","General Bernardino B","Arampampa","ESC. CHARCA MARCAVI",-66.04567,-17.92901,7,0,51,58,0,2,49,49
"Bolivia","Potosí","General Bernardino B","Arampampa","ESC. HUAYCURI",-66.10529,-17.85553,7,0,28,35,3,0,25,28
"Bolivia","Potosí","General Bernardino B","Arampampa","ESC. HUMAVIZA",-66.03617,-17.88659,4,1,16,20,4,2,9,13
"Bolivia","Potosí","General Bernardino B","Arampampa","ESC. MOLLEVILQUE",-66.10755,-17.84728,7,0,42,49,3,1,38,41
"Bolivia","Potosí","General Bernardino B","Arampampa","ESC. PARARANI",-66.105,-17.919,8,0,58,66,0,0,58,58
"Bolivia","Potosí","General Bernardino B","Arampampa","ESC. QOARACA",-66.17999,-18.0151,1,0,95,96,2,3,90,92
"Bolivia","Potosí","General Bernardino B","Arampampa","ESC. SANTIAGO",-66.19445,-17.99237,88,5,366,454,23,8,330,353
"Bolivia","Potosí","General Bernardino B","Arampampa","ESC. SARCURI",-66.08449,-17.94726,37,2,201,238,0,1,198,198
"Bolivia","Potosí","José María Linares","Caiza","COL. FRANZ TAMAYO",-65.69497,-19.88101,64,17,502,566,318,23,144,462
"Bolivia","Potosí","José María Linares","Caiza","ESC.DE KALTAPI",-65.55387,-20.01271,20,2,123,143,60,3,58,118
"Bolivia","Potosí","José María Linares","Caiza","ESC.DE PANOCOCHI",-65.6757,-20.1773,47,3,145,192,15,9,118,133
"Bolivia","Potosí","José María Linares","Caiza","ESC.HORNOS",-65.48529,-19.90132,92,5,253,345,67,14,167,234
"Bolivia","Potosí","José María Linares","Caiza","ESC. LA FRAGUA",-65.61447,-20.2052,29,4,154,183,18,9,123,141
"Bolivia","Potosí","José María Linares","Caiza","ESC.LA LAVA",-65.64637,-19.8947,79,15,372,451,134,21,202,336
"Bolivia","Potosí","José María Linares","Caiza","ESC. PALCA CANCHA",-65.56768,-19.94123,31,0,74,105,29,2,43,72
"Bolivia","Potosí","José María Linares","Caiza","ESC. SECCIONAL CHILLMA",-65.72665,-19.93593,58,15,309,367,156,23,115,271
"Bolivia","Potosí","José María Linares","Caiza","ESC. TRES CRUCES",-65.5471,-19.87114,253,40,801,1054,299,44,418,717
"Bolivia","Potosí","José María Linares","Caiza","ESC.TUCTAPARI",-65.53459,-20.04247,34,10,210,244,116,10,74,190
"Bolivia","Potosí","José María Linares","Caiza","NORMAL RURAL CAIZA D",-65.65247,-20.00772,212,28,953,1165,475,31,419,894
"Bolivia","Potosí","José María Linares","Ckochas","ESC. ALEJANDRO CORONADO",-65.14595,-19.67983,21,0,167,188,43,19,105,148
"Bolivia","Potosí","José María Linares","Ckochas","ESC. CENTRAL EUSEBIO B. FLORES",-64.83906,-19.61541,47,18,238,285,32,9,179,211
"Bolivia","Potosí","José María Linares","Ckochas","ESC.CKOCHAS",-65.2905,-19.63276,152,26,698,850,265,39,368,633
"Bolivia","Potosí","José María Linares","Ckochas","ESC.DE CALAPAYA",-65.206,-19.756,74,22,182,256,54,6,100,154
"Bolivia","Potosí","José María Linares","Ckochas","ESC.DE MELENA ALTA",-65.14054,-19.64427,37,4,221,258,55,7,155,210
"Bolivia","Potosí","José María Linares","Ckochas","ESC.DE MOJON CKASA",-64.9791,-19.75853,115,7,349,464,60,11,271,331
"Bolivia","Potosí","José María Linares","Ckochas","ESC.DE QUELUYO",-65.1904,-19.8398,128,8,297,425,61,24,204,265
"Bolivia","Potosí","José María Linares","Ckochas","ESC.DURAZNOS",-64.98342,-19.66648,56,4,240,296,54,12,170,224
"Bolivia","Potosí","José María Linares","Ckochas","ESC.ESQUIRI",-65.219,-19.64303,15,1,72,87,37,4,30,67
"Bolivia","Potosí","José María Linares","Ckochas","ESC.JOSE MA.LINARES",-64.94132,-19.81973,46,2,140,186,41,7,90,131
"Bolivia","Potosí","José María Linares","Ckochas","ESC. LAJAS",-64.91263,-19.58851,16,0,152,168,2,0,150,152
"Bolivia","Potosí","José María Linares","Ckochas","ESC. MEDIA LUNA",-64.77805,-19.76315,20,4,255,275,7,4,240,247
"Bolivia","Potosí","José María Linares","Ckochas","ESC. RODEO PAMPA",-64.81729,-19.81045,1,1,75,76,5,0,69,74
"Bolivia","Potosí","José María Linares","Ckochas","ESC. SAN PEDRO DE ESQUIRI",-65.19585,-19.5817,14,1,63,77,22,0,40,62
"Bolivia","Potosí","José María Linares","Ckochas","ESC.SECCIONAL",-64.83231,-19.83634,215,9,538,753,29,19,481,510
"Bolivia","Potosí","José María Linares","Ckochas","ESC. SECCIONAL CAPILLANI",-65.16954,-19.93791,35,3,104,139,33,7,61,94
"Bolivia","Potosí","José María Linares","Ckochas","ESC. SECCIONAL HUAYLLAJARA",-64.92155,-19.6202,35,3,141,176,21,3,114,135
"Bolivia","Potosí","José María Linares","Ckochas","ESC. SECCIONAL UYUNI",-65.12721,-19.85135,58,2,132,190,25,3,102,127
"Bolivia","Potosí","José María Linares","Ckochas","ESC. SEUCOCHI",-64.86348,-19.90878,111,13,339,450,32,14,280,312
"Bolivia","Potosí","José María Linares","Ckochas","ESC. SUCHINA",-65.24477,-19.72506,29,1,83,112,15,2,65,80
"Bolivia","Potosí","José María Linares","Ckochas","SECC. CARPA HUATA",-65.086,-19.586,19,1,59,78,12,2,44,56
"Bolivia","Potosí","José María Linares","Puna (Villa Talavera)","COLEG.LITORAL",-65.50571,-19.79494,223,50,819,1042,396,55,318,714
"Bolivia","Potosí","José María Linares","Puna (Villa Talavera)","ESC.BELEN",-65.54243,-19.86561,88,26,307,395,118,19,144,262
"Bolivia","Potosí","José María Linares","Puna (Villa Talavera)","ESC.CENTRAL",-65.52189,-19.49838,49,2,195,244,84,14,95,179
"Bolivia","Potosí","José María Linares","Puna (Villa Talavera)","ESC. CENTRAL JOSE MARIA LINARES",-65.30202,-19.6668,43,4,340,383,119,13,204,323
"Bolivia","Potosí","José María Linares","Puna (Villa Talavera)","ESC.DE ALCATUYO",-65.564,-19.86951,106,7,324,430,180,15,122,302
"Bolivia","Potosí","José María Linares","Puna (Villa Talavera)","ESC.DE HUAYCAYA",-65.61684,-19.8672,52,9,193,245,127,3,54,181
"Bolivia","Potosí","José María Linares","Puna (Villa Talavera)","ESC.DE KEPALLO",-65.31073,-19.90731,172,8,418,590,127,14,269,396
"Bolivia","Potosí","José María Linares","Puna (Villa Talavera)","ESC.DE LA ESMERALDA",-65.30669,-19.68868,77,30,307,384,125,13,139,264
"Bolivia","Potosí","José María Linares","Puna (Villa Talavera)","ESC.DE NUQUI",-65.30702,-19.97297,87,3,221,308,77,5,136,213
"Bolivia","Potosí","José María Linares","Puna (Villa Talavera)","ESC.DE SUQUICHA",-65.28864,-19.82753,117,7,266,383,111,16,132,243
"Bolivia","Potosí","José María Linares","Puna (Villa Talavera)","ESC. G.MALDINI CHACABUCO",-65.34591,-19.65162,49,6,301,350,124,16,155,279
"Bolivia","Potosí","José María Linares","Puna (Villa Talavera)","ESC.INCHASI",-65.47024,-19.7256,31,5,68,99,17,8,38,55
"Bolivia","Potosí","José María Linares","Puna (Villa Talavera)","ESC.JOSE MA. LINARES",-65.37317,-19.75613,123,4,315,438,89,16,206,295
"Bolivia","Potosí","José María Linares","Puna (Villa Talavera)","ESC.JOSE MARIA LINARES",-65.50571,-19.79494,195,53,871,1066,435,71,312,747
"Bolivia","Potosí","José María Linares","Puna (Villa Talavera)","ESC.MARAZA",-65.35992,-19.68579,43,22,174,217,60,7,85,145
"Bolivia","Potosí","José María Linares","Puna (Villa Talavera)","ESC. MOJONA",-65.33739,-20.07207,72,7,233,305,44,8,174,218
"Bolivia","Potosí","José María Linares","Puna (Villa Talavera)","ESC. SAN LORENZO",-65.32391,-19.80195,78,24,202,280,77,10,91,168
"Bolivia","Potosí","José María Linares","Puna (Villa Talavera)","ESC. SECCIONAL PAMPA TAMBO",-65.35207,-19.97996,54,4,125,179,43,5,73,116
"Bolivia","Potosí","José María Linares","Puna (Villa Talavera)","ESC.SEPULTURAS",-65.59354,-19.86297,82,25,300,382,118,18,139,257
"Bolivia","Potosí","José María Linares","Puna (Villa Talavera)","ESC.SIMON BOLIVAR",-65.33378,-20.05038,213,15,568,781,153,19,381,534
"Bolivia","Potosí","José María Linares","Puna (Villa Talavera)","ESC. TOMAS FRIAS",-65.51495,-19.7167,189,42,458,647,89,41,286,375
"Bolivia","Potosí","José María Linares","Puna (Villa Talavera)","ESC. TURQUIÑA",-65.26543,-19.7833,55,11,113,168,57,5,40,97
"Bolivia","Potosí","José María Linares","Puna (Villa Talavera)","ESC.VILACAYA",-65.48064,-19.99248,108,5,285,393,122,22,136,258
"Bolivia","Potosí","José María Linares","Puna (Villa Talavera)","ESC.YASPACI",-65.44774,-19.89478,66,2,174,240,59,6,107,166
"Bolivia","Potosí","José María Linares","Puna (Villa Talavera)","UNID. VILAMANI",-65.40481,-19.95643,38,4,142,180,40,6,92,132
"Bolivia","Potosí","Modesto Omiste","Villazón","COLEG. FRANZ TAMAYO",-65.81631,-21.80585,64,5,226,290,43,6,172,215
"Bolivia","Potosí","Modesto Omiste","Villazón","COLEGIO 9 DE ABRIL",-65.59546,-22.09029,712,61,2350,3062,1008,98,1183,2191
"Bolivia","Potosí","Modesto Omiste","Villazón","COL MARISCAL ANDRES DE SANTA CRUZ",-65.48156,-21.95128,17,5,130,147,28,5,92,120
"Bolivia","Potosí","Modesto Omiste","Villazón","COL.MODESTO OMISTE",-65.5955,-22.09031,587,24,1715,2302,859,63,769,1628
"Bolivia","Potosí","Modesto Omiste","Villazón","ESC. BERQUE",-65.78044,-21.94482,56,5,155,211,11,9,130,141
"Bolivia","Potosí","Modesto Omiste","Villazón","ESC. CORNELIO SAAVEDRA",-65.59546,-22.09029,818,44,2770,3588,1274,117,1335,2609
"Bolivia","Potosí","Modesto Omiste","Villazón","ESC. DANIEL CAMPOS",-65.59546,-22.09029,611,77,2640,3251,841,173,1549,2390
"Bolivia","Potosí","Modesto Omiste","Villazón","ESC. LIZARDO PEREZ",-65.51073,-21.91479,32,9,178,210,46,10,113,159
"Bolivia","Potosí","Modesto Omiste","Villazón","ESC. MAX FERNANDEZ",-65.59546,-22.09029,543,53,1897,2440,690,118,1036,1726
"Bolivia","Potosí","Modesto Omiste","Villazón","ESC. MORAYA",-65.54895,-21.74982,37,2,146,183,23,9,112,135
"Bolivia","Potosí","Modesto Omiste","Villazón","ESC. SALITRE",-65.34576,-22.02467,33,1,136,169,22,15,98,120
"Bolivia","Potosí","Modesto Omiste","Villazón","ESC. SAN PEDRO DE SOCOCHA",-65.45055,-21.93332,66,2,168,234,21,5,140,161
"Bolivia","Potosí","Modesto Omiste","Villazón","ESC. SARCARI",-66.02132,-21.91025,37,3,70,107,11,3,53,64
"Bolivia","Potosí","Modesto Omiste","Villazón","ESC. SARGENTO M. PAREDES",-65.87511,-21.95138,56,1,187,243,16,4,166,182
"Bolivia","Potosí","Modesto Omiste","Villazón","ESC. SECCIONAL CHAGUA",-65.80781,-21.88188,71,1,191,262,34,9,147,181
"Bolivia","Potosí","Modesto Omiste","Villazón","ESC. SECCIONAL SELOCHA",-65.48174,-21.80499,30,2,96,126,8,2,84,92
"Bolivia","Potosí","Modesto Omiste","Villazón","ESC. SECCIONAL SOCOCHA",-65.48177,-22.00244,93,14,166,259,19,10,123,142
"Bolivia","Potosí","Modesto Omiste","Villazón","ESC. YURUMA",-65.57485,-21.69375,38,2,209,247,62,10,135,197
"Bolivia","Potosí","Modesto Omiste","Villazón","NUCLEO DE MOJO",-65.55168,-21.83154,40,2,153,193,38,8,105,143
"Bolivia","Potosí","Modesto Omiste","Villazón","U.E. CALDERILLA",-65.58203,-21.71236,0,2,74,74,6,1,65,71
"Bolivia","Potosí","Modesto Omiste","Villazón","U.E.CUARTOS",-65.56418,-21.99242,1,0,27,28,6,1,20,26
"Bolivia","Potosí","Modesto Omiste","Villazón","U.E. MANTACILLAS",-65.59058,-22.06434,10,16,249,259,67,19,147,214
"Bolivia","Potosí","Modesto Omiste","Villazón","U.E. MONSEÑOR FELIX GAINZA",-65.56264,-21.73403,4,0,81,85,15,4,62,77
"Bolivia","Potosí","Modesto Omiste","Villazón","U.E. OJO DE AGUA",-65.61392,-22.08941,0,2,53,53,5,2,44,49
"Bolivia","Potosí","Modesto Omiste","Villazón","UN. ED. 1RO DE MAYO",-65.59546,-22.09029,999,107,4246,5245,1384,208,2547,3931
"Bolivia","Potosí","Modesto Omiste","Villazón","UN. ED. ALONSO DE IBAÑEZ",-65.59546,-22.09029,1085,73,2868,3953,950,184,1661,2611
"Bolivia","Potosí","Nor Chichas","Cotagaita","COLEG. CARLOS MEDINACELI",-65.66064,-20.8168,230,38,1159,1389,468,41,612,1080
"Bolivia","Potosí","Nor Chichas","Cotagaita","U.E. 2 DE ABRIL",-65.61977,-20.49149,31,4,145,176,50,2,89,139
"Bolivia","Potosí","Nor Chichas","Cotagaita","U.E. 6 DE JUNIO",-65.55482,-20.86805,27,2,236,263,30,5,199,229
"Bolivia","Potosí","Nor Chichas","Cotagaita","U.E. ASCANTY",-65.69196,-20.93444,24,11,234,258,19,4,200,219
"Bolivia","Potosí","Nor Chichas","Cotagaita","U.E. CARLOS MEDINACELI DE TASNA ROSARIO",-66.17947,-20.67462,182,16,841,1023,236,44,545,781
"Bolivia","Potosí","Nor Chichas","Cotagaita","U.E. CERRO COLORADO",-65.41893,-20.59675,9,0,49,58,2,0,47,49
"Bolivia","Potosí","Nor Chichas","Cotagaita","U.E. CHATI",-65.63601,-20.4317,39,1,123,162,27,10,85,112
"Bolivia","Potosí","Nor Chichas","Cotagaita","U.E. CHUI CHUI",-65.4746,-20.73512,29,0,59,88,3,2,54,57
"Bolivia","Potosí","Nor Chichas","Cotagaita","U.E. COLLPA UNO",-65.56855,-20.92512,22,3,231,253,65,1,162,227
"Bolivia","Potosí","Nor Chichas","Cotagaita","U.E. CORNACA",-65.57293,-21.06026,33,1,192,225,39,4,148,187
"Bolivia","Potosí","Nor Chichas","Cotagaita","U.E. COTAGAITILLA",-65.76016,-20.80183,49,7,252,301,34,15,196,230
"Bolivia","Potosí","Nor Chichas","Cotagaita","U.E. ELIZARDO PEREZ DE SAN JORGE",-65.72311,-20.26165,39,1,74,113,7,7,59,66
"Bolivia","Potosí","Nor Chichas","Cotagaita","U.E. EL MANZANAL",-65.5703,-21.10514,15,4,75,90,12,1,58,70
"Bolivia","Potosí","Nor Chichas","Cotagaita","U.E. EL PORVENIR A DE TOTORA I",-65.7318,-20.95282,194,22,614,808,148,18,426,574
"Bolivia","Potosí","Nor Chichas","Cotagaita","U.E. EL RANCHO",-65.43662,-20.66881,10,1,66,76,9,0,56,65
"Bolivia","Potosí","Nor Chichas","Cotagaita","U.E. JOSE ALONZO DE IBAÑEZ",-66.20502,-20.73754,63,6,354,417,117,19,212,329
"Bolivia","Potosí","Nor Chichas","Cotagaita","U.E. LAYTAPI",-65.61054,-20.99541,5,4,140,145,6,3,127,133
"Bolivia","Potosí","Nor Chichas","Cotagaita","U.E. MANUEL JOSE CORTEZ",-65.66064,-20.8168,220,21,1009,1229,404,45,539,943
"Bolivia","Potosí","Nor Chichas","Cotagaita","U.E. MARISCAL SUCRE",-65.69301,-20.41956,147,10,324,471,71,4,239,310
"Bolivia","Potosí","Nor Chichas","Cotagaita","U.E. MARTIN PRIMERO DE URUPALCA",-65.85529,-20.18545,47,0,84,131,27,1,56,83
"Bolivia","Potosí","Nor Chichas","Cotagaita","U.E. MOCKO PATA",-65.833,-20.729,15,0,169,184,10,5,154,164
"Bolivia","Potosí","Nor Chichas","Cotagaita","U.E. PAMPA GRANDE I",-65.39799,-20.70718,20,2,108,128,17,0,89,106
"Bolivia","Potosí","Nor Chichas","Cotagaita","U.E. PEDRO DOMINGO MURILLO DE SAGRARIO",-66.01643,-20.90559,53,8,326,379,65,14,239,304
"Bolivia","Potosí","Nor Chichas","Cotagaita","U.E. QUECHISLA",-66.11058,-20.87414,13,1,33,46,7,2,23,30
"Bolivia","Potosí","Nor Chichas","Cotagaita","U.E. RAMADAS",-65.63293,-21.08755,21,11,147,168,30,1,105,135
"Bolivia","Potosí","Nor Chichas","Cotagaita","U.E. SAN LORENZO",-65.40493,-20.75586,20,0,83,103,6,0,77,83
"Bolivia","Potosí","Nor Chichas","Cotagaita","U.E. SAN PEDRO DE CHECOCHI",-65.83663,-20.22395,43,1,102,145,31,4,66,97
"Bolivia","Potosí","Nor Chichas","Cotagaita","U.E. SANTIAGO WRIGHT",-65.70607,-20.62816,64,10,359,423,65,29,255,320
"Bolivia","Potosí","Nor Chichas","Cotagaita","U.E. SIMON BOLIVAR A DE TOROPALCA",-65.728,-20.329,228,28,555,783,119,16,392,511
"Bolivia","Potosí","Nor Chichas","Cotagaita","U.E. TAPCHIQUIRA",-65.79283,-20.41512,27,2,98,125,15,7,74,89
"Bolivia","Potosí","Nor Chichas","Cotagaita","U.E. TUPAC KATARI",-65.67236,-20.91708,87,6,194,281,20,3,165,185
"Bolivia","Potosí","Nor Chichas","Cotagaita","U.E. VILLA CONCEPCION",-65.567,-20.968,64,0,119,183,5,2,112,117
"Bolivia","Potosí","Nor Chichas","Cotagaita","U.E. VILLA IMPERIAL DE VICHACLA",-65.59898,-20.63377,40,9,208,248,34,15,150,184
"Bolivia","Potosí","Nor Chichas","Cotagaita","U.E. VILLA SAN LORENZO",-65.81915,-21.01485,46,1,195,241,8,2,184,192
"Bolivia","Potosí","Nor Chichas","Vitichi","U.E. ARA",-65.49908,-20.52345,84,10,223,307,70,10,133,203
"Bolivia","Potosí","Nor Chichas","Vitichi","U.E. AYOMA BAJA",-65.34461,-20.14421,65,7,180,245,17,4,152,169
"Bolivia","Potosí","Nor Chichas","Vitichi","U.E. CALCHA",-65.4649,-20.36904,180,45,415,595,119,25,226,345
"Bolivia","Potosí","Nor Chichas","Vitichi","U.E. ESTUMILLA",-65.40064,-20.5226,29,3,158,187,23,3,129,152
"Bolivia","Potosí","Nor Chichas","Vitichi","U.E. FRAY ANGELLO STELLINI DE CALVI",-65.35645,-20.34421,105,19,278,383,34,6,219,253
"Bolivia","Potosí","Nor Chichas","Vitichi","U.E. JUAN PELLEGRINI",-65.38126,-20.24069,177,38,508,685,86,7,377,463
"Bolivia","Potosí","Nor Chichas","Vitichi","U.E. MANUEL MORA DE PECKAJSI",-65.388,-20.354,85,0,256,341,20,11,225,245
"Bolivia","Potosí","Nor Chichas","Vitichi","U.E. PRIMO MARTINEZ",-65.49222,-20.55351,19,2,117,136,52,3,60,112
"Bolivia","Potosí","Nor Chichas","Vitichi","U.E. PULAXI",-65.51803,-20.55417,14,2,32,46,13,2,15,28
"Bolivia","Potosí","Nor Chichas","Vitichi","U.E. SAN MIGUEL DE TUSQUIÑA",-65.32579,-20.28519,72,9,483,555,95,7,372,467
"Bolivia","Potosí","Nor Chichas","Vitichi","U.E. TOMAS FRIAS",-65.49218,-20.20666,343,60,904,1247,348,34,462,810
"Bolivia","Potosí","Nor Lípez","Colcha K (Villa Martín)","ESC. ANTOFAGASTA",-67.76271,-20.89953,44,6,213,257,108,5,94,202
"Bolivia","Potosí","Nor Lípez","Colcha K (Villa Martín)","ESC. SANTIAGO",-67.1608,-21.64687,27,6,121,148,64,8,43,107
"Bolivia","Potosí","Nor Lípez","Colcha K (Villa Martín)","ESC. TOMAS FRIAS",-67.68085,-20.58681,3,0,93,96,40,0,53,93
"Bolivia","Potosí","Nor Lípez","Colcha K (Villa Martín)","U.E. 2 DE AGOSTO",-67.9187,-21.21596,27,6,195,222,84,7,98,182
"Bolivia","Potosí","Nor Lípez","Colcha K (Villa Martín)","U.E. ALFONZO IBAÑES",-67.70047,-20.62012,10,0,56,66,13,1,42,55
"Bolivia","Potosí","Nor Lípez","Colcha K (Villa Martín)","U.E. ANTOFAGASTA",-67.34248,-21.83394,35,2,241,276,107,5,127,234
"Bolivia","Potosí","Nor Lípez","Colcha K (Villa Martín)","U.E. BUENAS NUEVAS DE VINTO K",-67.02643,-20.68222,24,5,218,242,62,5,146,208
"Bolivia","Potosí","Nor Lípez","Colcha K (Villa Martín)","U.E. EDUARDO ABAROA",-67.66145,-20.73985,271,10,797,1068,329,25,433,762
"Bolivia","Potosí","Nor Lípez","Colcha K (Villa Martín)","U.E. EDUARDO ABAROA",-67.22194,-21.25105,271,10,797,1068,329,25,433,762
"Bolivia","Potosí","Nor Lípez","Colcha K (Villa Martín)","U.E. EDUARDO ABAROA DE VILLA MAR",-67.48146,-21.75496,42,12,182,224,64,4,102,166
"Bolivia","Potosí","Nor Lípez","Colcha K (Villa Martín)","U.E. HENRY LAREDO",-67.56828,-20.91416,11,0,38,49,17,0,21,38
"Bolivia","Potosí","Nor Lípez","Colcha K (Villa Martín)","U.E. JOSE BALLIVIAN",-66.3466,-18.14842,20,2,213,233,59,1,151,210
"Bolivia","Potosí","Nor Lípez","Colcha K (Villa Martín)","U.E. JUANA AZURDUY",-67.6095,-20.59178,2,3,33,35,15,1,14,29
"Bolivia","Potosí","Nor Lípez","Colcha K (Villa Martín)","U.E. LADISLAO CABRERA",-66.54451,-21.06077,30,2,122,152,25,8,87,112
"Bolivia","Potosí","Nor Lípez","Colcha K (Villa Martín)","U.E. LITORAL",-67.53351,-21.04118,38,0,96,134,33,2,61,94
"Bolivia","Potosí","Nor Lípez","Colcha K (Villa Martín)","U.E. LUIS ESPINAL",-67.63012,-20.57336,0,0,57,57,7,1,49,56
"Bolivia","Potosí","Nor Lípez","Colcha K (Villa Martín)","U.E. NUEVO AMANECER",-67.29654,-20.82078,88,6,354,442,141,6,201,342
"Bolivia","Potosí","Nor Lípez","Colcha K (Villa Martín)","U.E. RICARDO RODRIGUEZ",-67.17109,-21.16474,223,23,1485,1708,468,50,944,1412
"Bolivia","Potosí","Nor Lípez","Colcha K (Villa Martín)","U.E. SIMON BOLIVAR",-66.56165,-21.23029,50,4,208,258,58,13,133,191
"Bolivia","Potosí","Nor Lípez","Colcha K (Villa Martín)","U.E. TOMAS FRIAS",-66.79474,-21.20591,36,2,196,232,55,10,129,184
"Bolivia","Potosí","Nor Lípez","San Pedro de Quemes","U.E. CECILIO VELIZ",-68.04866,-20.74629,55,2,227,282,93,1,131,224
"Bolivia","Potosí","Nor Lípez","San Pedro de Quemes","U.E. CORNELIO SAAVEDRA",-68.03695,-20.94468,20,1,42,62,8,0,33,41
"Bolivia","Potosí","Nor Lípez","San Pedro de Quemes","U.E. EDUARDO ABAROA",-68.21673,-21.19829,1,0,12,13,3,0,9,12
"Bolivia","Potosí","Nor Lípez","San Pedro de Quemes","U.E.LADISLAO CABRERA",-68.34213,-21.01003,5,0,25,30,20,0,5,25
"Bolivia","Potosí","Rafael Bustillo","Chayanta","ESC. COCAFAYA",-66.37881,-18.50657,34,5,344,378,62,10,267,329
"Bolivia","Potosí","Rafael Bustillo","Chayanta","ESC. COPANA",-66.35302,-18.23664,16,27,352,368,34,13,278,312
"Bolivia","Potosí","Rafael Bustillo","Chayanta","ESC. MANCO CAPAC",-66.30493,-18.52878,23,22,329,352,40,9,258,298
"Bolivia","Potosí","Rafael Bustillo","Chayanta","ESC. MCAL. SANTA CRUZ",-66.44352,-18.46028,263,67,1688,1951,664,77,880,1544
"Bolivia","Potosí","Rafael Bustillo","Chayanta","ESC. OCTAVIO MURILLO",-66.38741,-18.48727,53,36,750,803,282,36,396,678
"Bolivia","Potosí","Rafael Bustillo","Chayanta","ESC. PHUSUTA PAMPA",-66.23933,-18.47786,13,7,120,133,13,11,89,102
"Bolivia","Potosí","Rafael Bustillo","Chayanta","ESC. PICHATA",-66.39987,-18.40766,30,0,284,314,24,7,253,277
"Bolivia","Potosí","Rafael Bustillo","Chayanta","ESC. QUINTA PAMPA",-66.32737,-18.23514,55,8,327,382,15,13,291,306
"Bolivia","Potosí","Rafael Bustillo","Chayanta","ESC. RAFAEL PABON",-66.46142,-18.44868,68,20,486,554,169,34,263,432
"Bolivia","Potosí","Rafael Bustillo","Chayanta","NUCLEO ESCOLAR",-66.28407,-18.42465,61,28,231,292,92,14,97,189
"Bolivia","Potosí","Rafael Bustillo","Chayanta","NUCLEO ESCOLAR IRUPATA",-66.37756,-18.29441,166,66,924,1090,117,43,698,815
"Bolivia","Potosí","Rafael Bustillo","Chayanta","NUCLEO ESCOLAR NUEVA COLCHA",-66.26283,-18.54489,43,0,277,320,13,12,252,265
"Bolivia","Potosí","Rafael Bustillo","Chayanta","NUCLEO ESCOLAR RIO VERDE (QUILA QUILA)",-66.30909,-18.37211,19,8,187,206,70,4,105,175
"Bolivia","Potosí","Rafael Bustillo","Chuquihuta","COL. PABLO ZARATE VILLCA",-66.36883,-18.59564,286,101,1568,1854,526,127,814,1340
"Bolivia","Potosí","Rafael Bustillo","Chuquihuta","ESC. LULUNI",-66.41494,-18.66807,41,59,284,325,40,17,168,208
"Bolivia","Potosí","Rafael Bustillo","Chuquihuta","ESC. TACOPALCA",-66.33701,-18.641,222,52,923,1145,240,103,528,768
"Bolivia","Potosí","Rafael Bustillo","Llallagua","COLEG. 1RO. DE MAYO",-66.58627,-18.42284,553,104,3722,4275,1973,182,1463,3436
"Bolivia","Potosí","Rafael Bustillo","Llallagua","COLEG. JUNIN",-66.58627,-18.42284,342,69,2250,2592,986,166,1029,2015
"Bolivia","Potosí","Rafael Bustillo","Llallagua","COLEG. SIGLO XX-AMERICA",-66.58627,-18.42284,562,67,3368,3930,1690,164,1447,3137
"Bolivia","Potosí","Rafael Bustillo","Llallagua","ESC. 6 DE JUNIO",-66.58627,-18.42284,227,47,1161,1388,537,83,494,1031
"Bolivia","Potosí","Rafael Bustillo","Llallagua","ESC. BARTOLINA SISA",-66.66508,-18.34604,50,34,503,553,130,37,302,432
"Bolivia","Potosí","Rafael Bustillo","Llallagua","ESC. CAPUNITA",-66.48626,-18.40959,47,6,279,326,67,16,190,257
"Bolivia","Potosí","Rafael Bustillo","Llallagua","ESC. CARLOS MEDINACELI",-66.58627,-18.42284,279,53,2121,2400,1133,106,829,1962
"Bolivia","Potosí","Rafael Bustillo","Llallagua","ESC. CHIRU CHIRU",-66.43234,-18.28475,14,3,207,221,21,9,174,195
"Bolivia","Potosí","Rafael Bustillo","Llallagua","ESC. JAIME MENDOZA",-66.58627,-18.42284,401,65,3191,3592,1809,148,1169,2978
"Bolivia","Potosí","Rafael Bustillo","Llallagua","ESC. UYUNI",-66.82401,-20.45792,24,0,318,342,16,37,265,281
"Bolivia","Potosí","Rafael Bustillo","Llallagua","HUMANISTICO LLALLAGUA",-66.58627,-18.42284,422,73,2559,2981,1343,152,991,2334
"Bolivia","Potosí","Rafael Bustillo","Llallagua","MARTIN CARDENAS",-66.58627,-18.42284,358,96,2566,2924,1036,215,1219,2255
"Bolivia","Potosí","Rafael Bustillo","Llallagua","NUCLEO JISK'ANQUI",-66.55359,-18.32512,20,21,253,273,106,11,115,221
"Bolivia","Potosí","Rafael Bustillo","Uncía","CÁRCEL SAN MIGUEL DE UNCÍA",-66.56538,-18.46565,7,1,29,36,15,0,13,28
"Bolivia","Potosí","Rafael Bustillo","Uncía","CHILCA PALCA",-66.48528,-18.62824,82,33,384,466,93,49,209,302
"Bolivia","Potosí","Rafael Bustillo","Uncía","COLEG. RAFAEL BUSTILLO",-66.56538,-18.46565,466,77,2251,2717,1085,97,992,2077
"Bolivia","Potosí","Rafael Bustillo","Uncía","COL. INTERMEDIO INDEPENDENCIA",-66.56538,-18.46565,276,72,1938,2214,1068,136,662,1730
"Bolivia","Potosí","Rafael Bustillo","Uncía","ESC. CHOCO CHICO",-66.56693,-18.66152,17,7,91,108,57,5,22,79
"Bolivia","Potosí","Rafael Bustillo","Uncía","ESC. HUACUTA A",-66.57107,-18.59737,20,10,123,143,62,5,46,108
"Bolivia","Potosí","Rafael Bustillo","Uncía","ESC. JUANA AZURDUY DE PADILLA",-66.56538,-18.46565,272,60,1759,2031,826,94,779,1605
"Bolivia","Potosí","Rafael Bustillo","Uncía","ESC. MODESTO OMISTE",-66.56538,-18.46565,162,35,1160,1322,707,45,373,1080
"Bolivia","Potosí","Rafael Bustillo","Uncía","ESC. MOROCOMARCA",-66.529,-18.674,116,29,334,450,80,28,197,277
"Bolivia","Potosí","Rafael Bustillo","Uncía","ESC. SUBCENTRAL LAGUNILLAS",-66.41483,-18.5441,46,18,337,383,57,19,243,300
"Bolivia","Potosí","Rafael Bustillo","Uncía","NUCLEO ESCOLAR CALA CALA",-66.48356,-18.52519,109,35,991,1100,173,48,735,908
"Bolivia","Potosí","Sur Chichas","Atocha","COL. CHOROLQUE",-66.0516,-20.92446,145,28,1092,1237,316,50,698,1014
"Bolivia","Potosí","Sur Chichas","Atocha","COLEG. GREGORIO PACHECO",-66.22056,-20.93593,181,20,751,932,293,33,405,698
"Bolivia","Potosí","Sur Chichas","Atocha","ESC. CHOCAYA",-66.3306,-20.97412,14,1,72,86,10,4,57,67
"Bolivia","Potosí","Sur Chichas","Atocha","ESC. CHOROLQUE VIEJO",-66.06475,-21.01707,4,0,12,16,2,0,10,12
"Bolivia","Potosí","Sur Chichas","Atocha","ESC. DE ANIMAS",-66.30733,-20.96173,83,20,677,760,312,15,330,642
"Bolivia","Potosí","Sur Chichas","Atocha","ESC. DE SIETE SUYOS",-66.29662,-20.9496,91,16,527,618,176,23,312,488
"Bolivia","Potosí","Sur Chichas","Atocha","ESC. DE TACMARI",-66.06282,-21.08223,0,0,21,21,3,1,17,20
"Bolivia","Potosí","Sur Chichas","Atocha","ESC. EDUARDO AVAROA",-66.22056,-20.93593,123,20,606,729,213,35,338,551
"Bolivia","Potosí","Sur Chichas","Atocha","ESC. GUADALUPE",-65.79517,-18.69062,17,0,46,63,9,3,34,43
"Bolivia","Potosí","Sur Chichas","Atocha","ESC. JULIO URQUIETA",-66.31551,-21.26756,94,12,473,567,137,26,298,435
"Bolivia","Potosí","Sur Chichas","Atocha","ESC. PORTUGALETE",-66.14603,-21.16817,50,8,310,360,74,13,215,289
"Bolivia","Potosí","Sur Chichas","Atocha","UNIDAD EDUCATIVA TELAMAYU",-66.22509,-20.94718,84,5,369,453,122,13,229,351
"Bolivia","Potosí","Sur Chichas","Tupiza","CÁRCEL TUPIZA",-65.72643,-21.4452,1,0,27,28,11,0,16,27
"Bolivia","Potosí","Sur Chichas","Tupiza","COLEGIO ANTOFAGASTA",-65.72643,-21.4452,364,38,1879,2243,788,83,970,1758
"Bolivia","Potosí","Sur Chichas","Tupiza","COL. NAL. MIXTO CHICHAS",-65.6029,-21.18405,22,6,107,129,9,5,87,96
"Bolivia","Potosí","Sur Chichas","Tupiza","EL MOLINO",-65.49464,-21.74079,13,0,58,71,11,1,46,57
"Bolivia","Potosí","Sur Chichas","Tupiza","ESC. CHACO PAMPA",-65.77544,-21.51714,69,7,283,352,46,10,220,266
"Bolivia","Potosí","Sur Chichas","Tupiza","ESC. CHIFLOCA",-65.79998,-21.48615,13,3,95,108,36,5,51,87
"Bolivia","Potosí","Sur Chichas","Tupiza","ESC. CHILLCO",-66.10437,-21.40515,28,4,104,132,29,8,63,92
"Bolivia","Potosí","Sur Chichas","Tupiza","ESC. CHUQUI",-66.17671,-21.72463,12,1,42,54,3,2,36,39
"Bolivia","Potosí","Sur Chichas","Tupiza","ESC. CHUQUIAGO",-65.64294,-21.56561,60,9,225,285,37,9,170,207
"Bolivia","Potosí","Sur Chichas","Tupiza","ESC. CONCEPCION",-66.12894,-21.69586,2,0,12,14,1,0,11,12
"Bolivia","Potosí","Sur Chichas","Tupiza","ESC. DE ALMONA",-65.78484,-21.17253,23,10,118,141,21,2,85,106
"Bolivia","Potosí","Sur Chichas","Tupiza","ESC. DE MOCHARA",-65.59682,-21.27156,25,5,218,243,14,5,194,208
"Bolivia","Potosí","Sur Chichas","Tupiza","ESC. DE OPLOCA",-65.80829,-21.33162,68,17,365,433,94,32,222,316
"Bolivia","Potosí","Sur Chichas","Tupiza","ESC. DE RIO BLANCO",-65.59937,-21.14781,33,0,125,158,10,6,109,119
"Bolivia","Potosí","Sur Chichas","Tupiza","ESC. DE SALO",-65.78109,-21.24509,32,7,183,215,28,4,144,172
"Bolivia","Potosí","Sur Chichas","Tupiza","ESC. DE SAN MIGUEL",-65.75484,-21.3053,28,1,121,149,21,7,92,113
"Bolivia","Potosí","Sur Chichas","Tupiza","ESC. ESMORACA",-66.22615,-21.6957,20,6,202,222,64,5,127,191
"Bolivia","Potosí","Sur Chichas","Tupiza","ESC. ESPICAYA",-65.79379,-21.58842,32,2,165,197,32,7,124,156
"Bolivia","Potosí","Sur Chichas","Tupiza","ESC. ESTARCA",-65.95553,-21.66106,22,0,138,160,21,1,116,137
"Bolivia","Potosí","Sur Chichas","Tupiza","ESC. HUARIRACA",-65.98829,-21.71672,5,1,33,38,5,0,27,32
"Bolivia","Potosí","Sur Chichas","Tupiza","ESC. KUCHU",-66.01013,-21.51916,11,1,54,65,11,1,41,52
"Bolivia","Potosí","Sur Chichas","Tupiza","ESC. MIXTA 7 DE NOVIEMBRE",-65.72643,-21.4452,415,23,2101,2516,1080,80,918,1998
"Bolivia","Potosí","Sur Chichas","Tupiza","ESC. NAZARENO",-65.58674,-21.60765,50,15,251,301,40,11,185,225
"Bolivia","Potosí","Sur Chichas","Tupiza","ESC. ORO INGENIO",-65.96437,-21.31153,13,1,44,57,7,5,31,38
"Bolivia","Potosí","Sur Chichas","Tupiza","ESC. REYNECILLA",-65.2538,-21.58071,45,0,113,158,19,4,90,109
"Bolivia","Potosí","Sur Chichas","Tupiza","ESC. SAN JOSE PAMPA GRANDE",-65.81684,-21.67879,52,15,178,230,14,7,142,156
"Bolivia","Potosí","Sur Chichas","Tupiza","ESC. SANTO DOMINCO",-66.10701,-21.56706,8,0,19,27,2,0,17,19
"Bolivia","Potosí","Sur Chichas","Tupiza","ESC. SECCIONAL",-65.30436,-21.69688,31,1,128,159,18,8,101,119
"Bolivia","Potosí","Sur Chichas","Tupiza","ESC. SUIPACHA",-65.60592,-21.57154,178,29,560,738,155,37,339,494
"Bolivia","Potosí","Sur Chichas","Tupiza","ESC. SUPIRA",-65.52016,-21.59575,31,6,148,179,40,15,87,127
"Bolivia","Potosí","Sur Chichas","Tupiza","ESC. TALINA",-65.82471,-21.74855,47,8,129,176,10,2,109,119
"Bolivia","Potosí","Sur Chichas","Tupiza","ESC. TAPAXA",-65.9848,-21.61774,15,4,96,111,13,5,74,87
"Bolivia","Potosí","Sur Chichas","Tupiza","ESC. TITIHOYO",-65.75745,-21.5398,8,1,78,86,10,6,61,71
"Bolivia","Potosí","Sur Chichas","Tupiza","ESC. TOCLOCA",-65.68027,-21.51474,74,11,285,359,57,10,207,264
"Bolivia","Potosí","Sur Chichas","Tupiza","ESC. VILLA FATIMA ANDRES DE SANTA CRUZ",-65.72643,-21.4452,330,63,1990,2320,775,115,1037,1812
"Bolivia","Potosí","Sur Chichas","Tupiza","ESC. ZAPATERA",-66.18834,-21.62791,5,0,33,38,9,0,24,33
"Bolivia","Potosí","Sur Chichas","Tupiza","INSTITUTO SAN JUAN",-65.72643,-21.4452,468,37,2402,2870,1277,102,986,2263
"Bolivia","Potosí","Sur Chichas","Tupiza","KINDER REMEDIOS",-65.72643,-21.4452,738,87,3803,4541,1206,200,2310,3516
"Bolivia","Potosí","Sur Chichas","Tupiza","NUCLEO ESCOLAR QUIRIZA",-65.79105,-21.61311,45,10,223,268,28,2,183,211
"Bolivia","Potosí","Sur Chichas","Tupiza","U.E. G. BERRIOS",-65.72643,-21.4452,22,5,137,159,39,5,88,127
"Bolivia","Potosí","Sur Chichas","Tupiza","U.E. NACIONAL 6 DE JUNIO",-65.58966,-21.57787,19,13,280,299,70,33,164,234
"Bolivia","Potosí","Sur Chichas","Tupiza","U.E. P. HARRIS",-65.72643,-21.4452,16,7,157,173,37,15,98,135
"Bolivia","Potosí","Sur Chichas","Tupiza","U.E. TOMATAS",-65.63572,-21.54967,11,4,115,126,20,13,78,98
"Bolivia","Potosí","Sur Chichas","Tupiza","UNIDAD EDUCATIVA RITA ROMANO",-65.72643,-21.4452,296,40,1575,1871,586,98,851,1437
"Bolivia","Potosí","Sur Chichas","Tupiza","UNIDAD EDUCATIVA TUPIZA B",-65.72643,-21.4452,337,30,1464,1801,493,78,863,1356
"Bolivia","Potosí","Sur Chichas","Tupiza","VETERINARIA SUB SEDE UATF",-65.72643,-21.4452,199,29,1070,1269,460,53,528,988
"Bolivia","Potosí","Sur Lípez","Mojinete","ESC. BONETE PALCA",-66.394,-21.788,0,0,13,13,1,0,12,13
"Bolivia","Potosí","Sur Lípez","Mojinete","ESC. CASA GRANDE",-66.27042,-21.93487,14,4,64,78,3,3,54,57
"Bolivia","Potosí","Sur Lípez","Mojinete","ESC. LA CIENEGA",-66.33878,-21.79782,7,0,24,31,2,1,21,23
"Bolivia","Potosí","Sur Lípez","Mojinete","ESC. PUEBLO VIEJO",-66.28301,-21.84269,2,0,20,22,1,0,19,20
"Bolivia","Potosí","Sur Lípez","Mojinete","H. ALCALDIA MUNICIPAL",-66.23934,-21.76464,24,2,97,121,12,2,81,93
"Bolivia","Potosí","Sur Lípez","San Antonio de Esmoruco","ESC. 10 DE NOVIEMBRE",-66.51337,-21.84954,20,0,73,93,12,0,61,73
"Bolivia","Potosí","Sur Lípez","San Antonio de Esmoruco","ESC. ANTOFAGASTA",-66.41882,-22.10488,34,6,112,146,31,3,72,103
"Bolivia","Potosí","Sur Lípez","San Antonio de Esmoruco","ESC. CENTRAL CALAMA",-66.51688,-21.9479,55,7,252,307,56,9,180,236
"Bolivia","Potosí","Sur Lípez","San Antonio de Esmoruco","ESC. DE RIO SECO",-66.33189,-21.99798,4,1,76,80,14,2,59,73
"Bolivia","Potosí","Sur Lípez","San Antonio de Esmoruco","ESC. OCKE ORCKO",-66.31582,-21.96951,7,2,48,55,6,0,40,46
"Bolivia","Potosí","Sur Lípez","San Antonio de Esmoruco","ESC. RANCHO CHILENO",-66.79728,-22.40032,9,0,29,38,8,0,21,29
"Bolivia","Potosí","Sur Lípez","San Pablo de Lípez","ESC. EDUARDO AVAROA",-67.35746,-22.22936,3,8,53,56,28,5,12,40
"Bolivia","Potosí","Sur Lípez","San Pablo de Lípez","ESC. KOLLPANI",-66.91783,-22.03759,6,0,51,57,7,3,41,48
"Bolivia","Potosí","Sur Lípez","San Pablo de Lípez","ESC. QUETENA CHICO",-67.34043,-22.1941,18,4,223,241,104,3,112,216
"Bolivia","Potosí","Sur Lípez","San Pablo de Lípez","ESC. RELAVE",-66.79867,-21.76142,15,1,45,60,16,4,24,40
"Bolivia","Potosí","Sur Lípez","San Pablo de Lípez","ESC. SANTA ISABEL",-66.45042,-21.64084,19,0,30,49,1,0,29,30
"Bolivia","Potosí","Sur Lípez","San Pablo de Lípez","ESC. SECCIONAL RIO SAN PABLO",-66.76449,-21.60779,12,3,89,101,23,2,61,84
"Bolivia","Potosí","Sur Lípez","San Pablo de Lípez","ESC. SECCIONAL VILUYO",-66.35195,-21.53281,16,0,83,99,5,3,75,80
"Bolivia","Potosí","Sur Lípez","San Pablo de Lípez","ESC. VILLA PORVENIR",-66.88214,-21.87592,23,3,111,134,37,9,62,99
"Bolivia","Potosí","Sur Lípez","San Pablo de Lípez","SALON DE COMUNIDAD",-66.48465,-21.41609,3,3,91,94,26,3,59,85
"Bolivia","Potosí","Sur Lípez","San Pablo de Lípez","SALON DE PLAZA",-66.67158,-21.50187,27,4,126,153,38,13,71,109
"Bolivia","Potosí","Sur Lípez","San Pablo de Lípez","U.E. COLORADOS DE BOLIVIA",-66.61893,-21.68718,12,0,70,82,23,7,40,63
"Bolivia","Potosí","Tomás Frías","Potosí","(CÁRCEL) PENAL DE CANTUMARCA",-65.78258,-19.59936,39,1,106,145,70,4,31,101
"Bolivia","Potosí","Tomás Frías","Potosí","CENTRO ED. FRAY VICENTE BERNEDO",-65.749,-19.58,551,40,4272,4823,3555,124,553,4108
"Bolivia","Potosí","Tomás Frías","Potosí","COL. 31 DE OCTUBRE",-65.7597,-19.58211,181,3,1186,1367,1006,30,147,1153
"Bolivia","Potosí","Tomás Frías","Potosí","COL. ANICETO ARCE",-65.75697,-19.58251,113,4,841,954,719,21,97,816
"Bolivia","Potosí","Tomás Frías","Potosí","COL. CARLOS MEDINACELI",-65.75753,-19.58196,96,3,731,827,641,9,78,719
"Bolivia","Potosí","Tomás Frías","Potosí","COL. DIVINO MAESTRO",-65.77073,-19.56213,348,7,2512,2860,2122,54,329,2451
"Bolivia","Potosí","Tomás Frías","Potosí","COLEG. ANTOFAGASTA",-65.74934,-19.59519,368,17,2803,3171,2396,54,336,2732
"Bolivia","Potosí","Tomás Frías","Potosí","COLEG. BANCARIO",-65.7532,-19.5843,131,3,1009,1140,910,9,87,997
"Bolivia","Potosí","Tomás Frías","Potosí","COLEG. CRISTO MAESTRO",-65.753,-19.583,63,1,548,611,497,4,46,543
"Bolivia","Potosí","Tomás Frías","Potosí","COLEG. DAVID BERRIOS",-65.76199,-19.58034,223,4,1576,1799,1323,42,207,1530
"Bolivia","Potosí","Tomás Frías","Potosí","COLEG. DON BOSCO",-65.75298,-19.58537,129,0,985,1114,887,10,88,975
"Bolivia","Potosí","Tomás Frías","Potosí","COLEGIO FRANCISCANO",-65.75263,-19.59103,94,2,927,1021,851,6,68,919
"Bolivia","Potosí","Tomás Frías","Potosí","COLEG. LUIS ESPINAL",-65.74538,-19.59578,525,34,3280,3805,2729,106,411,3140
"Bolivia","Potosí","Tomás Frías","Potosí","COLEG. SAN RAFAEL",-65.59398,-19.45205,99,17,822,921,503,89,213,716
"Bolivia","Potosí","Tomás Frías","Potosí","ESC. 12 DE ABRIL",-65.7491,-19.59479,119,5,898,1017,739,33,121,860
"Bolivia","Potosí","Tomás Frías","Potosí","ESC. 1RO DE ABRIL",-65.75495,-19.58885,61,2,526,587,456,9,59,515
"Bolivia","Potosí","Tomás Frías","Potosí","ESC. 6 DE JUNIO",-65.77945,-19.58491,182,25,1695,1877,1122,88,460,1582
"Bolivia","Potosí","Tomás Frías","Potosí","ESC. ANTONIO QUIJARRO",-65.75183,-19.59038,73,0,552,625,505,6,41,546
"Bolivia","Potosí","Tomás Frías","Potosí","ESC. BENICIO MONTERO MALLO",-65.74702,-19.59106,221,7,1868,2089,1631,42,188,1819
"Bolivia","Potosí","Tomás Frías","Potosí","ESC. BOLIVIANO ALEMÁN",-65.771,-19.583,155,20,1233,1388,1012,37,164,1176
"Bolivia","Potosí","Tomás Frías","Potosí","ESC. CLETO LOAYZA",-65.75833,-19.59216,352,27,2543,2895,2186,56,274,2460
"Bolivia","Potosí","Tomás Frías","Potosí","ESC. COBIJA",-65.75887,-19.57669,465,17,3334,3799,2826,73,418,3244
"Bolivia","Potosí","Tomás Frías","Potosí","ESC. COPACABANA",-65.75468,-19.59232,282,10,2160,2442,1905,52,193,2098
"Bolivia","Potosí","Tomás Frías","Potosí","ESC. DANIEL CAMPOS",-65.75119,-19.57934,792,30,4956,5748,4150,132,644,4794
"Bolivia","Potosí","Tomás Frías","Potosí","ESC. ENRIQUE VIANA",-65.75941,-19.57416,487,23,3819,4306,3238,81,477,3715
"Bolivia","Potosí","Tomás Frías","Potosí","ESC. GERMAN BUSCH",-65.76686,-19.59209,332,27,2128,2460,1676,100,325,2001
"Bolivia","Potosí","Tomás Frías","Potosí","ESC. GREGORIO BARRIGA",-65.75343,-19.58554,58,1,383,441,344,3,35,379
"Bolivia","Potosí","Tomás Frías","Potosí","ESC. GUALBERTO VILLARROEL",-65.75404,-19.59555,282,19,2176,2458,1756,77,324,2080
"Bolivia","Potosí","Tomás Frías","Potosí","ESC. JAIME MENDOZA",-65.744,-19.60323,201,21,1240,1441,981,41,197,1178
"Bolivia","Potosí","Tomás Frías","Potosí","ESC. JESUS DE NAZARET",-65.77232,-19.56954,321,28,2478,2799,1917,83,450,2367
"Bolivia","Potosí","Tomás Frías","Potosí","ESC. JOSE A.ZAMPA",-65.75164,-19.58199,175,9,725,900,613,18,85,698
"Bolivia","Potosí","Tomás Frías","Potosí","ESC. JOSE MARIA LINARES",-65.74564,-19.59069,225,10,1835,2060,1593,46,186,1779
"Bolivia","Potosí","Tomás Frías","Potosí","ESC. KARACHIPAMPA",-65.72121,-19.55614,98,6,576,674,402,46,122,524
"Bolivia","Potosí","Tomás Frías","Potosí","ESC. KENNY PRIETO MELGAREJO",-65.756,-19.561,443,43,3315,3758,2636,101,535,3171
"Bolivia","Potosí","Tomás Frías","Potosí","ESC. LITORAL",-65.75475,-19.58171,329,5,2262,2591,1948,37,272,2220
"Bolivia","Potosí","Tomás Frías","Potosí","ESC.L.SUBIETA SAGARNAGA",-65.74593,-19.59545,287,16,1934,2221,1405,81,432,1837
"Bolivia","Potosí","Tomás Frías","Potosí","ESC. MANQUIRI",-65.713,-19.422,42,6,191,233,126,21,38,164
"Bolivia","Potosí","Tomás Frías","Potosí","ESC. MARTIN CRUZ",-65.63708,-19.4641,47,18,411,458,227,13,153,380
"Bolivia","Potosí","Tomás Frías","Potosí","ESC. MODESTO OMISTE",-65.75407,-19.5905,80,1,498,578,428,9,60,488
"Bolivia","Potosí","Tomás Frías","Potosí","ESC. OCKORURO",-65.68793,-19.34093,39,14,148,187,84,12,38,122
"Bolivia","Potosí","Tomás Frías","Potosí","ESC. PARANTACA",-65.67346,-19.41582,14,2,126,140,91,2,31,122
"Bolivia","Potosí","Tomás Frías","Potosí","ESC. PARANTURI",-65.84405,-19.38804,8,5,86,94,55,8,18,73
"Bolivia","Potosí","Tomás Frías","Potosí","ESC. SALVADOR REVILLA",-65.75059,-19.58397,99,3,1074,1173,953,16,102,1055
"Bolivia","Potosí","Tomás Frías","Potosí","ESC. SAN JOSE",-65.75632,-19.58005,167,2,1693,1860,1478,35,178,1656
"Bolivia","Potosí","Tomás Frías","Potosí","ESC. SIMON RODRIGUEZ",-65.75714,-19.58396,172,5,1428,1600,1227,28,168,1395
"Bolivia","Potosí","Tomás Frías","Potosí","ESC. TARAPAYA",-65.79939,-19.47568,23,2,220,243,144,29,45,189
"Bolivia","Potosí","Tomás Frías","Potosí","ESC. TOMAS FRIAS",-65.78917,-19.42753,2,0,105,107,82,0,23,105
"Bolivia","Potosí","Tomás Frías","Potosí","ESC. TOPATER",-65.76611,-19.57706,524,19,3624,4148,3119,89,397,3516
"Bolivia","Potosí","Tomás Frías","Potosí","ESCUELA JOSÉ ALONSO DE IBÁÑEZ",-65.75143,-19.58758,191,4,1307,1498,1167,22,114,1281
"Bolivia","Potosí","Tomás Frías","Potosí","FE Y ALEGRIA Y SAN CLEMENTE",-65.76543,-19.57224,481,21,4159,4640,3662,81,395,4057
"Bolivia","Potosí","Tomás Frías","Potosí","INSTITUTO I.S.E.C.",-65.76514,-19.57146,109,3,1199,1308,1062,19,115,1177
"Bolivia","Potosí","Tomás Frías","Potosí","INSTITUTO SAN JUAN",-65.75861,-19.59069,116,7,1018,1134,866,30,115,981
"Bolivia","Potosí","Tomás Frías","Potosí","KINDER CONCEPCION",-65.747,-19.59719,207,14,1372,1579,1117,43,198,1315
"Bolivia","Potosí","Tomás Frías","Potosí","KINDER ISMAEL MONTES",-65.74657,-19.58614,448,37,3719,4167,3177,82,423,3600
"Bolivia","Potosí","Tomás Frías","Potosí","LIC. SUCRE",-65.7513,-19.58862,226,9,1737,1963,1560,19,149,1709
"Bolivia","Potosí","Tomás Frías","Potosí","MARISCAL SANTA CRUZ",-65.75602,-19.57199,599,43,4278,4877,3492,139,604,4096
"Bolivia","Potosí","Tomás Frías","Potosí","UE 31 DE OCTUBRE",-65.76176,-19.58175,458,27,3685,4143,3094,76,488,3582
"Bolivia","Potosí","Tomás Frías","Potosí","U.E. ANTONIO JOSE DE SUCRE",-65.75098,-19.57251,500,36,3678,4178,2914,151,577,3491
"Bolivia","Potosí","Tomás Frías","Potosí","U.E. CECILIO GUZMAN ROJAS",-65.75775,-19.56903,22,2,192,214,155,8,27,182
"Bolivia","Potosí","Tomás Frías","Potosí","U.E. DON BOSCO B",-65.76209,-19.59194,27,6,257,284,200,7,44,244
"Bolivia","Potosí","Tomás Frías","Potosí","U.E. DR. GONZALO CALDERON RIOS",-65.73939,-19.58194,21,8,312,333,219,17,68,287
"Bolivia","Potosí","Tomás Frías","Potosí","U.E. HUMBERTO IPORRE SALINAS",-65.748,-19.576,368,35,2350,2718,1653,127,535,2188
"Bolivia","Potosí","Tomás Frías","Potosí","UNIDAD EDUCATIVA JUAN PABLO II",-65.77334,-19.57676,490,50,4248,4738,3330,175,693,4023
"Bolivia","Potosí","Tomás Frías","Potosí","UNIDAD EDUCATIVA MEJILLONES",-65.74363,-19.58617,544,58,3993,4537,3174,181,580,3754
"Bolivia","Potosí","Tomás Frías","Potosí","UNIDAD EDUCATIVA SANTA ROSA",-65.75475,-19.58914,182,3,1341,1523,1180,35,123,1303
"Bolivia","Potosí","Tomás Frías","Potosí","UNIDAD EDUCATIVA VILLA COLON",-65.7385,-19.59098,531,60,3875,4406,2921,197,697,3618
"Bolivia","Potosí","Tomás Frías","Potosí","UNID. EDUCATIVA OSCAR ALFARO",-65.74941,-19.58645,130,4,1045,1175,928,18,95,1023
"Bolivia","Potosí","Tomás Frías","Tinguipaya","ESC. ACTARA",-65.95901,-19.07407,227,26,575,802,212,110,227,439
"Bolivia","Potosí","Tomás Frías","Tinguipaya","ESC. CALASAYA",-65.94428,-19.09865,88,1,192,280,3,10,178,181
"Bolivia","Potosí","Tomás Frías","Tinguipaya","ESC. CENTRAL ANTHURA",-65.96957,-19.12422,146,56,983,1129,145,112,670,815
"Bolivia","Potosí","Tomás Frías","Tinguipaya","ESC. CENTRAL JAHUACAYA",-65.88607,-19.19718,187,103,720,907,183,57,377,560
"Bolivia","Potosí","Tomás Frías","Tinguipaya","ESC. CENTRAL UTACALLA",-65.82983,-19.32134,111,18,327,438,124,20,165,289
"Bolivia","Potosí","Tomás Frías","Tinguipaya","ESC. EJE CAQUENA",-65.93787,-19.10439,75,30,320,395,122,15,153,275
"Bolivia","Potosí","Tomás Frías","Tinguipaya","ESC. FOROCTIRI",-65.71165,-19.14012,108,2,354,462,38,14,300,338
"Bolivia","Potosí","Tomás Frías","Tinguipaya","ESC. ISLA",-65.79921,-19.34833,15,2,69,84,47,5,15,62
"Bolivia","Potosí","Tomás Frías","Tinguipaya","ESC. ITHINOCA",-65.74291,-19.17638,53,4,370,423,50,18,298,348
"Bolivia","Potosí","Tomás Frías","Tinguipaya","ESC. LEÑAS",-66.08008,-19.24488,52,23,262,314,102,26,111,213
"Bolivia","Potosí","Tomás Frías","Tinguipaya","ESC. MARISCAL SUCRE",-65.86382,-19.09476,349,99,1428,1777,403,82,844,1247
"Bolivia","Potosí","Tomás Frías","Tinguipaya","ESC. MARISCAL SUCRE",-65.823,-19.22001,349,99,1428,1777,403,82,844,1247
"Bolivia","Potosí","Tomás Frías","Tinguipaya","ESC. MATANSUYO",-65.89815,-19.03701,83,20,208,291,83,15,90,173
"Bolivia","Potosí","Tomás Frías","Tinguipaya","ESC. MCAL. A. JOSE DE SUCRE",-65.72488,-19.24366,151,7,326,477,82,18,219,301
"Bolivia","Potosí","Tomás Frías","Tinguipaya","ESC. PUCA PUNTA",-65.68548,-19.11989,62,5,209,271,20,10,174,194
"Bolivia","Potosí","Tomás Frías","Tinguipaya","ESC. TACOHUARA",-65.7727,-19.13595,45,5,194,239,13,3,173,186
"Bolivia","Potosí","Tomás Frías","Tinguipaya","ESCUELA SAYACA",-66.0471,-19.11271,3,6,91,94,26,6,53,79
"Bolivia","Potosí","Tomás Frías","Tinguipaya","U.E. CIENEGOMA",-65.84728,-19.06967,0,1,256,256,52,19,184,236
"Bolivia","Potosí","Tomás Frías","Tinguipaya","U.E. MACHAC MARCA",-65.92706,-19.16479,12,24,195,207,131,10,30,161
"Bolivia","Potosí","Tomás Frías","Urmiri (Belén de Andamarca)","ESC. CAHUAYO",-66.17896,-19.27176,6,2,87,93,14,3,68,82
"Bolivia","Potosí","Tomás Frías","Urmiri (Belén de Andamarca)","ESC. JUAN JOSE PEREZ",-66.06399,-19.38641,27,2,267,294,85,12,168,253
"Bolivia","Potosí","Tomás Frías","Urmiri (Belén de Andamarca)","ESC. PUITUCO",-66.093,-19.315,19,3,112,131,47,2,60,107
"Bolivia","Potosí","Tomás Frías","Urmiri (Belén de Andamarca)","ESC. SECC. VACUYO",-66.10999,-19.45775,24,7,164,188,111,5,41,152
"Bolivia","Potosí","Tomás Frías","Yocalla","COLEG. ELIZARDO PEREZ",-65.97868,-19.41173,35,8,259,294,83,5,163,246
"Bolivia","Potosí","Tomás Frías","Yocalla","ESC. ALONSO DE IBANEZ",-65.81144,-19.51297,24,9,243,267,178,5,51,229
"Bolivia","Potosí","Tomás Frías","Yocalla","ESC. CAYARA",-65.88385,-19.55053,70,16,403,473,262,13,112,374
"Bolivia","Potosí","Tomás Frías","Yocalla","ESC. CHIRACORO",-65.9007,-19.60283,32,8,298,330,146,28,116,262
"Bolivia","Potosí","Tomás Frías","Yocalla","ESC. EDUARDO AVAROA",-65.90892,-19.38971,136,39,634,770,339,35,221,560
"Bolivia","Potosí","Tomás Frías","Yocalla","ESC. JOSE ANTONIO ZAMPA",-65.8355,-19.45168,63,29,503,566,281,26,167,448
"Bolivia","Potosí","Tomás Frías","Yocalla","ESC. JUAN XXIII",-66.019,-19.356,58,8,360,418,99,9,244,343
"Bolivia","Potosí","Tomás Frías","Yocalla","ESC. SAN ANTONIO",-65.79968,-19.58194,59,7,397,456,293,17,80,373
"Bolivia","Potosí","Tomás Frías","Yocalla","ESC. SANTA LUCIA",-65.84718,-19.55035,35,12,372,407,291,4,65,356
"Bolivia","Santa Cruz","Andrés Ibáñez","Cotoca","COLEGIO NAL. BENEMERITOS DE LA PATRIA",-62.99899,-17.75773,546,58,3675,4221,2367,95,1155,3522
"Bolivia","Santa Cruz","Andrés Ibáñez","Cotoca","ESC. GREMIAL CORTEZ",-63.01388,-17.82349,60,8,454,514,194,17,235,429
"Bolivia","Santa Cruz","Andrés Ibáñez","Cotoca","ESC. MARISCAL ANTONIO JOSE DE SUCRE",-63.05227,-17.74769,135,14,821,956,497,26,284,781
"Bolivia","Santa Cruz","Andrés Ibáñez","Cotoca","ESCUELA.COLEGIO LORENZO CORTEZ RIVERA",-62.9951,-17.75099,642,69,3952,4594,2513,117,1253,3766
"Bolivia","Santa Cruz","Andrés Ibáñez","Cotoca","ESCUELA.COLEGIO MANUEL ANGEL CORTEZ",-63.0035,-17.75491,443,33,2682,3125,1574,77,998,2572
"Bolivia","Santa Cruz","Andrés Ibáñez","Cotoca","ESCUELA.COL. SAN MARCOS",-62.98962,-17.75545,629,27,3675,4304,2039,131,1478,3517
"Bolivia","Santa Cruz","Andrés Ibáñez","Cotoca","ESCUELA DEMETRIO AÑEZ",-62.79085,-17.66665,462,16,2146,2608,1158,33,939,2097
"Bolivia","Santa Cruz","Andrés Ibáñez","Cotoca","ESCUELA GERMAN BUSCH",-62.93764,-17.73404,141,9,1072,1213,316,70,677,993
"Bolivia","Santa Cruz","Andrés Ibáñez","Cotoca","ESCUELA JESUS GOMEZ",-62.99224,-17.75945,187,14,991,1178,558,16,403,961
"Bolivia","Santa Cruz","Andrés Ibáñez","Cotoca","ESCUELA REP. DE MEXICO",-62.95778,-17.7372,279,27,1621,1900,356,137,1101,1457
"Bolivia","Santa Cruz","Andrés Ibáñez","Cotoca","ESCUELA.U.E. CALLEJAS",-62.9951,-17.75099,203,8,978,1181,666,14,290,956
"Bolivia","Santa Cruz","Andrés Ibáñez","Cotoca","ESCUELA U.E CLUB SOCIAL 24 DE SEPTIEMBRE",-63.0174,-17.69314,258,14,1674,1932,891,70,699,1590
"Bolivia","Santa Cruz","Andrés Ibáñez","Cotoca","ESCUELA UNIDADEDUCATIVA OSCAR ALFARO",-63.01909,-17.79542,202,26,1730,1932,356,66,1282,1638
"Bolivia","Santa Cruz","Andrés Ibáñez","Cotoca","U.E. PATUJU",-63.05326,-17.77304,12,4,236,248,146,8,78,224
"Bolivia","Santa Cruz","Andrés Ibáñez","Cotoca","U.E. SAN ANTONIO",-62.98827,-17.75096,7,1,62,69,39,1,21,60
"Bolivia","Santa Cruz","Andrés Ibáñez","Cotoca","UNIDAD EDUCATIVA FIDEL SAUCEDO",-62.99212,-17.69003,110,23,1116,1226,609,32,452,1061
"Bolivia","Santa Cruz","Andrés Ibáñez","El Torno","ESC.  29 DE JUNIO",-63.42663,-18.05655,314,62,2328,2642,1063,112,1091,2154
"Bolivia","Santa Cruz","Andrés Ibáñez","El Torno","ESC. ALBERTO RIBERA TAPIA",-63.50418,-18.15956,150,24,994,1144,371,105,494,865
"Bolivia","Santa Cruz","Andrés Ibáñez","El Torno","ESC. CAÑADA DOS",-63.32237,-18.06299,31,15,261,292,34,6,206,240
"Bolivia","Santa Cruz","Andrés Ibáñez","El Torno","ESC. CENTRAL MONTEVERDE",-63.50122,-17.92225,20,5,154,174,23,5,121,144
"Bolivia","Santa Cruz","Andrés Ibáñez","El Torno","ESC. ELENA VACA ANTELO",-63.3835,-17.99134,864,64,5819,6683,2753,271,2731,5484
"Bolivia","Santa Cruz","Andrés Ibáñez","El Torno","ESC. FE Y ALEGRIA",-63.45194,-17.981,42,6,369,411,114,11,238,352
"Bolivia","Santa Cruz","Andrés Ibáñez","El Torno","ESC. LA ELVIRA",-63.44523,-18.05682,0,2,24,24,13,0,9,22
"Bolivia","Santa Cruz","Andrés Ibáñez","El Torno","ESC. NACIONES UNIDAS",-63.38043,-17.9931,921,129,6202,7123,2304,309,3460,5764
"Bolivia","Santa Cruz","Andrés Ibáñez","El Torno","ESC, NUCLEO SAN LUIS",-63.48095,-18.1413,216,30,1305,1521,675,57,543,1218
"Bolivia","Santa Cruz","Andrés Ibáñez","El Torno","ESC. QUEBRADA LEON",-63.47776,-17.96212,17,3,140,157,39,4,94,133
"Bolivia","Santa Cruz","Andrés Ibáñez","El Torno","ESC. SECCIONAL SANTA RITA",-63.37109,-17.97818,207,32,1700,1907,740,72,856,1596
"Bolivia","Santa Cruz","Andrés Ibáñez","El Torno","ESCUELA 23 DE MARZO",-63.34325,-18.09747,61,3,374,435,57,16,298,355
"Bolivia","Santa Cruz","Andrés Ibáñez","El Torno","ESCUELA ANDRES IBAÑEZ",-63.40279,-18.02817,178,35,1785,1963,749,106,895,1644
"Bolivia","Santa Cruz","Andrés Ibáñez","El Torno","ESCUELA PUERTO RICO",-63.39142,-18.00683,357,48,2672,3029,1015,131,1478,2493
"Bolivia","Santa Cruz","Andrés Ibáñez","El Torno","ESCUELA SANTA MARTHA",-63.36341,-17.96476,157,13,1125,1282,334,110,668,1002
"Bolivia","Santa Cruz","Andrés Ibáñez","El Torno","ESCUELA TIQUIPAYA",-63.45114,-18.08387,134,43,1060,1194,224,42,751,975
"Bolivia","Santa Cruz","Andrés Ibáñez","El Torno","ESC. VILLA BARRIENTOS",-63.35257,-18.01478,14,3,90,104,16,3,68,84
"Bolivia","Santa Cruz","Andrés Ibáñez","El Torno","NUCLEO CENTRAL TARUMA",-63.46047,-18.11805,66,19,532,598,229,36,248,477
"Bolivia","Santa Cruz","Andrés Ibáñez","El Torno","SECCIONAL PARABANOCITO",-63.46001,-18.22056,14,6,135,149,53,3,73,126
"Bolivia","Santa Cruz","Andrés Ibáñez","El Torno","U.E. BICENTENARIO",-63.38105,-17.98782,21,4,178,199,71,2,101,172
"Bolivia","Santa Cruz","Andrés Ibáñez","El Torno","U.E. BICENTENARIO II",-63.38103,-17.98801,1,0,9,10,6,0,3,9
"Bolivia","Santa Cruz","Andrés Ibáñez","El Torno","U.E. LIC. ZACHARY MACY",-63.38482,-17.99942,25,2,199,224,72,4,121,193
"Bolivia","Santa Cruz","Andrés Ibáñez","El Torno","U.E. LIC. ZACHARY MACY",-63.38501,-17.9992,25,2,199,224,72,4,121,193
"Bolivia","Santa Cruz","Andrés Ibáñez","La Guardia","CAMBAO",-63.23442,-17.87344,79,6,822,901,397,22,397,794
"Bolivia","Santa Cruz","Andrés Ibáñez","La Guardia","ESC. CENTRAL ANGEL FOIANINI",-63.2851,-17.8802,572,78,4598,5170,2218,245,2057,4275
"Bolivia","Santa Cruz","Andrés Ibáñez","La Guardia","ESC. CENTRAL BASILIO",-63.19316,-18.12562,232,44,1398,1630,516,71,767,1283
"Bolivia","Santa Cruz","Andrés Ibáñez","La Guardia","ESC. JOSE MIGUEL DE VELASCO",-63.21535,-17.9662,35,5,282,317,172,5,100,272
"Bolivia","Santa Cruz","Andrés Ibáñez","La Guardia","ESC. JOSE VICENTE SOLIZ Y RAMOS",-63.32945,-17.89064,554,77,3290,3844,1744,169,1300,3044
"Bolivia","Santa Cruz","Andrés Ibáñez","La Guardia","ESC. JUANA AZURDUY DE PADILLA",-63.26641,-17.87674,350,17,2453,2803,1373,98,965,2338
"Bolivia","Santa Cruz","Andrés Ibáñez","La Guardia","ESC. LA PEÑA- BRECHA-3",-63.05506,-17.98781,67,17,470,537,213,13,227,440
"Bolivia","Santa Cruz","Andrés Ibáñez","La Guardia","ESC. NATANIEL VERDUGEZ",-63.25018,-17.85087,1438,62,9085,10523,4641,248,4134,8775
"Bolivia","Santa Cruz","Andrés Ibáñez","La Guardia","ESC. RUBEN DARIO SOLIZ",-63.35154,-17.93966,357,51,2252,2609,1051,76,1074,2125
"Bolivia","Santa Cruz","Andrés Ibáñez","La Guardia","ESC. TOMAS JOSE MORALES",-63.33047,-17.89173,650,39,4522,5172,2617,193,1673,4290
"Bolivia","Santa Cruz","Andrés Ibáñez","La Guardia","ESC. U. EDUC. ALFREDO IBAÑEZ FRANCO",-63.24312,-17.85056,637,105,4629,5266,2224,296,2004,4228
"Bolivia","Santa Cruz","Andrés Ibáñez","La Guardia","ESCUELA JOSE GIL SORUCO",-63.2532,-17.95629,141,15,850,991,457,61,317,774
"Bolivia","Santa Cruz","Andrés Ibáñez","La Guardia","ESCUELA MAESTRO PITAGORAS",-63.29059,-17.89535,625,47,4633,5258,1776,151,2659,4435
"Bolivia","Santa Cruz","Andrés Ibáñez","La Guardia","ESCUELA NUEVA ESPERANZA",-63.26702,-17.86146,440,17,2777,3217,1817,65,878,2695
"Bolivia","Santa Cruz","Andrés Ibáñez","La Guardia","MADRE TERESA DE CALCUTA",-63.23131,-17.87858,42,3,536,578,228,31,274,502
"Bolivia","Santa Cruz","Andrés Ibáñez","La Guardia","NUCLEO SAN CARLOS",-63.33423,-18.13221,22,4,142,164,78,4,56,134
"Bolivia","Santa Cruz","Andrés Ibáñez","La Guardia","U.E. ANGEL FOIANINI BANZER II",-63.2851,-17.8802,20,2,253,273,130,10,111,241
"Bolivia","Santa Cruz","Andrés Ibáñez","La Guardia","U.E. AYACUCHO",-63.21905,-17.86675,21,3,359,380,135,7,214,349
"Bolivia","Santa Cruz","Andrés Ibáñez","La Guardia","U.E. BARRIO LINDO",-63.26904,-17.89636,42,3,588,630,249,28,308,557
"Bolivia","Santa Cruz","Andrés Ibáñez","La Guardia","U.E. BICENTENARIO ARCO IRIS",-63.2214,-17.86212,22,1,180,202,112,5,62,174
"Bolivia","Santa Cruz","Andrés Ibáñez","La Guardia","U.E. CORDECRUZ",-63.24748,-17.84745,124,3,858,982,477,30,348,825
"Bolivia","Santa Cruz","Andrés Ibáñez","La Guardia","U.E. HERNANDO ZANABRIA",-63.28431,-17.89734,17,3,251,268,95,10,143,238
"Bolivia","Santa Cruz","Andrés Ibáñez","La Guardia","U.E. INTEGRACION DE LAS AMERICAS",-63.27132,-17.88183,42,6,608,650,88,10,504,592
"Bolivia","Santa Cruz","Andrés Ibáñez","La Guardia","U.E. JOSE MARIANO SERRANO",-63.25946,-17.83774,48,2,639,687,318,19,300,618
"Bolivia","Santa Cruz","Andrés Ibáñez","La Guardia","U.E. LUZ DE ESPERANZA",-63.27512,-17.85011,10,1,168,178,106,1,60,166
"Bolivia","Santa Cruz","Andrés Ibáñez","La Guardia","U.E. NACIONAL LA GUARDIA",-63.32025,-17.89236,31,6,451,482,215,18,212,427
"Bolivia","Santa Cruz","Andrés Ibáñez","La Guardia","U.E. NATANIEL GARCIA CHAVEZ",-63.23131,-17.87858,69,0,485,554,295,15,175,470
"Bolivia","Santa Cruz","Andrés Ibáñez","La Guardia","U.E. QUEBRADA SECA",-63.34096,-17.9067,0,1,41,41,26,1,13,39
"Bolivia","Santa Cruz","Andrés Ibáñez","La Guardia","U.E. TOMAS MORALES PADILLA",-63.22071,-17.89719,21,4,374,395,95,94,181,276
"Bolivia","Santa Cruz","Andrés Ibáñez","Porongo (Ayacucho)","ESC. FRAY SANTIAGO DE RIVERO",-63.30791,-17.85656,312,34,2277,2589,1348,50,845,2193
"Bolivia","Santa Cruz","Andrés Ibáñez","Porongo (Ayacucho)","ESC. JOSE PARADA LAGUINDEY",-63.38077,-17.72245,141,12,570,711,379,7,172,551
"Bolivia","Santa Cruz","Andrés Ibáñez","Porongo (Ayacucho)","ESC. NUCLEO CENTRAL SANTA FE",-63.45945,-17.70892,52,7,329,381,63,4,255,318
"Bolivia","Santa Cruz","Andrés Ibáñez","Porongo (Ayacucho)","ESCUELA 6 DE AGOSTO",-63.21883,-17.72828,26,4,694,720,568,75,47,615
"Bolivia","Santa Cruz","Andrés Ibáñez","Porongo (Ayacucho)","ESCUELA CENTRAL ANICETO PARADA ROCA",-63.44804,-17.6197,61,4,252,313,205,5,38,243
"Bolivia","Santa Cruz","Andrés Ibáñez","Porongo (Ayacucho)","ESCUELA CENTRAL SOMBRERITO",-63.36818,-17.88821,55,6,203,258,93,11,93,186
"Bolivia","Santa Cruz","Andrés Ibáñez","Porongo (Ayacucho)","ESCUELA IRENIA MONTERO",-63.4469,-17.87279,46,1,107,153,27,9,70,97
"Bolivia","Santa Cruz","Andrés Ibáñez","Porongo (Ayacucho)","ESCUELA PUERTO ICHILO",-63.23566,-17.74908,51,5,266,317,183,12,66,249
"Bolivia","Santa Cruz","Andrés Ibáñez","Porongo (Ayacucho)","ESCUELA SAN LORENZO",-63.24335,-17.76947,211,13,1196,1407,842,30,311,1153
"Bolivia","Santa Cruz","Andrés Ibáñez","Porongo (Ayacucho)","ESCUELA TARUMATU",-63.24299,-17.65729,71,2,360,431,263,12,83,346
"Bolivia","Santa Cruz","Andrés Ibáñez","Porongo (Ayacucho)","U.E. LAS CRUCES",-63.35539,-17.76963,8,0,72,80,48,4,20,68
"Bolivia","Santa Cruz","Andrés Ibáñez","Porongo (Ayacucho)","U.E. SAN PEDRO",-63.43151,-17.72083,0,0,50,50,23,0,27,50
"Bolivia","Santa Cruz","Andrés Ibáñez","Porongo (Ayacucho)","U.E. TACUAREMBO",-63.39894,-17.93078,1,0,6,7,0,0,6,6
"Bolivia","Santa Cruz","Andrés Ibáñez","Porongo (Ayacucho)","URUBO OPEN MALL",-63.21519,-17.7493,60,1,510,570,463,7,39,502
"Bolivia","Santa Cruz","Andrés Ibáñez","Santa Cruz de la Sierra","16 DE FEBRERO",-63.09864,-17.74821,0,1,139,139,82,14,42,124
"Bolivia","Santa Cruz","Andrés Ibáñez","Santa Cruz de la Sierra","16 DE JULIO",-63.11146,-17.75544,72,8,775,847,460,54,253,713
"Bolivia","Santa Cruz","Andrés Ibáñez","Santa Cruz de la Sierra","ANGELINA RIVERA",-63.17871,-17.85304,21,0,214,235,126,2,86,212
"Bolivia","Santa Cruz","Andrés Ibáñez","Santa Cruz de la Sierra","CAMPUS UNIVERSITARIO",-63.1925,-17.77396,566,6,2742,3308,2256,35,445,2701
"Bolivia","Santa Cruz","Andrés Ibáñez","Santa Cruz de la Sierra","COL. 12 DE DICIEMBRE",-63.13068,-17.821,1193,53,6567,7760,3871,178,2465,6336
"Bolivia","Santa Cruz","Andrés Ibáñez","Santa Cruz de la Sierra","COL. 18 DE MARZO",-63.12068,-17.78999,855,52,5021,5876,3225,153,1591,4816
"Bolivia","Santa Cruz","Andrés Ibáñez","Santa Cruz de la Sierra","COL. 27 DE MAYO",-63.1305,-17.80221,655,18,3291,3946,1750,112,1411,3161
"Bolivia","Santa Cruz","Andrés Ibáñez","Santa Cruz de la Sierra","COL. 30 DE MARZO",-63.14708,-17.80647,532,11,3569,4101,2721,91,746,3467
"Bolivia","Santa Cruz","Andrés Ibáñez","Santa Cruz de la Sierra","COL. 7 DE SEPTIEMBRE",-63.17094,-17.72965,552,10,3062,3614,2429,83,540,2969
"Bolivia","Santa Cruz","Andrés Ibáñez","Santa Cruz de la Sierra","COL.ADVENTISTA SANTA CRUZ",-63.16123,-17.73494,575,13,3616,4191,2831,147,625,3456
"Bolivia","Santa Cruz","Andrés Ibáñez","Santa Cruz de la Sierra","COL. ALAN FARAH",-63.0952,-17.79962,566,18,3107,3673,1992,150,947,2939
"Bolivia","Santa Cruz","Andrés Ibáñez","Santa Cruz de la Sierra","COL. ALFA Y OMEGA",-63.18944,-17.80245,212,7,1587,1799,1123,72,385,1508
"Bolivia","Santa Cruz","Andrés Ibáñez","Santa Cruz de la Sierra","COL. AMERICAN SCHOOL COOP.",-63.19998,-17.80871,315,4,1992,2307,1772,56,160,1932
"Bolivia","Santa Cruz","Andrés Ibáñez","Santa Cruz de la Sierra","COL. ANGELA PINCKERT",-63.12423,-17.80643,889,30,5378,6267,2843,179,2326,5169
"Bolivia","Santa Cruz","Andrés Ibáñez","Santa Cruz de la Sierra","COL. ANGLO AMERICANO",-63.17102,-17.75651,45,29,643,688,557,8,49,606
"Bolivia","Santa Cruz","Andrés Ibáñez","Santa Cruz de la Sierra","COL.  ANITA SUAREZ DE LEYGUE",-63.24062,-17.82561,262,17,2119,2381,1164,42,896,2060
"Bolivia","Santa Cruz","Andrés Ibáñez","Santa Cruz de la Sierra","COL.ANTONIO VICENTE SEOANE",-63.19352,-17.80136,281,9,2239,2520,1749,88,393,2142
"Bolivia","Santa Cruz","Andrés Ibáñez","Santa Cruz de la Sierra","COL. ARTURO MEDEIROS",-63.1909,-17.72338,192,8,1349,1541,855,41,445,1300
"Bolivia","Santa Cruz","Andrés Ibáñez","Santa Cruz de la Sierra","COL. ARZ. DANIEL RIVERO",-63.18145,-17.78975,25,0,137,162,108,1,28,136
"Bolivia","Santa Cruz","Andrés Ibáñez","Santa Cruz de la Sierra","COL. BAILON MERCADO ORTIZ",-63.16036,-17.75771,376,11,2633,3009,2098,62,462,2560
"Bolivia","Santa Cruz","Andrés Ibáñez","Santa Cruz de la Sierra","COL. BASILIO DE CUELLAR",-63.1786,-17.7843,145,1,778,923,709,15,53,762
"Bolivia","Santa Cruz","Andrés Ibáñez","Santa Cruz de la Sierra","COL. BATALLON TREN",-63.12371,-17.79344,243,9,1562,1805,1055,77,421,1476
"Bolivia","Santa Cruz","Andrés Ibáñez","Santa Cruz de la Sierra","COL. BERTHA CUELLAR",-63.13752,-17.78985,1101,25,5105,6206,3293,345,1442,4735
"Bolivia","Santa Cruz","Andrés Ibáñez","Santa Cruz de la Sierra","COL. BOSTON COLLEGE",-63.17429,-17.77369,188,3,1410,1598,1246,22,139,1385
"Bolivia","Santa Cruz","Andrés Ibáñez","Santa Cruz de la Sierra","COL. BRITANICO",-63.17352,-17.7643,381,4,2798,3179,2581,31,182,2763
"Bolivia","Santa Cruz","Andrés Ibáñez","Santa Cruz de la Sierra","COL. BUENAS NUEVAS",-63.13937,-17.8226,978,116,6445,7423,3805,205,2319,6124
"Bolivia","Santa Cruz","Andrés Ibáñez","Santa Cruz de la Sierra","COL. CAÑADA EL CARMEN",-63.15352,-17.81458,450,8,3510,3960,2813,87,602,3415
"Bolivia","Santa Cruz","Andrés Ibáñez","Santa Cruz de la Sierra","COL. CAÑADA PAILITAS",-63.14665,-17.81992,401,11,2507,2908,1766,63,667,2433
"Bolivia","Santa Cruz","Andrés Ibáñez","Santa Cruz de la Sierra","COL.CARCEL PUBLICA",-63.17891,-17.87441,400,3,530,930,265,9,253,518
"Bolivia","Santa Cruz","Andrés Ibáñez","Santa Cruz de la Sierra","COL.CARDENAL CUSHING JESUS MARIA",-63.18533,-17.79161,318,11,1929,2247,1566,41,311,1877
"Bolivia","Santa Cruz","Andrés Ibáñez","Santa Cruz de la Sierra","COL. CASTILLA LA MANCHA",-63.06415,-17.85068,1619,151,9549,11168,5034,419,3945,8979
"Bolivia","Santa Cruz","Andrés Ibáñez","Santa Cruz de la Sierra","COL. CENTRAL OBRERA DEPARTAMENTAL",-63.10396,-17.80835,771,69,4763,5534,2602,171,1921,4523
"Bolivia","Santa Cruz","Andrés Ibáñez","Santa Cruz de la Sierra","COL.CENTRO APRONDY",-63.15873,-17.77472,251,34,2255,2506,1823,114,284,2107
"Bolivia","Santa Cruz","Andrés Ibáñez","Santa Cruz de la Sierra","COL. CENTRO EDUCATIVO CARITAS",-63.18559,-17.83982,520,11,4777,5297,3648,162,956,4604
"Bolivia","Santa Cruz","Andrés Ibáñez","Santa Cruz de la Sierra","COL. CENTRO INTERNO BOL. ALEMAN",-63.11688,-17.82509,1431,53,6686,8117,3081,196,3356,6437
"Bolivia","Santa Cruz","Andrés Ibáñez","Santa Cruz de la Sierra","COL. CIUDAD NIÑO JESUS",-63.18233,-17.82738,643,18,4033,4676,2573,199,1243,3816
"Bolivia","Santa Cruz","Andrés Ibáñez","Santa Cruz de la Sierra","COL.CLUB DE LEONES",-63.17753,-17.7902,245,6,1758,2003,1297,32,423,1720
"Bolivia","Santa Cruz","Andrés Ibáñez","Santa Cruz de la Sierra","COL.CLUB DE LEONES #10",-63.17753,-17.7902,148,32,1130,1278,930,34,134,1064
"Bolivia","Santa Cruz","Andrés Ibáñez","Santa Cruz de la Sierra","COL. CLUB DE LEONES #6",-63.18416,-17.7943,118,3,670,788,450,45,172,622
"Bolivia","Santa Cruz","Andrés Ibáñez","Santa Cruz de la Sierra","COL. COMPLEJO EDUCATIVO JAPON",-63.18984,-17.80635,777,27,4684,5461,2821,182,1654,4475
"Bolivia","Santa Cruz","Andrés Ibáñez","Santa Cruz de la Sierra","COL. COVIPAL",-63.23657,-17.83965,151,14,933,1084,341,31,547,888
"Bolivia","Santa Cruz","Andrés Ibáñez","Santa Cruz de la Sierra","COL. CUPESI TERRADO",-63.09699,-17.81237,764,46,4206,4970,1806,173,2181,3987
"Bolivia","Santa Cruz","Andrés Ibáñez","Santa Cruz de la Sierra","COL. DIOS ES AMOR",-63.16571,-17.78535,174,8,1294,1468,1097,20,169,1266
"Bolivia","Santa Cruz","Andrés Ibáñez","Santa Cruz de la Sierra","COL.DOMINGO LEIGUE (BOLIVIANO CANADIENSE",-63.16274,-17.77073,265,5,1803,2068,1519,31,248,1767
"Bolivia","Santa Cruz","Andrés Ibáñez","Santa Cruz de la Sierra","COL. EDUCATIVO COTOCA",-63.11758,-17.74604,506,85,3026,3532,1654,128,1159,2813
"Bolivia","Santa Cruz","Andrés Ibáñez","Santa Cruz de la Sierra","COL. EDUCATIVO SAN ISIDRO",-63.13194,-17.80816,850,54,5300,6150,3113,144,1989,5102
"Bolivia","Santa Cruz","Andrés Ibáñez","Santa Cruz de la Sierra","COLEGIO  23 DE ABRIL",-63.14577,-17.74856,444,9,2730,3174,1761,123,837,2598
"Bolivia","Santa Cruz","Andrés Ibáñez","Santa Cruz de la Sierra","COLEGIO  6 DE JUNIO",-63.16083,-17.75763,600,7,2213,2813,1755,93,358,2113
"Bolivia","Santa Cruz","Andrés Ibáñez","Santa Cruz de la Sierra","COLEGIO ADELA ZAMUDIO",-63.17396,-17.8329,935,25,5934,6869,3515,228,2166,5681
"Bolivia","Santa Cruz","Andrés Ibáñez","Santa Cruz de la Sierra","COLEGIO BERTHA CUELLAR",-63.1344,-17.77751,187,5,856,1043,652,12,187,839
"Bolivia","Santa Cruz","Andrés Ibáñez","Santa Cruz de la Sierra","COLEGIO CASTULO CHAVEZ",-63.18775,-17.77663,395,14,2078,2473,1772,24,268,2040
"Bolivia","Santa Cruz","Andrés Ibáñez","Santa Cruz de la Sierra","COLEGIO CUPESO DE LOS REYES",-63.10786,-17.82436,609,21,3885,4494,1653,152,2059,3712
"Bolivia","Santa Cruz","Andrés Ibáñez","Santa Cruz de la Sierra","COLEGIO DOMINGO SAVIO - DON BOSCO",-63.19939,-17.83571,1167,39,7171,8338,4296,250,2586,6882
"Bolivia","Santa Cruz","Andrés Ibáñez","Santa Cruz de la Sierra","COLEGIO DON BOSCO",-63.17539,-17.79467,346,5,2023,2369,1752,37,229,1981
"Bolivia","Santa Cruz","Andrés Ibáñez","Santa Cruz de la Sierra","COLEGIO EL PROGRESO",-63.20576,-17.82713,926,33,5004,5930,2443,242,2286,4729
"Bolivia","Santa Cruz","Andrés Ibáñez","Santa Cruz de la Sierra","COLEGIO ELVIRA PARADA",-63.12992,-17.75476,646,16,3534,4180,2305,104,1109,3414
"Bolivia","Santa Cruz","Andrés Ibáñez","Santa Cruz de la Sierra","COLEGIO FUENTE DEL SABER",-63.16189,-17.87296,100,7,766,866,296,23,440,736
"Bolivia","Santa Cruz","Andrés Ibáñez","Santa Cruz de la Sierra","COLEGIO IGNACIO WARNES",-63.15627,-17.86588,614,20,3784,4398,1638,145,1981,3619
"Bolivia","Santa Cruz","Andrés Ibáñez","Santa Cruz de la Sierra","COLEGIO JOSEFINA BALSAMO( LOS TUSEQUIS)",-63.1523,-17.78086,539,50,3818,4357,2803,157,808,3611
"Bolivia","Santa Cruz","Andrés Ibáñez","Santa Cruz de la Sierra","COLEGIO JUSTO LEIGUE",-63.16701,-17.79873,132,4,1430,1562,1189,65,172,1361
"Bolivia","Santa Cruz","Andrés Ibáñez","Santa Cruz de la Sierra","COLEGIO LUZ Y VERDAD",-63.18724,-17.876,472,18,2520,2992,1136,76,1290,2426
"Bolivia","Santa Cruz","Andrés Ibáñez","Santa Cruz de la Sierra","COLEGIO MARCELINO CHAMPAGNAT",-63.18896,-17.85419,315,15,2690,3005,1976,107,592,2568
"Bolivia","Santa Cruz","Andrés Ibáñez","Santa Cruz de la Sierra","COLEGIO MARISTA",-63.17305,-17.78898,250,6,1698,1948,1523,21,148,1671
"Bolivia","Santa Cruz","Andrés Ibáñez","Santa Cruz de la Sierra","COLEGIO MARTIN SAPP",-63.17467,-17.82512,828,25,5678,6506,3614,179,1860,5474
"Bolivia","Santa Cruz","Andrés Ibáñez","Santa Cruz de la Sierra","COLEGIO NESTOR SUAREZ",-63.17374,-17.81688,548,12,3694,4242,2568,146,968,3536
"Bolivia","Santa Cruz","Andrés Ibáñez","Santa Cruz de la Sierra","COLEGIO PLAN 4000",-63.17594,-17.88471,685,37,4624,5309,1666,153,2768,4434
"Bolivia","Santa Cruz","Andrés Ibáñez","Santa Cruz de la Sierra","COLEGIO RAQUEL SOSSA",-63.19794,-17.77104,94,1,888,982,789,15,83,872
"Bolivia","Santa Cruz","Andrés Ibáñez","Santa Cruz de la Sierra","COLEGIO SAN FELIPE",-63.123,-17.76667,1279,166,7396,8675,3972,234,3024,6996
"Bolivia","Santa Cruz","Andrés Ibáñez","Santa Cruz de la Sierra","COLEGIO SAN FRANCISCO DE ASIS",-63.14429,-17.85693,46,5,434,480,220,6,203,423
"Bolivia","Santa Cruz","Andrés Ibáñez","Santa Cruz de la Sierra","COLEGIO SAN JORGE",-63.1956,-17.87261,466,49,2424,2890,1129,98,1148,2277
"Bolivia","Santa Cruz","Andrés Ibáñez","Santa Cruz de la Sierra","COLEGIO SIMON BOLIVAR",-63.1228,-17.82358,745,64,4324,5069,1870,135,2255,4125
"Bolivia","Santa Cruz","Andrés Ibáñez","Santa Cruz de la Sierra","COLEGIO TOKIO",-63.18006,-17.77509,273,2,1112,1385,708,25,377,1085
"Bolivia","Santa Cruz","Andrés Ibáñez","Santa Cruz de la Sierra","COLEGIO VILLA GLADYS THEVENETH",-63.11954,-17.82021,709,42,4643,5352,1923,222,2456,4379
"Bolivia","Santa Cruz","Andrés Ibáñez","Santa Cruz de la Sierra","COL. EL BUEN SAMARITANO",-63.08056,-17.81198,231,16,1724,1955,830,68,810,1640
"Bolivia","Santa Cruz","Andrés Ibáñez","Santa Cruz de la Sierra","COL. EL CARMEN 16 DE JULIO",-63.19295,-17.80798,301,12,2046,2347,1548,58,428,1976
"Bolivia","Santa Cruz","Andrés Ibáñez","Santa Cruz de la Sierra","COL.  ELFI RIVERA DE BARBERY",-63.15907,-17.73966,1594,50,8265,9859,4971,298,2946,7917
"Bolivia","Santa Cruz","Andrés Ibáñez","Santa Cruz de la Sierra","COL. EL PAJONAL",-63.16722,-17.81264,284,11,1633,1917,1353,29,240,1593
"Bolivia","Santa Cruz","Andrés Ibáñez","Santa Cruz de la Sierra","COL. ESC. 29 DE DICIEMBRE",-63.21157,-17.80971,337,8,1915,2252,1112,58,737,1849
"Bolivia","Santa Cruz","Andrés Ibáñez","Santa Cruz de la Sierra","COL.ESC.  AMSTERDAN",-63.14972,-17.85901,408,8,2357,2765,922,70,1357,2279
"Bolivia","Santa Cruz","Andrés Ibáñez","Santa Cruz de la Sierra","COL. ESC. CORONEL IGNACIO WARNES",-63.1825,-17.78679,150,2,585,735,466,21,96,562
"Bolivia","Santa Cruz","Andrés Ibáñez","Santa Cruz de la Sierra","COL.ESC. GRAL. ISMAEL MONTES GAMBOA",-63.10978,-17.74466,733,84,5227,5960,2676,238,2229,4905
"Bolivia","Santa Cruz","Andrés Ibáñez","Santa Cruz de la Sierra","COL. ESC. HILANDERIA",-63.21956,-17.80578,503,17,3062,3565,2090,98,857,2947
"Bolivia","Santa Cruz","Andrés Ibáñez","Santa Cruz de la Sierra","COL. ESC. HOLANDA",-63.19473,-17.88406,211,14,1625,1836,662,82,867,1529
"Bolivia","Santa Cruz","Andrés Ibáñez","Santa Cruz de la Sierra","COL. ESC. HONORATO MEJIA",-63.21367,-17.86145,335,52,2678,3013,1407,107,1112,2519
"Bolivia","Santa Cruz","Andrés Ibáñez","Santa Cruz de la Sierra","COL.ESC. INOCENCIO ROMAN",-63.06305,-17.85023,947,89,4783,5730,1783,171,2740,4523
"Bolivia","Santa Cruz","Andrés Ibáñez","Santa Cruz de la Sierra","COL. ESC.JUANA AZURDUY DE PADILLA",-63.10905,-17.84618,1216,186,7968,9184,3786,336,3660,7446
"Bolivia","Santa Cruz","Andrés Ibáñez","Santa Cruz de la Sierra","COL. ESC. LA BASE",-63.21367,-17.83001,351,14,2562,2913,1613,49,886,2499
"Bolivia","Santa Cruz","Andrés Ibáñez","Santa Cruz de la Sierra","COL. ESC. MAGISTERIO SUR",-63.18134,-17.86983,397,20,2581,2978,1301,103,1157,2458
"Bolivia","Santa Cruz","Andrés Ibáñez","Santa Cruz de la Sierra","COL. ESC. MANUEL IGNACIO SALVATIERRA",-63.17845,-17.78334,103,1,537,640,458,9,69,527
"Bolivia","Santa Cruz","Andrés Ibáñez","Santa Cruz de la Sierra","COL. ESC. MARIA ALICIA PAZ B.",-63.19432,-17.85304,810,32,5206,6016,3276,164,1734,5010
"Bolivia","Santa Cruz","Andrés Ibáñez","Santa Cruz de la Sierra","COL. ESC. MAX FERNANDEZ ROJAS B",-63.16543,-17.87381,524,28,3050,3574,1335,156,1531,2866
"Bolivia","Santa Cruz","Andrés Ibáñez","Santa Cruz de la Sierra","COL. ESC. NAUN FERNANDEZ",-63.17404,-17.83272,308,11,2526,2834,1607,101,807,2414
"Bolivia","Santa Cruz","Andrés Ibáñez","Santa Cruz de la Sierra","COL. ESC.PEREGRINA DAVALOS",-63.16763,-17.87231,589,17,3259,3848,1456,92,1694,3150
"Bolivia","Santa Cruz","Andrés Ibáñez","Santa Cruz de la Sierra","COL.ESC. ROCA CORONADO",-63.15992,-17.83748,872,36,5345,6217,2591,129,2589,5180
"Bolivia","Santa Cruz","Andrés Ibáñez","Santa Cruz de la Sierra","COL.ESC. TIERRAS NUEVAS EL CARMEN",-63.21467,-17.84509,1769,213,9544,11313,4380,453,4498,8878
"Bolivia","Santa Cruz","Andrés Ibáñez","Santa Cruz de la Sierra","COL. ESCUELA 2 DE AGOSTO",-63.15519,-17.75298,390,9,2532,2922,2063,32,428,2491
"Bolivia","Santa Cruz","Andrés Ibáñez","Santa Cruz de la Sierra","COL. ESCUELA AMBROCIO VILLARROEL",-63.2262,-17.79013,294,53,1659,1953,859,44,703,1562
"Bolivia","Santa Cruz","Andrés Ibáñez","Santa Cruz de la Sierra","COL.ESCUELA BOLIVIA HOLANDA",-63.14489,-17.86903,595,21,3656,4251,1247,190,2198,3445
"Bolivia","Santa Cruz","Andrés Ibáñez","Santa Cruz de la Sierra","COL.ESCUELA DELCY MARTINEZ SALINAS",-63.15478,-17.84095,300,8,1829,2129,890,186,745,1635
"Bolivia","Santa Cruz","Andrés Ibáñez","Santa Cruz de la Sierra","COL.ESCUELA EL FUERTE",-63.14807,-17.84582,999,75,5729,6728,2589,398,2667,5256
"Bolivia","Santa Cruz","Andrés Ibáñez","Santa Cruz de la Sierra","COL. ESCUELA JORGE URENDA TRIGO",-63.23063,-17.81518,505,17,3198,3703,2256,120,805,3061
"Bolivia","Santa Cruz","Andrés Ibáñez","Santa Cruz de la Sierra","COL. ESCUELA MAGISTERIO",-63.15523,-17.76229,390,43,3336,3726,2735,67,491,3226
"Bolivia","Santa Cruz","Andrés Ibáñez","Santa Cruz de la Sierra","COL.ESCUELA NUEVA ESPERANZA",-63.07431,-17.83275,291,18,1282,1573,511,36,717,1228
"Bolivia","Santa Cruz","Andrés Ibáñez","Santa Cruz de la Sierra","COL.ESCUELA POLY VILLARROEL",-63.1315,-17.8723,206,6,1541,1747,1034,81,420,1454
"Bolivia","Santa Cruz","Andrés Ibáñez","Santa Cruz de la Sierra","COL. ESCUELA SARA PORRAS DE PINTO",-63.22218,-17.79663,377,8,2465,2842,1720,127,610,2330
"Bolivia","Santa Cruz","Andrés Ibáñez","Santa Cruz de la Sierra","COL. ESC. UNZAGA DE LA VEGA",-63.22689,-17.82803,1549,91,9194,10743,5199,370,3534,8733
"Bolivia","Santa Cruz","Andrés Ibáñez","Santa Cruz de la Sierra","COL.ESC. VIRGEN DE URKUPINA",-63.10241,-17.74881,1331,65,7212,8543,2693,318,4136,6829
"Bolivia","Santa Cruz","Andrés Ibáñez","Santa Cruz de la Sierra","COL. FAUSTO MEDRANO",-63.12659,-17.78748,451,22,2839,3290,1664,130,1023,2687
"Bolivia","Santa Cruz","Andrés Ibáñez","Santa Cruz de la Sierra","COL. FELIX BASCOPE",-63.14538,-17.79648,433,11,3613,4046,2789,79,734,3523
"Bolivia","Santa Cruz","Andrés Ibáñez","Santa Cruz de la Sierra","COL. FELIX BASCOPE SANANDITA",-63.15129,-17.78336,309,8,2073,2382,1667,74,324,1991
"Bolivia","Santa Cruz","Andrés Ibáñez","Santa Cruz de la Sierra","COL. FE Y ALEGRIA",-63.13117,-17.79493,814,26,4302,5116,2823,74,1379,4202
"Bolivia","Santa Cruz","Andrés Ibáñez","Santa Cruz de la Sierra","COL. FE Y ALEGRIA - ANICETO ARZE",-63.15612,-17.7986,684,28,5033,5717,3934,218,853,4787
"Bolivia","Santa Cruz","Andrés Ibáñez","Santa Cruz de la Sierra","COL. FE Y ALEGRIA LA MERCED",-63.19189,-17.78853,575,20,4235,4810,3105,268,842,3947
"Bolivia","Santa Cruz","Andrés Ibáñez","Santa Cruz de la Sierra","COL. FE Y ALEGRIA NUEVA AMERICA",-63.13412,-17.82978,1332,62,7094,8426,3674,208,3150,6824
"Bolivia","Santa Cruz","Andrés Ibáñez","Santa Cruz de la Sierra","COL. GABRIEL RENE MORENO",-63.18595,-17.78357,230,2,1393,1623,1170,25,196,1366
"Bolivia","Santa Cruz","Andrés Ibáñez","Santa Cruz de la Sierra","COL.GASTON GUILLAUX",-63.17099,-17.77877,728,6,2912,3640,2454,57,395,2849
"Bolivia","Santa Cruz","Andrés Ibáñez","Santa Cruz de la Sierra","COL. GILBERTO MENACHO",-63.12507,-17.79899,871,62,5200,6071,3129,216,1793,4922
"Bolivia","Santa Cruz","Andrés Ibáñez","Santa Cruz de la Sierra","COL. GUALBERTO VILLARROEL",-63.16062,-17.77363,402,10,2624,3026,2179,45,390,2569
"Bolivia","Santa Cruz","Andrés Ibáñez","Santa Cruz de la Sierra","COL. GUAPILO JUNIN",-63.10236,-17.79171,769,31,4730,5499,3204,127,1368,4572
"Bolivia","Santa Cruz","Andrés Ibáñez","Santa Cruz de la Sierra","COL. HENRRY PRINCE",-63.20725,-17.81194,243,11,1409,1652,1048,27,323,1371
"Bolivia","Santa Cruz","Andrés Ibáñez","Santa Cruz de la Sierra","COL. HERMANOS CAVANIS",-63.22014,-17.81549,703,20,5427,6130,4031,164,1212,5243
"Bolivia","Santa Cruz","Andrés Ibáñez","Santa Cruz de la Sierra","COL. HERNANDO SILES",-63.17575,-17.86155,1926,71,10283,12209,5075,366,4771,9846
"Bolivia","Santa Cruz","Andrés Ibáñez","Santa Cruz de la Sierra","COL. HEROES DEL CHACO",-63.14454,-17.80119,730,21,4927,5657,3419,210,1277,4696
"Bolivia","Santa Cruz","Andrés Ibáñez","Santa Cruz de la Sierra","COL. HISPANO AMERICANO",-63.13283,-17.79934,319,12,1765,2084,1102,27,624,1726
"Bolivia","Santa Cruz","Andrés Ibáñez","Santa Cruz de la Sierra","COL. HNAS. ARREDONDO(COL.JESUS PEREDO)",-63.20106,-17.78474,533,39,3512,4045,2482,141,850,3332
"Bolivia","Santa Cruz","Andrés Ibáñez","Santa Cruz de la Sierra","COL. HUMBERTO EGUEZ",-63.11185,-17.79594,405,29,2887,3292,1660,168,1030,2690
"Bolivia","Santa Cruz","Andrés Ibáñez","Santa Cruz de la Sierra","COL.INST. DOMINGO SAVIO",-63.17353,-17.75908,178,1,870,1048,738,20,111,849
"Bolivia","Santa Cruz","Andrés Ibáñez","Santa Cruz de la Sierra","COL. INSTITUTO AMERICANO JUAN WESLEY",-63.16511,-17.78164,395,8,2843,3238,2379,93,363,2742
"Bolivia","Santa Cruz","Andrés Ibáñez","Santa Cruz de la Sierra","COL. INTERNACIONAL (BETHESDA)",-63.22035,-17.8294,344,14,2344,2688,1489,99,742,2231
"Bolivia","Santa Cruz","Andrés Ibáñez","Santa Cruz de la Sierra","COL. JHON KENNEDY",-63.19871,-17.78818,988,55,5951,6939,4339,182,1375,5714
"Bolivia","Santa Cruz","Andrés Ibáñez","Santa Cruz de la Sierra","COL. JOSEFINA GOYTIA",-63.17068,-17.79632,144,2,989,1133,860,20,107,967
"Bolivia","Santa Cruz","Andrés Ibáñez","Santa Cruz de la Sierra","COL. JOSE MALKY JESUS MARIA",-63.18144,-17.80808,895,13,4268,5163,3254,109,892,4146
"Bolivia","Santa Cruz","Andrés Ibáñez","Santa Cruz de la Sierra","COL. JUAN LA BORDE MOREL",-63.16035,-17.72277,282,3,2193,2475,1706,40,444,2150
"Bolivia","Santa Cruz","Andrés Ibáñez","Santa Cruz de la Sierra","COL. JUAN PABLO II",-63.17759,-17.7325,397,9,3247,3644,2813,126,299,3112
"Bolivia","Santa Cruz","Andrés Ibáñez","Santa Cruz de la Sierra","COL. JULIO A. GUTIERREZ",-63.18236,-17.79789,341,5,1524,1865,1214,30,275,1489
"Bolivia","Santa Cruz","Andrés Ibáñez","Santa Cruz de la Sierra","COL.KINDER FANNY ANTELO",-63.15987,-17.75532,107,3,704,811,537,13,151,688
"Bolivia","Santa Cruz","Andrés Ibáñez","Santa Cruz de la Sierra","COL. LA MADRE",-63.20914,-17.78125,598,17,3800,4398,2524,79,1180,3704
"Bolivia","Santa Cruz","Andrés Ibáñez","Santa Cruz de la Sierra","COL. LAS AMERICAS II",-63.19033,-17.86217,595,38,4929,5524,2664,348,1879,4543
"Bolivia","Santa Cruz","Andrés Ibáñez","Santa Cruz de la Sierra","COL.LA SANTA CRUZ",-63.17908,-17.76664,280,4,1998,2278,1757,54,183,1940
"Bolivia","Santa Cruz","Andrés Ibáñez","Santa Cruz de la Sierra","COL.LICEO MARIA VACADIEZ",-63.16927,-17.76587,164,1,1623,1787,1381,89,152,1533
"Bolivia","Santa Cruz","Andrés Ibáñez","Santa Cruz de la Sierra","COL. LUIS BARRANCO ALVAREZ",-63.12068,-17.84258,1072,48,5995,7067,2744,137,3066,5810
"Bolivia","Santa Cruz","Andrés Ibáñez","Santa Cruz de la Sierra","COL. LUIS ESPINAL CAMPOS",-63.16032,-17.86751,876,29,4883,5759,2253,222,2379,4632
"Bolivia","Santa Cruz","Andrés Ibáñez","Santa Cruz de la Sierra","COL. LUZ DEL ORIENTE",-63.13755,-17.79396,592,18,2849,3441,1917,78,836,2753
"Bolivia","Santa Cruz","Andrés Ibáñez","Santa Cruz de la Sierra","COL. LUZ Y SABER II",-63.14804,-17.73533,590,14,3343,3933,2463,113,753,3216
"Bolivia","Santa Cruz","Andrés Ibáñez","Santa Cruz de la Sierra","COL. MADRE CLARA RICCI (JESUS ROMAN VACA",-63.14016,-17.79584,208,2,1639,1847,1102,52,483,1585
"Bolivia","Santa Cruz","Andrés Ibáñez","Santa Cruz de la Sierra","COL. MAGDALENA POSTEL",-63.17854,-17.82687,569,19,3862,4431,2894,147,802,3696
"Bolivia","Santa Cruz","Andrés Ibáñez","Santa Cruz de la Sierra","COL. MARIA TERESA PULIDO",-63.1305,-17.8336,850,109,5129,5979,2601,250,2169,4770
"Bolivia","Santa Cruz","Andrés Ibáñez","Santa Cruz de la Sierra","COL. MARISCAL SUCRE",-63.15338,-17.77866,352,11,2646,2998,2240,45,350,2590
"Bolivia","Santa Cruz","Andrés Ibáñez","Santa Cruz de la Sierra","COL. MATEO KULJIS SECUNDARIO",-63.22539,-17.8377,463,43,4733,5196,2542,333,1815,4357
"Bolivia","Santa Cruz","Andrés Ibáñez","Santa Cruz de la Sierra","COL. MIRETTE SCIARONI",-63.18918,-17.76269,351,6,2162,2513,1833,48,275,2108
"Bolivia","Santa Cruz","Andrés Ibáñez","Santa Cruz de la Sierra","COL. M. NELLY VDA. DE BERTERO",-63.11536,-17.81427,271,13,1544,1815,770,44,717,1487
"Bolivia","Santa Cruz","Andrés Ibáñez","Santa Cruz de la Sierra","COL.MODULO # 5 ELVA ANTELO JORDAN",-63.16745,-17.86005,564,36,3171,3735,1558,63,1514,3072
"Bolivia","Santa Cruz","Andrés Ibáñez","Santa Cruz de la Sierra","COL. MODULO FLAMINGO",-63.21369,-17.82285,368,8,2480,2848,1922,45,505,2427
"Bolivia","Santa Cruz","Andrés Ibáñez","Santa Cruz de la Sierra","COL. MONSEÑOR LUIS RODRIGUEZ P.",-63.19559,-17.81594,916,24,5119,6035,3131,124,1840,4971
"Bolivia","Santa Cruz","Andrés Ibáñez","Santa Cruz de la Sierra","COL. NACIONAL 9 DE OCTUBRE",-63.15674,-17.84428,526,50,4490,5016,2931,218,1291,4222
"Bolivia","Santa Cruz","Andrés Ibáñez","Santa Cruz de la Sierra","COL. NACIONAL FLORIDA",-63.18027,-17.79039,150,4,1339,1489,1123,89,123,1246
"Bolivia","Santa Cruz","Andrés Ibáñez","Santa Cruz de la Sierra","COL. NACIONAL SALESIANO",-63.16814,-17.78925,276,6,1510,1786,1204,34,266,1470
"Bolivia","Santa Cruz","Andrés Ibáñez","Santa Cruz de la Sierra","COL. NIMIA CENTELLA",-63.11775,-17.78436,637,31,4115,4752,2457,170,1457,3914
"Bolivia","Santa Cruz","Andrés Ibáñez","Santa Cruz de la Sierra","COL. NORMANDIA JOSEFINA BALSAMO",-63.06764,-17.84974,559,35,3871,4430,1769,114,1953,3722
"Bolivia","Santa Cruz","Andrés Ibáñez","Santa Cruz de la Sierra","COL. NUCLEO ESCOLAR RAMAFA",-63.1834,-17.80372,238,7,1704,1942,1458,26,213,1671
"Bolivia","Santa Cruz","Andrés Ibáñez","Santa Cruz de la Sierra","COL. NUEVA AMERICA",-63.15847,-17.76582,330,8,1992,2322,1579,40,365,1944
"Bolivia","Santa Cruz","Andrés Ibáñez","Santa Cruz de la Sierra","COL. NUEVA ESPERANZA",-63.14962,-17.74375,384,10,1860,2244,1446,42,362,1808
"Bolivia","Santa Cruz","Andrés Ibáñez","Santa Cruz de la Sierra","COL. OBISPO SANTISTEVAN",-63.1792,-17.78578,113,2,731,844,653,16,60,713
"Bolivia","Santa Cruz","Andrés Ibáñez","Santa Cruz de la Sierra","COL. OSCAR ARNULFO",-63.23433,-17.82932,590,47,3909,4499,2207,272,1383,3590
"Bolivia","Santa Cruz","Andrés Ibáñez","Santa Cruz de la Sierra","COL. OVIDIO SANTISTEVAN",-63.19029,-17.74906,841,12,4602,5443,3526,130,934,4460
"Bolivia","Santa Cruz","Andrés Ibáñez","Santa Cruz de la Sierra","COL. PABLO SEXTO",-63.16424,-17.76425,256,3,1888,2144,1481,35,369,1850
"Bolivia","Santa Cruz","Andrés Ibáñez","Santa Cruz de la Sierra","COL. PAMPA DE LA CRUZ",-63.12878,-17.79276,436,15,2714,3150,1905,82,712,2617
"Bolivia","Santa Cruz","Andrés Ibáñez","Santa Cruz de la Sierra","COL. PAMPA DE LA ISLA",-63.12679,-17.77277,483,15,2007,2490,1340,39,613,1953
"Bolivia","Santa Cruz","Andrés Ibáñez","Santa Cruz de la Sierra","COL. PART. ALFRED B. NOBEL",-63.19432,-17.85304,275,8,1762,2037,1287,42,425,1712
"Bolivia","Santa Cruz","Andrés Ibáñez","Santa Cruz de la Sierra","COL.  PEDRO AÑEZ",-63.11894,-17.76698,815,27,4613,5428,2861,161,1564,4425
"Bolivia","Santa Cruz","Andrés Ibáñez","Santa Cruz de la Sierra","COL. PEDRO GUTIERREZ",-63.16812,-17.7553,264,7,2337,2601,2046,87,197,2243
"Bolivia","Santa Cruz","Andrés Ibáñez","Santa Cruz de la Sierra","COL  PLACIDO MOLILNA",-63.19062,-17.79406,506,21,2269,2775,1364,83,801,2165
"Bolivia","Santa Cruz","Andrés Ibáñez","Santa Cruz de la Sierra","COL.POLIFUNCIONAL CALAMA",-63.21886,-17.83718,533,26,3216,3749,1588,88,1514,3102
"Bolivia","Santa Cruz","Andrés Ibáñez","Santa Cruz de la Sierra","COL. PRIMAVERA",-63.1032,-17.81673,900,61,5207,6107,2346,200,2600,4946
"Bolivia","Santa Cruz","Andrés Ibáñez","Santa Cruz de la Sierra","COL. RAFAEL BUSTILLOS",-63.12329,-17.81418,625,21,3368,3993,1706,84,1557,3263
"Bolivia","Santa Cruz","Andrés Ibáñez","Santa Cruz de la Sierra","COL. RAMON DARIO GUTIERREZ",-63.164,-17.80529,196,0,1418,1614,1210,36,172,1382
"Bolivia","Santa Cruz","Andrés Ibáñez","Santa Cruz de la Sierra","COL.REPUBLICA DEL URUGUAY",-63.17242,-17.77493,459,9,2705,3164,2296,35,365,2661
"Bolivia","Santa Cruz","Andrés Ibáñez","Santa Cruz de la Sierra","COL. RODOLFO JOEM",-63.16545,-17.82204,1478,51,8097,9575,4736,285,3025,7761
"Bolivia","Santa Cruz","Andrés Ibáñez","Santa Cruz de la Sierra","COL.ROMULO HERRERA",-63.17609,-17.78023,217,5,1177,1394,840,29,303,1143
"Bolivia","Santa Cruz","Andrés Ibáñez","Santa Cruz de la Sierra","COL. SAGRADO CORAZON",-63.17153,-17.81605,139,5,937,1076,667,23,242,909
"Bolivia","Santa Cruz","Andrés Ibáñez","Santa Cruz de la Sierra","COL. SAN CARLOS",-63.15134,-17.79229,229,7,2142,2371,1689,94,352,2041
"Bolivia","Santa Cruz","Andrés Ibáñez","Santa Cruz de la Sierra","COL. SAN FRANCISCO DE SALES DON BOSCO",-63.0923,-17.76109,1196,51,7315,8511,5448,217,1599,7047
"Bolivia","Santa Cruz","Andrés Ibáñez","Santa Cruz de la Sierra","COL. SAN FRANCISCO SUR",-63.16087,-17.85275,562,26,3415,3977,1453,94,1842,3295
"Bolivia","Santa Cruz","Andrés Ibáñez","Santa Cruz de la Sierra","COL. SAN MARTIN DE PORRES",-63.2021,-17.77761,1088,30,7593,8681,4828,450,2285,7113
"Bolivia","Santa Cruz","Andrés Ibáñez","Santa Cruz de la Sierra","COL. SAN MARTIN NORTE",-63.14275,-17.7284,580,23,3799,4379,2529,217,1030,3559
"Bolivia","Santa Cruz","Andrés Ibáñez","Santa Cruz de la Sierra","COL. SAN PABLO",-63.18967,-17.83693,232,1,2029,2261,1671,29,328,1999
"Bolivia","Santa Cruz","Andrés Ibáñez","Santa Cruz de la Sierra","COL. SAN SILVESTRE",-63.11408,-17.81204,713,30,4262,4975,2053,119,2060,4113
"Bolivia","Santa Cruz","Andrés Ibáñez","Santa Cruz de la Sierra","COL. SANTA RAFAELA",-63.14124,-17.81471,378,44,2450,2828,1644,66,696,2340
"Bolivia","Santa Cruz","Andrés Ibáñez","Santa Cruz de la Sierra","COL. SECCIONAL MONSEÑOR SANTIESTEVAN",-63.18117,-17.77959,326,9,1516,1842,1195,25,287,1482
"Bolivia","Santa Cruz","Andrés Ibáñez","Santa Cruz de la Sierra","COL. SEFERINO NAMUCARA DON BOSCO",-63.17717,-17.77525,88,1,570,658,532,3,34,566
"Bolivia","Santa Cruz","Andrés Ibáñez","Santa Cruz de la Sierra","COL. SOCIEDAD DE INGENIEROS",-63.19918,-17.79882,427,8,3497,3924,2745,160,584,3329
"Bolivia","Santa Cruz","Andrés Ibáñez","Santa Cruz de la Sierra","COL. SOR MARIA CRISTINA PEREZ",-63.14532,-17.78059,1026,27,7718,8744,6347,174,1170,7517
"Bolivia","Santa Cruz","Andrés Ibáñez","Santa Cruz de la Sierra","COL.TECNOLOGICO SANTA CRUZ",-63.15675,-17.76927,192,8,1437,1629,1227,17,185,1412
"Bolivia","Santa Cruz","Andrés Ibáñez","Santa Cruz de la Sierra","COL. TRISTAN ROCA",-63.16394,-17.78412,376,11,2502,2878,1972,52,467,2439
"Bolivia","Santa Cruz","Andrés Ibáñez","Santa Cruz de la Sierra","COL.U.E.23 DE DICIEMBRE(J.  CARLOS TRUJI",-63.11529,-17.76983,847,40,4357,5204,3046,95,1176,4222
"Bolivia","Santa Cruz","Andrés Ibáñez","Santa Cruz de la Sierra","COL.U.E. 26 DE SEPTIEMBRE",-63.10361,-17.72374,994,45,5166,6160,2338,118,2665,5003
"Bolivia","Santa Cruz","Andrés Ibáñez","Santa Cruz de la Sierra","COL.U.E. ALFREDO BARBERY CHAVEZ",-63.11797,-17.75344,1039,47,6218,7257,3563,368,2240,5803
"Bolivia","Santa Cruz","Andrés Ibáñez","Santa Cruz de la Sierra","COL.U. E. CARLOS LA TORRE",-63.12363,-17.77396,515,47,3281,3796,2362,146,726,3088
"Bolivia","Santa Cruz","Andrés Ibáñez","Santa Cruz de la Sierra","COL.U.  E. EL DORADO NORTE",-63.09708,-17.73737,1662,45,8177,9839,4100,353,3679,7779
"Bolivia","Santa Cruz","Andrés Ibáñez","Santa Cruz de la Sierra","COL.U. E. EL RETOÑO",-63.07298,-17.73956,1068,34,5500,6568,3218,183,2065,5283
"Bolivia","Santa Cruz","Andrés Ibáñez","Santa Cruz de la Sierra","COL.U. E. ESCUELA ÑUFLO DE CHAVEZ",-63.15858,-17.74715,284,6,2043,2327,1766,43,228,1994
"Bolivia","Santa Cruz","Andrés Ibáñez","Santa Cruz de la Sierra","COL. U.E. LA RESURECCION -ESC.CONVIF",-63.17194,-17.7436,189,4,1609,1798,1478,10,117,1595
"Bolivia","Santa Cruz","Andrés Ibáñez","Santa Cruz de la Sierra","COL.U.E. NUEVO HORIZONTE",-63.10971,-17.73058,541,15,3152,3693,1403,265,1469,2872
"Bolivia","Santa Cruz","Andrés Ibáñez","Santa Cruz de la Sierra","COL.UNIDAD EDUCATIVA ESPAÑA",-63.11751,-17.77592,401,41,3081,3482,1827,141,1072,2899
"Bolivia","Santa Cruz","Andrés Ibáñez","Santa Cruz de la Sierra","COL. UNIDAD EDUCATIVA LA COLINA",-63.20247,-17.81842,705,25,4472,5177,2993,165,1289,4282
"Bolivia","Santa Cruz","Andrés Ibáñez","Santa Cruz de la Sierra","COL.UNIDAD EDUCATIVA LORENZO CABALLERO",-63.18774,-17.80008,241,8,1776,2017,1354,74,340,1694
"Bolivia","Santa Cruz","Andrés Ibáñez","Santa Cruz de la Sierra","COL.UNIDAD EDUCATIVA SAN JORGE",-63.10691,-17.83507,853,25,5194,6047,1655,299,3215,4870
"Bolivia","Santa Cruz","Andrés Ibáñez","Santa Cruz de la Sierra","COL. UV. LA MADRE",-63.21101,-17.78952,739,24,5166,5905,3851,183,1108,4959
"Bolivia","Santa Cruz","Andrés Ibáñez","Santa Cruz de la Sierra","COL.VENANCIO AQUINO VILLEGAS",-63.15873,-17.77472,176,1,1415,1591,1231,21,162,1393
"Bolivia","Santa Cruz","Andrés Ibáñez","Santa Cruz de la Sierra","COL. VICTOR PAZ ESTENSORO",-63.18661,-17.81709,729,26,4631,5360,2955,167,1483,4438
"Bolivia","Santa Cruz","Andrés Ibáñez","Santa Cruz de la Sierra","COL. VILLA ALEGRE",-63.17024,-17.87461,345,11,2083,2428,659,99,1314,1973
"Bolivia","Santa Cruz","Andrés Ibáñez","Santa Cruz de la Sierra","COL. VILLA BOLIVIA",-63.19029,-17.74906,746,17,3594,4340,2670,144,763,3433
"Bolivia","Santa Cruz","Andrés Ibáñez","Santa Cruz de la Sierra","COL. VILLA FATIMA",-63.20216,-17.81076,719,27,4231,4950,2904,118,1182,4086
"Bolivia","Santa Cruz","Andrés Ibáñez","Santa Cruz de la Sierra","COL. VILLA ROSARIO",-63.2086,-17.79646,787,24,3893,4680,2047,122,1700,3747
"Bolivia","Santa Cruz","Andrés Ibáñez","Santa Cruz de la Sierra","COL. VIRGEN DE COTOCA",-63.1789,-17.74445,463,14,3401,3864,2656,37,694,3350
"Bolivia","Santa Cruz","Andrés Ibáñez","Santa Cruz de la Sierra","COL.WENSESLAO MONTERO",-63.15583,-17.76315,370,12,2532,2902,2121,53,346,2467
"Bolivia","Santa Cruz","Andrés Ibáñez","Santa Cruz de la Sierra","ESC. APONTE TINEO(ESC.GREGORIO MORENO)",-63.18357,-17.76609,245,3,1632,1877,1412,54,163,1575
"Bolivia","Santa Cruz","Andrés Ibáñez","Santa Cruz de la Sierra","ESC.BERNARDO CADARIO(COL.KURT RICHTER)",-63.19029,-17.74906,537,11,2828,3365,2099,70,648,2747
"Bolivia","Santa Cruz","Andrés Ibáñez","Santa Cruz de la Sierra","ESC. CLARACUTA",-63.15587,-17.73351,342,10,2088,2430,1626,49,403,2029
"Bolivia","Santa Cruz","Andrés Ibáñez","Santa Cruz de la Sierra","ESC. GABRIEL JOSE MORENO",-62.94179,-17.88486,170,32,1584,1754,1141,42,369,1510
"Bolivia","Santa Cruz","Andrés Ibáñez","Santa Cruz de la Sierra","ESC. GERMAN BUSCH",-63.1716,-17.73681,401,6,2476,2877,1995,55,420,2415
"Bolivia","Santa Cruz","Andrés Ibáñez","Santa Cruz de la Sierra","ESC.HUGO BANZER SUAREZ",-63.1536,-17.88131,164,10,1245,1409,597,29,609,1206
"Bolivia","Santa Cruz","Andrés Ibáñez","Santa Cruz de la Sierra","ESC. JOSE MARIANO SERRANO",-63.16407,-17.72271,212,3,1279,1491,1103,12,161,1264
"Bolivia","Santa Cruz","Andrés Ibáñez","Santa Cruz de la Sierra","ESC. LA PEÑA",-62.96586,-17.96183,138,12,741,879,95,28,606,701
"Bolivia","Santa Cruz","Andrés Ibáñez","Santa Cruz de la Sierra","ESC LOS SAUCES I",-63.17955,-17.72833,408,10,2328,2736,1633,63,622,2255
"Bolivia","Santa Cruz","Andrés Ibáñez","Santa Cruz de la Sierra","ESC.MAMERTO CUELLAR COSTA",-63.16402,-17.69388,246,9,1758,2004,1254,46,449,1703
"Bolivia","Santa Cruz","Andrés Ibáñez","Santa Cruz de la Sierra","ESC. NORMAL ENRIQUET  FINOT",-63.19629,-17.76357,709,2,3948,4657,3621,20,305,3926
"Bolivia","Santa Cruz","Andrés Ibáñez","Santa Cruz de la Sierra","ESC. REAL AMERICA(ESC.F.FLORIDA)",-63.14962,-17.74375,237,4,1785,2022,1336,27,418,1754
"Bolivia","Santa Cruz","Andrés Ibáñez","Santa Cruz de la Sierra","ESC. RENE BARRIENTOS",-63.19794,-17.77104,590,10,3093,3683,2349,44,690,3039
"Bolivia","Santa Cruz","Andrés Ibáñez","Santa Cruz de la Sierra","ESC. SECCIONAL VILLA FLOR",-63.12761,-17.91508,92,11,643,735,324,20,288,612
"Bolivia","Santa Cruz","Andrés Ibáñez","Santa Cruz de la Sierra","ESC.SOLIDARIDAD 55",-63.09384,-17.88467,644,32,4023,4667,1800,199,1992,3792
"Bolivia","Santa Cruz","Andrés Ibáñez","Santa Cruz de la Sierra","ESCUELA 1RO DE MAYO",-63.12766,-17.79881,226,7,1399,1625,1031,62,299,1330
"Bolivia","Santa Cruz","Andrés Ibáñez","Santa Cruz de la Sierra","ESCUELA 23 DE MARZO",-63.14704,-17.71829,544,17,2990,3534,1885,104,984,2869
"Bolivia","Santa Cruz","Andrés Ibáñez","Santa Cruz de la Sierra","ESCUELA ADOLFO ROMAN HIJO",-62.82351,-17.6432,180,9,1323,1503,805,61,448,1253
"Bolivia","Santa Cruz","Andrés Ibáñez","Santa Cruz de la Sierra","ESCUELA CANOTO",-63.19444,-17.78442,162,3,1077,1239,867,14,193,1060
"Bolivia","Santa Cruz","Andrés Ibáñez","Santa Cruz de la Sierra","ESCUELA KM 9",-63.15509,-17.6916,574,11,3766,4340,2661,110,984,3645
"Bolivia","Santa Cruz","Andrés Ibáñez","Santa Cruz de la Sierra","ESCUELA NUEVA AURORA",-62.8249,-17.57719,40,0,63,103,48,3,12,60
"Bolivia","Santa Cruz","Andrés Ibáñez","Santa Cruz de la Sierra","ESCUELA PRIMAVERA",-63.1032,-17.81673,121,7,508,629,337,11,153,490
"Bolivia","Santa Cruz","Andrés Ibáñez","Santa Cruz de la Sierra","ESCUELA SAN CARLOS",-63.18186,-17.7572,467,7,2738,3205,2256,39,436,2692
"Bolivia","Santa Cruz","Andrés Ibáñez","Santa Cruz de la Sierra","ESCUELA SAN JOAQUIN",-63.13668,-17.72238,354,15,2179,2533,1317,129,718,2035
"Bolivia","Santa Cruz","Andrés Ibáñez","Santa Cruz de la Sierra","ESCUELA SECCIONAL GUAPILO",-63.08126,-17.74644,401,16,2227,2628,1374,81,756,2130
"Bolivia","Santa Cruz","Andrés Ibáñez","Santa Cruz de la Sierra","ESCUELA SECCIONAL ZAFRANILLA",-63.00508,-17.62794,43,2,314,357,199,9,104,303
"Bolivia","Santa Cruz","Andrés Ibáñez","Santa Cruz de la Sierra","ESC. USURI APONTE",-63.05743,-17.92564,60,2,218,278,132,7,77,209
"Bolivia","Santa Cruz","Andrés Ibáñez","Santa Cruz de la Sierra","ESC VILLA NORTE",-63.18038,-17.74704,265,5,1467,1732,1193,13,256,1449
"Bolivia","Santa Cruz","Andrés Ibáñez","Santa Cruz de la Sierra","ESC..ZENOVIA APONTE",-63.10257,-17.87117,277,11,1687,1964,782,39,855,1637
"Bolivia","Santa Cruz","Andrés Ibáñez","Santa Cruz de la Sierra","FACULTAD DE CIENCIAS AGRICOLAS UAGRM",-63.14874,-17.69814,22,2,303,325,207,8,86,293
"Bolivia","Santa Cruz","Andrés Ibáñez","Santa Cruz de la Sierra","FRED NUÑEZ GONZALES",-63.06961,-17.71776,88,9,1011,1099,453,26,523,976
"Bolivia","Santa Cruz","Andrés Ibáñez","Santa Cruz de la Sierra","GLADYS RIVERO DE JIMENEZ",-63.20806,-17.77348,469,14,3062,3531,2000,229,819,2819
"Bolivia","Santa Cruz","Andrés Ibáñez","Santa Cruz de la Sierra","KINDER CARIÑOSITO",-63.21444,-17.8494,1,0,3,4,2,0,1,3
"Bolivia","Santa Cruz","Andrés Ibáñez","Santa Cruz de la Sierra","KINDER FERROVIARIO",-63.145,-17.781,2,0,19,21,12,0,7,19
"Bolivia","Santa Cruz","Andrés Ibáñez","Santa Cruz de la Sierra","KINDER GUARDERIA EL CARMEN",-63.20383,-17.77054,1,1,48,49,39,2,6,45
"Bolivia","Santa Cruz","Andrés Ibáñez","Santa Cruz de la Sierra","KINDER LIBERTAD",-63.12066,-17.80011,0,0,9,9,7,1,1,8
"Bolivia","Santa Cruz","Andrés Ibáñez","Santa Cruz de la Sierra","KINDER LUISA SAUCEDO",-63.18323,-17.77909,103,0,758,861,677,5,76,753
"Bolivia","Santa Cruz","Andrés Ibáñez","Santa Cruz de la Sierra","KINDER NIMIA CENTELLA",-63.11775,-17.78436,0,0,45,45,31,10,4,35
"Bolivia","Santa Cruz","Andrés Ibáñez","Santa Cruz de la Sierra","LUZ DEL MUNDO C",-63.1118,-17.77199,10,0,142,152,98,0,44,142
"Bolivia","Santa Cruz","Andrés Ibáñez","Santa Cruz de la Sierra","MISIONES DE JESUS",-63.21696,-17.84764,0,1,285,285,130,53,101,231
"Bolivia","Santa Cruz","Andrés Ibáñez","Santa Cruz de la Sierra","MODULO EDUCATIVO 24 DE SEPTIEMBRE",-63.20504,-17.81955,28,1,110,138,73,4,32,105
"Bolivia","Santa Cruz","Andrés Ibáñez","Santa Cruz de la Sierra","MODULO EDUCATIVO 3 LAGUNAS",-63.1305,-17.80221,286,14,1915,2201,1082,40,779,1861
"Bolivia","Santa Cruz","Andrés Ibáñez","Santa Cruz de la Sierra","MODULO EDUCATIVO CENETROP",-63.17531,-17.86828,6,0,53,59,32,1,20,52
"Bolivia","Santa Cruz","Andrés Ibáñez","Santa Cruz de la Sierra","MODULO EDUCATIVO GERMAN BUSCH",-63.17423,-17.73516,13,2,151,164,126,2,21,147
"Bolivia","Santa Cruz","Andrés Ibáñez","Santa Cruz de la Sierra","MODULO EDUCATIVO JARDIN LATINO",-63.22685,-17.81104,0,0,65,65,52,3,10,62
"Bolivia","Santa Cruz","Andrés Ibáñez","Santa Cruz de la Sierra","MODULO EDUCATIVO JOSE MIGUEL DE VELASCO",-63.18459,-17.75368,703,54,4506,5209,3568,115,769,4337
"Bolivia","Santa Cruz","Andrés Ibáñez","Santa Cruz de la Sierra","MODULO EDUCATIVO MARIA DE MATTIAS",-63.19329,-17.84451,5,0,79,84,57,1,21,78
"Bolivia","Santa Cruz","Andrés Ibáñez","Santa Cruz de la Sierra","MODULO EDUCATIVO REPUBLICA DE COLOMBIA",-63.20602,-17.86002,18,4,196,214,84,0,108,192
"Bolivia","Santa Cruz","Andrés Ibáñez","Santa Cruz de la Sierra","MODULO RANCHO NUEVO",-63.12128,-17.74573,256,9,1188,1444,735,28,416,1151
"Bolivia","Santa Cruz","Andrés Ibáñez","Santa Cruz de la Sierra","MOTACUSAL",-63.10342,-17.68219,0,1,176,176,14,46,115,129
"Bolivia","Santa Cruz","Andrés Ibáñez","Santa Cruz de la Sierra","NACIONES UNIDAS",-63.17759,-17.7325,532,11,3355,3887,2418,150,776,3194
"Bolivia","Santa Cruz","Andrés Ibáñez","Santa Cruz de la Sierra","PEDRO DIEZ",-63.18398,-17.85394,31,0,133,164,83,2,48,131
"Bolivia","Santa Cruz","Andrés Ibáñez","Santa Cruz de la Sierra","PROGRESO",-63.13077,-17.72208,27,1,147,174,99,4,43,142
"Bolivia","Santa Cruz","Andrés Ibáñez","Santa Cruz de la Sierra","SAHARA GUARDIA",-63.20287,-17.85209,35,7,616,651,413,32,164,577
"Bolivia","Santa Cruz","Andrés Ibáñez","Santa Cruz de la Sierra","U.E. 18 DE JULIO",-63.0932,-17.7454,149,7,1028,1177,520,59,442,962
"Bolivia","Santa Cruz","Andrés Ibáñez","Santa Cruz de la Sierra","U.E 19 DE MARZO",-63.08685,-17.86819,16,1,294,310,91,1,201,292
"Bolivia","Santa Cruz","Andrés Ibáñez","Santa Cruz de la Sierra","U.E. 24 DE MARZO",-63.10131,-17.72942,16,1,153,169,51,6,95,146
"Bolivia","Santa Cruz","Andrés Ibáñez","Santa Cruz de la Sierra","U.E. 25 DE OCTUBRE",-63.0919,-17.81277,29,1,294,323,117,38,138,255
"Bolivia","Santa Cruz","Andrés Ibáñez","Santa Cruz de la Sierra","U.E. 26 DE JUNIO",-63.10215,-17.84533,37,2,245,282,100,9,134,234
"Bolivia","Santa Cruz","Andrés Ibáñez","Santa Cruz de la Sierra","U.E. 26 DE NOVIEMBRE",-63.13193,-17.73059,9,0,91,100,62,1,28,90
"Bolivia","Santa Cruz","Andrés Ibáñez","Santa Cruz de la Sierra","U.E. 2 DE ABRIL",-63.14366,-17.81759,17,1,111,128,86,3,21,107
"Bolivia","Santa Cruz","Andrés Ibáñez","Santa Cruz de la Sierra","UE 3 DE MAYO",-63.12704,-17.82614,95,7,635,730,284,19,325,609
"Bolivia","Santa Cruz","Andrés Ibáñez","Santa Cruz de la Sierra","U.E. APONTE DE JORORI",-63.02875,-17.88749,122,15,709,831,249,40,405,654
"Bolivia","Santa Cruz","Andrés Ibáñez","Santa Cruz de la Sierra","U.E. ARBOLEDA DE FATIMA",-63.09396,-17.77194,60,7,638,698,386,63,182,568
"Bolivia","Santa Cruz","Andrés Ibáñez","Santa Cruz de la Sierra","U.E. ARCA DE NOE",-63.0994,-17.74709,0,39,1073,1073,561,123,350,911
"Bolivia","Santa Cruz","Andrés Ibáñez","Santa Cruz de la Sierra","U.E. BIBOSI",-63.10976,-17.72477,16,1,109,125,53,2,53,106
"Bolivia","Santa Cruz","Andrés Ibáñez","Santa Cruz de la Sierra","U.E. CIELITO LINDO",-63.10667,-17.77039,97,39,1192,1289,746,61,346,1092
"Bolivia","Santa Cruz","Andrés Ibáñez","Santa Cruz de la Sierra","U.E. CLARA SERRANO",-63.06764,-17.69809,10,2,136,146,66,0,68,134
"Bolivia","Santa Cruz","Andrés Ibáñez","Santa Cruz de la Sierra","UE DOMINGO FAUSTINO",-63.1547,-17.78424,203,11,1367,1570,1142,21,193,1335
"Bolivia","Santa Cruz","Andrés Ibáñez","Santa Cruz de la Sierra","U.E. EL ARENAL C",-63.12381,-17.76286,0,3,29,29,10,0,16,26
"Bolivia","Santa Cruz","Andrés Ibáñez","Santa Cruz de la Sierra","U.E. HACIA LA CUMBRE",-63.13114,-17.79115,15,0,67,82,52,0,15,67
"Bolivia","Santa Cruz","Andrés Ibáñez","Santa Cruz de la Sierra","U.E. ISUTO",-63.19371,-17.74409,77,1,524,601,385,16,122,507
"Bolivia","Santa Cruz","Andrés Ibáñez","Santa Cruz de la Sierra","U.E. JOSEFINA BALSAMO CORDECRUZ",-63.13193,-17.73059,2,0,25,27,20,2,3,23
"Bolivia","Santa Cruz","Andrés Ibáñez","Santa Cruz de la Sierra","U.E. JOSEFINA BALSAMO LOS PINOS",-63.13827,-17.73302,10,3,107,117,67,0,37,104
"Bolivia","Santa Cruz","Andrés Ibáñez","Santa Cruz de la Sierra","U.E. LOS CUSIS",-63.07648,-17.73135,106,9,849,955,516,58,266,782
"Bolivia","Santa Cruz","Andrés Ibáñez","Santa Cruz de la Sierra","U.E. LUIS ANTONIO AÑEZ CAMPOS",-63.12105,-17.83816,18,0,117,135,49,4,64,113
"Bolivia","Santa Cruz","Andrés Ibáñez","Santa Cruz de la Sierra","U.E. MANANTIAL DE VIDA",-63.07259,-17.85223,64,8,804,868,307,17,472,779
"Bolivia","Santa Cruz","Andrés Ibáñez","Santa Cruz de la Sierra","U.E. MANOS UNIDAS",-63.12869,-17.83705,6,0,30,36,13,1,16,29
"Bolivia","Santa Cruz","Andrés Ibáñez","Santa Cruz de la Sierra","U.E. MARIA DE LAS CANDELARIAS",-63.11254,-17.78087,0,0,3,3,3,0,0,3
"Bolivia","Santa Cruz","Andrés Ibáñez","Santa Cruz de la Sierra","U.E. MATEO KULJIS LLIC II",-63.22541,-17.83761,19,2,65,84,35,3,25,60
"Bolivia","Santa Cruz","Andrés Ibáñez","Santa Cruz de la Sierra","U.E. MIGUEL APONTE",-63.02794,-17.93152,1,0,3,4,3,0,0,3
"Bolivia","Santa Cruz","Andrés Ibáñez","Santa Cruz de la Sierra","U.E. NESTOR PAZ ZAMORA",-63.16751,-17.82976,35,5,249,284,157,2,85,242
"Bolivia","Santa Cruz","Andrés Ibáñez","Santa Cruz de la Sierra","U.E. PALMAR DEL ORIENTE",-63.16326,-17.84556,0,0,38,38,23,4,11,34
"Bolivia","Santa Cruz","Andrés Ibáñez","Santa Cruz de la Sierra","U.E. PASTORCITO DE FÁTIMA (DON BOSCO)",-63.19865,-17.77891,5,0,32,37,27,0,5,32
"Bolivia","Santa Cruz","Andrés Ibáñez","Santa Cruz de la Sierra","U.E. REP. DEL PARAGUAY",-63.19029,-17.74906,9,0,74,83,38,6,30,68
"Bolivia","Santa Cruz","Andrés Ibáñez","Santa Cruz de la Sierra","U.E. SAN CAYETANO",-63.08637,-17.73178,122,9,946,1068,529,14,394,923
"Bolivia","Santa Cruz","Andrés Ibáñez","Santa Cruz de la Sierra","U.E. SAN DIEGO DE SAMARIA",-63.07624,-17.84651,39,0,237,276,99,3,135,234
"Bolivia","Santa Cruz","Andrés Ibáñez","Santa Cruz de la Sierra","U.E. SAN JUAN BAUTISTA",-63.084,-17.82422,27,2,323,350,143,9,169,312
"Bolivia","Santa Cruz","Andrés Ibáñez","Santa Cruz de la Sierra","U.E. SAN JUAN DEL ESTE",-63.05619,-17.85738,15,1,80,95,36,2,41,77
"Bolivia","Santa Cruz","Andrés Ibáñez","Santa Cruz de la Sierra","U.E. SAN MIGUEL APONTE",-63.02491,-17.91358,4,6,133,137,73,2,52,125
"Bolivia","Santa Cruz","Andrés Ibáñez","Santa Cruz de la Sierra","U.E. SANTA ANA C",-63.22587,-17.82052,19,0,118,137,66,2,50,116
"Bolivia","Santa Cruz","Andrés Ibáñez","Santa Cruz de la Sierra","U.E. SANTA CRUZ DE LA SIERRA",-63.15969,-17.70646,415,6,3367,3782,2847,58,456,3303
"Bolivia","Santa Cruz","Andrés Ibáñez","Santa Cruz de la Sierra","U.E. SEÑOR DE LOS MILAGROS",-63.11103,-17.73937,0,0,124,124,69,12,43,112
"Bolivia","Santa Cruz","Andrés Ibáñez","Santa Cruz de la Sierra","U.E. SIXTO SUAREZ NAVARRO",-63.08702,-17.83393,23,7,321,344,119,8,187,306
"Bolivia","Santa Cruz","Andrés Ibáñez","Santa Cruz de la Sierra","U.E. SIXTO SUAREZ NAVARRO",-63.08702,-17.83391,23,7,321,344,119,8,187,306
"Bolivia","Santa Cruz","Andrés Ibáñez","Santa Cruz de la Sierra","U.E. THEVENET DE VIANA",-63.05536,-17.87156,17,7,275,292,122,5,141,263
"Bolivia","Santa Cruz","Andrés Ibáñez","Santa Cruz de la Sierra","UE UNION Y PROGRESO",-63.20576,-17.82713,633,27,3331,3964,1659,127,1518,3177
"Bolivia","Santa Cruz","Andrés Ibáñez","Santa Cruz de la Sierra","U.E. VICTORIA",-63.10123,-17.8158,35,1,113,148,55,1,56,111
"Bolivia","Santa Cruz","Andrés Ibáñez","Santa Cruz de la Sierra","U.E. VICTORIA DIEZ",-63.19228,-17.87336,2,0,37,39,21,5,11,32
"Bolivia","Santa Cruz","Andrés Ibáñez","Santa Cruz de la Sierra","U.E. VILLA ALBA",-63.11149,-17.76056,4,1,12,16,7,0,4,11
"Bolivia","Santa Cruz","Andrés Ibáñez","Santa Cruz de la Sierra","U.E. VILLA MODERNA",-63.08892,-17.84801,59,10,444,503,158,7,269,427
"Bolivia","Santa Cruz","Andrés Ibáñez","Santa Cruz de la Sierra","U.E. ZARAGOZA",-63.0803,-17.73039,71,5,839,910,460,27,347,807
"Bolivia","Santa Cruz","Andrés Ibáñez","Santa Cruz de la Sierra","UNIDAD EDUCATIVA POMPEYA SANTISIMO REDENTOR",-63.13646,-17.73572,1180,25,6120,7300,3745,175,2175,5920
"Bolivia","Santa Cruz","Andrés Ibáñez","Santa Cruz de la Sierra","UNIDAD EDUCATIVA SAN JORGE NORTE",-63.18151,-17.74152,366,6,2032,2398,1567,47,412,1979
"Bolivia","Santa Cruz","Andrés Ibáñez","Santa Cruz de la Sierra","UNIDAD EDUCATIVA SAN JUAN",-63.15163,-17.71595,101,5,661,762,458,19,179,637
"Bolivia","Santa Cruz","Andrés Ibáñez","Santa Cruz de la Sierra","UNIVERSITARIO SUR",-63.20155,-17.84228,11,2,203,214,138,10,53,191
"Bolivia","Santa Cruz","Andrés Ibáñez","Santa Cruz de la Sierra","URKUPIÑA",-63.10837,-17.74188,39,51,579,618,278,20,230,508
"Bolivia","Santa Cruz","Andrés Ibáñez","Santa Cruz de la Sierra","VIRGEN DE GUADALUPE",-63.12177,-17.72815,178,21,1962,2140,1155,89,697,1852
"Bolivia","Santa Cruz","Ángel Sandoval","San Matías","ESC. BENJAMIN CATACORA",-59.44956,-16.31998,104,6,544,648,294,40,204,498
"Bolivia","Santa Cruz","Ángel Sandoval","San Matías","ESC. LAS PETAS",-58.39948,-16.36022,94,4,318,412,206,3,105,311
"Bolivia","Santa Cruz","Ángel Sandoval","San Matías","ESC. SAN FERNANDO",-58.50947,-17.16588,29,0,41,70,32,0,9,41
"Bolivia","Santa Cruz","Ángel Sandoval","San Matías","ESC. SANTA ISABEL",-58.64299,-16.41756,15,0,96,111,24,1,71,95
"Bolivia","Santa Cruz","Ángel Sandoval","San Matías","ESC. SANTO CORAZON",-58.80663,-17.97362,65,1,218,283,144,3,70,214
"Bolivia","Santa Cruz","Ángel Sandoval","San Matías","ESC. SECCIONAL CANDELARIA",-58.98688,-18.62612,92,1,259,351,132,5,121,253
"Bolivia","Santa Cruz","Ángel Sandoval","San Matías","ESC. U.E. EMILIA RODAT",-58.40152,-16.35967,635,77,2354,2989,1139,27,1111,2250
"Bolivia","Santa Cruz","Ángel Sandoval","San Matías","ESC. U.E.TECNICA VOCACIONAL",-58.40529,-16.36109,559,83,1882,2441,855,36,908,1763
"Bolivia","Santa Cruz","Chiquitos","Pailón","ESC. 25 DE MAYO (CHIQUITOS)",-62.72187,-17.665,7,2,97,104,18,4,73,91
"Bolivia","Santa Cruz","Chiquitos","Pailón","ESC. 3 DE MAYO",-62.71723,-17.65756,240,24,1005,1245,435,32,514,949
"Bolivia","Santa Cruz","Chiquitos","Pailón","ESC. EL TINTO",-61.51249,-17.66647,41,1,104,145,58,2,43,101
"Bolivia","Santa Cruz","Chiquitos","Pailón","ESC. EMILIO SUNCER SALINAS",-61.98844,-17.60188,99,4,358,457,159,6,189,348
"Bolivia","Santa Cruz","Chiquitos","Pailón","ESC. FE ALEGRIA",-62.72065,-17.65843,1615,81,7072,8687,4100,231,2660,6760
"Bolivia","Santa Cruz","Chiquitos","Pailón","ESC. MUNICIPAL ROSAL CENTRO",-62.68006,-17.93407,80,3,517,597,281,14,219,500
"Bolivia","Santa Cruz","Chiquitos","Pailón","ESC. POZA VERDE",-62.70517,-17.71927,18,0,93,111,17,3,73,90
"Bolivia","Santa Cruz","Chiquitos","Pailón","ESC. PUESTO PAZ",-62.44294,-17.48613,0,2,75,75,20,15,38,58
"Bolivia","Santa Cruz","Chiquitos","Pailón","ESC. SECCIONAL CAÑADA LARGA",-62.49146,-17.64193,57,2,278,335,167,2,107,274
"Bolivia","Santa Cruz","Chiquitos","Pailón","ESCUELA TUNAS NUEVO",-61.71287,-17.63908,195,9,605,800,105,8,483,588
"Bolivia","Santa Cruz","Chiquitos","Pailón","U.E. 12 DE OCTUBRE",-61.51058,-17.54329,0,1,39,39,26,0,12,38
"Bolivia","Santa Cruz","Chiquitos","Pailón","U.E. ING. JORGE MAURICIO ROJAS P.",-62.76874,-17.66311,9,3,129,138,85,4,37,122
"Bolivia","Santa Cruz","Chiquitos","Roboré","ESC. DON BOSCO",-59.75139,-18.33508,506,10,1459,1965,962,17,470,1432
"Bolivia","Santa Cruz","Chiquitos","Roboré","ESC. GUIDO OSWALDO SUANZO",-59.75161,-18.33875,343,17,1223,1566,824,15,367,1191
"Bolivia","Santa Cruz","Chiquitos","Roboré","ESC. LOS SOTOS",-59.8557,-18.24889,19,0,90,109,38,1,51,89
"Bolivia","Santa Cruz","Chiquitos","Roboré","ESC. MARISTA",-59.75665,-18.34039,455,11,1400,1855,909,18,462,1371
"Bolivia","Santa Cruz","Chiquitos","Roboré","ESC. NAPOLEON MONTERO MONTERO",-59.59888,-18.33945,176,7,616,792,463,5,141,604
"Bolivia","Santa Cruz","Chiquitos","Roboré","ESC. SAGRADA FAMILIA",-59.75781,-18.33087,484,17,1757,2241,1185,43,512,1697
"Bolivia","Santa Cruz","Chiquitos","Roboré","ESC. SAN ANTONIO DEL POTRERO",-59.74802,-18.342,8,1,45,53,13,1,30,43
"Bolivia","Santa Cruz","Chiquitos","Roboré","ESC. SECCIONAL AGUAS CALIENTES",-59.50294,-18.45304,55,5,346,401,108,12,221,329
"Bolivia","Santa Cruz","Chiquitos","Roboré","ESC.SECCIONAL CHOCHIS",-60.03102,-18.14897,94,3,453,547,350,8,92,442
"Bolivia","Santa Cruz","Chiquitos","San José de Chiquitos","ESC. EDUCACIONAL TAPERAS",-62.70883,-17.65825,113,6,445,558,267,8,164,431
"Bolivia","Santa Cruz","Chiquitos","San José de Chiquitos","ESC. GERMAN BUSCH",-60.74323,-17.84692,794,15,2574,3368,1633,53,873,2506
"Bolivia","Santa Cruz","Chiquitos","San José de Chiquitos","ESC. LEONOR RIVERA",-60.7432,-17.83881,673,19,2279,2952,1367,33,860,2227
"Bolivia","Santa Cruz","Chiquitos","San José de Chiquitos","ESC.MUNICIPAL",-61.17406,-17.70868,29,1,233,262,140,4,88,228
"Bolivia","Santa Cruz","Chiquitos","San José de Chiquitos","ESC. NUEVO HORIZONTE",-60.73072,-17.43794,0,15,75,75,40,0,20,60
"Bolivia","Santa Cruz","Chiquitos","San José de Chiquitos","ESC. SAN JUAN",-59.93511,-17.77805,129,6,304,433,169,1,128,297
"Bolivia","Santa Cruz","Chiquitos","San José de Chiquitos","ESC. SANTA TERESITA",-60.49098,-17.94919,0,0,13,13,0,0,13,13
"Bolivia","Santa Cruz","Chiquitos","San José de Chiquitos","ESC. UNZAGA DE LA VEGA",-60.73931,-17.84642,603,63,2603,3206,1663,52,825,2488
"Bolivia","Santa Cruz","Chiquitos","San José de Chiquitos","U.E. BUENA VISTA",-59.97245,-17.82214,12,2,166,178,98,3,63,161
"Bolivia","Santa Cruz","Chiquitos","San José de Chiquitos","U.E. RAMADA",-60.05825,-18.00214,2,1,41,43,22,1,17,39
"Bolivia","Santa Cruz","Cordillera","Boyuibe","ESC. CENTRAL RAFAEL PABON",-63.28176,-20.43133,615,20,1770,2385,806,55,889,1695
"Bolivia","Santa Cruz","Cordillera","Boyuibe","ESC. SECC. CHOROQUETAL LA ELE",-62.71613,-20.43031,11,0,13,24,8,0,5,13
"Bolivia","Santa Cruz","Cordillera","Boyuibe","ESC. SECC. POZO DE MONTE",-63.21899,-20.28442,0,1,85,85,25,13,46,71
"Bolivia","Santa Cruz","Cordillera","Cabezas","ESC. 12 DE ABRIL",-63.21368,-18.45699,296,37,1584,1880,796,61,690,1486
"Bolivia","Santa Cruz","Cordillera","Cabezas","ESC. COTOCA (CORDILLERA)",-63.19016,-18.28279,10,1,82,92,65,1,15,80
"Bolivia","Santa Cruz","Cordillera","Cabezas","ESC. EDUARDO ABAROA",-63.42406,-18.29929,20,2,178,198,77,25,74,151
"Bolivia","Santa Cruz","Cordillera","Cabezas","ESC. PAMPA DEL COSCAL",-63.31197,-18.78212,48,2,226,274,68,10,146,214
"Bolivia","Santa Cruz","Cordillera","Cabezas","ESC. PTO. CAMACHO",-63.39868,-18.90593,301,26,1630,1931,899,68,637,1536
"Bolivia","Santa Cruz","Cordillera","Cabezas","ESC. RIO SECO FLORIDA",-63.24144,-18.67221,93,3,413,506,207,28,175,382
"Bolivia","Santa Cruz","Cordillera","Cabezas","ESC. SANTA ROSA",-63.00379,-18.31618,30,3,145,175,74,1,67,141
"Bolivia","Santa Cruz","Cordillera","Cabezas","ESC. SECC. EL CURICHI",-63.18411,-18.36359,15,0,105,120,68,6,31,99
"Bolivia","Santa Cruz","Cordillera","Cabezas","ESC. SECCIONAL EL FILO",-63.31801,-18.78696,0,1,22,22,20,0,1,21
"Bolivia","Santa Cruz","Cordillera","Cabezas","ESC. SECCIONAL PUEBLO VIEJO",-63.32113,-18.79173,66,8,221,287,116,2,95,211
"Bolivia","Santa Cruz","Cordillera","Cabezas","ESC. SECC SAN FRANCISCO DE ASIS",-62.9499,-18.13124,75,8,297,372,97,11,181,278
"Bolivia","Santa Cruz","Cordillera","Cabezas","ESC. SERAFIN RODRIGUEZ",-63.31145,-18.78667,419,19,1402,1821,760,94,529,1289
"Bolivia","Santa Cruz","Cordillera","Cabezas","ESC. YATIRENDA",-63.22488,-18.60128,11,3,196,207,147,4,42,189
"Bolivia","Santa Cruz","Cordillera","Cabezas","ESC. ZANJA HONDA",-63.30159,-18.78745,219,23,1238,1457,611,41,563,1174
"Bolivia","Santa Cruz","Cordillera","Camiri","AULAS U.A.G.R.M.",-63.52124,-20.03783,635,37,2928,3563,1600,107,1184,2784
"Bolivia","Santa Cruz","Cordillera","Camiri","COL. HUGO ARTEAGA",-63.51498,-20.03587,214,14,968,1182,600,25,329,929
"Bolivia","Santa Cruz","Cordillera","Camiri","ESC. 12 DE JULIO",-63.53097,-20.04149,431,27,2244,2675,1228,122,867,2095
"Bolivia","Santa Cruz","Cordillera","Camiri","ESC. 16 DE MARZO",-63.52925,-20.04896,254,22,1233,1487,640,50,521,1161
"Bolivia","Santa Cruz","Cordillera","Camiri","ESC. 24 DE SEPTIEMBRE",-63.5203,-20.04004,370,17,1891,2261,1173,60,641,1814
"Bolivia","Santa Cruz","Cordillera","Camiri","ESC. ABEL ITURRALDE",-63.52305,-20.04487,309,11,1455,1764,906,35,503,1409
"Bolivia","Santa Cruz","Cordillera","Camiri","ESC. APONTE J. MANUEL O.H. DEL CHACO",-63.52154,-20.04499,240,15,1528,1768,949,36,528,1477
"Bolivia","Santa Cruz","Cordillera","Camiri","ESC. CENTRAL DE ITANAMBIKUA",-63.51152,-20.01815,70,15,484,554,109,26,334,443
"Bolivia","Santa Cruz","Cordillera","Camiri","ESC. CENTRAL URBANA",-63.53619,-20.01045,231,14,718,949,327,20,357,684
"Bolivia","Santa Cruz","Cordillera","Camiri","ESC. CRISTIANA EVANGELICA",-63.52061,-20.04179,153,7,889,1042,590,17,275,865
"Bolivia","Santa Cruz","Cordillera","Camiri","ESC. GABRIEL RENE MORENO",-63.52212,-20.03892,393,15,1646,2039,957,42,632,1589
"Bolivia","Santa Cruz","Cordillera","Camiri","ESC. JOSE CASTRILLO",-63.52077,-20.03724,301,18,1404,1705,708,42,636,1344
"Bolivia","Santa Cruz","Cordillera","Camiri","ESC. NIÑO JESUS",-63.51853,-20.04194,165,7,916,1081,635,21,253,888
"Bolivia","Santa Cruz","Cordillera","Camiri","ESC. SECC. CURUNDAITY",-63.52541,-19.96275,39,5,284,323,44,4,231,275
"Bolivia","Santa Cruz","Cordillera","Camiri","ESC. SECC. GUIRARAPO",-63.48684,-20.09914,18,2,120,138,41,5,72,113
"Bolivia","Santa Cruz","Cordillera","Camiri","ESC. SECC. IMBOCHI",-63.51324,-20.06726,19,9,114,133,36,3,66,102
"Bolivia","Santa Cruz","Cordillera","Camiri","ESC. SECCIONAL EL RODEO",-63.41266,-19.96312,31,9,205,236,31,13,152,183
"Bolivia","Santa Cruz","Cordillera","Camiri","ESC. SECCIONAL PIPI",-63.42315,-20.08308,37,2,147,184,22,2,121,143
"Bolivia","Santa Cruz","Cordillera","Camiri","ESC. SECC. PUENTE VIEJO",-63.54469,-20.01106,36,9,185,221,49,5,122,171
"Bolivia","Santa Cruz","Cordillera","Charagua","ESC. 25 DE MAYO",-62.11812,-18.4546,47,0,79,126,12,1,66,78
"Bolivia","Santa Cruz","Cordillera","Charagua","ESC. CENTRAL IYOBI",-63.14491,-19.7853,129,14,596,725,249,13,320,569
"Bolivia","Santa Cruz","Cordillera","Charagua","ESC. COOPERE BRECHA",-62.7429,-19.42522,146,6,419,565,105,14,294,399
"Bolivia","Santa Cruz","Cordillera","Charagua","ESC. ENRIQUE QUINTELA",-63.18414,-20.00909,116,10,549,665,228,14,297,525
"Bolivia","Santa Cruz","Cordillera","Charagua","ESC. ESTACION CHARAGUA",-63.1487,-19.78266,181,15,819,1000,392,22,390,782
"Bolivia","Santa Cruz","Cordillera","Charagua","ESC. NUCLEO ESCOLAR LA BRECHA",-62.7429,-19.42522,150,8,547,697,188,10,341,529
"Bolivia","Santa Cruz","Cordillera","Charagua","ESC. NUEVA ESPERANZA",-63.20002,-19.79183,53,0,84,137,19,1,64,83
"Bolivia","Santa Cruz","Cordillera","Charagua","ESC. OKITA",-63.2003,-19.79011,16,2,72,88,10,0,60,70
"Bolivia","Santa Cruz","Cordillera","Charagua","ESC. PUEBLO NUEVO PARAPETI",-63.13974,-19.98935,31,3,163,194,63,8,89,152
"Bolivia","Santa Cruz","Cordillera","Charagua","ESC. SECC. CENTRAL MASAVI",-63.19563,-19.79061,63,14,348,411,84,9,241,325
"Bolivia","Santa Cruz","Cordillera","Charagua","ESC. SECC. DE KAIPEPE",-63.19104,-19.79076,29,5,264,293,72,7,180,252
"Bolivia","Santa Cruz","Cordillera","Charagua","ESC. SECC. EL ESPINO",-63.32734,-19.21872,47,8,394,441,54,8,324,378
"Bolivia","Santa Cruz","Cordillera","Charagua","ESC. SECC. HUARIRENDA NUEVA",-63.19857,-19.78299,120,7,310,430,104,6,193,297
"Bolivia","Santa Cruz","Cordillera","Charagua","ESC. SECCIONAL ISIPORENDA",-62.5005,-19.24791,49,0,112,161,28,2,82,110
"Bolivia","Santa Cruz","Cordillera","Charagua","ESC. SECCIONAL ITATIQUE",-63.17703,-19.99888,11,0,82,93,8,1,73,81
"Bolivia","Santa Cruz","Cordillera","Charagua","ESC. SECCIONAL SAN F. DE PARAPETI",-63.17523,-19.99946,36,7,144,180,43,2,92,135
"Bolivia","Santa Cruz","Cordillera","Charagua","ESC. SECCIONAL SAN LORENZO",-63.12445,-19.649,19,0,87,106,36,4,47,83
"Bolivia","Santa Cruz","Cordillera","Charagua","ESC. SECC. RANCHO NUEVO",-63.1832,-20.01321,117,18,387,504,160,11,198,358
"Bolivia","Santa Cruz","Cordillera","Charagua","ESC. SECC. TACOBO",-63.19634,-19.78686,26,7,216,242,50,9,150,200
"Bolivia","Santa Cruz","Cordillera","Charagua","ESC. SECC. TAPUTA",-63.22105,-19.5902,0,33,272,272,13,9,217,230
"Bolivia","Santa Cruz","Cordillera","Charagua","ESCUELA CENTRAL FE Y ALEGRIA",-63.19686,-19.79076,461,28,2212,2673,1281,67,836,2117
"Bolivia","Santa Cruz","Cordillera","Charagua","ESCUELA SECCIONAL SAIPURU",-63.14339,-19.78258,0,2,132,132,56,27,47,103
"Bolivia","Santa Cruz","Cordillera","Charagua","U.E. 24 DE SEPTIEMBRE",-63.19831,-19.75614,1,4,65,66,16,5,40,56
"Bolivia","Santa Cruz","Cordillera","Charagua","U.E. JOSERAVI",-62.29416,-18.33184,19,0,62,81,36,1,25,61
"Bolivia","Santa Cruz","Cordillera","Charagua","U.E. JUAN LUIS OTIN",-63.08943,-19.97976,2,2,90,92,37,6,45,82
"Bolivia","Santa Cruz","Cordillera","Charagua","U.E. MACHIPO",-63.17883,-19.83895,6,8,100,106,36,4,52,88
"Bolivia","Santa Cruz","Cordillera","Charagua","U.E. PEDRO RAMOS",-63.21563,-19.63187,3,2,121,124,49,2,68,117
"Bolivia","Santa Cruz","Cordillera","Charagua","U.E. YAPIROA",-62.57546,-19.60771,5,1,185,190,112,5,67,179
"Bolivia","Santa Cruz","Cordillera","Cuevo","ESC. SECC. EL ARENAL",-63.51422,-20.40347,0,0,8,8,1,0,7,8
"Bolivia","Santa Cruz","Cordillera","Cuevo","ESC. SECC. ITAKUATIA",-63.51872,-20.45691,10,2,64,74,42,3,17,59
"Bolivia","Santa Cruz","Cordillera","Cuevo","ESC. UB. ANGEL SANDOVAL",-63.46928,-20.39243,502,20,1218,1720,706,26,466,1172
"Bolivia","Santa Cruz","Cordillera","Cuevo","ESC. UNIDAD EDUCATIVA IVICUATI",-63.41391,-20.37102,42,3,144,186,95,0,46,141
"Bolivia","Santa Cruz","Cordillera","Cuevo","ESC. UNIDAD SECCIONAL HUARACA",-63.51622,-20.4536,29,2,116,145,83,3,28,111
"Bolivia","Santa Cruz","Cordillera","Cuevo","U.E. EL ARENAL",-63.51412,-20.40366,9,2,98,107,5,3,88,93
"Bolivia","Santa Cruz","Cordillera","Cuevo","U.E. SALINAS",-63.46267,-20.226,16,1,93,109,19,2,71,90
"Bolivia","Santa Cruz","Cordillera","Gutiérrez","ESC. CENTRAL IPATIMIRI",-63.48169,-19.76727,85,7,515,600,167,30,311,478
"Bolivia","Santa Cruz","Cordillera","Gutiérrez","ESC. EMILIO FINOT",-63.52944,-19.42346,196,10,749,945,446,15,278,724
"Bolivia","Santa Cruz","Cordillera","Gutiérrez","ESC. IBAMIRAPINTA",-63.53056,-19.4212,90,18,552,642,185,17,332,517
"Bolivia","Santa Cruz","Cordillera","Gutiérrez","ESC. KURUGUAKUA",-63.52905,-19.42271,20,1,107,127,22,1,83,105
"Bolivia","Santa Cruz","Cordillera","Gutiérrez","ESC. MARCELINO REVOLLO",-63.39302,-19.72541,92,19,566,658,229,16,302,531
"Bolivia","Santa Cruz","Cordillera","Gutiérrez","ESC. MARISCAL SUCRE",-63.50597,-19.35422,67,15,298,365,181,4,98,279
"Bolivia","Santa Cruz","Cordillera","Gutiérrez","ESC. MIGUEL LANDIVAR",-63.50658,-19.34445,59,8,348,407,111,21,208,319
"Bolivia","Santa Cruz","Cordillera","Gutiérrez","ESC. PALMARITO",-63.46463,-19.50546,69,2,267,336,21,11,233,254
"Bolivia","Santa Cruz","Cordillera","Gutiérrez","ESC. SECC. GUASANTI",-63.42537,-19.78613,32,4,243,275,57,7,175,232
"Bolivia","Santa Cruz","Cordillera","Gutiérrez","ESC. SECCIONAL CAIPIPENDI",-63.3559,-19.78204,0,5,54,54,11,0,38,49
"Bolivia","Santa Cruz","Cordillera","Gutiérrez","ESC. SECCIONAL CAPIRENDA",-63.37655,-19.6701,36,5,225,261,45,10,165,210
"Bolivia","Santa Cruz","Cordillera","Gutiérrez","ESC. SECCIONAL ITEMBEGUAZU",-63.36713,-19.36706,33,7,181,214,80,4,90,170
"Bolivia","Santa Cruz","Cordillera","Gutiérrez","ESC. SECCIONAL S. MIGUEL POCITO",-63.45378,-19.68275,16,5,126,142,78,3,40,118
"Bolivia","Santa Cruz","Cordillera","Gutiérrez","ESC. TATARENDA VIEJA",-63.53038,-19.42489,62,8,339,401,94,18,219,313
"Bolivia","Santa Cruz","Cordillera","Lagunillas","ESC. LAGUNILLAS",-63.67723,-19.65222,334,18,1086,1420,478,26,564,1042
"Bolivia","Santa Cruz","Cordillera","Lagunillas","ESC. PROF. DELFIN ARTEAGA IPATI",-63.56137,-19.76491,99,17,666,765,316,21,312,628
"Bolivia","Santa Cruz","Cordillera","Lagunillas","ESC. SECCIONAL AGUADA GRANDE",-63.67469,-19.64971,40,5,191,231,76,7,103,179
"Bolivia","Santa Cruz","Cordillera","Lagunillas","ESC. SECCIONAL ALTO PARAPETI",-63.67161,-19.65821,15,2,67,82,11,5,49,60
"Bolivia","Santa Cruz","Cordillera","Lagunillas","ESC. TASETE",-63.65621,-19.65524,3,0,40,43,7,3,30,37
"Bolivia","Santa Cruz","Cordillera","Lagunillas","ESCUELA SECCIONAL AQUIO",-63.68824,-19.70833,6,1,69,75,49,2,17,66
"Bolivia","Santa Cruz","Cordillera","Lagunillas","U.E. CARPARICITO",-63.66229,-19.80228,41,5,145,186,44,10,86,130
"Bolivia","Santa Cruz","Cordillera","Lagunillas","U.E. PAMPA REDONDA",-63.66234,-19.60102,5,4,73,78,26,4,39,65
"Bolivia","Santa Cruz","Cordillera","Lagunillas","U. E. TENTA PIAU",-63.66815,-19.55789,12,0,73,85,32,5,36,68
"Bolivia","Santa Cruz","Cordillera","Lagunillas","U.E. YAITY",-63.63815,-20.06437,9,2,80,89,15,3,60,75
"Bolivia","Santa Cruz","Florida","Mairana","ESC. ANANIAS MELENDRES",-64.03188,-17.97899,99,18,599,698,203,31,347,550
"Bolivia","Santa Cruz","Florida","Mairana","ESC. ANGEL SAAVEDRA CHAVEZ",-63.96286,-18.12236,19,5,139,158,74,8,52,126
"Bolivia","Santa Cruz","Florida","Mairana","ESC. RENE BARRIENTOS ORTUÑO",-63.95997,-18.11939,690,134,4900,5590,2049,323,2394,4443
"Bolivia","Santa Cruz","Florida","Pampa Grande","ESC. NUCLEO SANTA ROSA",-64.24594,-17.86679,18,2,172,190,68,4,98,166
"Bolivia","Santa Cruz","Florida","Pampa Grande","ESC. PALMASOLA (EL CARMEN)",-64.2088,-17.89188,23,6,156,179,47,4,99,146
"Bolivia","Santa Cruz","Florida","Pampa Grande","ESC. PEDRO ARISTIDES",-64.11092,-18.08937,98,21,602,700,372,15,194,566
"Bolivia","Santa Cruz","Florida","Pampa Grande","ESC. SAN IGNACIO DE LOYOLA",-64.11346,-18.0916,83,12,457,540,294,18,133,427
"Bolivia","Santa Cruz","Florida","Pampa Grande","ESC. U.E. EDUARDO AVAROA",-64.12405,-18.05703,457,72,2948,3405,980,151,1745,2725
"Bolivia","Santa Cruz","Florida","Quirusillas","ESC. NESTOR PAZ ZAMORA",-63.96211,-18.37715,208,27,865,1073,465,56,317,782
"Bolivia","Santa Cruz","Florida","Samaipata","ESC. CENTRAL BELLA VICTORIA",-63.94548,-18.23438,74,23,893,967,436,49,385,821
"Bolivia","Santa Cruz","Florida","Samaipata","ESC. GRAL. AGUSTIN SAAVEDRA",-63.87621,-18.1794,270,15,1483,1753,850,94,524,1374
"Bolivia","Santa Cruz","Florida","Samaipata","ESC. NAPOLEON GOMEZ",-63.87625,-18.17913,229,45,1779,2008,1079,74,581,1660
"Bolivia","Santa Cruz","Florida","Samaipata","ESC. NUCLEO SAN JUAN DEL ROSARIO",-63.8751,-18.17855,63,2,193,256,108,6,77,185
"Bolivia","Santa Cruz","Florida","Samaipata","ESC. SANTIAGO DEL VALLE",-63.91644,-18.22129,62,7,327,389,224,7,89,313
"Bolivia","Santa Cruz","Florida","Samaipata","ESC. TIMOTEO RONDALES",-63.63435,-18.13063,64,12,341,405,206,23,100,306
"Bolivia","Santa Cruz","Florida","Samaipata","ESC. UNIDAD EDUCATIVA 27 DE MAYO",-63.79241,-18.17142,18,3,110,128,39,2,66,105
"Bolivia","Santa Cruz","Germán Busch","El Carmen Rivero Tórrez","ESC. CANDELARIA (CHIQUITOS)",-58.98688,-18.62612,11,1,59,70,26,2,30,56
"Bolivia","Santa Cruz","Germán Busch","El Carmen Rivero Tórrez","ESC. DANIEL ZAMBRANA",-58.62548,-18.82769,546,24,1737,2283,910,29,774,1684
"Bolivia","Santa Cruz","Germán Busch","El Carmen Rivero Tórrez","ESC. EVANGELICA RINCON DEL TIGRE",-58.16805,-18.21079,90,4,199,289,104,8,83,187
"Bolivia","Santa Cruz","Germán Busch","El Carmen Rivero Tórrez","ESC. PALMERAS",-58.20692,-18.22021,39,2,87,126,41,4,40,81
"Bolivia","Santa Cruz","Germán Busch","El Carmen Rivero Tórrez","ESC. SANTA ANA",-58.78492,-18.70716,59,0,181,240,87,4,90,177
"Bolivia","Santa Cruz","Germán Busch","El Carmen Rivero Tórrez","U.E. PALMITO",-58.40663,-18.91338,19,0,34,53,21,0,13,34
"Bolivia","Santa Cruz","Germán Busch","Puerto Quijarro","ESC. GISELA BRUN SCIARONI",-57.7165,-19.00469,238,24,2908,3146,1610,453,821,2431
"Bolivia","Santa Cruz","Germán Busch","Puerto Quijarro","ESC. MIXTA LA FRONTERA",-57.70963,-19.02897,1229,24,2836,4065,1399,111,1302,2701
"Bolivia","Santa Cruz","Germán Busch","Puerto Quijarro","ESC. SAMUEL LOPEZ MENDOZA",-57.7174,-19.00237,971,14,2691,3662,1543,66,1068,2611
"Bolivia","Santa Cruz","Germán Busch","Puerto Quijarro","U.E. SAN SALVADOR",-57.74367,-18.91407,0,0,13,13,1,0,12,13
"Bolivia","Santa Cruz","Germán Busch","Puerto Suárez","ESC. ANGELICA RIVERO",-57.79461,-18.96881,171,7,812,983,542,10,253,795
"Bolivia","Santa Cruz","Germán Busch","Puerto Suárez","ESC. COLONIA WARNES",-57.94844,-19.21188,0,0,62,62,12,9,41,53
"Bolivia","Santa Cruz","Germán Busch","Puerto Suárez","ESC. COOP EDUCACIONAL PUERTO SUAREZ",-57.80175,-18.96629,674,24,2287,2961,1408,33,822,2230
"Bolivia","Santa Cruz","Germán Busch","Puerto Suárez","ESC. ELIODORO PAZ",-57.79655,-18.96109,357,6,946,1303,644,18,278,922
"Bolivia","Santa Cruz","Germán Busch","Puerto Suárez","ESC. GERMAN BUSCH YACUSES",-58.23871,-18.97605,80,10,382,462,167,11,194,361
"Bolivia","Santa Cruz","Germán Busch","Puerto Suárez","ESC. JOSEFINA GOYTIA",-57.80096,-18.96123,351,10,1330,1681,944,20,356,1300
"Bolivia","Santa Cruz","Germán Busch","Puerto Suárez","ESC. MIGUEL SUAREZ ARANA",-57.79474,-18.96855,533,19,2294,2827,1447,108,720,2167
"Bolivia","Santa Cruz","Germán Busch","Puerto Suárez","U.E. EL SALAO",-57.80831,-18.97087,3,0,4,7,3,0,1,4
"Bolivia","Santa Cruz","Germán Busch","Puerto Suárez","U.E. MOTACUCITO",-57.86888,-18.9975,2,1,19,21,6,0,12,18
"Bolivia","Santa Cruz","Guarayos","Ascención de Guarayos","COL. JOSE BARRERA",-63.19069,-15.89573,67,4,371,438,230,7,130,360
"Bolivia","Santa Cruz","Guarayos","Ascención de Guarayos","ESC. 17 DE FEBRERO",-63.46325,-15.73225,45,0,218,263,29,4,185,214
"Bolivia","Santa Cruz","Guarayos","Ascención de Guarayos","ESC. 6 DE ABRIL",-63.45643,-15.72873,16,0,86,102,29,2,55,84
"Bolivia","Santa Cruz","Guarayos","Ascención de Guarayos","ESC. ASCENCION CENTRAL",-63.18915,-15.89754,1057,37,3873,4930,2022,94,1720,3742
"Bolivia","Santa Cruz","Guarayos","Ascención de Guarayos","ESC. COLONIA 5 DE MARZO",-63.79241,-15.32275,39,3,163,202,65,4,91,156
"Bolivia","Santa Cruz","Guarayos","Ascención de Guarayos","ESC. ESTEBAN GEBARD",-63.187,-15.90327,1040,40,4564,5604,2575,136,1813,4388
"Bolivia","Santa Cruz","Guarayos","Ascención de Guarayos","ESC. SAN PABLO",-63.30412,-15.89327,82,14,476,558,174,17,271,445
"Bolivia","Santa Cruz","Guarayos","Ascención de Guarayos","ESC. SANTA MARIA",-63.45824,-15.73023,48,11,345,393,103,9,222,325
"Bolivia","Santa Cruz","Guarayos","Ascención de Guarayos","KINDER MI DULCE HOGAR",-63.19152,-15.89707,68,1,480,548,214,13,252,466
"Bolivia","Santa Cruz","Guarayos","El Puente","ESC. 10 DE NOVIEMBRE",-63.10825,-16.43058,95,13,493,588,137,13,330,467
"Bolivia","Santa Cruz","Guarayos","El Puente","ESC. ALFREDO SMITH",-62.90907,-16.32987,442,29,1732,2174,1003,42,658,1661
"Bolivia","Santa Cruz","Guarayos","El Puente","ESC. CACHUELA",-63.11323,-16.20543,10,1,65,75,11,2,51,62
"Bolivia","Santa Cruz","Guarayos","El Puente","ESC. CORRALON",-63.21976,-16.36582,83,0,220,303,32,2,186,218
"Bolivia","Santa Cruz","Guarayos","El Puente","ESC. EL COMBATE",-64.34967,-15.96244,5,0,34,39,10,0,24,34
"Bolivia","Santa Cruz","Guarayos","El Puente","ESC. LOS CHACOS",-63.53627,-15.93622,19,0,51,70,46,1,4,50
"Bolivia","Santa Cruz","Guarayos","El Puente","ESC. PUEBLOS UNIDOS",-64.45015,-15.95046,154,1,222,376,30,8,183,213
"Bolivia","Santa Cruz","Guarayos","El Puente","ESC. SAN JOSE DE YOTAU",-63.02123,-16.17607,257,20,1041,1298,322,29,670,992
"Bolivia","Santa Cruz","Guarayos","El Puente","ESC. SECCIONAL EL CARMEN",-63.38649,-16.17395,75,5,346,421,128,15,198,326
"Bolivia","Santa Cruz","Guarayos","El Puente","ESC. SECCIONAL LIMONCITO",-63.38322,-15.91767,15,0,33,48,21,1,11,32
"Bolivia","Santa Cruz","Guarayos","El Puente","ESC. U.E. BOLIVAR",-63.2851,-16.27928,35,13,255,290,70,13,159,229
"Bolivia","Santa Cruz","Guarayos","El Puente","MONTE SINAI",-63.28524,-16.28186,32,2,224,256,32,7,183,215
"Bolivia","Santa Cruz","Guarayos","El Puente","U.E EL CORRALON",-63.44645,-16.40989,0,4,104,104,12,9,79,91
"Bolivia","Santa Cruz","Guarayos","Urubichá","ESC, MARIA DE LOS ANGELES",-63.08243,-15.62326,404,27,1715,2119,720,44,924,1644
"Bolivia","Santa Cruz","Guarayos","Urubichá","ESC. NUCLEO ESCOLAR YAGUARU",-63.22532,-15.60033,180,14,860,1040,538,28,280,818
"Bolivia","Santa Cruz","Guarayos","Urubichá","ESC. SANTA TERESITA (CURURU)",-63.19052,-15.89766,15,2,57,72,45,0,10,55
"Bolivia","Santa Cruz","Guarayos","Urubichá","ESC. SECC.MON.SALVATIERRA",-63.01738,-15.50296,29,1,78,107,32,0,45,77
"Bolivia","Santa Cruz","Ichilo","Buena Vista","ESC. ADHEMAR ORTIZ",-63.5253,-17.61063,31,1,213,244,81,1,130,211
"Bolivia","Santa Cruz","Ichilo","Buena Vista","ESC. EDUARDO ABAROA",-63.6379,-17.55737,109,14,762,871,218,30,500,718
"Bolivia","Santa Cruz","Ichilo","Buena Vista","ESC. MARIANO SAUCEDO SEVILLA",-63.66378,-17.45934,380,13,1750,2130,1047,43,647,1694
"Bolivia","Santa Cruz","Ichilo","Buena Vista","ESC. OVIDIO SUAREZ",-63.66139,-17.45913,473,25,1661,2134,850,75,711,1561
"Bolivia","Santa Cruz","Ichilo","Buena Vista","ESC. U.E. CARANDA",-63.53439,-17.52241,117,15,643,760,262,21,345,607
"Bolivia","Santa Cruz","Ichilo","Buena Vista","ESC. U.E. LUCIO  PEREZ",-63.5322,-17.4093,34,3,182,216,140,5,34,174
"Bolivia","Santa Cruz","Ichilo","Buena Vista","ESC. U.E. PEDRO DOMINGO MURILLO",-63.57303,-17.63503,75,8,459,534,57,10,384,441
"Bolivia","Santa Cruz","Ichilo","Buena Vista","ESC. U.E. SAN ISIDRO",-63.53614,-17.44589,44,1,199,243,175,0,23,198
"Bolivia","Santa Cruz","Ichilo","Buena Vista","ESC. U.E. SAN JAVIER",-63.56753,-17.36419,0,0,48,48,36,3,9,45
"Bolivia","Santa Cruz","Ichilo","Buena Vista","ESC. U.E. SANTO ESPOSORIO",-63.60875,-17.35815,40,0,158,198,130,2,26,156
"Bolivia","Santa Cruz","Ichilo","Buena Vista","U.E. 5 DE SEPTIEMBRE",-63.69266,-17.53192,3,2,89,92,5,0,82,87
"Bolivia","Santa Cruz","Ichilo","Buena Vista","U.E. 6 DE AGOSTO",-63.60951,-17.40799,6,6,265,271,214,5,40,254
"Bolivia","Santa Cruz","Ichilo","San Carlos","ESC. CENTRAL SAN CARLOS",-63.72837,-17.40302,456,40,2762,3218,1740,104,878,2618
"Bolivia","Santa Cruz","Ichilo","San Carlos","ESC. FISCAL DE NINOS SANTA FE",-63.82872,-17.39861,865,58,4764,5629,1936,215,2555,4491
"Bolivia","Santa Cruz","Ichilo","San Carlos","ESC. NUCLEO CENTRAL",-63.76135,-17.16378,95,14,740,835,148,14,564,712
"Bolivia","Santa Cruz","Ichilo","San Carlos","ESC. U.E. POPULAR DON BOSCO",-63.76614,-17.09247,66,11,934,1000,533,123,267,800
"Bolivia","Santa Cruz","Ichilo","San Juan","ESC. POPULAR DON BOSCO",-63.85132,-17.29254,435,75,2475,2910,1395,47,958,2353
"Bolivia","Santa Cruz","Ichilo","San Juan","NUCLEO CENTRAL LA ENCONADA",-63.89576,-17.05627,105,17,652,757,203,21,411,614
"Bolivia","Santa Cruz","Ichilo","San Juan","UN. ED. AYACUCHO",-63.90579,-17.00542,54,6,288,342,90,2,190,280
"Bolivia","Santa Cruz","Ichilo","San Juan","UN. ED.  NUCLEO CENTRAL",-63.99822,-16.91391,34,1,126,160,31,2,92,123
"Bolivia","Santa Cruz","Ichilo","San Juan","UN. ED. RAUL MENACHO",-64.04461,-16.70449,44,1,225,269,61,7,156,217
"Bolivia","Santa Cruz","Ichilo","Yapacaní","ESC. CESAR BANZER ALIAGA",-63.88105,-17.40066,1311,94,7132,8443,2413,387,4238,6651
"Bolivia","Santa Cruz","Ichilo","Yapacaní","ESC. DON BOSCO FE Y ALEGRIA",-64.09068,-17.35061,419,24,2019,2438,432,50,1513,1945
"Bolivia","Santa Cruz","Ichilo","Yapacaní","ESC. EL PALLAR",-64.81531,-16.76252,77,6,197,274,57,4,130,187
"Bolivia","Santa Cruz","Ichilo","Yapacaní","ESC. GERMAN BUSCH",-63.88563,-17.40492,683,66,4440,5123,1652,151,2571,4223
"Bolivia","Santa Cruz","Ichilo","Yapacaní","ESC. MARISCAL SUCRE",-63.96143,-17.38778,129,16,997,1126,226,24,731,957
"Bolivia","Santa Cruz","Ichilo","Yapacaní","ESC. NACIONAL BOLIVIA",-63.88673,-17.40517,69,3,372,441,99,37,233,332
"Bolivia","Santa Cruz","Ichilo","Yapacaní","ESC. NOEL KENP MERCADO",-64.29475,-17.08242,217,16,1115,1332,156,22,921,1077
"Bolivia","Santa Cruz","Ichilo","Yapacaní","ESC. NUEVO SIMON BOLLIVAR",-63.88425,-17.4061,847,37,4136,4983,1514,94,2491,4005
"Bolivia","Santa Cruz","Ichilo","Yapacaní","ESC. U.E. CASCABEL",-64.25111,-17.05944,124,8,494,618,84,11,391,475
"Bolivia","Santa Cruz","Ichilo","Yapacaní","ESC. U.E. GERMAN BUSCH (P. GRETHER)",-64.3512,-17.18946,68,7,299,367,99,14,179,278
"Bolivia","Santa Cruz","Ichilo","Yapacaní","ESCUELA CORTE HONDO",-64.77988,-16.74353,0,0,69,69,7,1,61,68
"Bolivia","Santa Cruz","Ichilo","Yapacaní","ESC. U.E. NUCLEO CENTRAL",-64.03771,-17.36884,85,5,625,710,145,15,460,605
"Bolivia","Santa Cruz","Ichilo","Yapacaní","ESC. U.E. NUCLEO CENTRAL EL CONDOR",-64.12843,-17.42864,44,6,251,295,49,5,191,240
"Bolivia","Santa Cruz","Ichilo","Yapacaní","ESC. U.E. NUCLEO CENTRAL LOS POZOS",-64.07143,-17.0136,31,5,228,259,64,9,150,214
"Bolivia","Santa Cruz","Ichilo","Yapacaní","ESC. U.E. PUERTO AVAROA",-64.22526,-17.25569,58,6,402,460,113,8,275,388
"Bolivia","Santa Cruz","Ichilo","Yapacaní","U.E. JUANA AZURDUY",-63.90387,-17.41217,7,0,58,65,21,5,32,53
"Bolivia","Santa Cruz","Ichilo","Yapacaní","U.E. NUEVO HORIZONTE",-64.1521,-17.31313,25,12,394,419,57,13,312,369
"Bolivia","Santa Cruz","Ichilo","Yapacaní","U.E. SAN RAFAEL",-63.92513,-17.45016,5,0,121,126,14,3,104,118
"Bolivia","Santa Cruz","Manuel M. Caballero","Comarapa","ESC.  EL JAGUE",-64.32232,-18.02102,10,0,48,58,26,0,22,48
"Bolivia","Santa Cruz","Manuel M. Caballero","Comarapa","ESC. ESCUELA SAN MATEO",-64.66756,-17.75924,19,4,205,224,24,4,173,197
"Bolivia","Santa Cruz","Manuel M. Caballero","Comarapa","ESC. GABRIEL RENE MORENO",-64.52667,-17.91351,532,73,3949,4481,1439,227,2210,3649
"Bolivia","Santa Cruz","Manuel M. Caballero","Comarapa","ESC. HABRA DE CAPILLA",-64.73131,-17.87328,9,2,116,125,17,6,91,108
"Bolivia","Santa Cruz","Manuel M. Caballero","Comarapa","ESC. MANZANAL",-64.77901,-17.84591,12,0,98,110,8,3,87,95
"Bolivia","Santa Cruz","Manuel M. Caballero","Comarapa","ESC. MARCELINO CHAIPANA",-64.43036,-18.10087,48,4,372,420,158,19,191,349
"Bolivia","Santa Cruz","Manuel M. Caballero","Comarapa","ESC. SAN ISIDRO",-64.43211,-18.04461,162,14,909,1071,427,43,425,852
"Bolivia","Santa Cruz","Manuel M. Caballero","Comarapa","ESC. SAN JOSE DE LA CAPILLA",-64.4388,-18.0994,56,8,365,421,160,23,174,334
"Bolivia","Santa Cruz","Manuel M. Caballero","Comarapa","ESC. SAN JUAN DEL POTRERO",-64.29284,-17.96157,53,13,331,384,164,12,142,306
"Bolivia","Santa Cruz","Manuel M. Caballero","Comarapa","ESC. SIBERIA",-64.75382,-17.82761,10,0,120,130,30,3,87,117
"Bolivia","Santa Cruz","Manuel M. Caballero","Comarapa","ESC. TORRECILLAS",-64.61208,-17.86851,67,28,740,807,112,60,540,652
"Bolivia","Santa Cruz","Manuel M. Caballero","Comarapa","ESC. U.E. LA PALIZADA",-64.43266,-18.06145,45,13,328,373,126,12,177,303
"Bolivia","Santa Cruz","Manuel M. Caballero","Saipina","ESC. EMILIA CABALLERO",-64.63905,-17.96113,1,0,33,34,6,1,26,32
"Bolivia","Santa Cruz","Manuel M. Caballero","Saipina","ESC. HUMBERTO VILLARROEL",-64.58239,-18.09421,322,35,2105,2427,718,73,1279,1997
"Bolivia","Santa Cruz","Manuel M. Caballero","Saipina","ESC. OCONI",-64.68318,-17.98282,21,3,103,124,6,2,92,98
"Bolivia","Santa Cruz","Manuel M. Caballero","Saipina","ESC. SAN RAFAEL",-64.56412,-18.1077,16,1,207,223,54,6,146,200
"Bolivia","Santa Cruz","Manuel M. Caballero","Saipina","ESC. U.E. SANTA CATALINA CHILON",-64.63826,-18.00198,65,8,397,462,99,15,275,374
"Bolivia","Santa Cruz","Ñuflo De Chávez","Concepción","ESC. CENT. JULIO FLORES FRANCO",-62.01875,-16.44536,26,7,207,233,112,3,85,197
"Bolivia","Santa Cruz","Ñuflo De Chávez","Concepción","ESC. CENTRAL SAN PEDRO",-62.2496,-16.67241,28,0,143,171,94,3,46,140
"Bolivia","Santa Cruz","Ñuflo De Chávez","Concepción","ESC. EDUCATIVA MAKANATE",-62.29666,-15.48511,15,2,109,124,4,3,100,104
"Bolivia","Santa Cruz","Ñuflo De Chávez","Concepción","ESC. GUADALUPE FE Y ALEGRIA",-62.02316,-16.13626,1293,115,7052,8345,3589,185,3163,6752
"Bolivia","Santa Cruz","Ñuflo De Chávez","Concepción","ESC. PALESTINA",-62.25437,-15.5535,0,0,73,73,3,12,58,61
"Bolivia","Santa Cruz","Ñuflo De Chávez","Concepción","ESC. SECCIONAL CALENDARIA",-62.12077,-16.2456,13,5,188,201,64,7,112,176
"Bolivia","Santa Cruz","Ñuflo De Chávez","Concepción","ESC. SECCIONAL PALMARITO",-61.58675,-15.68015,29,2,211,240,155,3,51,206
"Bolivia","Santa Cruz","Ñuflo De Chávez","Concepción","ESC. TIERRA HERMOZA",-61.96533,-16.47223,116,6,486,602,42,11,427,469
"Bolivia","Santa Cruz","Ñuflo De Chávez","Concepción","ESC. U.E. ALTAMIRA",-62.02086,-16.13548,74,10,374,448,166,18,180,346
"Bolivia","Santa Cruz","Ñuflo De Chávez","Concepción","ESC. U.E. GUAYABA",-62.00958,-16.11202,9,4,130,139,16,2,108,124
"Bolivia","Santa Cruz","Ñuflo De Chávez","Concepción","ESC. U.E. LAS MERCEDES",-62.15521,-16.63746,13,1,38,51,18,0,19,37
"Bolivia","Santa Cruz","Ñuflo De Chávez","Concepción","ESC. U.E. SAN SILVESTRE",-61.8651,-15.87338,14,1,123,137,45,8,69,114
"Bolivia","Santa Cruz","Ñuflo De Chávez","Concepción","ESC. U.E. SANTA MONICA",-62.19145,-15.97295,13,1,91,104,6,0,84,90
"Bolivia","Santa Cruz","Ñuflo De Chávez","Concepción","ESC. U.E. ZAPOCO",-61.64749,-16.49761,7,0,14,21,9,0,5,14
"Bolivia","Santa Cruz","Ñuflo De Chávez","Concepción","MEDIO MONTE",-62.07742,-16.52462,6,0,108,114,10,1,97,107
"Bolivia","Santa Cruz","Ñuflo De Chávez","Concepción","U.E. JOSE ORTIZ SENAR",-61.9508,-16.22951,9,0,63,72,6,0,57,63
"Bolivia","Santa Cruz","Ñuflo De Chávez","Concepción","U.E. NUBIASIX",-62.1369,-16.33951,4,2,59,63,16,2,39,55
"Bolivia","Santa Cruz","Ñuflo De Chávez","Concepción","U.E. SAN FRANCISCO DE ASIS",-62.06047,-16.13365,3,2,80,83,13,4,61,74
"Bolivia","Santa Cruz","Ñuflo De Chávez","Cuatro Cañadas","COL. NACIONAL CUATRO CAÑANDAS",-62.55971,-17.27547,21,5,147,168,40,4,98,138
"Bolivia","Santa Cruz","Ñuflo De Chávez","Cuatro Cañadas","ESC. 26 DE AGOSTO",-62.60896,-17.44349,89,14,703,792,226,29,434,660
"Bolivia","Santa Cruz","Ñuflo De Chávez","Cuatro Cañadas","ESC. JOSE LUIS CASTRO",-62.55427,-17.34488,180,17,1297,1477,418,39,823,1241
"Bolivia","Santa Cruz","Ñuflo De Chávez","Cuatro Cañadas","ESC. JUAN PABLO SEGUNDO",-62.55701,-17.26752,996,72,5934,6930,2113,310,3439,5552
"Bolivia","Santa Cruz","Ñuflo De Chávez","Cuatro Cañadas","ESC. LOS TRONCOS",-62.63882,-17.06814,25,3,182,207,96,3,80,176
"Bolivia","Santa Cruz","Ñuflo De Chávez","Cuatro Cañadas","ESC. MONTE RICO",-62.48614,-17.37492,34,2,206,240,24,1,179,203
"Bolivia","Santa Cruz","Ñuflo De Chávez","Cuatro Cañadas","U.E. HAZIEL",-62.152,-17.22365,13,2,235,248,181,7,45,226
"Bolivia","Santa Cruz","Ñuflo De Chávez","San Antonio de Lomerio","ESC. CENTRAL EL PUQUIO",-61.9117,-16.73251,54,3,400,454,4,3,390,394
"Bolivia","Santa Cruz","Ñuflo De Chávez","San Antonio de Lomerio","ESC. HOLANDA",-61.79376,-16.88703,0,0,7,7,0,2,5,5
"Bolivia","Santa Cruz","Ñuflo De Chávez","San Antonio de Lomerio","ESC. PADRE MATIAS LENS",-61.81025,-16.76787,209,11,1149,1358,496,36,606,1102
"Bolivia","Santa Cruz","Ñuflo De Chávez","San Antonio de Lomerio","ESC.SAN LORENZO",-61.87291,-16.70838,31,7,265,296,5,1,252,257
"Bolivia","Santa Cruz","Ñuflo De Chávez","San Antonio de Lomerio","ESC. SECCIONAL SALINAS",-61.85703,-16.98182,43,8,188,231,72,5,103,175
"Bolivia","Santa Cruz","Ñuflo De Chávez","San Antonio de Lomerio","ESC. U.E. LAS TRANCAS",-61.86698,-16.5975,9,0,109,118,6,2,101,107
"Bolivia","Santa Cruz","Ñuflo De Chávez","San Antonio de Lomerio","ESC. U.E. MONTERITO",-61.96834,-16.70661,8,1,173,181,0,0,172,172
"Bolivia","Santa Cruz","Ñuflo De Chávez","San Antonio de Lomerio","ESC. U.E. PADRE PIO",-61.8397,-16.68229,16,1,147,163,10,2,134,144
"Bolivia","Santa Cruz","Ñuflo De Chávez","San Antonio de Lomerio","PEDRO PABLO PEÑA GARCIA",-61.93461,-16.75292,2,0,60,62,0,0,60,60
"Bolivia","Santa Cruz","Ñuflo De Chávez","San Javier","ESC. SECCIONAL CORONACION",-62.63953,-16.50191,59,6,424,483,132,9,277,409
"Bolivia","Santa Cruz","Ñuflo De Chávez","San Javier","ESCUELA ADOLFO BURTON",-62.50405,-16.27246,877,109,4625,5502,2881,73,1562,4443
"Bolivia","Santa Cruz","Ñuflo De Chávez","San Javier","ESC. U.E. LAS ABRAS",-62.62867,-16.31566,37,2,195,232,16,2,175,191
"Bolivia","Santa Cruz","Ñuflo De Chávez","San Javier","ESC. U.E. SAN PABLO",-62.59928,-16.16368,12,0,104,116,4,0,100,104
"Bolivia","Santa Cruz","Ñuflo De Chávez","San Javier","ESC. U.E. SANTA RITA",-62.41707,-16.19858,10,0,59,69,21,0,38,59
"Bolivia","Santa Cruz","Ñuflo De Chávez","San Javier","ESC. U.E. TURUX NAPEZ",-62.54155,-16.06091,13,2,86,99,1,1,82,83
"Bolivia","Santa Cruz","Ñuflo De Chávez","San Julián","ESC. 26 DE OCT. FE Y ALEGRIA",-62.75789,-16.80131,48,4,501,549,43,6,448,491
"Bolivia","Santa Cruz","Ñuflo De Chávez","San Julián","ESC. CENTRAL FRANZ TAMAYO",-62.84544,-16.9986,153,26,865,1018,190,43,606,796
"Bolivia","Santa Cruz","Ñuflo De Chávez","San Julián","ESC. COL  CIRO MEALLA",-62.61414,-16.90736,1235,165,9306,10541,2619,651,5871,8490
"Bolivia","Santa Cruz","Ñuflo De Chávez","San Julián","ESC. EL PROGRESO",-62.62124,-16.91284,74,4,498,572,116,38,340,456
"Bolivia","Santa Cruz","Ñuflo De Chávez","San Julián","ESC. FE Y ALEGRIA",-62.68461,-17.09639,153,16,786,939,385,26,359,744
"Bolivia","Santa Cruz","Ñuflo De Chávez","San Julián","ESC. GRAL SAN MARTIN",-62.85691,-16.70174,81,9,499,580,90,17,383,473
"Bolivia","Santa Cruz","Ñuflo De Chávez","San Julián","ESC. LA ASUNTA SAN BERNARDO",-62.57837,-16.76817,171,17,1201,1372,445,34,705,1150
"Bolivia","Santa Cruz","Ñuflo De Chávez","San Julián","ESC.LIMONCITO",-63.06672,-16.76165,51,6,223,274,60,6,151,211
"Bolivia","Santa Cruz","Ñuflo De Chávez","San Julián","ESC. MAX FERNANDEZ ROJAS",-62.54577,-16.97607,44,11,477,521,101,13,352,453
"Bolivia","Santa Cruz","Ñuflo De Chávez","San Julián","ESC. NUCLEO 66 2 DE AGOSTO",-62.78839,-16.6398,55,8,417,472,128,9,272,400
"Bolivia","Santa Cruz","Ñuflo De Chávez","San Julián","ESC. PATUJU",-62.61599,-16.9081,65,2,497,562,133,19,343,476
"Bolivia","Santa Cruz","Ñuflo De Chávez","San Julián","ESC. SAN ANTONIO",-62.72305,-16.83416,7,1,125,132,24,1,99,123
"Bolivia","Santa Cruz","Ñuflo De Chávez","San Julián","ESC. SAN SALVADOR NUCLEO 38",-63.01813,-16.53014,94,7,480,574,50,23,400,450
"Bolivia","Santa Cruz","Ñuflo De Chávez","San Julián","ESC. SEBASTIAN PAGADOR",-62.62574,-16.91129,9,0,104,113,6,0,98,104
"Bolivia","Santa Cruz","Ñuflo De Chávez","San Julián","ESC. U.E. 16 DE MARZO",-62.46996,-16.93457,42,5,276,318,23,25,223,246
"Bolivia","Santa Cruz","Ñuflo De Chávez","San Julián","ESC. U.E. EL LIMONAL",-62.94872,-16.60476,41,5,263,304,34,8,216,250
"Bolivia","Santa Cruz","Ñuflo De Chávez","San Julián","ESCUELA EDUARDO AVAROA",-62.93443,-17.02607,143,17,1026,1169,287,40,682,969
"Bolivia","Santa Cruz","Ñuflo De Chávez","San Julián","ESCUELA LUZ Y VERDAD",-62.91896,-16.63566,35,10,282,317,75,11,186,261
"Bolivia","Santa Cruz","Ñuflo De Chávez","San Julián","ESC. U.E. SEGUNDA MILLA",-62.91419,-16.50614,12,1,123,135,89,6,27,116
"Bolivia","Santa Cruz","Ñuflo De Chávez","San Julián","U.E. 27 DE ABRIL",-62.61187,-16.86376,3,0,28,31,10,2,16,26
"Bolivia","Santa Cruz","Ñuflo De Chávez","San Julián","U.E. GUILLERMO JORDAN",-62.62149,-16.91677,350,19,2052,2402,535,122,1376,1911
"Bolivia","Santa Cruz","Ñuflo De Chávez","San Julián","U.E. JOSE DAVID BERRIOS",-62.63219,-16.90126,0,0,20,20,6,2,12,18
"Bolivia","Santa Cruz","Ñuflo De Chávez","San Julián","U.E. SAN JULIAN DE BERLIN",-62.63087,-17.0567,3,1,31,34,6,3,21,27
"Bolivia","Santa Cruz","Ñuflo De Chávez","San Julián","U.E. SANTA ANA",-63.06822,-16.33947,3,2,98,101,8,2,86,94
"Bolivia","Santa Cruz","Ñuflo De Chávez","San Ramón","ESC. CENTRAL SAN RAMON",-62.49786,-16.61663,737,58,3465,4202,1874,146,1387,3261
"Bolivia","Santa Cruz","Ñuflo De Chávez","San Ramón","ESC. SANTA ROSA DE LA MINA",-62.46406,-16.54375,19,1,156,175,89,9,57,146
"Bolivia","Santa Cruz","Obispo Santisteban","Fernández Alonso","ESC. AGUAICES",-63.31085,-16.89686,33,3,274,307,88,14,169,257
"Bolivia","Santa Cruz","Obispo Santisteban","Fernández Alonso","ESC. EDUARDO AVAROA",-63.23214,-16.96287,63,12,499,562,156,15,316,472
"Bolivia","Santa Cruz","Obispo Santisteban","Fernández Alonso","ESC. NUCLEO MARISCAL SUCRE",-63.2194,-16.96726,276,20,1815,2091,575,67,1153,1728
"Bolivia","Santa Cruz","Obispo Santisteban","Fernández Alonso","ESC. SECCIONAL",-63.31478,-17.03029,4,0,20,24,2,1,17,19
"Bolivia","Santa Cruz","Obispo Santisteban","Fernández Alonso","ESC. SECCIONAL FAJA BOLIVAR",-63.22898,-16.97343,0,1,10,10,0,0,9,9
"Bolivia","Santa Cruz","Obispo Santisteban","Fernández Alonso","ESC. U.E. BETANIA",-63.20389,-16.86883,5,3,106,111,30,2,71,101
"Bolivia","Santa Cruz","Obispo Santisteban","Fernández Alonso","ESC. U.E. VICTOR HUGO OTALORA",-63.22835,-17.00979,494,52,3096,3590,1080,138,1826,2906
"Bolivia","Santa Cruz","Obispo Santisteban","General Agustín Saavedra","COL. PRINCIPE DE PAZ",-63.21263,-17.22497,523,39,3217,3740,1900,134,1144,3044
"Bolivia","Santa Cruz","Obispo Santisteban","General Agustín Saavedra","ESC. 1 DE SEPTIEMBRE",-63.08397,-17.09076,78,7,379,457,140,7,225,365
"Bolivia","Santa Cruz","Obispo Santisteban","General Agustín Saavedra","ESC. NUCLEO CENTRAL NUEVA ESPERANZA",-63.21746,-17.16079,129,9,823,952,363,22,429,792
"Bolivia","Santa Cruz","Obispo Santisteban","General Agustín Saavedra","ESC. NUCLEO  MARISCAL SUCRE",-63.12855,-17.10982,149,17,857,1006,283,34,523,806
"Bolivia","Santa Cruz","Obispo Santisteban","General Agustín Saavedra","ESC. U.E. CHANE BEDOYA",-63.07076,-17.02967,68,3,313,381,109,8,193,302
"Bolivia","Santa Cruz","Obispo Santisteban","General Agustín Saavedra","ESC. U.E. GUALBERTO VILLARROEL",-63.13241,-17.22034,96,12,458,554,129,25,292,421
"Bolivia","Santa Cruz","Obispo Santisteban","General Agustín Saavedra","ESC. U.E. SANTIAGO CORNEN",-63.07765,-17.07392,53,1,352,405,171,13,167,338
"Bolivia","Santa Cruz","Obispo Santisteban","General Agustín Saavedra","U.E. ARMINDA MERCADO P.",-63.27879,-17.22003,4,4,81,85,57,2,18,75
"Bolivia","Santa Cruz","Obispo Santisteban","General Agustín Saavedra","U.E. MARCELO QUIROGA SANTA CRUZ",-63.23772,-17.25334,1,6,81,82,17,1,57,74
"Bolivia","Santa Cruz","Obispo Santisteban","General Agustín Saavedra","U.E. SAN FELIX",-63.16826,-17.22752,6,3,45,51,15,2,25,40
"Bolivia","Santa Cruz","Obispo Santisteban","Mineros","ESC. LA PATRIA",-63.33168,-17.13894,48,6,220,268,99,10,105,204
"Bolivia","Santa Cruz","Obispo Santisteban","Mineros","ESC. LAS PALMAS",-63.27835,-17.07745,46,5,326,372,115,11,195,310
"Bolivia","Santa Cruz","Obispo Santisteban","Mineros","ESC. NUCLEO CENTRAL MINERO",-63.23399,-17.11312,1568,165,9457,11025,5140,371,3781,8921
"Bolivia","Santa Cruz","Obispo Santisteban","Mineros","ESC. SUB. CENTRAL LA PORFIA",-63.15114,-17.05671,98,5,388,486,144,6,233,377
"Bolivia","Santa Cruz","Obispo Santisteban","Mineros","ESC. U.E. SAN JUAN DEL CARMEN",-63.18584,-17.07821,6,1,58,64,21,3,33,54
"Bolivia","Santa Cruz","Obispo Santisteban","Mineros","U.E. 24 DE JUNIO",-63.37979,-17.01744,0,0,88,88,14,7,67,81
"Bolivia","Santa Cruz","Obispo Santisteban","Mineros","U.E. ALIANZA EL PROGRESO",-63.2196,-17.05495,0,19,183,183,42,5,117,159
"Bolivia","Santa Cruz","Obispo Santisteban","Mineros","U.E. ALICE ALVAREZ DE AREDONDO I",-63.23064,-17.11864,81,9,560,641,305,11,235,540
"Bolivia","Santa Cruz","Obispo Santisteban","Mineros","U.E. BENJAMIN BANEGAS VACA",-63.22878,-17.1259,37,5,252,289,131,4,112,243
"Bolivia","Santa Cruz","Obispo Santisteban","Montero","CARCEL PUBLICA DE MONTERO",-63.20849,-17.31119,84,0,26,110,15,4,7,22
"Bolivia","Santa Cruz","Obispo Santisteban","Montero","COL. ANGEL LIMPIAS",-63.23486,-17.34456,384,28,2254,2638,929,72,1225,2154
"Bolivia","Santa Cruz","Obispo Santisteban","Montero","COL. DANIEL RIVERO",-63.24461,-17.34128,1029,58,5460,6489,2066,169,3167,5233
"Bolivia","Santa Cruz","Obispo Santisteban","Montero","COL. EDUARDO ABAROA",-63.23902,-17.32316,331,15,2193,2524,1362,54,762,2124
"Bolivia","Santa Cruz","Obispo Santisteban","Montero","COL. FE Y ALEGRIA",-63.22857,-17.34315,222,13,1807,2029,1483,28,283,1766
"Bolivia","Santa Cruz","Obispo Santisteban","Montero","COL. FRANZ TAMAYO",-63.23262,-17.34123,343,21,2293,2636,1066,76,1130,2196
"Bolivia","Santa Cruz","Obispo Santisteban","Montero","COL. GUILLERMO KRUEGLER",-63.26248,-17.34654,475,19,2960,3435,2154,119,668,2822
"Bolivia","Santa Cruz","Obispo Santisteban","Montero","COL. JOSE CRONEMBOL",-63.25688,-17.35259,404,15,2141,2545,1565,78,483,2048
"Bolivia","Santa Cruz","Obispo Santisteban","Montero","COL. JUAN ZABALA",-63.27181,-17.31366,770,35,4491,5261,2796,132,1528,4324
"Bolivia","Santa Cruz","Obispo Santisteban","Montero","COL. MARCELIANO MONTERO",-63.25363,-17.34717,325,42,2464,2789,1844,86,492,2336
"Bolivia","Santa Cruz","Obispo Santisteban","Montero","COL. MARCOS CHAVEZ",-63.24632,-17.35353,348,23,2349,2697,1490,51,785,2275
"Bolivia","Santa Cruz","Obispo Santisteban","Montero","COL. NACIONAL GUABIRA",-63.26613,-17.30766,346,11,2427,2773,1400,126,890,2290
"Bolivia","Santa Cruz","Obispo Santisteban","Montero","COL. OBISPO SANTISTEBAN",-63.25393,-17.34288,253,4,1683,1936,1226,41,412,1638
"Bolivia","Santa Cruz","Obispo Santisteban","Montero","COL. RAFAEL TERRAZAS",-63.25919,-17.3407,325,8,1954,2279,1572,46,328,1900
"Bolivia","Santa Cruz","Obispo Santisteban","Montero","COL. RENE MORENO",-63.25811,-17.33856,199,9,2754,2953,2172,155,418,2590
"Bolivia","Santa Cruz","Obispo Santisteban","Montero","COL. SAN JOSE OBRERO",-63.24022,-17.34599,621,38,3672,4293,1383,137,2114,3497
"Bolivia","Santa Cruz","Obispo Santisteban","Montero","COL. SIMON BOLIVAR",-63.25801,-17.34814,173,8,1404,1577,983,110,303,1286
"Bolivia","Santa Cruz","Obispo Santisteban","Montero","COL. U.E. ELVIRA FRIAS",-63.25016,-17.33013,929,77,5774,6703,1833,287,3577,5410
"Bolivia","Santa Cruz","Obispo Santisteban","Montero","COL. U.E. MONTECRISTO",-63.26806,-17.34976,359,13,1873,2232,738,310,812,1550
"Bolivia","Santa Cruz","Obispo Santisteban","Montero","COL. UNIDAD EDUCATIVA LA ESPERANZA",-63.23973,-17.35262,304,10,2210,2514,1188,81,931,2119
"Bolivia","Santa Cruz","Obispo Santisteban","Montero","COL. UNIDAD EDUCATIVA VILLA VIRGINIA",-63.23734,-17.33811,358,24,1977,2335,563,86,1304,1867
"Bolivia","Santa Cruz","Obispo Santisteban","Montero","COL. VICTOR SALVATIERRA",-63.25366,-17.34156,266,8,1851,2117,1398,42,403,1801
"Bolivia","Santa Cruz","Obispo Santisteban","Montero","ESC. U.E. MARILUZ ESTREMADOIRO",-63.22701,-17.32729,27,4,158,185,74,8,72,146
"Bolivia","Santa Cruz","Obispo Santisteban","Montero","U.E. 12 DE ABRIL",-63.25831,-17.33828,23,3,331,354,148,19,161,309
"Bolivia","Santa Cruz","Obispo Santisteban","Montero","U.E. JUANCITO PINTO",-63.14261,-17.58141,44,15,922,966,189,31,687,876
"Bolivia","Santa Cruz","Obispo Santisteban","Montero","U.E. MARCELIANO MONTERO",-63.25181,-17.34623,251,14,1663,1914,1287,33,329,1616
"Bolivia","Santa Cruz","Obispo Santisteban","Montero","UE MAXIMILIANO KOLBE",-63.26643,-17.3404,613,29,4199,4812,2592,165,1413,4005
"Bolivia","Santa Cruz","Obispo Santisteban","Montero","U.E. NUEVO MILENIO",-63.24696,-17.32077,31,2,170,201,62,5,101,163
"Bolivia","Santa Cruz","Obispo Santisteban","Montero","U.E. SAN RAMON DE LA VIBORA",-63.26657,-17.33263,15,0,154,169,41,4,109,150
"Bolivia","Santa Cruz","Obispo Santisteban","Montero","U.E. SAN SILVESTRE",-63.26012,-17.3525,33,3,234,267,96,9,126,222
"Bolivia","Santa Cruz","Obispo Santisteban","Montero","U.E. SANTA ROSITA",-63.2749,-17.30831,0,0,4,4,3,0,1,4
"Bolivia","Santa Cruz","Obispo Santisteban","San Pedro","ESC. 9 DE ABRIL",-63.66607,-16.60111,106,9,588,694,180,12,387,567
"Bolivia","Santa Cruz","Obispo Santisteban","San Pedro","ESC. CANANDOA",-63.71227,-16.52267,80,6,343,423,68,13,256,324
"Bolivia","Santa Cruz","Obispo Santisteban","San Pedro","ESC. FE Y ALEGRIA",-63.48004,-16.82541,301,38,1758,2059,789,34,897,1686
"Bolivia","Santa Cruz","Obispo Santisteban","San Pedro","ESC. FE Y ALEGRIA TITO BOLTAN",-63.42871,-16.84723,113,7,864,977,420,12,425,845
"Bolivia","Santa Cruz","Obispo Santisteban","San Pedro","ESC. NUCLEO CENTRAL MURILLO",-63.55027,-16.75557,15,4,178,193,62,4,108,170
"Bolivia","Santa Cruz","Obispo Santisteban","San Pedro","ESC. OBISPO SANTISTEBAN",-63.38285,-16.84942,77,6,601,678,162,34,399,561
"Bolivia","Santa Cruz","Obispo Santisteban","San Pedro","ESC. PADRE REMO PRANDINI VIOTTI",-63.6132,-16.67545,195,29,1059,1254,380,22,628,1008
"Bolivia","Santa Cruz","Obispo Santisteban","San Pedro","ESC. SAN SILVESTRE",-63.3363,-16.87776,16,0,113,129,34,1,78,112
"Bolivia","Santa Cruz","Obispo Santisteban","San Pedro","ESC. SECCIONAL LITORAL",-63.57311,-16.72976,28,2,270,298,75,1,192,267
"Bolivia","Santa Cruz","Obispo Santisteban","San Pedro","ESC. U.E. PETA GRANDE",-63.68477,-16.44438,25,1,112,137,24,8,79,103
"Bolivia","Santa Cruz","Obispo Santisteban","San Pedro","ESC. VILLA ROSARIO",-63.42629,-16.93978,74,5,291,365,47,8,231,278
"Bolivia","Santa Cruz","Sara","Colpa Bélgica","ESC. LOLA TERRAZAS DE GASSER",-63.23116,-17.5691,440,15,2358,2798,1357,39,947,2304
"Bolivia","Santa Cruz","Sara","Colpa Bélgica","ESC, REPUBLICA DEL BRASIL",-63.2303,-17.56968,109,8,689,798,478,20,183,661
"Bolivia","Santa Cruz","Sara","Portachuelo","ESC. ANGEL MARIA LIMPIAS",-63.39923,-17.35743,236,11,1770,2006,1310,24,425,1735
"Bolivia","Santa Cruz","Sara","Portachuelo","ESC. JULIO LANDIVAR",-63.39304,-17.35695,176,6,1373,1549,1085,23,259,1344
"Bolivia","Santa Cruz","Sara","Portachuelo","ESC. LA APLICACION",-63.39476,-17.35477,368,54,3185,3553,2389,107,635,3024
"Bolivia","Santa Cruz","Sara","Portachuelo","ESC. MARTINA DORADO",-63.39271,-17.35174,365,60,2771,3136,1964,71,676,2640
"Bolivia","Santa Cruz","Sara","Portachuelo","ESC. NUCLEO CENTRAL",-63.51644,-17.58445,88,9,595,683,403,4,179,582
"Bolivia","Santa Cruz","Sara","Portachuelo","ESC. PEROTO",-63.41801,-17.47633,0,0,53,53,38,2,13,51
"Bolivia","Santa Cruz","Sara","Portachuelo","ESC. SAN IGNACIO",-63.57069,-17.2788,59,3,363,422,225,7,128,353
"Bolivia","Santa Cruz","Sara","Santa Rosa del Sara","ESC. 4 DE MARZO",-63.89693,-16.93718,35,5,293,328,31,10,247,278
"Bolivia","Santa Cruz","Sara","Santa Rosa del Sara","ESC.  ALFREDO VACA FLOR",-63.86467,-16.67098,100,8,454,554,58,13,375,433
"Bolivia","Santa Cruz","Sara","Santa Rosa del Sara","ESC  ALFREDO VASQUEZ",-63.18314,-17.78275,65,7,575,640,438,33,97,535
"Bolivia","Santa Cruz","Sara","Santa Rosa del Sara","ESC. EL COLORADO",-63.42475,-17.17983,18,2,97,115,40,3,52,92
"Bolivia","Santa Cruz","Sara","Santa Rosa del Sara","ESC.GALILEA",-63.67821,-16.95352,63,2,404,467,71,4,327,398
"Bolivia","Santa Cruz","Sara","Santa Rosa del Sara","ESC. LA CONQUISTA",-63.95355,-16.73366,72,6,363,435,53,17,287,340
"Bolivia","Santa Cruz","Sara","Santa Rosa del Sara","ESC.  MIXTO LOS ANDES",-63.83144,-16.88512,206,20,1067,1273,175,44,828,1003
"Bolivia","Santa Cruz","Sara","Santa Rosa del Sara","ESC. PALOMETAS",-63.52637,-17.03255,16,0,83,99,46,0,37,83
"Bolivia","Santa Cruz","Sara","Santa Rosa del Sara","ESC. PASTO MERCADO QUIROGA",-63.43382,-17.12932,64,6,318,382,145,12,155,300
"Bolivia","Santa Cruz","Sara","Santa Rosa del Sara","ESC. RINCON DE PALOMETA",-63.18314,-17.78275,67,7,405,472,263,2,133,396
"Bolivia","Santa Cruz","Sara","Santa Rosa del Sara","ESC. SAN LUIS",-63.78288,-16.94883,63,4,295,358,39,11,241,280
"Bolivia","Santa Cruz","Sara","Santa Rosa del Sara","ESC. SANTA ROSA",-63.59691,-17.11006,565,37,2833,3398,1803,52,941,2744
"Bolivia","Santa Cruz","Valle Grande","Moro Moro","ESC. ASTILLERO",-64.3554,-18.40132,4,9,119,123,26,5,79,105
"Bolivia","Santa Cruz","Valle Grande","Moro Moro","ESC.LA LAJA",-64.29583,-18.25416,14,8,175,189,96,9,62,158
"Bolivia","Santa Cruz","Valle Grande","Moro Moro","ESC. MOROMORO",-64.3226,-18.36664,94,11,646,740,393,30,212,605
"Bolivia","Santa Cruz","Valle Grande","Moro Moro","ESC.NUCLEO AÑAPACO",-64.28843,-18.44178,0,0,25,25,15,1,9,24
"Bolivia","Santa Cruz","Valle Grande","Moro Moro","ESC. NUCLEO ARIRUMA",-64.32661,-18.43659,23,1,155,178,65,8,81,146
"Bolivia","Santa Cruz","Valle Grande","Moro Moro","ESC. NUCLEO CENTRAL",-64.29378,-18.52514,6,0,61,67,17,2,42,59
"Bolivia","Santa Cruz","Valle Grande","Moro Moro","ESC. U.E. EL VELADERO",-64.26523,-18.35126,39,8,245,284,114,14,109,223
"Bolivia","Santa Cruz","Valle Grande","Postrer Valle","ESC. NUCLEO POSTERVALLE",-63.83601,-18.49309,143,19,603,746,398,23,163,561
"Bolivia","Santa Cruz","Valle Grande","Postrer Valle","ESC.SAN PABLO DE LA LADERA",-63.92479,-18.43073,7,0,36,43,18,1,17,35
"Bolivia","Santa Cruz","Valle Grande","Postrer Valle","ESC.TIERRAS NUEVAS",-63.90362,-18.48421,16,0,105,121,87,3,15,102
"Bolivia","Santa Cruz","Valle Grande","Postrer Valle","ESC. UNIDAD EDUCATIVA MOSQUERA",-63.75977,-18.62887,31,5,92,123,68,3,16,84
"Bolivia","Santa Cruz","Valle Grande","Pucará","ESC. EDEY CORBAN SEHALLER",-64.18601,-18.71765,99,9,593,692,262,18,304,566
"Bolivia","Santa Cruz","Valle Grande","Pucará","ESC. LA HIGUERA",-64.18205,-18.71724,54,8,322,376,195,10,109,304
"Bolivia","Santa Cruz","Valle Grande","Trigal","ESC. LA AGUADA",-64.05747,-18.29873,0,1,53,53,29,7,16,45
"Bolivia","Santa Cruz","Valle Grande","Trigal","ESC.LAGUNILLAS",-64.15909,-18.26369,39,4,276,315,113,60,99,212
"Bolivia","Santa Cruz","Valle Grande","Trigal","ESC.SAN JOSE AGUIRRE ACHA",-64.15065,-18.30182,136,10,533,669,266,15,242,508
"Bolivia","Santa Cruz","Valle Grande","Trigal","ESC.TTE.ROMAN ALDERETTE",-64.15926,-18.35822,29,2,156,185,88,7,59,147
"Bolivia","Santa Cruz","Valle Grande","Vallegrande","ESC. ALTO SECO",-64.07446,-18.87057,53,5,285,338,151,12,117,268
"Bolivia","Santa Cruz","Valle Grande","Vallegrande","ESC. CASAMONTES",-64.02926,-18.70448,44,4,138,182,90,3,41,131
"Bolivia","Santa Cruz","Valle Grande","Vallegrande","ESC. CENTRAL GUADALUPE",-64.08943,-18.55554,39,12,378,417,196,9,161,357
"Bolivia","Santa Cruz","Valle Grande","Vallegrande","ESC. DE CHACOPATA",-64.22842,-18.35763,11,8,153,164,77,21,47,124
"Bolivia","Santa Cruz","Valle Grande","Vallegrande","ESC.DE MANKAILLPA",-64.21599,-18.39356,0,0,61,61,44,7,10,54
"Bolivia","Santa Cruz","Valle Grande","Vallegrande","ESC. IGNACIO TERAN",-64.10592,-18.48932,362,42,2095,2457,1261,109,683,1944
"Bolivia","Santa Cruz","Valle Grande","Vallegrande","ESC. JUANA CARMEN ROMAN",-64.10367,-18.4858,300,25,1457,1757,857,71,504,1361
"Bolivia","Santa Cruz","Valle Grande","Vallegrande","ESC.LOMA LARGA",-63.90175,-18.76361,13,1,88,101,67,1,19,86
"Bolivia","Santa Cruz","Valle Grande","Vallegrande","ESC. LOS SITANOS",-63.95913,-18.86104,31,4,151,182,116,3,28,144
"Bolivia","Santa Cruz","Valle Grande","Vallegrande","ESC.MASICURI",-63.7827,-18.83035,30,3,166,196,109,7,47,156
"Bolivia","Santa Cruz","Valle Grande","Vallegrande","ESC.NARANJO",-64.25002,-18.42377,9,1,69,78,55,0,13,68
"Bolivia","Santa Cruz","Valle Grande","Vallegrande","ESC. NUCLEO EL BELLO",-64.1921,-18.4416,8,4,90,98,76,0,10,86
"Bolivia","Santa Cruz","Valle Grande","Vallegrande","ESC. NUCLEO SAN JUAN",-64.20347,-18.3373,15,5,158,173,101,3,49,150
"Bolivia","Santa Cruz","Valle Grande","Vallegrande","ESC. NUCLEO TUCUMANCILLO",-64.14893,-18.37689,4,1,54,58,37,0,16,53
"Bolivia","Santa Cruz","Valle Grande","Vallegrande","ESC. OBISPO MANUEL JOSE PEÑA",-64.10788,-18.48844,343,26,1917,2260,1149,100,642,1791
"Bolivia","Santa Cruz","Valle Grande","Vallegrande","ESC. PIRAIMIRI",-63.96607,-18.63742,13,5,83,96,46,7,25,71
"Bolivia","Santa Cruz","Valle Grande","Vallegrande","ESC.SANTA ANA",-64.14568,-18.59265,11,1,108,119,52,5,50,102
"Bolivia","Santa Cruz","Valle Grande","Vallegrande","ESC. SANTA ROSITA",-64.08921,-18.52326,22,3,132,154,85,3,41,126
"Bolivia","Santa Cruz","Valle Grande","Vallegrande","ESC. TEMPORAL",-64.07647,-18.63612,6,0,29,35,21,1,7,28
"Bolivia","Santa Cruz","Valle Grande","Vallegrande","ESC. UNIDAD EDUCATIVA ARENALES",-63.72049,-18.95825,28,0,113,141,87,4,22,109
"Bolivia","Santa Cruz","Valle Grande","Vallegrande","KINDER SANTA MARIA",-64.1016,-18.48618,239,26,1628,1867,968,80,554,1522
"Bolivia","Santa Cruz","Velasco","San Ignacio (San Ignacio de Velasco)","15 DE AGOSTO",-61.22021,-16.04663,28,5,192,220,13,6,168,181
"Bolivia","Santa Cruz","Velasco","San Ignacio (San Ignacio de Velasco)","ESC.ALBERTO NATUSCH BUSCH",-61.19359,-14.61075,6,0,36,42,11,0,25,36
"Bolivia","Santa Cruz","Velasco","San Ignacio (San Ignacio de Velasco)","ESC. CAMPAMENTO",-61.01795,-15.1786,121,10,391,512,206,16,159,365
"Bolivia","Santa Cruz","Velasco","San Ignacio (San Ignacio de Velasco)","ESC. CARLOS MAYSER",-60.96424,-16.37827,751,52,3206,3957,2263,74,817,3080
"Bolivia","Santa Cruz","Velasco","San Ignacio (San Ignacio de Velasco)","ESC.CENTRAL EL PORVENIR",-59.49656,-16.28357,89,2,119,208,46,1,70,116
"Bolivia","Santa Cruz","Velasco","San Ignacio (San Ignacio de Velasco)","ESC.CENTRAL PISO FIRME",-61.73743,-13.63076,32,4,143,175,49,6,84,133
"Bolivia","Santa Cruz","Velasco","San Ignacio (San Ignacio de Velasco)","ESC. DON BOSCO",-60.9684,-16.38181,500,65,2505,3005,1494,60,886,2380
"Bolivia","Santa Cruz","Velasco","San Ignacio (San Ignacio de Velasco)","ESC.EL CARMEN DE RUIZ",-61.09895,-16.04755,92,6,488,580,359,13,110,469
"Bolivia","Santa Cruz","Velasco","San Ignacio (San Ignacio de Velasco)","ESC. LIC. SENORITAS MONSENOR DANIEL RIVE",-60.95947,-16.38194,1047,45,4525,5572,3400,116,964,4364
"Bolivia","Santa Cruz","Velasco","San Ignacio (San Ignacio de Velasco)","ESC. MARISCAL SUCRE",-60.97673,-16.37599,890,47,3456,4346,2594,78,737,3331
"Bolivia","Santa Cruz","Velasco","San Ignacio (San Ignacio de Velasco)","ESC.MIRAFLORES",-60.39898,-15.7093,9,0,31,40,25,0,6,31
"Bolivia","Santa Cruz","Velasco","San Ignacio (San Ignacio de Velasco)","ESC.NUCLEO CENTRAL ESPIRITU",-60.52824,-16.18724,116,5,244,360,164,3,72,236
"Bolivia","Santa Cruz","Velasco","San Ignacio (San Ignacio de Velasco)","ESC. PAILITA",-60.71217,-16.55711,12,1,54,66,22,0,31,53
"Bolivia","Santa Cruz","Velasco","San Ignacio (San Ignacio de Velasco)","ESC. RECREO",-61.05543,-16.42583,17,1,108,125,38,1,68,106
"Bolivia","Santa Cruz","Velasco","San Ignacio (San Ignacio de Velasco)","ESC. SAN JOSEMA",-61.0378,-16.26388,6,5,97,103,27,4,61,88
"Bolivia","Santa Cruz","Velasco","San Ignacio (San Ignacio de Velasco)","ESC. SAN JUAN DEL MACOÑO",-60.1824,-16.04592,8,0,56,64,37,3,16,53
"Bolivia","Santa Cruz","Velasco","San Ignacio (San Ignacio de Velasco)","ESC. SAN MARTIN",-61.48943,-15.39137,193,14,705,898,97,29,565,662
"Bolivia","Santa Cruz","Velasco","San Ignacio (San Ignacio de Velasco)","ESC.SANTA ANA",-60.68709,-16.58516,107,2,363,470,274,4,83,357
"Bolivia","Santa Cruz","Velasco","San Ignacio (San Ignacio de Velasco)","ESC.SANTA ROSA ROCA",-61.43752,-15.9136,394,22,1053,1447,549,45,437,986
"Bolivia","Santa Cruz","Velasco","San Ignacio (San Ignacio de Velasco)","ESC.SAN VICENTE",-60.07525,-16.27286,61,5,229,290,122,10,92,214
"Bolivia","Santa Cruz","Velasco","San Ignacio (San Ignacio de Velasco)","ESC. U.E. 25 DE JULIO",-60.34592,-15.55293,18,1,67,85,41,5,20,61
"Bolivia","Santa Cruz","Velasco","San Ignacio (San Ignacio de Velasco)","ESC. U.E. LA ESTRELLA",-61.51268,-15.57549,44,5,337,381,106,13,213,319
"Bolivia","Santa Cruz","Velasco","San Ignacio (San Ignacio de Velasco)","ESC. U.E. SIMON BOLIVAR",-60.42154,-15.33675,14,0,118,132,55,6,57,112
"Bolivia","Santa Cruz","Velasco","San Ignacio (San Ignacio de Velasco)","U.E. 15 DE AGOSTO",-61.221,-16.0462,5,0,105,110,16,2,87,103
"Bolivia","Santa Cruz","Velasco","San Ignacio (San Ignacio de Velasco)","U.E. 19 DE MARZO",-61.04763,-16.33254,8,0,0,8,0,0,0,0
"Bolivia","Santa Cruz","Velasco","San Ignacio (San Ignacio de Velasco)","U.E. BERNARDO MONTEAGUDO",-61.43381,-15.22893,11,1,94,105,6,2,85,91
"Bolivia","Santa Cruz","Velasco","San Ignacio (San Ignacio de Velasco)","U.E. CELEDONIO CORTEZON",-61.15897,-16.03947,4,0,0,4,0,0,0,0
"Bolivia","Santa Cruz","Velasco","San Ignacio (San Ignacio de Velasco)","U.E. JOSE CHAVEZ",-61.42244,-15.99493,1,0,75,76,41,1,33,74
"Bolivia","Santa Cruz","Velasco","San Ignacio (San Ignacio de Velasco)","U.E. JOSE FERREIRA",-60.96625,-15.38916,3,0,41,44,25,0,16,41
"Bolivia","Santa Cruz","Velasco","San Ignacio (San Ignacio de Velasco)","U.E. JOSE PESSOA",-60.89307,-15.46235,0,2,42,42,23,2,15,38
"Bolivia","Santa Cruz","Velasco","San Ignacio (San Ignacio de Velasco)","U.E. MERCEDES DE LAS MINAS",-60.87927,-16.38784,3,2,50,53,27,0,21,48
"Bolivia","Santa Cruz","Velasco","San Ignacio (San Ignacio de Velasco)","U.E. SAN BARTOLO DE LA FRONTERA",-59.89635,-16.29955,22,1,109,131,57,5,46,103
"Bolivia","Santa Cruz","Velasco","San Ignacio (San Ignacio de Velasco)","U.E. SAN JAVIERITO",-61.00164,-16.16473,12,3,247,259,155,21,68,223
"Bolivia","Santa Cruz","Velasco","San Ignacio (San Ignacio de Velasco)","U.E. SAN LORENCITO DE LA FRONTERA",-60.32001,-15.62855,12,1,107,119,68,2,36,104
"Bolivia","Santa Cruz","Velasco","San Ignacio (San Ignacio de Velasco)","U.E. SAN RAFAELITO DE SUPONEMA",-60.73782,-16.51591,4,1,107,111,86,1,19,105
"Bolivia","Santa Cruz","Velasco","San Ignacio (San Ignacio de Velasco)","U.E. SANTA ANITA DE LA FRONTERA",-60.46891,-16.16416,5,1,64,69,9,1,53,62
"Bolivia","Santa Cruz","Velasco","San Ignacio (San Ignacio de Velasco)","U.E. TARCILA JUSTINIANO",-61.3272,-15.92669,4,1,68,72,30,3,34,64
"Bolivia","Santa Cruz","Velasco","San Ignacio (San Ignacio de Velasco)","U.E. TIERRA FIRME",-61.38297,-15.43932,13,1,123,136,7,4,111,118
"Bolivia","Santa Cruz","Velasco","San Miguel (San Miguel de Velasco)","ESC. BELISARIO SANTISTEBAN",-60.96719,-16.70072,369,14,1819,2188,784,34,987,1771
"Bolivia","Santa Cruz","Velasco","San Miguel (San Miguel de Velasco)","ESC. JOSE J.DORADO",-60.96856,-16.69866,431,61,2409,2840,1178,44,1126,2304
"Bolivia","Santa Cruz","Velasco","San Miguel (San Miguel de Velasco)","ESC. MONSEÑOR BONIFACIO",-61.49168,-17.07628,59,9,378,437,203,7,159,362
"Bolivia","Santa Cruz","Velasco","San Miguel (San Miguel de Velasco)","ESC. U.E. CRUZ DEL TOCOIGO",-61.14905,-16.62491,14,3,112,126,27,1,81,108
"Bolivia","Santa Cruz","Velasco","San Miguel (San Miguel de Velasco)","ESC. U.E. SAN LUISITO DE LIMA",-61.22618,-16.79143,2,0,20,22,1,2,17,18
"Bolivia","Santa Cruz","Velasco","San Miguel (San Miguel de Velasco)","ESC. U.E. SAN PEDRO DEL CERRITO",-61.1039,-16.61456,6,0,49,55,17,2,30,47
"Bolivia","Santa Cruz","Velasco","San Miguel (San Miguel de Velasco)","U.E. ALTAMIRA",-61.0463,-16.71514,6,2,49,55,6,1,40,46
"Bolivia","Santa Cruz","Velasco","San Miguel (San Miguel de Velasco)","U.E. SAPOCO",-60.99136,-16.61194,0,3,85,85,11,1,70,81
"Bolivia","Santa Cruz","Velasco","San Rafael","ESC. EL TUNA",-59.6983,-16.62828,32,0,138,170,106,3,29,135
"Bolivia","Santa Cruz","Velasco","San Rafael","ESC. GODOFREDO TRENKER",-60.67352,-16.78576,458,24,1673,2131,1119,39,491,1610
"Bolivia","Santa Cruz","Velasco","San Rafael","ESC. MIRAFLORES II",-60.58031,-17.12125,64,0,228,292,56,5,167,223
"Bolivia","Santa Cruz","Velasco","San Rafael","ESC. VILLA FATIMA",-60.60354,-16.9649,17,1,52,69,34,3,14,48
"Bolivia","Santa Cruz","Warnes","Okinawa Uno","ESC. NUEVA AURORA",-62.80148,-17.49827,7,0,48,55,39,0,9,48
"Bolivia","Santa Cruz","Warnes","Okinawa Uno","ESCUELA. COLEGIO EVANGELICO METODISTA",-62.88918,-17.21915,486,66,3233,3719,2007,172,988,2995
"Bolivia","Santa Cruz","Warnes","Okinawa Uno","ESCUELA UNID. EDU.NUEVO HORIZONTE",-62.80159,-17.32424,135,14,934,1069,639,9,272,911
"Bolivia","Santa Cruz","Warnes","Okinawa Uno","ESC. UNIDAD EDUCATIVA NUEVA ESPERANZA",-62.7861,-17.24826,30,5,201,231,107,6,83,190
"Bolivia","Santa Cruz","Warnes","Okinawa Uno","ESC. UNID. EDU. SAN MIGUEL",-62.90409,-17.43998,60,3,373,433,217,8,145,362
"Bolivia","Santa Cruz","Warnes","Okinawa Uno","ESC. UNID.EDU. SECCIONAL PUERTO NUEVO",-62.79018,-17.17909,52,5,338,390,251,5,77,328
"Bolivia","Santa Cruz","Warnes","Okinawa Uno","ESC.UNID EDU.  VILLA REYES",-62.82537,-17.39157,19,0,129,148,54,5,70,124
"Bolivia","Santa Cruz","Warnes","Warnes","26 DE MARZO",-63.13284,-17.58807,25,2,152,177,57,28,65,122
"Bolivia","Santa Cruz","Warnes","Warnes","ESC. ADRIAN JUSTINIANO ROCA",-63.01891,-17.59505,73,12,474,547,287,10,165,452
"Bolivia","Santa Cruz","Warnes","Warnes","ESC. CIUDAD SATELITE NORTE",-63.14571,-17.60657,1688,57,8634,10322,3703,302,4572,8275
"Bolivia","Santa Cruz","Warnes","Warnes","ESC. COL. CONSTANTINO CUELLAR",-63.16426,-17.50641,477,89,3386,3863,2007,85,1205,3212
"Bolivia","Santa Cruz","Warnes","Warnes","ESC. COLEGIO JULIA SAID",-63.16407,-17.51213,1125,51,6745,7870,3208,253,3233,6441
"Bolivia","Santa Cruz","Warnes","Warnes","ESC. EL JIPA",-63.14586,-17.50428,34,5,450,484,197,17,231,428
"Bolivia","Santa Cruz","Warnes","Warnes","ESC. FISCAL POTRERO LARGO",-63.11728,-17.56155,448,24,2508,2956,1064,103,1317,2381
"Bolivia","Santa Cruz","Warnes","Warnes","ESC. JUANA AZURDUY DE PADILLA",-63.0628,-17.51302,633,32,4061,4694,1485,187,2357,3842
"Bolivia","Santa Cruz","Warnes","Warnes","ESC. TERRACOR",-63.18655,-17.65559,324,24,2002,2326,1188,49,741,1929
"Bolivia","Santa Cruz","Warnes","Warnes","ESC. UE ANGELMIRA MONTE. DE DALENCE",-62.96617,-17.45183,46,6,429,475,269,9,145,414
"Bolivia","Santa Cruz","Warnes","Warnes","ESC. UE LAS BARRERAS",-63.18001,-17.44845,189,29,1575,1764,761,101,684,1445
"Bolivia","Santa Cruz","Warnes","Warnes","ESC. UE MARIANO VACA MONTERO",-63.05692,-17.42761,163,10,849,1012,458,49,332,790
"Bolivia","Santa Cruz","Warnes","Warnes","ESC. UE. NUCLEO CENTRAL CLARA CHUCHIO",-63.10474,-17.6164,84,8,615,699,397,14,196,593
"Bolivia","Santa Cruz","Warnes","Warnes","ESC. UE SECCIONAL AZUZAQUI",-63.15946,-17.43235,33,3,340,373,149,13,175,324
"Bolivia","Santa Cruz","Warnes","Warnes","ESC. UE SECCIONAL LA MARINA",-63.00195,-17.4187,62,9,345,407,123,8,205,328
"Bolivia","Santa Cruz","Warnes","Warnes","ESC. UE TUROBITO",-63.14501,-17.36471,26,5,314,340,193,16,100,293
"Bolivia","Santa Cruz","Warnes","Warnes","ESC. UNID. EDU. 21 DE OCTUBRE",-62.99185,-17.40991,30,5,171,201,27,5,134,161
"Bolivia","Santa Cruz","Warnes","Warnes","ESC. UNID. EDU. DON BOSCO",-63.20383,-17.40809,91,4,566,657,333,17,212,545
"Bolivia","Santa Cruz","Warnes","Warnes","ESC. UNID. EDU. EL TAJIBO",-62.99646,-17.24698,146,14,736,882,434,18,270,704
"Bolivia","Santa Cruz","Warnes","Warnes","ESC.  UNID. EDU. FELIX PAZ VIEIRA",-63.04347,-17.29358,26,17,287,313,127,9,134,261
"Bolivia","Santa Cruz","Warnes","Warnes","ESC. UNID. EDU.  JUAN LATINO",-63.22111,-17.4443,59,5,392,451,188,17,182,370
"Bolivia","Santa Cruz","Warnes","Warnes","ESC. UNID. EDU.  LA REFORMA",-63.07001,-17.26757,87,13,627,714,301,7,306,607
"Bolivia","Santa Cruz","Warnes","Warnes","ESC. UNID. EDU.  LOS CHACOS",-63.01535,-17.29066,54,5,360,414,251,2,102,353
"Bolivia","Santa Cruz","Warnes","Warnes","ESC.UNID.EDU.    MOTACU",-63.11813,-17.55554,30,2,206,236,140,3,61,201
"Bolivia","Santa Cruz","Warnes","Warnes","ESC. UNID. EDU. SECCIONAL EL FUTURO",-63.0559,-17.36139,6,3,73,79,27,2,41,68
"Bolivia","Santa Cruz","Warnes","Warnes","ESC. VALLE SANCHEZ",-63.16564,-17.65603,523,14,2806,3329,1988,78,726,2714
"Bolivia","Santa Cruz","Warnes","Warnes","POLITECNICO PENTAGUAZU",-63.13067,-17.59501,8,0,53,61,23,0,30,53
"Bolivia","Santa Cruz","Warnes","Warnes","U.E. AKUALAND",-63.17204,-17.64403,23,1,330,353,217,5,107,324
"Bolivia","Santa Cruz","Warnes","Warnes","U.E. ANTONIO ANZUATI",-63.17149,-17.53695,12,2,163,175,52,8,101,153
"Bolivia","Santa Cruz","Warnes","Warnes","U.E. BUENA FE",-63.0742,-17.5464,52,5,673,725,181,55,432,613
"Bolivia","Santa Cruz","Warnes","Warnes","U.E. CAMPO ROSSO 4 DE ABRIL",-63.13654,-17.59862,157,9,1048,1205,489,28,522,1011
"Bolivia","Santa Cruz","Warnes","Warnes","U.E. EL MANANTIAL",-63.12106,-17.60827,94,2,738,832,407,14,315,722
"Bolivia","Santa Cruz","Warnes","Warnes","U.E. IGNACIO WARNES",-63.16686,-17.50828,1162,44,7429,8591,4224,228,2933,7157
"Bolivia","Santa Cruz","Warnes","Warnes","U.E. JOSE MANUEL VACA",-63.16396,-17.50945,34,5,235,269,134,4,92,226
"Bolivia","Santa Cruz","Warnes","Warnes","U.E. JUANCITO PINTO",-63.27866,-17.35187,19,1,252,271,78,6,167,245
"Bolivia","Santa Cruz","Warnes","Warnes","U.E. MAXIMO NOVILLO",-63.12106,-17.60827,0,10,975,975,320,107,538,858
"Bolivia","Santa Cruz","Warnes","Warnes","U.E. MONTE CARMELO",-63.11643,-17.59848,26,2,251,277,104,37,108,212
"Bolivia","Santa Cruz","Warnes","Warnes","U.E. NUEVA JERUSALEN-PENTAGUAZU",-63.12896,-17.60241,30,1,377,407,155,8,213,368
"Bolivia","Santa Cruz","Warnes","Warnes","U.E. PAITITI",-63.17518,-17.5598,18,3,232,250,68,5,156,224
"Bolivia","Santa Cruz","Warnes","Warnes","U.E . SAN JUAN",-63.10375,-17.60646,122,3,865,987,414,31,417,831
"Bolivia","Santa Cruz","Warnes","Warnes","U.E. SATELITE NORTE",-63.14511,-17.60841,91,3,565,656,251,25,286,537
"Bolivia","Santa Cruz","Warnes","Warnes","U.E. WAJOJO",-63.18615,-17.54112,12,5,225,237,89,15,116,205
"Bolivia","Tarija","Arce","Bermejo","(CÁRCEL) CARCELETA BERMEJO",-64.34433,-22.73379,1,0,14,15,6,0,8,14
"Bolivia","Tarija","Arce","Bermejo","U.E. 25 DE MAYO",-64.33881,-22.73283,751,34,2989,3740,1773,60,1122,2895
"Bolivia","Tarija","Arce","Bermejo","U.E. 8 DE SEPTIEMBRE",-64.3345,-22.74253,499,33,1867,2366,936,54,844,1780
"Bolivia","Tarija","Arce","Bermejo","U.E. ANTONIO JOSE DE SUCRE",-64.33714,-22.72646,197,5,812,1009,408,22,377,785
"Bolivia","Tarija","Arce","Bermejo","U.E. ARROZALES",-64.28224,-22.71737,45,2,187,232,72,6,107,179
"Bolivia","Tarija","Arce","Bermejo","U.E. AULIO ARAOZ",-64.34415,-22.72519,444,32,1518,1962,708,62,716,1424
"Bolivia","Tarija","Arce","Bermejo","U.E. BARREDERO",-64.25467,-22.60689,59,6,258,317,42,5,205,247
"Bolivia","Tarija","Arce","Bermejo","U.E. CAMPO GRANDE (ARCE)",-64.31056,-22.8059,111,12,300,411,84,30,174,258
"Bolivia","Tarija","Arce","Bermejo","U.E. COLONIA LINARES",-64.27553,-22.67242,127,18,486,613,124,20,324,448
"Bolivia","Tarija","Arce","Bermejo","U.E. EDUARDO AVAROA",-64.34496,-22.72868,920,44,3542,4462,1931,103,1464,3395
"Bolivia","Tarija","Arce","Bermejo","U.E. FLOR DE ORO",-64.42138,-22.64809,47,3,141,188,56,4,78,134
"Bolivia","Tarija","Arce","Bermejo","U.E. GUIDO VILLAGOMEZ",-64.333,-22.73719,648,45,2524,3172,1332,71,1076,2408
"Bolivia","Tarija","Arce","Bermejo","U.E. LA ESPERANZA",-64.31773,-22.72795,16,6,289,305,77,5,201,278
"Bolivia","Tarija","Arce","Bermejo","U.E. MOTO MENDEZ",-64.40874,-22.67791,78,11,209,287,71,8,119,190
"Bolivia","Tarija","Arce","Bermejo","U.E. MSCAL. ANDRES DE SANTA CRUZ",-64.33983,-22.73268,620,20,1911,2531,1155,37,699,1854
"Bolivia","Tarija","Arce","Bermejo","U.E. OCTAVIO CAMPERO ECHAZU (BERMEJO)",-64.33255,-22.73421,795,42,3075,3870,1617,101,1315,2932
"Bolivia","Tarija","Arce","Bermejo","U.E. PORCELANA",-64.2924,-22.77003,40,6,97,137,28,3,60,88
"Bolivia","Tarija","Arce","Padcaya","ESC. SECCIONAL QUEÑAHUAYCO",-64.95709,-21.92935,31,2,259,290,37,9,211,248
"Bolivia","Tarija","Arce","Padcaya","ESC. TACUARA SIMON BOLIVAR",-64.85365,-21.8613,38,2,154,192,30,2,120,150
"Bolivia","Tarija","Arce","Padcaya","NUCLEO 9 DE OCTUBRE",-64.16064,-22.4478,73,5,169,242,30,7,127,157
"Bolivia","Tarija","Arce","Padcaya","NUCLEO  SAN TELMO/PRIMERO DE MAYO",-64.41067,-22.53317,50,8,278,328,124,16,130,254
"Bolivia","Tarija","Arce","Padcaya","U.E. 2 DE AGOSTO",-64.24153,-22.49751,66,3,248,314,30,8,207,237
"Bolivia","Tarija","Arce","Padcaya","U.E. ABRA DE SAN MIGUEL",-64.80976,-21.90239,12,1,213,225,80,1,131,211
"Bolivia","Tarija","Arce","Padcaya","U.E. ANICETO ARCE",-64.71397,-21.88711,317,26,1759,2076,975,41,717,1692
"Bolivia","Tarija","Arce","Padcaya","U.E. ANZELMO ONTIVEROS",-64.53857,-22.26854,73,4,365,438,71,8,282,353
"Bolivia","Tarija","Arce","Padcaya","U.E. BLANCA NAVAJAS",-64.84832,-21.89751,89,6,384,473,105,31,242,347
"Bolivia","Tarija","Arce","Padcaya","U.E. CAMACHO",-64.91243,-21.89222,64,5,367,431,84,9,269,353
"Bolivia","Tarija","Arce","Padcaya","U.E. CANCHAS MAYU",-64.89188,-21.89764,28,2,209,237,42,2,163,205
"Bolivia","Tarija","Arce","Padcaya","U.E. EL CARMEN",-64.84747,-22.04908,25,1,135,160,32,1,101,133
"Bolivia","Tarija","Arce","Padcaya","U.E. ELOY APARICIO",-64.67204,-21.83963,116,8,518,634,188,12,310,498
"Bolivia","Tarija","Arce","Padcaya","U.E. JUAN PABLO II",-64.47629,-22.45985,54,1,127,181,50,3,73,123
"Bolivia","Tarija","Arce","Padcaya","U.E. LA HUERTA",-64.93794,-21.91131,43,7,209,252,27,6,169,196
"Bolivia","Tarija","Arce","Padcaya","U.E. LA MERCED",-64.67546,-22.02656,64,4,338,402,171,11,152,323
"Bolivia","Tarija","Arce","Padcaya","U.E. LIMAL",-64.49821,-22.32937,21,0,107,128,35,3,69,104
"Bolivia","Tarija","Arce","Padcaya","U.E. NARANJO AGRIO",-64.49283,-22.30481,23,1,100,123,17,1,81,98
"Bolivia","Tarija","Arce","Padcaya","U.E. OROZAS ARRIBA",-64.64409,-21.91746,90,15,505,595,137,23,330,467
"Bolivia","Tarija","Arce","Padcaya","U.E. OSCAR HIZA BASTIAS",-64.66535,-22.17904,117,9,466,583,149,19,289,438
"Bolivia","Tarija","Arce","Padcaya","U.E. PAMPA GRANDE",-64.43581,-22.04747,181,23,464,645,110,17,314,424
"Bolivia","Tarija","Arce","Padcaya","U.E. QUEBRADA DE CAÑAS",-64.88522,-21.96515,25,3,135,160,19,6,107,126
"Bolivia","Tarija","Arce","Padcaya","U.E. RIO NEGRO",-64.67294,-22.10281,53,11,305,358,103,11,180,283
"Bolivia","Tarija","Arce","Padcaya","U.E. ROSILLAS II",-64.78128,-21.93346,110,10,525,635,211,11,293,504
"Bolivia","Tarija","Arce","Padcaya","U.E. RUMY CANCHA",-64.67708,-21.94845,45,6,146,191,57,6,77,134
"Bolivia","Tarija","Arce","Padcaya","U.E. SALADO CONCHAS",-64.41152,-22.36673,15,0,122,137,27,2,93,120
"Bolivia","Tarija","Arce","Padcaya","U.E. SAN ANTONIO DE MACOYA",-64.89361,-22.10435,92,6,233,325,164,12,51,215
"Bolivia","Tarija","Arce","Padcaya","U.E. SAN FRANCISCO (ARCE)",-64.81699,-21.99598,22,1,151,173,34,5,111,145
"Bolivia","Tarija","Arce","Padcaya","U.E. SAN JOSE DE MARAÑUELO",-64.8847,-21.02283,20,3,175,195,18,2,152,170
"Bolivia","Tarija","Arce","Padcaya","U.E. SIMON BOLIVAR DE REJARA",-64.98435,-22.00053,49,2,271,320,21,4,244,265
"Bolivia","Tarija","Arce","Padcaya","U.E. VIRGEN DE CHAGUAYA",-64.82275,-21.86792,70,4,296,366,108,11,173,281
"Bolivia","Tarija","Avilés","Uriondo (Concepción)","COL. DELFIN PINO ICHAZU",-64.65437,-21.69452,359,20,1833,2192,1080,75,658,1738
"Bolivia","Tarija","Avilés","Uriondo (Concepción)","ESC. FELIPE ARAOZ",-64.79521,-21.81298,72,8,255,327,107,10,130,237
"Bolivia","Tarija","Avilés","Uriondo (Concepción)","ESC. MULLI CANCHA 27 DE MAYO",-64.75569,-21.66716,15,2,67,82,23,7,35,58
"Bolivia","Tarija","Avilés","Uriondo (Concepción)","ESC. NICOLAS GARECA",-64.73965,-21.68574,18,8,125,143,36,8,73,109
"Bolivia","Tarija","Avilés","Uriondo (Concepción)","ESC. WALTER MADALLENO",-64.87085,-21.83233,79,4,223,302,48,8,163,211
"Bolivia","Tarija","Avilés","Uriondo (Concepción)","U.E. 15 DE OCTUBRE",-64.87048,-21.78415,121,9,347,468,82,12,244,326
"Bolivia","Tarija","Avilés","Uriondo (Concepción)","U.E. 19 DE MARZO",-64.76694,-21.79675,44,4,203,247,73,7,119,192
"Bolivia","Tarija","Avilés","Uriondo (Concepción)","U.E. ANCON CHICO",-64.65513,-21.67163,37,5,295,332,106,4,180,286
"Bolivia","Tarija","Avilés","Uriondo (Concepción)","U.E. ANCON GRANDE",-64.65231,-21.62995,9,0,129,138,82,8,39,121
"Bolivia","Tarija","Avilés","Uriondo (Concepción)","U.E. ANICETO ARCE",-64.73565,-21.75162,181,22,870,1051,431,28,389,820
"Bolivia","Tarija","Avilés","Uriondo (Concepción)","U.E. LA CHOZA",-64.61714,-21.67806,85,13,590,675,323,32,222,545
"Bolivia","Tarija","Avilés","Uriondo (Concepción)","U.E. LA COMPAÑIA",-64.68107,-21.70434,37,7,329,366,106,14,202,308
"Bolivia","Tarija","Avilés","Uriondo (Concepción)","U.E. NUEVO AMANECER",-64.65608,-21.7632,178,17,888,1066,450,19,402,852
"Bolivia","Tarija","Avilés","Uriondo (Concepción)","U.E. ROSARIO JARAMILLO",-64.62204,-21.69797,261,40,1842,2103,823,84,895,1718
"Bolivia","Tarija","Avilés","Uriondo (Concepción)","U.E. VIRGEN DE LADERAS",-64.55874,-21.6606,27,4,166,193,45,9,108,153
"Bolivia","Tarija","Avilés","Yunchará","COL. 6 DE ABRIL",-65.22864,-21.82303,67,1,260,327,61,12,186,247
"Bolivia","Tarija","Avilés","Yunchará","U.E. 13 DE ABRIL",-65.09945,-21.99084,28,1,162,190,10,8,143,153
"Bolivia","Tarija","Avilés","Yunchará","U.E. 15 DE ABRIL",-65.32096,-21.76059,13,3,67,80,8,2,54,62
"Bolivia","Tarija","Avilés","Yunchará","U.E.  25 DE MAYO",-65.13538,-21.55874,39,2,194,233,26,7,159,185
"Bolivia","Tarija","Avilés","Yunchará","U.E. CHORCOYA AVILES",-65.05279,-21.65858,24,4,123,147,43,5,71,114
"Bolivia","Tarija","Avilés","Yunchará","U.E. FELIX RAMOS",-65.28792,-21.84653,23,0,54,77,7,2,45,52
"Bolivia","Tarija","Avilés","Yunchará","U.E. HUGO AMABLE HOYOS",-65.25793,-21.60342,8,1,45,53,3,0,41,44
"Bolivia","Tarija","Avilés","Yunchará","U.E. JOSE BALLIVIAN",-65.09161,-21.8291,90,10,208,298,44,6,148,192
"Bolivia","Tarija","Avilés","Yunchará","U.E. JOSE MARIA AVILES",-65.24372,-21.56001,18,1,99,117,15,7,76,91
"Bolivia","Tarija","Avilés","Yunchará","U.E. NARCISO CAMPERO",-65.32111,-21.81886,36,6,124,160,23,6,89,112
"Bolivia","Tarija","Avilés","Yunchará","U.E. ÑOQUERA",-65.13422,-21.62397,35,5,151,186,53,3,90,143
"Bolivia","Tarija","Avilés","Yunchará","U.E. PASAJES",-65.08871,-21.74598,48,5,272,320,50,10,207,257
"Bolivia","Tarija","Avilés","Yunchará","U.E. QUEBRADA HONDA",-65.15102,-21.95652,36,0,125,161,19,5,101,120
"Bolivia","Tarija","Avilés","Yunchará","U.E. SAN JOSE DE CHURQUIS",-65.23459,-21.72629,22,3,68,90,8,6,51,59
"Bolivia","Tarija","Avilés","Yunchará","U.E. SATURNINO URZAGASTE",-65.30037,-21.69103,18,0,123,141,15,0,108,123
"Bolivia","Tarija","Avilés","Yunchará","U.E. YUTICANCHA",-65.06479,-21.91516,4,2,91,95,13,5,71,84
"Bolivia","Tarija","Burnet O'Connor","Entre Ríos (La Moreta)","CENTRO P.A.N TENTAGUAZU",-63.96276,-21.11408,35,0,116,151,75,4,37,112
"Bolivia","Tarija","Burnet O'Connor","Entre Ríos (La Moreta)","U.E. 12 DE ABRIL",-63.78238,-21.41462,69,5,350,419,235,5,105,340
"Bolivia","Tarija","Burnet O'Connor","Entre Ríos (La Moreta)","U.E. CANALETAS CENTRO",-64.35432,-21.45255,32,2,134,166,33,7,92,125
"Bolivia","Tarija","Burnet O'Connor","Entre Ríos (La Moreta)","U.E. CHIQUIACA CENTRO",-64.12215,-21.86438,64,14,431,495,153,11,253,406
"Bolivia","Tarija","Burnet O'Connor","Entre Ríos (La Moreta)","U.E. CNL. EUSTAQUIO MENDEZ",-64.27944,-21.40812,43,6,346,389,94,14,232,326
"Bolivia","Tarija","Burnet O'Connor","Entre Ríos (La Moreta)","U.E. FRANZ TAMAYO",-64.17131,-21.52566,870,75,4070,4940,2194,116,1685,3879
"Bolivia","Tarija","Burnet O'Connor","Entre Ríos (La Moreta)","U.E. HUAICO ACERRADERO",-64.25552,-21.33019,53,4,244,297,90,12,138,228
"Bolivia","Tarija","Burnet O'Connor","Entre Ríos (La Moreta)","U.E. JUAN SAAVEDRA MEALLA",-64.23573,-21.79252,62,5,262,324,119,11,127,246
"Bolivia","Tarija","Burnet O'Connor","Entre Ríos (La Moreta)","U.E. LAGUNITAS",-63.89547,-21.41483,42,2,101,143,61,5,33,94
"Bolivia","Tarija","Burnet O'Connor","Entre Ríos (La Moreta)","U.E. LUIS VACA GALLARDO",-64.1218,-21.31882,47,5,176,223,98,7,66,164
"Bolivia","Tarija","Burnet O'Connor","Entre Ríos (La Moreta)","U.E. MISTOLAR",-63.78576,-21.17984,80,1,146,226,86,4,55,141
"Bolivia","Tarija","Burnet O'Connor","Entre Ríos (La Moreta)","U.E. ÑAURENDA",-64.05932,-21.1314,58,4,265,323,100,9,152,252
"Bolivia","Tarija","Burnet O'Connor","Entre Ríos (La Moreta)","U.E. PAJONAL",-64.16981,-21.48504,34,4,161,195,74,3,80,154
"Bolivia","Tarija","Burnet O'Connor","Entre Ríos (La Moreta)","U.E. PAMPA REDONDA",-64.17494,-21.997,16,0,118,134,23,3,92,115
"Bolivia","Tarija","Burnet O'Connor","Entre Ríos (La Moreta)","U.E. POTRERILLOS (O CONNOR)",-64.10823,-21.2234,45,13,250,295,105,3,129,234
"Bolivia","Tarija","Burnet O'Connor","Entre Ríos (La Moreta)","U.E. PROF. EMILIANO VILLARRUBIA",-63.98725,-21.52296,44,2,226,270,114,6,104,218
"Bolivia","Tarija","Burnet O'Connor","Entre Ríos (La Moreta)","U.E. PROFESOR RENE AVILA BAYON",-64.23028,-21.20329,141,13,504,645,179,21,291,470
"Bolivia","Tarija","Burnet O'Connor","Entre Ríos (La Moreta)","U.E. PUESTO MARGARITA",-63.79027,-21.1828,27,3,108,135,65,4,36,101
"Bolivia","Tarija","Burnet O'Connor","Entre Ríos (La Moreta)","U.E. REMIGIO VACA",-64.14987,-21.6035,31,2,118,149,60,23,33,93
"Bolivia","Tarija","Burnet O'Connor","Entre Ríos (La Moreta)","U.E. SAN DIEGO CENTRO",-64.18287,-21.42213,69,6,263,332,70,4,183,253
"Bolivia","Tarija","Burnet O'Connor","Entre Ríos (La Moreta)","U.E. SAN SIMON",-64.12061,-21.44145,20,7,123,143,56,1,59,115
"Bolivia","Tarija","Burnet O'Connor","Entre Ríos (La Moreta)","U.E. SECCIONAL BERETY",-64.03776,-21.44295,24,1,127,151,60,3,63,123
"Bolivia","Tarija","Burnet O'Connor","Entre Ríos (La Moreta)","U.E. SECCIONAL CAÑADAS",-63.97494,-21.41901,11,1,25,36,15,0,9,24
"Bolivia","Tarija","Burnet O'Connor","Entre Ríos (La Moreta)","U.E. SIVINGAL",-64.20417,-21.33499,30,3,188,218,23,8,154,177
"Bolivia","Tarija","Burnet O'Connor","Entre Ríos (La Moreta)","U.E. TAQUILLOS",-64.11756,-21.39566,15,3,75,90,18,2,52,70
"Bolivia","Tarija","Burnet O'Connor","Entre Ríos (La Moreta)","U.E. TARUPAYO",-63.95544,-21.32335,52,0,129,181,63,5,61,124
"Bolivia","Tarija","Burnet O'Connor","Entre Ríos (La Moreta)","U.E. TENTAPIAO",-63.91972,-21.15654,27,1,72,99,53,2,16,69
"Bolivia","Tarija","Burnet O'Connor","Entre Ríos (La Moreta)","U.E. TIMBOY",-64.06391,-21.16788,106,7,357,463,203,16,131,334
"Bolivia","Tarija","Burnet O'Connor","Entre Ríos (La Moreta)","U.E. TTE. GUALBERTO VILLARROEL",-64.20447,-21.69906,54,3,223,277,80,10,130,210
"Bolivia","Tarija","Burnet O'Connor","Entre Ríos (La Moreta)","U.E. VALLECITO DE LOS LAPACHOS",-64.05889,-21.7324,25,8,157,182,91,6,52,143
"Bolivia","Tarija","Burnet O'Connor","Entre Ríos (La Moreta)","U.E. YUKIMBIA",-63.97997,-21.04885,21,0,128,149,17,3,108,125
"Bolivia","Tarija","Cercado","Tarija","ALDEAS S.O.S ALTO SENAC",-64.76811,-21.53532,133,11,842,975,603,19,209,812
"Bolivia","Tarija","Cercado","Tarija","(CÁRCEL) PENAL DE MORROS BLANCOS",-64.70137,-21.54816,38,3,153,191,66,5,79,145
"Bolivia","Tarija","Cercado","Tarija","C.E.B.A.",-64.74647,-21.51721,571,37,2861,3432,1716,96,1012,2728
"Bolivia","Tarija","Cercado","Tarija","LOCAL PALO SANTO",-64.74363,-21.53167,342,12,1738,2080,1148,35,543,1691
"Bolivia","Tarija","Cercado","Tarija","SALON CAPACITACION BARRIO CATEDRAL",-64.76089,-21.54589,107,8,696,803,472,9,207,679
"Bolivia","Tarija","Cercado","Tarija","U.A.J.M.S CAMPUS",-64.72205,-21.54214,396,6,2039,2435,1603,47,383,1986
"Bolivia","Tarija","Cercado","Tarija","U.E. 15 DE ABRIL",-64.70269,-21.39775,49,7,209,258,155,5,42,197
"Bolivia","Tarija","Cercado","Tarija","U.E. 6 DE JUNIO",-64.73151,-21.56649,168,11,904,1072,604,25,264,868
"Bolivia","Tarija","Cercado","Tarija","U.E. ALTO DE ESPAÑA NORTE",-64.44588,-21.33693,58,9,212,270,63,34,106,169
"Bolivia","Tarija","Cercado","Tarija","U.E. AUDELIO QUIFRE",-64.53367,-21.61713,53,4,178,231,57,7,110,167
"Bolivia","Tarija","Cercado","Tarija","U.E. AVELINA RAÑA",-64.73672,-21.52712,614,26,3520,4134,2628,50,816,3444
"Bolivia","Tarija","Cercado","Tarija","U.E. BANCARIO",-64.73233,-21.54881,86,4,639,725,518,7,110,628
"Bolivia","Tarija","Cercado","Tarija","U.E. BELGRANO",-64.72131,-21.53838,965,25,5409,6374,4355,105,924,5279
"Bolivia","Tarija","Cercado","Tarija","U.E. BELLA VISTA",-64.84763,-21.65682,124,17,444,568,153,27,247,400
"Bolivia","Tarija","Cercado","Tarija","U.E. BOLIVIA",-64.7492,-21.54095,581,18,4290,4871,3316,114,842,4158
"Bolivia","Tarija","Cercado","Tarija","U.E. CARLAZO CENTRO",-64.48372,-21.48354,34,4,140,174,67,6,63,130
"Bolivia","Tarija","Cercado","Tarija","U.E. CARMEN ECHAZU",-64.72836,-21.53263,223,7,1348,1571,1121,17,203,1324
"Bolivia","Tarija","Cercado","Tarija","U.E. CASTELFORT CASTELLANOS",-64.70528,-21.54581,639,22,4069,4708,3124,110,813,3937
"Bolivia","Tarija","Cercado","Tarija","U.E. CHURQUIS",-64.78795,-21.66093,82,13,263,345,95,19,136,231
"Bolivia","Tarija","Cercado","Tarija","U.E. EL PORTILLO",-64.65661,-21.56547,204,13,1138,1342,681,39,405,1086
"Bolivia","Tarija","Cercado","Tarija","U.E. ESTEBAN MIGLIACI",-64.71228,-21.53156,800,38,5623,6423,4074,138,1373,5447
"Bolivia","Tarija","Cercado","Tarija","U.E. EULOGIO RUIZ",-64.7403,-21.51833,764,39,3787,4551,2177,103,1468,3645
"Bolivia","Tarija","Cercado","Tarija","U.E. FE Y ALEGRIA",-64.73994,-21.52347,933,40,4992,5925,3342,135,1475,4817
"Bolivia","Tarija","Cercado","Tarija","U.E. GAMONEDA",-64.62419,-21.49576,24,5,176,200,69,10,92,161
"Bolivia","Tarija","Cercado","Tarija","U.E. HERMANN GMEINER",-64.73551,-21.50994,1019,72,5020,6039,2440,227,2281,4721
"Bolivia","Tarija","Cercado","Tarija","U.E. IGNACIA NAZARIA MARCH",-64.75533,-21.50238,406,37,3082,3488,1585,128,1332,2917
"Bolivia","Tarija","Cercado","Tarija","U.E. J. NAVAL MONZON",-64.76114,-21.53481,406,33,2559,2965,1560,71,895,2455
"Bolivia","Tarija","Cercado","Tarija","U.E. JOSE MANUEL AVILA",-64.72959,-21.52524,1334,41,7435,8769,5604,189,1601,7205
"Bolivia","Tarija","Cercado","Tarija","U.E. JUANA AZURDUY DE PADILLA",-64.7084,-21.54054,372,5,2667,3039,2048,73,541,2589
"Bolivia","Tarija","Cercado","Tarija","U.E. JUAN PABLO II",-64.7523,-21.53608,542,40,3599,4141,2092,185,1282,3374
"Bolivia","Tarija","Cercado","Tarija","U.E. JUAN XXIII",-64.71565,-21.53829,604,19,3610,4214,2932,81,578,3510
"Bolivia","Tarija","Cercado","Tarija","U.E. JULIO CALVO",-64.72686,-21.51741,1247,70,7131,8378,3926,272,2863,6789
"Bolivia","Tarija","Cercado","Tarija","U.E. JUNACAS SUD",-64.46302,-21.43147,40,9,223,263,71,16,127,198
"Bolivia","Tarija","Cercado","Tarija","U.E. LA PAZ",-64.71841,-21.52833,663,36,3836,4499,2671,143,986,3657
"Bolivia","Tarija","Cercado","Tarija","U.E. LA PINTADA",-64.64189,-21.60837,106,19,823,929,502,18,284,786
"Bolivia","Tarija","Cercado","Tarija","U.E. LICEO CAMPERO",-64.73161,-21.53495,213,4,1162,1375,981,11,166,1147
"Bolivia","Tarija","Cercado","Tarija","U.E. LOS CALLEJONES",-64.73492,-21.54672,151,13,922,1073,666,27,216,882
"Bolivia","Tarija","Cercado","Tarija","U.E. LUIS DE FUENTES",-64.82387,-21.70473,178,6,323,501,173,6,138,311
"Bolivia","Tarija","Cercado","Tarija","U.E. MARIA LAURA JUSTINIANO",-64.72923,-21.53517,334,7,2046,2380,1770,27,242,2012
"Bolivia","Tarija","Cercado","Tarija","U.E. MONS ABEL COSTAS",-64.71011,-21.52861,304,28,2615,2919,1621,107,859,2480
"Bolivia","Tarija","Cercado","Tarija","U.E. MONTE CERCADO",-64.6991,-21.43521,25,3,145,170,109,8,25,134
"Bolivia","Tarija","Cercado","Tarija","U.E. NACIONAL SAN LUIS",-64.73555,-21.53229,326,7,1721,2047,1459,27,228,1687
"Bolivia","Tarija","Cercado","Tarija","U.E. NARCISO CAMPERO",-64.73502,-21.53197,210,4,1059,1269,898,14,143,1041
"Bolivia","Tarija","Cercado","Tarija","U.E. NUESTRA SEÑORA DEL ROSARIO",-64.73557,-21.52024,401,16,1990,2391,1276,72,626,1902
"Bolivia","Tarija","Cercado","Tarija","U.E. OCTAVIO CAMPERO ECHAZU",-64.72095,-21.52139,969,50,5770,6739,3400,197,2123,5523
"Bolivia","Tarija","Cercado","Tarija","U.E. OSCAR ZAMORA",-64.77103,-21.62803,184,12,596,780,237,49,298,535
"Bolivia","Tarija","Cercado","Tarija","U.E. PAPACHACRA",-64.40735,-21.48955,46,7,152,198,39,12,94,133
"Bolivia","Tarija","Cercado","Tarija","U.E. PINOS SUD",-64.87549,-21.73471,110,10,328,438,73,19,226,299
"Bolivia","Tarija","Cercado","Tarija","U.E.ROSA ARCE",-64.73045,-21.53088,344,12,2149,2493,1788,41,308,2096
"Bolivia","Tarija","Cercado","Tarija","U.E. SAN AGUSTIN SUD",-64.5279,-21.55583,56,1,136,192,70,6,59,129
"Bolivia","Tarija","Cercado","Tarija","U.E. SAN ANDRES",-64.81682,-21.62062,273,22,1369,1642,580,61,706,1286
"Bolivia","Tarija","Cercado","Tarija","U.E. SAN BLAS",-64.71835,-21.56428,84,8,466,550,313,8,137,450
"Bolivia","Tarija","Cercado","Tarija","U.E. SAN FRANCISCO DE ASIS",-64.7686,-21.51214,37,7,307,344,190,9,101,291
"Bolivia","Tarija","Cercado","Tarija","U.E. SAN GERONIMO",-64.71439,-21.54964,1257,22,3256,4513,2473,73,688,3161
"Bolivia","Tarija","Cercado","Tarija","U.E. SAN JACINTO SUD",-64.72188,-21.61152,63,8,325,388,138,16,163,301
"Bolivia","Tarija","Cercado","Tarija","U.E. SAN JORGE",-64.69663,-21.55364,693,30,3914,4607,2790,120,974,3764
"Bolivia","Tarija","Cercado","Tarija","U.E. SAN LAZARO DE GUERRA HUAYCO",-64.81322,-21.59201,385,34,1176,1561,414,45,683,1097
"Bolivia","Tarija","Cercado","Tarija","U.E. SAN LUIS",-64.69969,-21.56867,265,18,1518,1783,1013,55,432,1445
"Bolivia","Tarija","Cercado","Tarija","U.E. SAN MATEO",-64.75101,-21.48644,207,20,1239,1446,713,42,464,1177
"Bolivia","Tarija","Cercado","Tarija","U.E. SAN ROQUE",-64.73508,-21.52923,465,6,2503,2968,2108,32,357,2465
"Bolivia","Tarija","Cercado","Tarija","U.E. SANTA ANA LA NUEVA",-64.57794,-21.5435,80,12,467,547,250,5,200,450
"Bolivia","Tarija","Cercado","Tarija","U.E. SELLA QUEBRADA",-64.66478,-21.38699,86,21,257,343,112,18,106,218
"Bolivia","Tarija","Cercado","Tarija","U.E. TARIJA",-64.74217,-21.51051,455,25,2446,2901,1404,85,932,2336
"Bolivia","Tarija","Cercado","Tarija","U.E. TERESA DE CALCUTA",-64.74924,-21.53217,284,25,2053,2337,1317,79,632,1949
"Bolivia","Tarija","Cercado","Tarija","U.E. TOLOMOSITA",-64.75163,-21.6041,41,15,259,300,101,18,125,226
"Bolivia","Tarija","Cercado","Tarija","U.E. TORRECILLAS",-64.67634,-21.55232,205,19,1434,1639,862,61,492,1354
"Bolivia","Tarija","Cercado","Tarija","U.E. YESERA CENTRO",-64.5505,-21.41345,36,6,220,256,102,6,106,208
"Bolivia","Tarija","Cercado","Tarija","U.E. YESERA NORTE",-64.54983,-21.37354,59,11,251,310,111,17,112,223
"Bolivia","Tarija","Cercado","Tarija","U.E. YESERA SUD",-64.56313,-21.46948,55,5,255,310,165,15,70,235
"Bolivia","Tarija","Gran Chaco","Caraparí","POSTA SANITARIA KEREIMBA RENDA (INDIGENA)",-64.10361,-22.10099,0,0,23,23,0,0,23,23
"Bolivia","Tarija","Gran Chaco","Caraparí","U.E. 15 DE ABRIL",-63.76043,-21.74331,25,5,180,205,77,2,96,173
"Bolivia","Tarija","Gran Chaco","Caraparí","U.E. 17 DE AGOSTO",-63.92107,-21.94912,20,1,72,92,16,2,53,69
"Bolivia","Tarija","Gran Chaco","Caraparí","U.E. 2 DE AGOSTO",-63.99053,-22.09679,60,4,224,284,32,5,183,215
"Bolivia","Tarija","Gran Chaco","Caraparí","U.E. 3 DE MAYO",-63.73976,-21.82526,723,46,3404,4127,1593,70,1695,3288
"Bolivia","Tarija","Gran Chaco","Caraparí","U.E. 6 DE AGOSTO",-63.72484,-21.77807,29,8,236,265,80,9,139,219
"Bolivia","Tarija","Gran Chaco","Caraparí","U.E. BERETY CHACO",-63.69269,-21.58313,43,3,221,264,65,5,148,213
"Bolivia","Tarija","Gran Chaco","Caraparí","U.E. BOLIVIA",-63.93956,-21.80327,10,0,168,178,82,2,84,166
"Bolivia","Tarija","Gran Chaco","Caraparí","U.E. BOLIVIA DE CARAPARI",-63.77484,-21.93113,0,8,103,103,46,3,46,92
"Bolivia","Tarija","Gran Chaco","Caraparí","U.E. CAMPO LARGO HITO 22",-63.95479,-22.02285,30,2,132,162,33,2,95,128
"Bolivia","Tarija","Gran Chaco","Caraparí","U.E. CAÑITAS",-63.90673,-21.88649,3,1,74,77,21,1,51,72
"Bolivia","Tarija","Gran Chaco","Caraparí","U.E. CELSO RAFFAELLI",-63.77841,-21.8849,136,6,508,644,246,11,245,491
"Bolivia","Tarija","Gran Chaco","Caraparí","U.E. EUSTAQUIO MENDEZ/FRAY QUEBRACHO",-63.88299,-21.70185,84,8,516,600,240,10,258,498
"Bolivia","Tarija","Gran Chaco","Caraparí","U.E. FRAY QUEBRACHO",-63.72994,-21.69252,109,7,413,522,185,13,208,393
"Bolivia","Tarija","Gran Chaco","Caraparí","U.E. JULIO RAMOS VALDEZ",-63.87885,-21.81146,79,5,361,440,142,10,204,346
"Bolivia","Tarija","Gran Chaco","Caraparí","U.E. LIDIA GALARZA",-63.72426,-21.68103,141,12,631,772,234,25,360,594
"Bolivia","Tarija","Gran Chaco","Caraparí","U.E. SAN ALBERTO",-63.80844,-21.91013,108,13,522,630,210,20,279,489
"Bolivia","Tarija","Gran Chaco","Caraparí","U.E. SAN JUAN",-63.84999,-21.98089,0,0,31,31,11,1,19,30
"Bolivia","Tarija","Gran Chaco","Caraparí","U.E. SAN NICOLAS",-64.10381,-22.10169,2,3,52,54,13,2,34,47
"Bolivia","Tarija","Gran Chaco","Caraparí","U.E. ZAPATERA NORTE",-63.82479,-21.55252,61,5,285,346,111,5,164,275
"Bolivia","Tarija","Gran Chaco","Villamontes","CASA DEL NOTARIO",-62.86723,-21.80463,14,0,30,44,10,0,20,30
"Bolivia","Tarija","Gran Chaco","Villamontes","CENTRO COMUNAL",-63.45503,-21.54227,84,7,297,381,88,10,192,280
"Bolivia","Tarija","Gran Chaco","Villamontes","KINDER COLORADOS DE BOLIVIA",-63.44756,-21.25988,136,7,521,657,246,10,258,504
"Bolivia","Tarija","Gran Chaco","Villamontes","SEDE SOCIAL DE LA COMUNIDAD",-63.15966,-21.41535,15,0,41,56,25,0,16,41
"Bolivia","Tarija","Gran Chaco","Villamontes","U.E. 27 DE MAYO",-63.39827,-21.13041,48,9,345,393,130,3,203,333
"Bolivia","Tarija","Gran Chaco","Villamontes","U.E. 27 DE MAYO",-63.36565,-21.1518,48,9,345,393,130,3,203,333
"Bolivia","Tarija","Gran Chaco","Villamontes","U.E. ADELA HOYOS",-63.46374,-21.26653,568,12,2111,2679,1303,35,761,2064
"Bolivia","Tarija","Gran Chaco","Villamontes","U.E. AGUARAGÜE",-63.57405,-21.22751,44,2,147,191,81,7,57,138
"Bolivia","Tarija","Gran Chaco","Villamontes","U.E. ALGARROBAL",-63.30728,-21.38963,27,1,123,150,14,3,105,119
"Bolivia","Tarija","Gran Chaco","Villamontes","U.E.ANTONIO JOSE DE SUCRE",-63.41752,-21.06529,31,3,170,201,67,10,90,157
"Bolivia","Tarija","Gran Chaco","Villamontes","U.E. ASAMBLEA DE DIOS",-63.46189,-21.27044,742,53,3006,3748,1552,71,1330,2882
"Bolivia","Tarija","Gran Chaco","Villamontes","U.E. CABO JUAN",-63.42142,-21.16265,95,12,497,592,222,10,253,475
"Bolivia","Tarija","Gran Chaco","Villamontes","U.E. CAPIRENDA",-63.00224,-21.09902,14,0,30,44,25,0,5,30
"Bolivia","Tarija","Gran Chaco","Villamontes","U.E. CAPIRENDITA",-63.43694,-21.29784,337,12,589,926,81,72,424,505
"Bolivia","Tarija","Gran Chaco","Villamontes","U.E. CENTRAL CUTAIQUI",-62.83306,-21.892,11,0,49,60,18,0,31,49
"Bolivia","Tarija","Gran Chaco","Villamontes","U.E. CHACO BOREAL",-62.62968,-21.56227,2,1,13,15,3,0,9,12
"Bolivia","Tarija","Gran Chaco","Villamontes","U.E. CHIMEO",-63.44035,-21.18806,19,4,249,268,68,5,172,240
"Bolivia","Tarija","Gran Chaco","Villamontes","U.E. COLORADOS DE BOLIVIA",-63.44739,-21.26013,825,44,3487,4312,1600,147,1696,3296
"Bolivia","Tarija","Gran Chaco","Villamontes","U.E. IBIBOBO",-62.99517,-21.5432,198,2,133,331,62,1,68,130
"Bolivia","Tarija","Gran Chaco","Villamontes","U.E. IBOPEITI",-63.3834,-21.29926,34,2,197,231,43,2,150,193
"Bolivia","Tarija","Gran Chaco","Villamontes","U.E. ISMAEL MONTES",-63.47746,-21.25815,512,24,2204,2716,1419,47,714,2133
"Bolivia","Tarija","Gran Chaco","Villamontes","U.E. JUANA AZURDUY DE PADILLA (V.M.)",-63.46507,-21.25878,558,31,2820,3378,1845,58,886,2731
"Bolivia","Tarija","Gran Chaco","Villamontes","U.E.  JULIO CREVAUX",-63.47588,-21.26414,764,16,2612,3376,1752,60,784,2536
"Bolivia","Tarija","Gran Chaco","Villamontes","U.E. LA ESMERALDA",-62.65346,-22.22636,12,0,25,37,11,0,14,25
"Bolivia","Tarija","Gran Chaco","Villamontes","U.E. NUEVA ESPERANZA",-62.73864,-21.84503,13,0,48,61,16,3,29,45
"Bolivia","Tarija","Gran Chaco","Villamontes","U.E. REBECA AGUIRRE",-63.33084,-21.00389,173,12,610,783,301,16,281,582
"Bolivia","Tarija","Gran Chaco","Villamontes","U.E. RESISTENCIA",-63.113,-21.5044,0,32,154,154,20,4,98,118
"Bolivia","Tarija","Gran Chaco","Villamontes","U.E. SAN ANTONIO (VILLA MONTES)",-63.47097,-21.27801,150,9,776,926,419,15,333,752
"Bolivia","Tarija","Gran Chaco","Villamontes","U.E. SAN ISIDRO LA VICTORIA",-62.75867,-22.14704,23,1,45,68,35,0,9,44
"Bolivia","Tarija","Gran Chaco","Villamontes","U.E. TENIENTE VICTOR ZEBALLOS CLAROS",-63.42403,-21.09695,57,11,345,402,129,11,194,323
"Bolivia","Tarija","Gran Chaco","Yacuiba","(CÁRCEL) CARCELETA PUBLICA",-63.61958,-21.87883,26,0,76,102,29,2,45,74
"Bolivia","Tarija","Gran Chaco","Yacuiba","ESC. 2 DE AGOSTO",-63.6631,-21.98295,291,32,1763,2054,834,72,825,1659
"Bolivia","Tarija","Gran Chaco","Yacuiba","ESCUELA 27 DE MAYO",-63.63179,-21.86089,25,4,217,242,90,9,114,204
"Bolivia","Tarija","Gran Chaco","Yacuiba","U.E. 12 DE AGOSTO",-63.62997,-21.90739,175,13,808,983,318,45,432,750
"Bolivia","Tarija","Gran Chaco","Yacuiba","U.E. 21 DE SEPTIEMBRE",-63.38381,-21.8469,37,3,131,168,76,6,46,122
"Bolivia","Tarija","Gran Chaco","Yacuiba","U.E. 27 DE MAYO",-63.63601,-21.93299,313,13,1107,1420,402,30,662,1064
"Bolivia","Tarija","Gran Chaco","Yacuiba","U.E. 4 DE MAYO",-63.55672,-21.71432,144,28,822,966,246,27,521,767
"Bolivia","Tarija","Gran Chaco","Yacuiba","U.E. ALCIDES D`ORBIGNI",-62.8343,-21.99477,184,11,334,518,45,15,263,308
"Bolivia","Tarija","Gran Chaco","Yacuiba","U.E. CAMPO GRANDE (GRAN CHACO)",-63.6561,-21.95966,324,33,1779,2103,805,57,884,1689
"Bolivia","Tarija","Gran Chaco","Yacuiba","U.E. CAÑON OCULTO",-63.61351,-21.97809,38,7,220,258,71,6,136,207
"Bolivia","Tarija","Gran Chaco","Yacuiba","U.E. CLUB DE LEONES (BÁSICO Y MEDIO)",-63.6776,-22.00842,967,29,4201,5168,2720,104,1348,4068
"Bolivia","Tarija","Gran Chaco","Yacuiba","U.E. CREVAUX SUD",-62.93186,-21.81382,227,7,600,827,116,23,454,570
"Bolivia","Tarija","Gran Chaco","Yacuiba","U.E. FERROVIARIA",-63.6751,-22.01609,451,15,1736,2187,1017,39,665,1682
"Bolivia","Tarija","Gran Chaco","Yacuiba","U.E. GERMAN BUSCH",-63.68483,-22.02006,369,14,1322,1691,789,29,490,1279
"Bolivia","Tarija","Gran Chaco","Yacuiba","U.E. HEROES DE BOQUERON",-63.60726,-21.6859,292,6,502,794,242,25,229,471
"Bolivia","Tarija","Gran Chaco","Yacuiba","U.E. HEROES DEL CHACO",-63.68172,-22.05065,1086,37,2919,4005,1380,60,1442,2822
"Bolivia","Tarija","Gran Chaco","Yacuiba","U.E. JOSE MANUEL BELGRANO (YACUIBA)",-63.6762,-22.01613,713,18,3055,3768,1888,64,1085,2973
"Bolivia","Tarija","Gran Chaco","Yacuiba","U.E. JUANA AZURDUY DE PADILLA (YACUIBA)",-63.67266,-22.00477,864,40,3561,4425,2125,120,1276,3401
"Bolivia","Tarija","Gran Chaco","Yacuiba","U.E. LA PURISIMA",-62.99116,-21.62585,35,0,90,125,17,0,73,90
"Bolivia","Tarija","Gran Chaco","Yacuiba","U.E. LICEO GRAN CHACO",-63.67698,-22.01581,538,19,2359,2897,1600,47,693,2293
"Bolivia","Tarija","Gran Chaco","Yacuiba","U.E. MARISCAL SUCRE",-63.66786,-21.99878,193,9,806,999,434,17,346,780
"Bolivia","Tarija","Gran Chaco","Yacuiba","U.E. MIGUEL ESTENSORO",-63.68021,-22.01661,1277,31,4464,5741,2800,94,1539,4339
"Bolivia","Tarija","Gran Chaco","Yacuiba","U.E. NACIONAL MIXTO EL PALMAR",-63.61583,-21.88011,371,23,1426,1797,756,47,600,1356
"Bolivia","Tarija","Gran Chaco","Yacuiba","U.E. NESTOR PAZ GALARZA",-63.67497,-21.99887,587,19,2316,2903,1276,96,925,2201
"Bolivia","Tarija","Gran Chaco","Yacuiba","U.E. OLIVERIO PELICHELLI",-63.67335,-22.02432,251,15,1090,1341,568,26,481,1049
"Bolivia","Tarija","Gran Chaco","Yacuiba","U.E. PROF. BAUTISTA JURADO",-63.55737,-21.8007,183,23,797,980,323,17,434,757
"Bolivia","Tarija","Gran Chaco","Yacuiba","U.E. SACHAPERA",-63.55339,-21.66175,55,14,607,662,150,24,419,569
"Bolivia","Tarija","Gran Chaco","Yacuiba","U.E. SAN FRANCISCO DE INTI",-63.58647,-21.81835,55,10,394,449,133,12,239,372
"Bolivia","Tarija","Gran Chaco","Yacuiba","U.E. SIMON BOLIVAR",-63.6829,-22.0522,1095,94,3863,4958,1415,130,2224,3639
"Bolivia","Tarija","Gran Chaco","Yacuiba","U.E. SUNCHAL",-63.49324,-21.68086,35,2,95,130,44,1,48,92
"Bolivia","Tarija","Gran Chaco","Yacuiba","U.E. TIERRAS NUEVAS",-63.56289,-21.74935,124,15,653,777,131,35,472,603
"Bolivia","Tarija","Gran Chaco","Yacuiba","U.E. TIMBOY TIGUAZU",-63.57601,-21.55468,32,4,170,202,34,6,126,160
"Bolivia","Tarija","Gran Chaco","Yacuiba","U.E. VILLA EL CARMEN",-63.57232,-21.78605,185,28,1001,1186,310,45,618,928
"Bolivia","Tarija","Gran Chaco","Yacuiba","U.E. YACUIBA",-63.67945,-21.99672,784,52,3662,4446,1964,126,1520,3484
"Bolivia","Tarija","Méndez","Tomayapo (El Puente)","CENTRO COMUNAL",-65.21614,-21.31723,24,3,170,194,83,3,81,164
"Bolivia","Tarija","Méndez","Tomayapo (El Puente)","NUCLEO ANDRES ZAMORA",-65.23907,-21.43847,18,3,120,138,51,2,64,115
"Bolivia","Tarija","Méndez","Tomayapo (El Puente)","SEDE CLUB DE MADRES",-65.24256,-21.46749,15,0,53,68,19,6,28,47
"Bolivia","Tarija","Méndez","Tomayapo (El Puente)","SEDE COMUNAL",-64.96433,-21.23611,58,8,254,312,134,7,105,239
"Bolivia","Tarija","Méndez","Tomayapo (El Puente)","U.E. 1O. DE JULIO",-65.20398,-21.23499,166,13,751,917,347,21,370,717
"Bolivia","Tarija","Méndez","Tomayapo (El Puente)","U.E. CHINCHILLA",-65.14574,-21.19778,10,0,60,70,18,1,41,59
"Bolivia","Tarija","Méndez","Tomayapo (El Puente)","U.E. CHORCOYA MENDEZ",-65.01444,-21.56835,78,10,175,253,30,5,130,160
"Bolivia","Tarija","Méndez","Tomayapo (El Puente)","U.E. CUMBRE DE SAMA",-64.95296,-21.48289,57,12,236,293,62,10,152,214
"Bolivia","Tarija","Méndez","Tomayapo (El Puente)","U.E. EDUARDO ABAROA",-65.11504,-21.35772,3,1,70,73,17,2,50,67
"Bolivia","Tarija","Méndez","Tomayapo (El Puente)","U.E. EL MOLINO",-64.95007,-21.39787,80,8,282,362,70,18,186,256
"Bolivia","Tarija","Méndez","Tomayapo (El Puente)","U.E. FRANZ TAMAYO",-64.96854,-21.48615,285,44,1112,1397,392,78,598,990
"Bolivia","Tarija","Méndez","Tomayapo (El Puente)","U.E. GERALDINO GUERRERO",-64.95905,-21.14464,94,3,280,374,145,11,121,266
"Bolivia","Tarija","Méndez","Tomayapo (El Puente)","U.E. HUARMACHI",-65.06249,-21.44367,22,0,131,153,74,5,52,126
"Bolivia","Tarija","Méndez","Tomayapo (El Puente)","U.E. HUERTA HUAYCO",-64.94923,-21.11442,35,2,87,122,27,6,52,79
"Bolivia","Tarija","Méndez","Tomayapo (El Puente)","U.E. IRCALAYA",-65.20068,-21.19576,14,1,48,62,15,1,31,46
"Bolivia","Tarija","Méndez","Tomayapo (El Puente)","U.E. JESUS ZAMORA",-65.22533,-21.37169,33,4,145,178,83,2,56,139
"Bolivia","Tarija","Méndez","Tomayapo (El Puente)","U.E. LIC. SEGUNDINO UGARTE DURAN",-65.04431,-21.27013,39,2,153,192,98,5,48,146
"Bolivia","Tarija","Méndez","Tomayapo (El Puente)","U.E. MONTE GRANDE",-65.08482,-21.24768,33,2,113,146,76,3,32,108
"Bolivia","Tarija","Méndez","Tomayapo (El Puente)","U.E. OBISPO EL CARMEN",-65.03886,-21.30891,38,2,81,119,48,4,27,75
"Bolivia","Tarija","Méndez","Tomayapo (El Puente)","U.E. PUEBLO NUEVO",-64.98272,-21.53179,115,15,236,351,36,14,171,207
"Bolivia","Tarija","Méndez","Tomayapo (El Puente)","U.E. SAN ANTONIO DE CURQUI",-65.07034,-21.49188,36,4,196,232,99,5,88,187
"Bolivia","Tarija","Méndez","Tomayapo (El Puente)","U.E. SAN ANTONIO (MENDEZ)",-64.965,-21.44068,67,8,235,302,60,29,138,198
"Bolivia","Tarija","Méndez","Tomayapo (El Puente)","U.E. SANTA ROSA",-65.05383,-21.13585,40,1,58,98,1,1,55,56
"Bolivia","Tarija","Méndez","Tomayapo (El Puente)","U.E. VILLA NUEVA",-64.9509,-21.35972,39,1,122,161,43,10,68,111
"Bolivia","Tarija","Méndez","Villa San Lorenzo","PUESTO DE SALUD JARCAS",-64.50289,-21.28495,4,0,66,70,19,3,44,63
"Bolivia","Tarija","Méndez","Villa San Lorenzo","U.E. 15 DE ABRIL ERQUIS",-64.79546,-21.46687,110,15,734,844,409,48,262,671
"Bolivia","Tarija","Méndez","Villa San Lorenzo","U.E. 1O. DE MAYO",-64.57595,-21.03652,59,8,134,193,24,7,95,119
"Bolivia","Tarija","Méndez","Villa San Lorenzo","U.E. ALTO DE CAJAS",-64.47047,-21.30705,29,2,70,99,40,4,24,64
"Bolivia","Tarija","Méndez","Villa San Lorenzo","U.E. ANGEL CALABI PASOLINNI",-64.76366,-21.49823,258,18,1513,1771,907,47,541,1448
"Bolivia","Tarija","Méndez","Villa San Lorenzo","U.E. BORDO EL MOLLAR",-64.76112,-21.42673,66,9,403,469,226,23,145,371
"Bolivia","Tarija","Méndez","Villa San Lorenzo","U.E. CARACHIMAYO CENTRO",-64.72285,-21.35113,153,23,433,586,207,34,169,376
"Bolivia","Tarija","Méndez","Villa San Lorenzo","U.E. CHAUPICANCHA",-64.66171,-21.34586,33,6,56,89,18,3,29,47
"Bolivia","Tarija","Méndez","Villa San Lorenzo","U.E. COCHAS",-64.8509,-21.37324,10,4,71,81,17,3,47,64
"Bolivia","Tarija","Méndez","Villa San Lorenzo","U.E. COLORADO NORTE",-64.78835,-21.17892,62,0,124,186,7,8,109,116
"Bolivia","Tarija","Méndez","Villa San Lorenzo","U.E. EL PAJONAL",-64.52412,-21.20756,23,0,61,84,28,4,29,57
"Bolivia","Tarija","Méndez","Villa San Lorenzo","U.E. EL PUESTO",-64.52888,-21.28559,30,1,57,87,10,6,40,50
"Bolivia","Tarija","Méndez","Villa San Lorenzo","U.E. EUSTAQUIO MENDEZ",-64.75005,-21.41892,943,72,3042,3985,1845,129,996,2841
"Bolivia","Tarija","Méndez","Villa San Lorenzo","U.E. EUSTAQUIO MENDEZ",-64.67755,-21.04951,943,72,3042,3985,1845,129,996,2841
"Bolivia","Tarija","Méndez","Villa San Lorenzo","U.E. EUSTAQUIO MENDEZ",-64.76018,-21.34489,943,72,3042,3985,1845,129,996,2841
"Bolivia","Tarija","Méndez","Villa San Lorenzo","U.E. HUANCOIRO",-64.85504,-21.19721,13,1,68,81,31,4,32,63
"Bolivia","Tarija","Méndez","Villa San Lorenzo","U.E. JUAN MISAEL SARACHO",-64.7941,-21.49765,47,7,407,454,257,17,126,383
"Bolivia","Tarija","Méndez","Villa San Lorenzo","U.E. JULIO SUCRE SELLA MENDEZ",-64.69686,-21.38795,95,9,360,455,248,12,91,339
"Bolivia","Tarija","Méndez","Villa San Lorenzo","U.E. LEON CANCHA",-64.71355,-21.17894,128,13,219,347,62,12,132,194
"Bolivia","Tarija","Méndez","Villa San Lorenzo","U.E. MANDOR GRANDE",-64.74651,-21.06744,29,1,25,54,13,1,10,23
"Bolivia","Tarija","Méndez","Villa San Lorenzo","U.E. NESTOR PAZ ZAMORA",-64.75089,-21.38968,114,24,499,613,269,22,184,453
"Bolivia","Tarija","Méndez","Villa San Lorenzo","U.E. OSVALDO GALVEZ",-64.80488,-21.4087,136,24,514,650,241,15,234,475
"Bolivia","Tarija","Méndez","Villa San Lorenzo","U.E. PEÑADERIA",-64.49856,-21.2275,3,3,67,70,25,7,32,57
"Bolivia","Tarija","Méndez","Villa San Lorenzo","U.E. RANCHO SUD",-64.7542,-21.4619,69,4,455,524,331,9,111,442
"Bolivia","Tarija","Méndez","Villa San Lorenzo","U.E. SAN LORENCITO",-64.47129,-21.25033,14,1,71,85,6,7,57,63
"Bolivia","Tarija","Méndez","Villa San Lorenzo","U.E. SAN PEDRO DE LAS PEÑAS",-64.65049,-21.14055,37,2,49,86,17,1,29,46
"Bolivia","Tarija","Méndez","Villa San Lorenzo","U.E. SERAPIO MARTINEZ",-64.74917,-21.44493,121,11,876,997,602,23,240,842
"Bolivia","Tarija","Méndez","Villa San Lorenzo","U.E. SIMON BOLIVAR",-64.7877,-21.50771,97,14,791,888,565,31,181,746
"Bolivia","Tarija","Méndez","Villa San Lorenzo","U.E. TARIJA CANCHA SUD",-64.76456,-21.41479,88,9,532,620,331,16,176,507
"Bolivia","Tarija","Méndez","Villa San Lorenzo","U.E. TOMATAS GRANDE",-64.78188,-21.3224,101,10,429,530,235,21,163,398
"Bolivia","Tarija","Méndez","Villa San Lorenzo","U.E. TRANCAS",-64.8347,-21.30479,44,3,127,171,65,12,47,112
"Bolivia","Tarija","Méndez","Villa San Lorenzo","U.E. TUCUMILLAS",-64.83385,-21.45885,18,2,104,122,16,3,83,99
"Bolivia","Beni","Cercado","San Javier","ESCUELA ESPIRITU SANTO",-64.80295,-14.63469,7,0,34,41,13,0,21,34
"Bolivia","Beni","Cercado","San Javier","ESCUELA LAGUNA COLORADA",-64.63057,-14.63861,15,0,33,48,14,0,19,33
"Bolivia","Beni","Cercado","San Javier","ESCUELA NUEVA ISRAEL",-64.3355,-14.67209,110,7,420,530,195,36,182,377
"Bolivia","Beni","Cercado","San Javier","ESCUELA PEDRO IGNACIO MUIBA",-64.08376,-14.49183,23,1,161,184,74,0,86,160
"Bolivia","Beni","Cercado","San Javier","ESCUELA SAN JAVIER",-64.88087,-14.59987,63,4,287,350,141,2,140,281
"Bolivia","Beni","Cercado","San Javier","ESCUELA SAN PEDRO",-64.90086,-14.33668,79,2,319,398,157,10,150,307
"Bolivia","Beni","Cercado","San Javier","U.E. LA CURVA",-64.20807,-14.58863,41,2,100,141,37,3,58,95
"Bolivia","Beni","Cercado","Trinidad","CARCEL DE MUJERES",-64.90281,-14.84692,9,1,36,45,19,0,16,35
"Bolivia","Beni","Cercado","Trinidad","CARCEL MOCOBI",-64.90376,-14.77958,0,0,178,178,62,50,66,128
"Bolivia","Beni","Cercado","Trinidad","CENTRO INTEGRADO SAN FRANCISCO DE ASIS",-64.88588,-14.82278,85,4,686,771,488,11,183,671
"Bolivia","Beni","Cercado","Trinidad","COL. JOAQUIN HURTADO CHAVEZ",-64.90425,-14.81511,383,17,1922,2305,1225,38,642,1867
"Bolivia","Beni","Cercado","Trinidad","COL. LA SALLE",-64.89569,-14.82676,329,5,1457,1786,1045,38,369,1414
"Bolivia","Beni","Cercado","Trinidad","COL. SAN VICENTE (EX UAB)",-64.91093,-14.8346,631,20,3141,3772,2072,80,969,3041
"Bolivia","Beni","Cercado","Trinidad","ESC.4 DE  FEBRERO",-64.90131,-14.84447,801,36,3606,4407,2139,91,1340,3479
"Bolivia","Beni","Cercado","Trinidad","ESC.CORINA HURTADO DE",-64.89422,-14.84378,458,15,2434,2892,1438,50,931,2369
"Bolivia","Beni","Cercado","Trinidad","ESC.J.AZURDUY DE PADILLA",-64.8893,-14.82634,271,8,1612,1883,1128,36,440,1568
"Bolivia","Beni","Cercado","Trinidad","ESC.J. CHAVEZ SUAREZ",-64.90463,-14.8414,1158,36,5202,6360,3120,112,1934,5054
"Bolivia","Beni","Cercado","Trinidad","ESC.J. LORENZO CAMPERO",-64.89998,-14.8257,226,7,1423,1649,982,23,411,1393
"Bolivia","Beni","Cercado","Trinidad","ESC. LOMA SUAREZ",-64.96272,-14.76063,202,7,444,646,182,19,236,418
"Bolivia","Beni","Cercado","Trinidad","ESC. MANGALITO",-64.91572,-14.84847,371,11,1608,1979,872,32,693,1565
"Bolivia","Beni","Cercado","Trinidad","ESC.MARY RIBERA G.",-64.88783,-14.81399,613,20,3832,4445,2571,95,1146,3717
"Bolivia","Beni","Cercado","Trinidad","ESC.MAYOR PEDRO VACA DIEZ",-64.96582,-14.86952,100,3,236,336,109,1,123,232
"Bolivia","Beni","Cercado","Trinidad","ESC.NICOLAS SUAREZ",-64.90492,-14.83268,444,10,2080,2524,1516,37,517,2033
"Bolivia","Beni","Cercado","Trinidad","ESC. NUESTRA SEÑORA DE FATIMA",-64.89811,-14.83099,758,18,3338,4096,2229,82,1009,3238
"Bolivia","Beni","Cercado","Trinidad","ESC. PEDRO IGNACIO MUIBA",-64.91414,-14.84481,472,25,2346,2818,1413,96,812,2225
"Bolivia","Beni","Cercado","Trinidad","ESC.PUERTO BALLIVIAN",-64.97205,-14.79312,20,2,119,139,55,0,62,117
"Bolivia","Beni","Cercado","Trinidad","ESC. PUERTO VARADOR",-64.99762,-14.87702,128,13,453,581,242,21,177,419
"Bolivia","Beni","Cercado","Trinidad","ESC. RAUL MONJE ROCA",-64.8938,-14.83707,439,7,2240,2679,1414,74,745,2159
"Bolivia","Beni","Cercado","Trinidad","ESC.SAN ANTONIO",-64.91032,-14.83844,573,47,3077,3650,2005,42,983,2988
"Bolivia","Beni","Cercado","Trinidad","ESC.SAN JOSE",-64.90439,-14.82626,209,9,1272,1481,931,21,311,1242
"Bolivia","Beni","Cercado","Trinidad","ESC.SAN JUAN DE AGUAS DULCES",-64.57809,-14.80817,12,0,89,101,67,0,22,89
"Bolivia","Beni","Cercado","Trinidad","ESCUELA 13 DE ABRIL",-64.8902,-14.83764,333,22,2304,2637,1262,129,891,2153
"Bolivia","Beni","Cercado","Trinidad","ESCUELA CASARABE",-64.47997,-14.87161,112,3,415,527,228,9,175,403
"Bolivia","Beni","Cercado","Trinidad","ESCUELA EMILIO CAMPOS PEDRIEL",-64.8847,-14.81962,388,12,1994,2382,1324,39,619,1943
"Bolivia","Beni","Cercado","Trinidad","ESCUELA IVIATO",-64.44854,-14.83285,40,1,172,212,94,0,77,171
"Bolivia","Beni","Cercado","Trinidad","ESCUELA NUEVA TRINIDAD",-64.8754,-14.82357,857,28,3145,4002,1882,72,1163,3045
"Bolivia","Beni","Cercado","Trinidad","ESC. URBANIZ.MANA",-64.9059,-14.77769,100,2,512,612,306,5,199,505
"Bolivia","Beni","Cercado","Trinidad","ESC. VILLA VECINAL",-64.87392,-14.81023,400,26,2609,3009,1791,40,752,2543
"Bolivia","Beni","Cercado","Trinidad","INFOCAL",-64.90236,-14.82328,231,7,1082,1313,736,19,320,1056
"Bolivia","Beni","Cercado","Trinidad","LICEO MARIO SAIELLY",-64.90276,-14.83593,321,6,1655,1976,1150,17,482,1632
"Bolivia","Beni","Cercado","Trinidad","U.A.B. (CARRERA DE DERECHO)",-64.91308,-14.83274,454,46,2151,2605,1438,31,636,2074
"Bolivia","Beni","Cercado","Trinidad","U.E 15 DE AGOSTO",-64.92943,-14.83425,115,11,811,926,454,19,327,781
"Bolivia","Beni","Cercado","Trinidad","U.E GONZALO SUAREZ D.",-64.90136,-14.85325,80,5,337,417,214,4,114,328
"Bolivia","Beni","Cercado","Trinidad","U.E LUIS ESPINAL CAMS",-64.92085,-14.84365,160,16,1065,1225,577,22,450,1027
"Bolivia","Beni","Cercado","Trinidad","U.E. ORLANDO MONASTERIO CLAURE",-64.93098,-14.8181,22,7,259,281,151,4,97,248
"Bolivia","Beni","General Jose Ballivián Segurola","Puerto Rurrenabaque","ESC. ASUNCION DEL QUIQUIBEY",-67.51161,-14.64125,29,2,73,102,36,2,33,69
"Bolivia","Beni","General Jose Ballivián Segurola","Puerto Rurrenabaque","ESC.CENTRAL NUEVOS HORIZONTES",-67.27888,-14.59985,115,9,374,489,122,29,214,336
"Bolivia","Beni","General Jose Ballivián Segurola","Puerto Rurrenabaque","ESC.CENTRAL PIEDRAS BLANCAS",-67.15208,-14.78934,100,16,586,686,79,15,476,555
"Bolivia","Beni","General Jose Ballivián Segurola","Puerto Rurrenabaque","ESC.GUALBERTO VILLARRUEL",-67.5281,-14.44452,861,31,2868,3729,1703,52,1082,2785
"Bolivia","Beni","General Jose Ballivián Segurola","Puerto Rurrenabaque","ESC. PLAYA ANCHA",-67.26197,-14.62954,27,5,164,191,12,9,138,150
"Bolivia","Beni","General Jose Ballivián Segurola","Puerto Rurrenabaque","ESCUELA VILLA LOURDES",-67.5043,-14.42944,45,5,152,197,71,3,73,144
"Bolivia","Beni","General Jose Ballivián Segurola","Puerto Rurrenabaque","UNIDAD EDUCATIVA LUCIO LENS",-67.52292,-14.44037,953,50,3672,4625,2055,165,1402,3457
"Bolivia","Beni","General Jose Ballivián Segurola","Reyes","COL. NACIONAL REYES",-67.33482,-14.29558,370,16,1409,1779,779,27,587,1366
"Bolivia","Beni","General Jose Ballivián Segurola","Reyes","ESC. BUEN DESTINO",-66.76987,-11.76321,21,4,102,123,17,2,79,96
"Bolivia","Beni","General Jose Ballivián Segurola","Reyes","ESC. CENTRAL BAQUETY",-66.79783,-12.53514,65,0,48,113,4,1,43,47
"Bolivia","Beni","General Jose Ballivián Segurola","Reyes","ESC.CENTRAL PUERTO CAVINAS",-66.91502,-12.53129,85,5,133,218,46,1,81,127
"Bolivia","Beni","General Jose Ballivián Segurola","Reyes","ESC. CONSTANZA VARGAS",-66.73828,-11.73581,11,0,24,35,13,2,9,22
"Bolivia","Beni","General Jose Ballivián Segurola","Reyes","ESC.JESUS ALVAREZ",-67.3343,-14.29483,471,23,1650,2121,912,74,641,1553
"Bolivia","Beni","General Jose Ballivián Segurola","Reyes","ESC.PEÑA AMARILLA",-66.67179,-11.5471,61,2,95,156,77,2,14,91
"Bolivia","Beni","General Jose Ballivián Segurola","Reyes","ESC. RENE BARRIENTOS ORTUÑO",-67.33835,-14.29512,113,1,310,423,174,9,126,300
"Bolivia","Beni","General Jose Ballivián Segurola","Reyes","ESC. SAN JOSE",-67.37435,-14.30772,12,1,89,101,41,5,42,83
"Bolivia","Beni","General Jose Ballivián Segurola","Reyes","ESC. SAN MARCOS",-67.50578,-13.81978,3,0,22,25,18,1,3,21
"Bolivia","Beni","General Jose Ballivián Segurola","Reyes","ESC. SORAIDA",-67.50439,-14.05581,17,0,24,41,14,0,10,24
"Bolivia","Beni","General Jose Ballivián Segurola","Reyes","ESCUELA DE CALIFORNIA",-66.90263,-11.95482,16,0,54,70,22,1,31,53
"Bolivia","Beni","General Jose Ballivián Segurola","Reyes","U.E. CARMEN ALTO",-66.36278,-11.71022,6,4,88,94,39,1,44,83
"Bolivia","Beni","General Jose Ballivián Segurola","San Borja","COL. ARNULFO MARTINEZ",-66.74274,-14.86135,1010,35,3361,4371,1946,68,1312,3258
"Bolivia","Beni","General Jose Ballivián Segurola","San Borja","COL.INDUSTRIAL INGAVI",-67.03596,-15.14148,666,37,2392,3058,828,69,1458,2286
"Bolivia","Beni","General Jose Ballivián Segurola","San Borja","COL.SAN FRANCISCO DE BORJA",-66.75023,-14.85829,760,29,2731,3491,1804,62,836,2640
"Bolivia","Beni","General Jose Ballivián Segurola","San Borja","ESC.DE PUERTO YUCUMO",-66.93755,-15.19761,36,3,276,312,16,6,251,267
"Bolivia","Beni","General Jose Ballivián Segurola","San Borja","ESC.EL CHACAL",-66.62759,-14.75295,62,6,300,362,3,3,288,291
"Bolivia","Beni","General Jose Ballivián Segurola","San Borja","ESC.EL PALMAR",-67.08794,-14.97903,131,20,688,819,150,19,499,649
"Bolivia","Beni","General Jose Ballivián Segurola","San Borja","ESC.GERMAN BUSCH",-66.74983,-14.85664,707,19,2407,3114,1615,47,726,2341
"Bolivia","Beni","General Jose Ballivián Segurola","San Borja","ESC. INDIGENA ARENALES",-66.9127,-15.10867,41,8,455,496,13,12,422,435
"Bolivia","Beni","General Jose Ballivián Segurola","San Borja","ESC.JUNRRENO",-66.93327,-14.37257,11,1,32,43,15,0,16,31
"Bolivia","Beni","General Jose Ballivián Segurola","San Borja","ESC. LA CRUZ",-66.73125,-14.97601,78,14,584,662,38,9,523,561
"Bolivia","Beni","General Jose Ballivián Segurola","San Borja","ESC.LA EMBOCADA",-66.73125,-14.97601,85,1,254,339,96,7,150,246
"Bolivia","Beni","General Jose Ballivián Segurola","San Borja","ESC.LAS ABRAS",-66.93307,-14.4615,12,4,77,89,6,0,67,73
"Bolivia","Beni","General Jose Ballivián Segurola","San Borja","ESC. MISION FATIMA",-66.746,-15.45636,43,7,352,395,23,3,319,342
"Bolivia","Beni","General Jose Ballivián Segurola","San Borja","ESC.SANTA ELENA DEL CARIPO",-66.82342,-14.5799,19,1,102,121,39,0,62,101
"Bolivia","Beni","General Jose Ballivián Segurola","San Borja","ESC.S.JUAN DEL REMANZO",-66.5321,-14.67902,8,0,39,47,7,0,32,39
"Bolivia","Beni","General Jose Ballivián Segurola","San Borja","ESC. TACUARAL DE MATTOS",-66.53598,-14.99362,39,46,471,510,17,8,400,417
"Bolivia","Beni","General Jose Ballivián Segurola","San Borja","ESCUELA EL ORIENTE DEL YACUMA",-66.99512,-14.35404,26,1,79,105,34,0,44,78
"Bolivia","Beni","General Jose Ballivián Segurola","San Borja","U.E. MANGUITO",-66.63986,-14.89842,39,10,458,497,56,3,389,445
"Bolivia","Beni","General Jose Ballivián Segurola","San Borja","U.E MARCA COROICO",-67.08862,-14.78361,10,4,109,119,14,7,84,98
"Bolivia","Beni","General Jose Ballivián Segurola","San Borja","U.E. QUIQUIBEY",-67.0975,-15.36358,27,1,174,201,22,1,150,172
"Bolivia","Beni","General Jose Ballivián Segurola","San Borja","U.E SAN IGNACIO DEL MANIQUI",-66.72903,-14.85899,101,7,365,466,195,8,155,350
"Bolivia","Beni","General Jose Ballivián Segurola","San Borja","U.E VILLA SAN ANTONIO",-66.74652,-14.87003,108,6,463,571,252,13,192,444
"Bolivia","Beni","General Jose Ballivián Segurola","Santa Rosa","COLEGIO NACIONAL SANTA ROSA",-66.78864,-14.07823,263,4,654,917,407,23,220,627
"Bolivia","Beni","General Jose Ballivián Segurola","Santa Rosa","ESC.CENTRAL PALMA FLOR",-66.6287,-12.96253,45,1,71,116,40,9,21,61
"Bolivia","Beni","General Jose Ballivián Segurola","Santa Rosa","ESC.EL CANDADO",-66.84259,-13.50823,30,2,80,110,25,1,52,77
"Bolivia","Beni","General Jose Ballivián Segurola","Santa Rosa","ESC. EL CERRITO",-66.7103,-13.09042,22,1,82,104,53,1,27,80
"Bolivia","Beni","General Jose Ballivián Segurola","Santa Rosa","ESC.EL TRIUNFO",-66.76116,-13.86169,58,0,223,281,118,1,104,222
"Bolivia","Beni","General Jose Ballivián Segurola","Santa Rosa","ESC.GERARDO REYES",-66.79248,-14.07916,509,30,2303,2812,1545,43,685,2230
"Bolivia","Beni","General Jose Ballivián Segurola","Santa Rosa","ESC. PUERTO TERESA",-66.60133,-13.44813,18,0,67,85,49,1,17,66
"Bolivia","Beni","General Jose Ballivián Segurola","Santa Rosa","ESC.PUERTO YATA",-66.63308,-13.45108,66,5,119,185,81,1,32,113
"Bolivia","Beni","General Jose Ballivián Segurola","Santa Rosa","ESCUELA AUSTRALIA",-66.52208,-12.78946,79,2,155,234,75,3,75,150
"Bolivia","Beni","General Jose Ballivián Segurola","Santa Rosa","ESCUELA EL ROSARIO",-66.71803,-13.82903,14,8,130,144,61,4,57,118
"Bolivia","Beni","Iténez","Baures","ESC. ALTA GRACIA",-63.66943,-13.63675,8,0,51,59,32,0,19,51
"Bolivia","Beni","Iténez","Baures","ESC. CAIRO II",-63.52425,-14.20468,7,0,22,29,0,0,22,22
"Bolivia","Beni","Iténez","Baures","ESC.CARMELO LOPEZ",-63.69662,-13.65491,305,11,1213,1518,674,7,521,1195
"Bolivia","Beni","Iténez","Baures","ESC.EL CAIRO",-63.72225,-13.72575,10,1,95,105,42,3,49,91
"Bolivia","Beni","Iténez","Baures","ESC.EL REMANZO",-61.8741,-13.52387,114,4,291,405,126,5,156,282
"Bolivia","Beni","Iténez","Baures","ESC. MONTE CRISTO DEL TIQUIN",-61.97526,-13.62647,100,3,121,221,21,3,94,115
"Bolivia","Beni","Iténez","Baures","ESC. RURAL JASIAQUIRI",-63.7384,-13.72094,12,0,150,162,70,1,79,149
"Bolivia","Beni","Iténez","Baures","ESC.SAN SIMON",-62.02819,-13.61491,54,4,138,192,40,2,92,132
"Bolivia","Beni","Iténez","Baures","ESC.SECCIONAL CAFETAL",-61.88521,-13.49341,98,1,122,220,40,0,81,121
"Bolivia","Beni","Iténez","Huacaraje","ESC.EL CARMEN",-63.80146,-14.23021,129,2,461,590,275,5,179,454
"Bolivia","Beni","Iténez","Huacaraje","ESC.JUAN ALBERTO ORELLANA",-63.87964,-13.59328,313,15,1104,1417,627,17,445,1072
"Bolivia","Beni","Iténez","Huacaraje","NUCLEO ESCOLAR LA EMBROLLA",-63.82495,-13.6832,3,0,58,61,10,6,42,52
"Bolivia","Beni","Iténez","Magdalena","COL.CNEL.CARMELO CUELLAR J.",-63.79037,-13.23383,30,1,219,249,109,2,107,216
"Bolivia","Beni","Iténez","Magdalena","ESC.ANGEL CHAVEZ ARZA",-64.24437,-12.89689,10,1,112,122,30,0,81,111
"Bolivia","Beni","Iténez","Magdalena","ESC.BUENA VISTA",-64.23037,-12.45551,133,7,236,369,109,4,116,225
"Bolivia","Beni","Iténez","Magdalena","ESC.CENTRAL 1O. DE MAYO",-63.37995,-12.65748,2,0,36,38,3,0,33,36
"Bolivia","Beni","Iténez","Magdalena","ESC.GIL COIMBRA",-64.05195,-13.25954,419,19,1839,2258,1018,22,780,1798
"Bolivia","Beni","Iténez","Magdalena","ESC.JOSE BALLIVIAN",-64.05527,-13.26313,184,9,1079,1263,584,30,456,1040
"Bolivia","Beni","Iténez","Magdalena","ESC.LA CAYOBA",-64.08502,-13.09004,9,0,69,78,45,2,22,67
"Bolivia","Beni","Iténez","Magdalena","ESC. SAN BORJA RIO BLANCO",-64.10181,-12.62778,25,4,146,171,77,1,64,141
"Bolivia","Beni","Iténez","Magdalena","ESC.SANTA MARIA",-63.825,-13.11831,8,0,84,92,55,0,29,84
"Bolivia","Beni","Iténez","Magdalena","U.E. MACEDONIO PAZ PINO",-63.70535,-13.27234,226,8,927,1153,454,23,442,896
"Bolivia","Beni","Mamoré","Puerto Siles","ESC.ALEJANDRIA",-65.06511,-12.08011,3,2,47,50,12,1,32,44
"Bolivia","Beni","Mamoré","Puerto Siles","ESC.ANTOFAGASTA",-65.00496,-12.80045,57,1,159,216,43,3,112,155
"Bolivia","Beni","Mamoré","Puerto Siles","ESC.SANTA ROSA",-65.11021,-12.29405,48,3,121,169,90,0,28,118
"Bolivia","Beni","Mamoré","San Joaquín","ESC.CAP.ARTURO CUELLAR REA",-64.66712,-13.04515,431,9,1044,1475,506,80,449,955
"Bolivia","Beni","Mamoré","San Joaquín","ESC.CHACO LEJOS",-64.9071,-12.83958,3,1,29,32,9,0,19,28
"Bolivia","Beni","Mamoré","San Joaquín","ESC.LAS PEÑITAS",-64.4332,-12.65806,0,0,5,5,0,1,4,4
"Bolivia","Beni","Mamoré","San Joaquín","ESC. MORE-MONTE AZUL",-64.91856,-12.09472,12,0,50,62,0,0,50,50
"Bolivia","Beni","Mamoré","San Joaquín","ESC. PUERTO USTAREZ",-64.45786,-12.40728,10,1,44,54,14,1,28,42
"Bolivia","Beni","Mamoré","San Joaquín","UNIDAD EDUCATIVA 21 DE AGOSTO",-64.6656,-13.04053,381,11,1044,1425,583,20,430,1013
"Bolivia","Beni","Mamoré","San Ramón","ESC. EL CARMEN DE GUACAYANE",-64.37999,-13.12766,5,0,38,43,0,0,38,38
"Bolivia","Beni","Mamoré","San Ramón","ESC.EL POYORI",-64.42094,-13.00931,2,1,38,40,6,0,31,37
"Bolivia","Beni","Mamoré","San Ramón","ESC.NAPOLEON AÑEZ ORTIZ",-64.61865,-13.26702,463,16,1835,2298,999,24,796,1795
"Bolivia","Beni","Mamoré","San Ramón","U.E. LAS PEÑAS",-64.39467,-12.63922,7,0,4,11,2,0,2,4
"Bolivia","Beni","Marbán","Loreto","ESC.CAMIACO",-64.86686,-15.33278,57,0,246,303,155,7,84,239
"Bolivia","Beni","Marbán","Loreto","ESC.GUNDONOVIA",-65.11512,-15.51444,62,4,135,197,79,1,51,130
"Bolivia","Beni","Marbán","Loreto","ESC.PERFECTA VDA. DE BEJARANO",-64.76012,-15.19398,155,3,335,490,130,10,192,322
"Bolivia","Beni","Marbán","Loreto","ESC.SACHOJERE",-64.75289,-14.98731,60,1,183,243,79,2,101,180
"Bolivia","Beni","Marbán","Loreto","ESC.SAN ANTONIO",-64.99944,-15.1992,23,0,55,78,26,1,28,54
"Bolivia","Beni","Marbán","Loreto","ESC.SAN PABLO-ISIBORO",-65.14317,-15.70741,33,1,138,171,31,5,101,132
"Bolivia","Beni","Marbán","Loreto","ESCUELA SANTA ROSA DEL CHAPARE",-64.75703,-15.93923,22,0,27,49,21,0,6,27
"Bolivia","Beni","Marbán","Loreto","SANTA ROSA DEL ISIBORO",-65.20737,-16.26001,23,2,71,94,16,0,53,69
"Bolivia","Beni","Marbán","Loreto","U.E. PALERMO",-64.65648,-15.88381,3,0,21,24,8,0,13,21
"Bolivia","Beni","Marbán","Loreto","U.E. VILLA EL CARMEN DEL REMANZO",-65.00182,-15.25932,18,0,63,81,21,1,41,62
"Bolivia","Beni","Marbán","San Andrés","ESC.BUEN JESUS",-64.37089,-14.98918,45,5,248,293,153,4,86,239
"Bolivia","Beni","Marbán","San Andrés","ESC.CAIMANES",-64.05082,-15.16342,32,7,163,195,87,2,67,154
"Bolivia","Beni","Marbán","San Andrés","ESC.CENTRAL 2 DE AGOSTO",-63.86697,-15.24271,419,28,1546,1965,595,33,890,1485
"Bolivia","Beni","Marbán","San Andrés","ESC.HUMBERTO VELARDE",-64.66631,-15.02232,61,2,225,286,110,5,108,218
"Bolivia","Beni","Marbán","San Andrés","ESC.LA ISIGA-PERSEVERA",-64.32283,-15.39423,38,1,38,76,22,0,15,37
"Bolivia","Beni","Marbán","San Andrés","ESC. MONTE CRISTO",-64.37347,-15.61208,29,1,46,75,21,0,24,45
"Bolivia","Beni","Marbán","San Andrés","ESC.PEROTO",-64.63706,-14.97516,41,3,145,186,82,1,59,141
"Bolivia","Beni","Marbán","San Andrés","ESC.SAN LORENZO",-64.7207,-15.03478,32,2,73,105,34,1,36,70
"Bolivia","Beni","Marbán","San Andrés","ESC.SANTA ROSA",-64.244,-15.10586,97,8,407,504,181,6,212,393
"Bolivia","Beni","Marbán","San Andrés","ESC.SOMOPAE",-64.65401,-14.94441,41,1,194,235,99,2,92,191
"Bolivia","Beni","Marbán","San Andrés","ESCUELA 4 DE JULIO",-63.46377,-15.73327,59,6,243,302,35,7,195,230
"Bolivia","Beni","Marbán","San Andrés","ESCUELA DE NUEVA BETANIA",-64.34632,-15.02995,55,3,219,274,90,3,123,213
"Bolivia","Beni","Marbán","San Andrés","ESCUELA ELVIRA",-64.60383,-14.92893,43,2,181,224,102,2,75,177
"Bolivia","Beni","Marbán","San Andrés","ESCUELA LIMONCITO",-63.46377,-15.73327,0,0,30,30,15,1,14,29
"Bolivia","Beni","Marbán","San Andrés","ESCUELA NUEVA MAGDALENA",-63.69929,-15.48585,51,0,117,168,31,0,86,117
"Bolivia","Beni","Marbán","San Andrés","ESCUELA TAJIBOTE",-64.08765,-15.63134,5,0,9,14,3,0,6,9
"Bolivia","Beni","Marbán","San Andrés","ESC. VILLA ALBA",-64.68153,-15.06132,30,0,135,165,65,2,68,133
"Bolivia","Beni","Marbán","San Andrés","ESC.VILLA BANZER",-64.41677,-14.94876,17,0,64,81,25,0,39,64
"Bolivia","Beni","Moxos","San Ignacio","COL.SOCRATES PARADA EGUEZ",-65.64265,-14.9983,661,55,2892,3553,1138,64,1635,2773
"Bolivia","Beni","Moxos","San Ignacio","ESC.CENTRAL SAN IGNACITO",-65.64748,-15.4581,8,0,21,29,6,0,15,21
"Bolivia","Beni","Moxos","San Ignacio","ESC.CENTRAL SANTA ROSA",-65.85181,-15.22264,5,2,91,96,10,0,79,89
"Bolivia","Beni","Moxos","San Ignacio","ESC. EL DESENGAÑO",-65.44534,-14.27502,45,2,121,166,59,2,58,117
"Bolivia","Beni","Moxos","San Ignacio","ESC.FATIMA",-65.34778,-14.91402,20,0,78,98,44,0,34,78
"Bolivia","Beni","Moxos","San Ignacio","ESC.LA ARGENTINA",-65.32679,-14.82843,9,0,68,77,24,1,43,67
"Bolivia","Beni","Moxos","San Ignacio","ESC.LITORAL",-65.57434,-14.97235,10,3,107,117,10,0,94,104
"Bolivia","Beni","Moxos","San Ignacio","ESC.MERCEDES DE LOJOJOTA",-65.57259,-16.5034,22,4,74,96,8,4,58,66
"Bolivia","Beni","Moxos","San Ignacio","ESC.MONTE GRANDE",-65.82966,-15.63879,23,1,90,113,16,8,65,81
"Bolivia","Beni","Moxos","San Ignacio","ESC.MONTE MAE",-65.72498,-15.53512,36,0,49,85,28,0,21,49
"Bolivia","Beni","Moxos","San Ignacio","ESC. OROMOMO",-66.18743,-16.04399,46,28,279,325,37,6,208,245
"Bolivia","Beni","Moxos","San Ignacio","ESC.OVIDIO ROCA C.",-65.55151,-15.55553,123,1,430,553,225,7,197,422
"Bolivia","Beni","Moxos","San Ignacio","ESC.PTO.SAN LORENZO",-65.4773,-15.77166,29,6,98,127,41,5,46,87
"Bolivia","Beni","Moxos","San Ignacio","ESC. PUERTO SAN BORJA",-65.79875,-14.98267,28,0,83,111,12,2,69,81
"Bolivia","Beni","Moxos","San Ignacio","ESC.RETIRO",-65.80604,-15.34924,15,1,106,121,2,2,101,103
"Bolivia","Beni","Moxos","San Ignacio","ESC.SAN ANTONIO DE IMOSE",-65.35487,-15.95693,45,2,94,139,48,9,35,83
"Bolivia","Beni","Moxos","San Ignacio","ESC.SAN FRANCISCO",-65.35629,-15.41029,63,8,231,294,68,7,148,216
"Bolivia","Beni","Moxos","San Ignacio","ESC.SAN JOSE DEL CABITU",-65.9744,-15.26368,60,1,163,223,35,6,121,156
"Bolivia","Beni","Moxos","San Ignacio","ESC.SAN JOSE DE PATROCINIO",-65.29938,-15.7724,16,0,22,38,20,0,2,22
"Bolivia","Beni","Moxos","San Ignacio","ESC.SAN MIGUELITO ISIBORO",-65.44078,-16.52943,15,1,68,83,6,4,57,63
"Bolivia","Beni","Moxos","San Ignacio","ESC.SUB-CENTRAL PUEBLO NUEVO",-65.88788,-15.24535,13,0,32,45,5,0,27,32
"Bolivia","Beni","Moxos","San Ignacio","ESC.TRINIDACITO",-65.30994,-15.76319,19,0,31,50,27,0,4,31
"Bolivia","Beni","Moxos","San Ignacio","ESCUELA DE BERMEO",-65.3772,-14.89496,28,1,82,110,30,0,51,81
"Bolivia","Beni","Moxos","San Ignacio","ESCUELA SANTÍSIMA TRINIDAD",-65.76534,-16.61358,21,3,160,181,42,2,113,155
"Bolivia","Beni","Moxos","San Ignacio","L.GILFREDO CORTEZ CANDIA",-65.64448,-14.99516,671,44,2561,3232,964,47,1506,2470
"Bolivia","Beni","Moxos","San Ignacio","U.E. SAN BERNARDO",-65.2933,-15.65132,43,2,92,135,73,3,14,87
"Bolivia","Beni","Vaca Diéz","Puerto Guayaramerín","(CÁRCEL) PENAL GUAYARAMERIN",-65.35279,-10.81292,11,0,22,33,11,1,10,21
"Bolivia","Beni","Vaca Diéz","Puerto Guayaramerín","CENTRO EDUCATIVO SIMON BOLIVAR",-65.36375,-10.83101,75,4,283,358,175,3,101,276
"Bolivia","Beni","Vaca Diéz","Puerto Guayaramerín","COL. 6 DE JUNIO",-65.34737,-10.82762,365,9,1476,1841,976,27,464,1440
"Bolivia","Beni","Vaca Diéz","Puerto Guayaramerín","COL. ALTO DE LA ALIANZA",-65.36181,-10.82369,485,15,1787,2272,1098,40,634,1732
"Bolivia","Beni","Vaca Diéz","Puerto Guayaramerín","COLEGIO ANTONIO VACA DIEZ",-65.35497,-10.81294,92,3,342,434,224,2,113,337
"Bolivia","Beni","Vaca Diéz","Puerto Guayaramerín","COLEGIO MANUEL VICENTE BALLIVIAN",-65.35051,-10.81116,182,1,302,484,218,5,78,296
"Bolivia","Beni","Vaca Diéz","Puerto Guayaramerín","COL. EVANGELICO NACIONAL",-65.35439,-10.81791,541,9,1442,1983,905,25,503,1408
"Bolivia","Beni","Vaca Diéz","Puerto Guayaramerín","COL.MANUEL ANTONIO OJOPI",-65.35567,-10.81322,732,14,2585,3317,1703,32,836,2539
"Bolivia","Beni","Vaca Diéz","Puerto Guayaramerín","DR.ELMER BOTSFORD",-65.35297,-10.8088,225,6,701,926,471,17,207,678
"Bolivia","Beni","Vaca Diéz","Puerto Guayaramerín","ESC.ANTOFAGASTA",-65.39104,-10.39382,15,0,51,66,28,0,23,51
"Bolivia","Beni","Vaca Diéz","Puerto Guayaramerín","ESC.CENTRAL SAN LORENZO",-65.23228,-11.73968,22,0,85,107,34,1,50,84
"Bolivia","Beni","Vaca Diéz","Puerto Guayaramerín","ESC.JUDDI DE SUAREZ",-65.58167,-10.53687,80,5,257,337,179,3,70,249
"Bolivia","Beni","Vaca Diéz","Puerto Guayaramerín","ESC. MEJILLONES",-65.35355,-10.82544,908,42,3354,4262,2205,58,1049,3254
"Bolivia","Beni","Vaca Diéz","Puerto Guayaramerín","ESC.ROSARIO DEL YATA",-65.57995,-10.99195,72,3,200,272,84,6,107,191
"Bolivia","Beni","Vaca Diéz","Puerto Guayaramerín","ESC. SAN FRANCISCO DEL YATA",-65.51111,-10.61194,15,1,46,61,29,0,16,45
"Bolivia","Beni","Vaca Diéz","Puerto Guayaramerín","ESC. SAN JOSE",-65.34554,-10.81522,402,12,1405,1807,904,25,464,1368
"Bolivia","Beni","Vaca Diéz","Puerto Guayaramerín","ESCUELA BRASIL",-65.3572,-10.8307,153,1,472,625,316,8,147,463
"Bolivia","Beni","Vaca Diéz","Puerto Guayaramerín","ESCUELA LOS ALMENDROS",-65.3472,-10.83402,425,10,1488,1913,890,44,544,1434
"Bolivia","Beni","Vaca Diéz","Puerto Guayaramerín","LIC.MIXTO GUAYAMERIN",-65.35883,-10.82098,541,8,1386,1927,891,24,463,1354
"Bolivia","Beni","Vaca Diéz","Puerto Guayaramerín","U.E. 9 DE ABRIL",-65.36181,-10.84011,25,2,266,291,154,5,105,259
"Bolivia","Beni","Vaca Diéz","Puerto Guayaramerín","U.E. BELEN",-65.35558,-10.83641,96,1,433,529,258,10,164,422
"Bolivia","Beni","Vaca Diéz","Puerto Guayaramerín","U.E MIGUEL ANTELO",-65.34438,-10.82256,49,0,186,235,111,8,67,178
"Bolivia","Beni","Vaca Diéz","Riberalta","(CÁRCEL) PENAL RIBERALTA",-66.0738,-10.99669,29,1,17,46,9,1,6,15
"Bolivia","Beni","Vaca Diéz","Riberalta","COL. 6 DE JUNIO",-66.077,-11.00458,534,11,1371,1905,1014,18,328,1342
"Bolivia","Beni","Vaca Diéz","Riberalta","COLEGIO EDUARDO ABAROA",-66.06204,-11.00703,637,23,2435,3072,1638,47,727,2365
"Bolivia","Beni","Vaca Diéz","Riberalta","COLEGIO ISMAEL CARRASCO TELLERIA",-66.05402,-11.01021,122,8,387,509,215,12,152,367
"Bolivia","Beni","Vaca Diéz","Riberalta","COLEGIO SAN FRANCISCO",-66.07206,-11.00753,81,3,359,440,244,7,105,349
"Bolivia","Beni","Vaca Diéz","Riberalta","COLEGIO SAN JUAN",-66.04671,-11.03188,542,57,1894,2436,967,57,813,1780
"Bolivia","Beni","Vaca Diéz","Riberalta","COLEGIO WALTER ALPIRE DURAN",-66.05729,-11.01164,157,6,638,795,429,8,195,624
"Bolivia","Beni","Vaca Diéz","Riberalta","COL. PEDRO KRAMER",-66.06915,-10.99869,391,8,1297,1688,929,37,323,1252
"Bolivia","Beni","Vaca Diéz","Riberalta","COL. SAN JOSE OBRERO",-66.06607,-10.99754,484,12,1271,1755,894,21,344,1238
"Bolivia","Beni","Vaca Diéz","Riberalta","COMITE CIVICO TUMICHUCUA",-66.16624,-11.14738,73,11,254,327,145,20,78,223
"Bolivia","Beni","Vaca Diéz","Riberalta","ESC.BRITANICA",-66.05006,-11.01523,915,39,2819,3734,1780,89,911,2691
"Bolivia","Beni","Vaca Diéz","Riberalta","ESC.FELIX SATTORY ROMAN",-66.06739,-11.00182,858,22,3384,4242,2517,66,779,3296
"Bolivia","Beni","Vaca Diéz","Riberalta","ESC. JUANA AZURDUY DE PADILLA",-66.07388,-10.99538,257,4,847,1104,649,23,171,820
"Bolivia","Beni","Vaca Diéz","Riberalta","ESCUELA 12 DE OCTUBRE",-65.69309,-11.0167,65,6,206,271,93,2,105,198
"Bolivia","Beni","Vaca Diéz","Riberalta","ESCUELA 1RO DE DICIEMBRE",-66.07318,-11.01311,454,12,1301,1755,933,18,338,1271
"Bolivia","Beni","Vaca Diéz","Riberalta","ESCUELA ALTO IVON",-66.03656,-11.87361,21,4,244,265,4,3,233,237
"Bolivia","Beni","Vaca Diéz","Riberalta","ESCUELA BOLIVAR",-65.9,-11.00223,93,5,268,361,124,6,133,257
"Bolivia","Beni","Vaca Diéz","Riberalta","ESCUELA LOS TAJIBOS",-66.04456,-11.02086,1118,41,3198,4316,1929,76,1152,3081
"Bolivia","Beni","Vaca Diéz","Riberalta","ESCUELA MARIPOSA",-66.1415,-12.27631,20,1,87,107,51,5,30,81
"Bolivia","Beni","Vaca Diéz","Riberalta","ESCUELA NAZARETH",-66.3375,-11.38739,22,2,92,114,60,3,27,87
"Bolivia","Beni","Vaca Diéz","Riberalta","ESCUELA PETROLERA",-66.05014,-11.00229,1526,58,4261,5787,2792,100,1311,4103
"Bolivia","Beni","Vaca Diéz","Riberalta","ESCUELA SANTA MARIA",-65.93813,-11.1185,68,9,280,348,112,6,153,265
"Bolivia","Beni","Vaca Diéz","Riberalta","ESCUELA SANTUARIO",-66.4724,-11.5389,6,2,53,59,23,6,22,45
"Bolivia","Beni","Vaca Diéz","Riberalta","ESCUELA WARNES",-65.96947,-10.92752,166,10,185,351,105,4,66,171
"Bolivia","Beni","Vaca Diéz","Riberalta","KINDER JHON F. KENNEDY",-66.06571,-10.99814,298,18,1487,1785,1094,20,355,1449
"Bolivia","Beni","Vaca Diéz","Riberalta","POLITECNICO BENJAMIN BOWLES",-66.05167,-11.00485,866,24,2961,3827,1945,58,934,2879
"Bolivia","Beni","Vaca Diéz","Riberalta","U.E. BELLA FLOR",-66.21178,-11.33017,4,0,71,75,31,2,38,69
"Bolivia","Beni","Vaca Diéz","Riberalta","U.E FEDERICO DEMMER",-66.04344,-10.99968,429,20,1389,1818,904,42,423,1327
"Bolivia","Beni","Vaca Diéz","Riberalta","U.E. LA ESPERANZA",-66.0544,-11.06529,16,3,147,163,85,14,45,130
"Bolivia","Beni","Vaca Diéz","Riberalta","U.E. NUESTRA SEÑORA DEL CARMEN",-66.07724,-10.99875,465,15,1549,2014,1070,31,433,1503
"Bolivia","Beni","Vaca Diéz","Riberalta","U.E. POPECHI",-66.07248,-11.13074,26,11,186,212,78,7,90,168
"Bolivia","Beni","Vaca Diéz","Riberalta","UNIDAD EDUCATIVA NATANIEL GARCÍA CHAVEZ",-66.07935,-11.00858,687,35,2572,3259,1803,101,633,2436
"Bolivia","Beni","Yacuma","Exaltación","ESC. CAMPO ANA MARIA",-65.57471,-12.94433,4,0,23,27,6,0,17,23
"Bolivia","Beni","Yacuma","Exaltación","ESC.COOPERATIVA",-65.04883,-12.6354,15,0,46,61,19,1,26,45
"Bolivia","Beni","Yacuma","Exaltación","ESC.COQUINAL",-65.85875,-12.97027,26,2,165,191,35,2,126,161
"Bolivia","Beni","Yacuma","Exaltación","ESC.EL MOTACUSAL",-65.4307,-12.91581,10,1,71,81,34,0,36,70
"Bolivia","Beni","Yacuma","Exaltación","ESC.EL TROMPILLO",-65.11865,-13.11602,7,0,10,17,6,0,4,10
"Bolivia","Beni","Yacuma","Exaltación","ESC.JOSE MAX PAREDES",-65.25107,-13.32101,133,1,411,544,149,3,258,407
"Bolivia","Beni","Yacuma","Exaltación","ESC. NUEVA ESPERANZA",-66.00737,-12.97329,9,0,17,26,9,0,8,17
"Bolivia","Beni","Yacuma","Exaltación","ESC.SAN CARLOS",-65.70103,-13.23234,15,0,44,59,11,0,33,44
"Bolivia","Beni","Yacuma","Exaltación","ESC.SANTA ROSA",-66.16964,-13.51003,1,0,9,10,4,0,5,9
"Bolivia","Beni","Yacuma","Exaltación","ESCUELA PUERTO SANTIAGO",-65.20205,-13.10789,2,0,16,18,11,0,5,16
"Bolivia","Beni","Yacuma","Exaltación","ESCUELA SAN JUAN DEL JORDAN",-66.42942,-12.88492,12,0,22,34,12,0,10,22
"Bolivia","Beni","Yacuma","Santa Ana (de Yacuma)","COL.ANDRES ALBERDI SALEGUI",-65.4307,-13.7505,621,21,2129,2750,1406,29,673,2079
"Bolivia","Beni","Yacuma","Santa Ana (de Yacuma)","COLEGIO GUILLERMO SEARLE",-65.42456,-13.74432,225,7,663,888,403,10,243,646
"Bolivia","Beni","Yacuma","Santa Ana (de Yacuma)","COL.MONS.DANIEL RIVERO",-65.42525,-13.74378,971,44,3247,4218,1945,65,1193,3138
"Bolivia","Beni","Yacuma","Santa Ana (de Yacuma)","ESC.CEC EL TOTAISAL",-66.32708,-14.87791,58,1,158,216,58,5,94,152
"Bolivia","Beni","Yacuma","Santa Ana (de Yacuma)","ESC.LOS MONTES DE ORO",-65.8585,-14.33763,11,1,13,24,6,0,6,12
"Bolivia","Beni","Yacuma","Santa Ana (de Yacuma)","ESC.WENCESLAO AÑEZ",-65.63189,-14.60486,123,3,350,473,185,8,154,339
"Bolivia","Chuquisaca","Azurduy","Tarvita (Villa Orías)","ESCUELA 12 DE OCTUBRE",-64.46204,-19.78101,146,18,552,698,176,21,337,513
"Bolivia","Chuquisaca","Azurduy","Tarvita (Villa Orías)","ESCUELA CHUNCA CANCHA",-64.68405,-19.58565,6,2,73,79,4,10,57,61
"Bolivia","Chuquisaca","Azurduy","Tarvita (Villa Orías)","ESCUELA CRUZ CKASA",-64.57745,-19.87214,132,9,572,704,123,21,419,542
"Bolivia","Chuquisaca","Azurduy","Tarvita (Villa Orías)","ESCUELA LUIS EVENCIO ORÍAS",-64.44648,-19.61855,173,9,567,740,272,16,270,542
"Bolivia","Chuquisaca","Azurduy","Tarvita (Villa Orías)","ESCUELA MARISCAL BRAUN",-64.56983,-19.97382,66,13,388,454,143,15,217,360
"Bolivia","Chuquisaca","Azurduy","Tarvita (Villa Orías)","ESCUELA MOLLE CANCHA",-64.61646,-19.74335,6,0,75,81,4,1,70,74
"Bolivia","Chuquisaca","Azurduy","Tarvita (Villa Orías)","ESCUELA SAN JOSE DE ALISOS",-64.63702,-19.69949,45,6,207,252,44,5,152,196
"Bolivia","Chuquisaca","Azurduy","Tarvita (Villa Orías)","U.E. VILLA PAMPA",-64.51918,-19.65606,37,6,172,209,62,3,101,163
"Bolivia","Chuquisaca","Azurduy","Tarvita (Villa Orías)","UNIDAD EDUCATIVA ANTONIO TOVAR",-64.48597,-19.92718,198,31,807,1005,294,34,448,742
"Bolivia","Chuquisaca","Azurduy","Tarvita (Villa Orías)","UNIDAD EDUCATIVA JESÚS MAESTRO",-64.68082,-19.674,157,17,786,943,56,31,682,738
"Bolivia","Chuquisaca","Azurduy","Tarvita (Villa Orías)","UNIDAD EDUCATIVA PAMPAS DE LEQUE",-64.57776,-19.72431,27,5,288,315,22,3,258,280
"Bolivia","Chuquisaca","Azurduy","Villa Azurduy","ESCUELA DURAZNAL",-64.42482,-20.41302,37,2,193,230,18,5,168,186
"Bolivia","Chuquisaca","Azurduy","Villa Azurduy","ESCUELA HUANCARANI",-64.48476,-20.23491,29,1,131,160,3,7,120,123
"Bolivia","Chuquisaca","Azurduy","Villa Azurduy","ESCUELA PINOS",-64.45695,-20.32877,52,0,177,229,5,1,171,176
"Bolivia","Chuquisaca","Azurduy","Villa Azurduy","ESCUELA  RODEO CHICO",-64.53408,-20.24856,63,5,380,443,12,10,353,365
"Bolivia","Chuquisaca","Azurduy","Villa Azurduy","ESCUELA TABLANI",-64.56451,-20.06003,82,2,315,397,27,24,262,289
"Bolivia","Chuquisaca","Azurduy","Villa Azurduy","ESCUELA TORRECILLAS",-64.3971,-19.9672,56,3,133,189,36,9,85,121
"Bolivia","Chuquisaca","Azurduy","Villa Azurduy","U.E. COLLPAMAYU",-64.51823,-20.08899,51,9,282,333,14,8,251,265
"Bolivia","Chuquisaca","Azurduy","Villa Azurduy","U.E. QUEHUEÑAL",-64.4158,-19.92459,12,3,73,85,23,3,44,67
"Bolivia","Chuquisaca","Azurduy","Villa Azurduy","UNIDAD EDUCATIVA NICANOR LOPEZ",-64.41391,-20.10486,400,54,1556,1956,633,68,801,1434
"Bolivia","Chuquisaca","Azurduy","Villa Azurduy","UNIDAD EDUCATIVA SAN ROQUE",-64.51511,-20.13545,45,1,162,207,6,9,146,152
"Bolivia","Chuquisaca","Azurduy","Villa Azurduy","UNIDAD EDUCATIVA SANTA ROSA",-64.3904,-19.88058,76,2,138,214,33,5,98,131
"Bolivia","Chuquisaca","Belisario Boeto","Villa Serrano","COLEGIO DANIEL SANCHEZ BUSTAMANTE",-64.42113,-19.01643,85,9,476,561,67,25,375,442
"Bolivia","Chuquisaca","Belisario Boeto","Villa Serrano","ESCUELA DARIO OVANDO CUELLAR",-64.3476,-18.8886,38,2,134,172,4,8,120,124
"Bolivia","Chuquisaca","Belisario Boeto","Villa Serrano","ESCUELA ELISARDO PEREZ",-64.19292,-19.11728,61,5,240,301,67,9,159,226
"Bolivia","Chuquisaca","Belisario Boeto","Villa Serrano","ESCUELA HEROES DEL CHACO",-64.13771,-19.06195,54,3,199,253,15,3,178,193
"Bolivia","Chuquisaca","Belisario Boeto","Villa Serrano","ESCUELA JORGE ANIBARRO ZAPATA",-64.29203,-18.99208,127,13,442,569,87,20,322,409
"Bolivia","Chuquisaca","Belisario Boeto","Villa Serrano","ESCUELA LUIS SANTOS PRADO",-64.2653,-19.1737,20,0,95,115,4,3,88,92
"Bolivia","Chuquisaca","Belisario Boeto","Villa Serrano","ESCUELA MARISCAL SUCRE",-64.32195,-19.12737,494,67,2485,2979,948,112,1358,2306
"Bolivia","Chuquisaca","Belisario Boeto","Villa Serrano","ESCUELA RENÉ ANIBARRO GÓMEZ",-64.396,-18.8268,99,4,201,300,16,11,170,186
"Bolivia","Chuquisaca","Belisario Boeto","Villa Serrano","U.E. LAMPAZOS",-64.39145,-18.76599,3,0,72,75,15,2,55,70
"Bolivia","Chuquisaca","Belisario Boeto","Villa Serrano","U.E. LOTHAR BRUCKER",-64.36176,-18.82008,3,0,97,100,1,3,93,94
"Bolivia","Chuquisaca","Belisario Boeto","Villa Serrano","UNIDAD EDUCATIVA MAMERTO NAVA DURAN",-64.37803,-18.94884,47,3,150,197,15,10,122,137
"Bolivia","Chuquisaca","Belisario Boeto","Villa Serrano","UNID. EDUC. SAN MIGUEL DE LA QUEBRADA",-64.24857,-19.1079,29,2,91,120,6,5,78,84
"Bolivia","Chuquisaca","Hernando Siles","Monteagudo","ESCUELA 6 DE JUNIO",-64.11983,-20.33284,125,2,368,493,159,16,191,350
"Bolivia","Chuquisaca","Hernando Siles","Monteagudo","ESCUELA BERNARDO MONTEAGUDO",-63.95635,-19.78872,594,59,3297,3891,1692,101,1445,3137
"Bolivia","Chuquisaca","Hernando Siles","Monteagudo","ESCUELA CHAPIMAYU",-64.14899,-19.87584,70,2,268,338,62,8,196,258
"Bolivia","Chuquisaca","Hernando Siles","Monteagudo","ESCUELA DESPENSAS",-64.1007,-20.04283,61,2,173,234,71,10,90,161
"Bolivia","Chuquisaca","Hernando Siles","Monteagudo","ESCUELA EL ZAPALLAR",-63.93938,-19.80897,32,7,194,226,60,8,119,179
"Bolivia","Chuquisaca","Hernando Siles","Monteagudo","ESCUELA FERNANDEZ",-64.23994,-20.16429,46,3,168,214,72,4,89,161
"Bolivia","Chuquisaca","Hernando Siles","Monteagudo","ESCUELA MARÍA VDA. DE VALDA",-63.95535,-19.80042,630,50,3353,3983,1657,124,1522,3179
"Bolivia","Chuquisaca","Hernando Siles","Monteagudo","ESCUELA PAMPA HEREDIA",-64.0597,-19.80225,37,2,118,155,40,5,71,111
"Bolivia","Chuquisaca","Hernando Siles","Monteagudo","ESCUELA PEDERNAL",-64.11466,-19.77911,52,8,246,298,45,7,186,231
"Bolivia","Chuquisaca","Hernando Siles","Monteagudo","ESCUELA SAN LORENZO",-64.20084,-19.92886,24,2,139,163,31,5,101,132
"Bolivia","Chuquisaca","Hernando Siles","Monteagudo","ESCUELA YANA YANA",-64.13422,-20.19204,24,0,34,58,19,2,13,32
"Bolivia","Chuquisaca","Hernando Siles","Monteagudo","NUCLEO ESCOLAR BARTOLO",-64.03931,-19.66221,13,1,94,107,11,1,81,92
"Bolivia","Chuquisaca","Hernando Siles","Monteagudo","U. EDU. JUANA AZURDUY DE PADILLA",-63.9845,-20.0189,99,16,495,594,164,45,270,434
"Bolivia","Chuquisaca","Hernando Siles","Monteagudo","U. EDU. SAN MIGUEL DEL BAÑADO",-63.88668,-20.0789,87,22,503,590,198,23,260,458
"Bolivia","Chuquisaca","Hernando Siles","Monteagudo","U. EDU. SAN PEDRO DEL PARAPETI",-63.88159,-20.16382,15,0,59,74,35,1,23,58
"Bolivia","Chuquisaca","Hernando Siles","Monteagudo","UNIDAD EDUCATIVA AZERO NORTE",-63.99007,-19.56839,4,0,42,46,13,2,27,40
"Bolivia","Chuquisaca","Hernando Siles","Monteagudo","UNIDAD EDUCATIVA INGAVI",-64.0831,-20.21808,8,2,92,100,45,0,45,90
"Bolivia","Chuquisaca","Hernando Siles","Monteagudo","UNIDAD EDUCATIVA LOS ARCOS",-64.22605,-20.3155,25,0,92,117,21,4,67,88
"Bolivia","Chuquisaca","Hernando Siles","Monteagudo","UNIDAD EDUCATIVA REBECA DE LA VEGA",-63.97173,-19.81358,269,37,1608,1877,630,82,859,1489
"Bolivia","Chuquisaca","Hernando Siles","Monteagudo","UNIDAD EDUCATIVA ROLDANA",-64.12152,-19.80378,13,4,101,114,23,1,73,96
"Bolivia","Chuquisaca","Hernando Siles","Monteagudo","UNIDAD EDUCATIVA VALLE NUEVO",-63.98814,-19.9332,29,6,181,210,43,10,122,165
"Bolivia","Chuquisaca","Hernando Siles","San Pablo de Huacareta","COLEGIO AMISTAD A",-64.00413,-20.36557,328,14,1206,1534,748,26,418,1166
"Bolivia","Chuquisaca","Hernando Siles","San Pablo de Huacareta","ESCUELA MIGUEL JHASTER",-64.02778,-20.71865,46,5,189,235,120,1,63,183
"Bolivia","Chuquisaca","Hernando Siles","San Pablo de Huacareta","ESCUELA RAFAEL PABON",-64.14964,-20.57222,94,8,366,460,176,16,166,342
"Bolivia","Chuquisaca","Hernando Siles","San Pablo de Huacareta","ESCUELA SALVIO LANUZA",-63.89535,-20.5817,106,11,312,418,189,20,92,281
"Bolivia","Chuquisaca","Hernando Siles","San Pablo de Huacareta","UNIDAD BALDOMERO LOPEZ",-63.96331,-20.16225,65,8,254,319,109,8,129,238
"Bolivia","Chuquisaca","Hernando Siles","San Pablo de Huacareta","UNIDAD EDUCATIVA ATIRIMBIA",-63.93389,-20.8244,24,8,92,116,37,3,44,81
"Bolivia","Chuquisaca","Hernando Siles","San Pablo de Huacareta","UNIDAD EDUCATIVA ERNESTO THEOBALD",-64.15099,-20.51959,146,6,433,579,159,14,254,413
"Bolivia","Chuquisaca","Hernando Siles","San Pablo de Huacareta","UNIDAD EDUCATIVA HUIRASAI",-63.992,-20.61985,23,0,123,146,17,3,103,120
"Bolivia","Chuquisaca","Hernando Siles","San Pablo de Huacareta","UNIDAD EDUCATIVA SAN JORGE DE IPATY",-63.8552,-20.42435,51,9,298,349,18,10,261,279
"Bolivia","Chuquisaca","Luis Calvo","Macharetí","COLEGIO 27 DE MARZO",-63.28704,-20.70558,54,0,221,275,61,36,124,185
"Bolivia","Chuquisaca","Luis Calvo","Macharetí","COLEGIO FRAY QUEBRACHO",-63.32757,-20.99875,13,2,118,131,50,4,62,112
"Bolivia","Chuquisaca","Luis Calvo","Macharetí","ESCUELA 25 DE MAYO",-63.42398,-20.45202,75,10,410,485,110,7,283,393
"Bolivia","Chuquisaca","Luis Calvo","Macharetí","ESCUELA EDUARDO AVAROA",-63.3611,-20.81543,284,22,938,1222,464,37,415,879
"Bolivia","Chuquisaca","Luis Calvo","Macharetí","ESCUELA EL SIMBOLAR",-62.9492,-20.5253,16,2,55,71,25,4,24,49
"Bolivia","Chuquisaca","Luis Calvo","Macharetí","ESCUELA EL VINAL",-63.10925,-20.70269,18,3,53,71,23,3,24,47
"Bolivia","Chuquisaca","Luis Calvo","Macharetí","ESCUELA IPATI",-63.40212,-20.54343,25,7,139,164,73,2,57,130
"Bolivia","Chuquisaca","Luis Calvo","Macharetí","ESCUELA PEDRO DOMINGO MURILLO",-63.3061,-20.86273,10,1,62,72,4,0,57,61
"Bolivia","Chuquisaca","Luis Calvo","Macharetí","ESCUELA SAN JUAN DE CAMATINDI",-63.39542,-20.99425,37,5,147,184,44,6,92,136
"Bolivia","Chuquisaca","Luis Calvo","Macharetí","ESCUELA TIGUIPA PUEBLO",-63.38359,-20.91519,24,4,147,171,76,5,62,138
"Bolivia","Chuquisaca","Luis Calvo","Macharetí","U. EDU. HEROES DEL CHACO HERNADO SILES",-63.07143,-20.75865,106,8,259,365,151,6,94,245
"Bolivia","Chuquisaca","Luis Calvo","Macharetí","U.E. ISIPOTINDI",-63.31057,-20.61732,13,0,118,131,21,16,81,102
"Bolivia","Chuquisaca","Luis Calvo","Macharetí","U.E. TENTAMI",-63.3348,-20.937,13,1,75,88,7,2,65,72
"Bolivia","Chuquisaca","Luis Calvo","Macharetí","U.E. TIMBOYCITO",-63.311,-20.7379,5,1,46,51,13,0,32,45
"Bolivia","Chuquisaca","Luis Calvo","Macharetí","UNIDAD EDUCATIVA CUATRO VIENTOS",-62.68652,-20.86266,6,1,24,30,20,0,3,23
"Bolivia","Chuquisaca","Luis Calvo","Macharetí","UNIDAD EDUCATIVA MANUEL MARIANO GÓMEZ",-63.06475,-20.53849,2,2,34,36,16,3,13,29
"Bolivia","Chuquisaca","Luis Calvo","Villa de Huacaya","ESCUELA BOYCOBO",-63.65736,-20.69879,17,2,102,119,24,2,74,98
"Bolivia","Chuquisaca","Luis Calvo","Villa de Huacaya","ESCUELA CHIMBE",-63.55851,-20.64951,10,0,34,44,4,1,29,33
"Bolivia","Chuquisaca","Luis Calvo","Villa de Huacaya","ESCUELA FRAY MARCOS OZETI",-63.52636,-20.48822,118,7,450,568,118,11,314,432
"Bolivia","Chuquisaca","Luis Calvo","Villa de Huacaya","ESCUELA SAN ANTONIO",-63.66537,-20.74458,57,0,177,234,78,3,96,174
"Bolivia","Chuquisaca","Luis Calvo","Villa de Huacaya","UNIDAD EDUCATIVA ANKAGUAZU",-63.67434,-20.88688,2,0,33,35,7,0,26,33
"Bolivia","Chuquisaca","Luis Calvo","Villa de Huacaya","UNIDAD EDUCATIVA BORORIGUA",-63.63357,-20.56405,22,0,140,162,26,2,112,138
"Bolivia","Chuquisaca","Luis Calvo","Villa Vaca Guzmán (Muyupampa)","CASA COMUNAL AGUAIRENDA",-63.76873,-19.46924,66,4,205,271,34,1,166,200
"Bolivia","Chuquisaca","Luis Calvo","Villa Vaca Guzmán (Muyupampa)","CASA COMUNAL TENTAYAPI",-63.85,-20.86667,21,1,190,211,2,0,187,189
"Bolivia","Chuquisaca","Luis Calvo","Villa Vaca Guzmán (Muyupampa)","ESCUELA HERNANDO SILES",-63.75016,-19.8965,490,42,2498,2988,1405,108,943,2348
"Bolivia","Chuquisaca","Luis Calvo","Villa Vaca Guzmán (Muyupampa)","ESCUELA RUFINO SALAZAR",-63.8163,-19.67933,67,7,200,267,70,6,117,187
"Bolivia","Chuquisaca","Luis Calvo","Villa Vaca Guzmán (Muyupampa)","ESCUELA SAPIRANGUIMIRI",-63.76806,-20.09122,16,2,78,94,26,6,44,70
"Bolivia","Chuquisaca","Luis Calvo","Villa Vaca Guzmán (Muyupampa)","ESCUELA TICUCHA",-63.82461,-19.62364,18,2,97,115,38,6,51,89
"Bolivia","Chuquisaca","Luis Calvo","Villa Vaca Guzmán (Muyupampa)","NUCLEO ESCOLAR CUMANDAITI",-63.84387,-19.45372,53,4,193,246,64,2,123,187
"Bolivia","Chuquisaca","Luis Calvo","Villa Vaca Guzmán (Muyupampa)","U.E. LEO SCHWARZ",-63.88537,-19.26629,5,1,58,63,17,2,38,55
"Bolivia","Chuquisaca","Luis Calvo","Villa Vaca Guzmán (Muyupampa)","UNIDAD EDUCATIVA IGUEMBE",-63.7504,-20.55215,86,6,326,412,115,26,179,294
"Bolivia","Chuquisaca","Luis Calvo","Villa Vaca Guzmán (Muyupampa)","UNIDAD EDUCATIVA ITAU",-63.76336,-20.27766,19,0,57,76,17,2,38,55
"Bolivia","Chuquisaca","Luis Calvo","Villa Vaca Guzmán (Muyupampa)","UNIDAD EDUCATIVA ITY",-63.7644,-19.6085,11,2,181,192,48,2,129,177
"Bolivia","Chuquisaca","Nor Cinti","Camargo","(CÁRCEL) CARCELETA PÚBLICA DE CAMARGO",-65.20866,-20.64096,6,0,15,21,6,0,9,15
"Bolivia","Chuquisaca","Nor Cinti","Camargo","COLEGIO BOLIVIA",-65.20852,-20.6396,414,32,1894,2308,1048,64,750,1798
"Bolivia","Chuquisaca","Nor Cinti","Camargo","COLEGIO NACIONAL MIXTO 3 DE ABRIL",-65.21046,-20.64259,475,27,2154,2629,1169,82,876,2045
"Bolivia","Chuquisaca","Nor Cinti","Camargo","ESCUELA EL CHURO",-65.13138,-20.63216,21,0,57,78,2,1,54,56
"Bolivia","Chuquisaca","Nor Cinti","Camargo","ESCUELA LA QUEMADA",-65.29808,-20.75148,13,2,98,111,33,10,53,86
"Bolivia","Chuquisaca","Nor Cinti","Camargo","ESCUELA RIO CHICO",-65.22565,-20.69902,23,1,127,150,42,4,80,122
"Bolivia","Chuquisaca","Nor Cinti","Camargo","ESCUELA YURAC CABALLO",-65.13165,-20.74312,41,3,144,185,27,7,107,134
"Bolivia","Chuquisaca","Nor Cinti","Camargo","UNIDAD EDUCATIVA CARPACHACRA",-65.34814,-20.64821,18,1,99,117,21,6,71,92
"Bolivia","Chuquisaca","Nor Cinti","Camargo","UNIDAD EDUCATIVA CUEVA PAMPA",-65.04705,-20.45579,45,4,167,212,14,3,146,160
"Bolivia","Chuquisaca","Nor Cinti","Camargo","UNIDAD EDUCATIVA HIGUERA HUAYCO",-65.22394,-20.79629,47,5,174,221,48,3,118,166
"Bolivia","Chuquisaca","Nor Cinti","Camargo","UNIDAD EDUCATIVA HUACA CANCHA",-64.95026,-20.47788,57,4,118,175,6,8,100,106
"Bolivia","Chuquisaca","Nor Cinti","Camargo","UNIDAD EDUCATIVA JATUN QUINRAY",-64.9914,-20.5823,16,1,86,102,7,0,78,85
"Bolivia","Chuquisaca","Nor Cinti","Camargo","UNIDAD EDUCATIVA LINTACA",-65.34542,-20.73311,15,0,24,39,7,0,17,24
"Bolivia","Chuquisaca","Nor Cinti","Camargo","UNIDAD EDUCATIVA MUYUQUIRI",-65.14874,-20.49716,106,11,471,577,57,14,389,446
"Bolivia","Chuquisaca","Nor Cinti","Camargo","UNIDAD EDUCATIVA PALCA GRANDE",-65.23849,-20.7456,48,3,151,199,90,9,49,139
"Bolivia","Chuquisaca","Nor Cinti","Camargo","UNIDAD EDUCATIVA QUIRUCILLANI",-64.88852,-20.49862,0,0,28,28,0,0,28,28
"Bolivia","Chuquisaca","Nor Cinti","Camargo","UNIDAD EDUCATIVA SUQUISTACA",-65.09431,-20.38414,45,5,208,253,21,5,177,198
"Bolivia","Chuquisaca","Nor Cinti","Camargo","UNIDAD EDUCATIVA TACAQUIRA",-65.14967,-20.54018,107,0,260,367,69,12,179,248
"Bolivia","Chuquisaca","Nor Cinti","Incahuasi","ESCUELA 2 DE AGOSTO",-64.70975,-20.70182,52,6,334,386,14,7,307,321
"Bolivia","Chuquisaca","Nor Cinti","Incahuasi","ESCUELA EL VERANO",-64.6666,-20.56279,21,0,181,202,4,1,176,180
"Bolivia","Chuquisaca","Nor Cinti","Incahuasi","ESCUELA HUAJLAYA",-64.5423,-20.59936,109,15,256,365,28,4,209,237
"Bolivia","Chuquisaca","Nor Cinti","Incahuasi","ESCUELA JOLENCIA",-64.86333,-20.71497,72,11,316,388,60,24,221,281
"Bolivia","Chuquisaca","Nor Cinti","Incahuasi","ESCUELA LAMPAZAR",-64.4935,-20.5347,46,0,115,161,3,0,112,115
"Bolivia","Chuquisaca","Nor Cinti","Incahuasi","ESCUELA SAN LORENCITO",-64.87055,-20.79387,7,2,32,39,4,6,20,24
"Bolivia","Chuquisaca","Nor Cinti","Incahuasi","U.E. YATINA",-64.73019,-20.61985,90,10,285,375,19,8,248,267
"Bolivia","Chuquisaca","Nor Cinti","Incahuasi","UNIDAD EDUCATIVA EDUARDO AVAROA",-64.86781,-20.78048,398,24,1297,1695,493,57,723,1216
"Bolivia","Chuquisaca","Nor Cinti","Incahuasi","UNIDAD EDUCATIVA EL QUEMADO",-64.5985,-20.57037,5,2,257,262,3,2,250,253
"Bolivia","Chuquisaca","Nor Cinti","San Lucas","ESCUELA HUAYLLANI",-64.93605,-20.36235,66,6,194,260,6,4,178,184
"Bolivia","Chuquisaca","Nor Cinti","San Lucas","ESCUELA MOLLE PATA",-64.64008,-20.41311,81,7,264,345,36,17,204,240
"Bolivia","Chuquisaca","Nor Cinti","San Lucas","ESCUELA PAYACOTA DEL CARMEN",-65.25732,-20.21278,104,8,367,471,75,14,270,345
"Bolivia","Chuquisaca","Nor Cinti","San Lucas","U.E. CINTEÑO TAMBO",-65.01966,-20.22208,61,3,296,357,71,8,214,285
"Bolivia","Chuquisaca","Nor Cinti","San Lucas","U.E. CRUZ MAYU",-64.87011,-20.03394,2,2,90,92,1,0,87,88
"Bolivia","Chuquisaca","Nor Cinti","San Lucas","U. EDU. EDUARDO AVAROA",-65.13464,-20.1035,537,55,2040,2577,664,101,1220,1884
"Bolivia","Chuquisaca","Nor Cinti","San Lucas","U.E. EL TERRADO",-64.98693,-20.39509,15,2,133,148,5,1,125,130
"Bolivia","Chuquisaca","Nor Cinti","San Lucas","U.E. TORRE DE LINARES",-64.7693,-19.901,55,8,171,226,8,0,155,163
"Bolivia","Chuquisaca","Nor Cinti","San Lucas","UNIDAD EDUCATIVA 12 DE ABRIL",-65.02613,-20.27677,159,12,691,850,96,13,570,666
"Bolivia","Chuquisaca","Nor Cinti","San Lucas","UNIDAD EDUCATIVA ACCHILLA",-64.80387,-20.32539,141,13,250,391,16,11,210,226
"Bolivia","Chuquisaca","Nor Cinti","San Lucas","UNIDAD EDUCATIVA BUENA VISTA",-64.93593,-19.9318,52,1,175,227,5,3,166,171
"Bolivia","Chuquisaca","Nor Cinti","San Lucas","UNIDAD EDUCATIVA CANCHAS BLANCAS",-64.79684,-20.03145,104,8,256,360,16,6,226,242
"Bolivia","Chuquisaca","Nor Cinti","San Lucas","UNIDAD EDUCATIVA CHILLAGUA",-64.96616,-20.26884,62,1,265,327,14,3,247,261
"Bolivia","Chuquisaca","Nor Cinti","San Lucas","UNIDAD EDUCATIVA CIVITA",-64.90813,-20.00292,8,0,110,118,0,3,107,107
"Bolivia","Chuquisaca","Nor Cinti","San Lucas","UNIDAD EDUCATIVA HUAÑUMILLA",-64.74733,-19.94859,81,1,267,348,18,6,242,260
"Bolivia","Chuquisaca","Nor Cinti","San Lucas","UNIDAD EDUCATIVA JAPO",-64.77112,-20.09636,34,2,113,147,9,2,100,109
"Bolivia","Chuquisaca","Nor Cinti","San Lucas","UNIDAD EDUCATIVA KOLLPA",-64.65379,-20.03951,66,0,257,323,2,6,249,251
"Bolivia","Chuquisaca","Nor Cinti","San Lucas","UNIDAD EDUCATIVA LAJA CKASA",-64.94637,-20.19596,87,5,190,277,24,8,153,177
"Bolivia","Chuquisaca","Nor Cinti","San Lucas","UNIDAD EDUCATIVA MURIFAYA",-65.00114,-20.13484,13,3,94,107,9,4,78,87
"Bolivia","Chuquisaca","Nor Cinti","San Lucas","UNIDAD EDUCATIVA OCURI",-65.05057,-20.21683,74,21,392,466,30,7,334,364
"Bolivia","Chuquisaca","Nor Cinti","San Lucas","UNIDAD EDUCATIVA PADCOYO",-65.15222,-20.23535,186,23,665,851,96,17,529,625
"Bolivia","Chuquisaca","Nor Cinti","San Lucas","UNIDAD EDUCATIVA PALACIO TAMBO",-64.9901,-20.21117,278,36,822,1100,181,38,567,748
"Bolivia","Chuquisaca","Nor Cinti","San Lucas","UNIDAD EDUCATIVA PASLA",-64.78234,-19.94768,27,4,151,178,1,0,146,147
"Bolivia","Chuquisaca","Nor Cinti","San Lucas","UNIDAD EDUCATIVA PIRHUANI",-64.6492,-20.16914,111,4,290,401,2,4,280,282
"Bolivia","Chuquisaca","Nor Cinti","San Lucas","UNIDAD EDUCATIVA ROSENDO LA FUENTE",-65.01423,-20.3716,149,17,529,678,92,15,405,497
"Bolivia","Chuquisaca","Nor Cinti","San Lucas","UNIDAD EDUCATIVA SACAVILLQUE CHICO",-64.6198,-20.30524,112,8,204,316,13,11,172,185
"Bolivia","Chuquisaca","Nor Cinti","San Lucas","UNIDAD EDUCATIVA SAN PEDRO DE HUANAYA",-64.69353,-20.28096,16,3,91,107,1,0,87,88
"Bolivia","Chuquisaca","Nor Cinti","San Lucas","UNIDAD EDUCATIVA TAMBILLOS",-65.27066,-20.04161,102,33,284,386,18,4,229,247
"Bolivia","Chuquisaca","Nor Cinti","San Lucas","UNIDAD EDUCATIVA TAMBO CKASA",-64.7476,-20.33026,120,1,223,343,0,1,221,221
"Bolivia","Chuquisaca","Nor Cinti","San Lucas","UNIDAD EDUCATIVA TOROJCHI",-64.9986,-19.99369,32,1,122,154,13,4,104,117
"Bolivia","Chuquisaca","Nor Cinti","San Lucas","UNIDAD EDUCATIVA URUCHINI",-64.98957,-19.87956,53,3,129,182,27,7,92,119
"Bolivia","Chuquisaca","Nor Cinti","Villa Charcas","COLEGIO PADRE LANDINI SIMON BOLIVAR",-64.88494,-20.72522,756,80,2586,3342,773,151,1582,2355
"Bolivia","Chuquisaca","Nor Cinti","Villa Charcas","ESCUELA BOMBOMA",-64.69144,-20.44497,8,1,75,83,7,0,67,74
"Bolivia","Chuquisaca","Nor Cinti","Villa Charcas","ESCUELA CAIZA K",-64.74667,-20.52791,76,8,232,308,8,5,211,219
"Bolivia","Chuquisaca","Nor Cinti","Villa Charcas","ESCUELA LLUJLLAYA",-64.73945,-20.54849,45,20,255,300,12,6,217,229
"Bolivia","Chuquisaca","Nor Cinti","Villa Charcas","ESCUELA SANTA ELENA",-64.77654,-20.58304,86,5,359,445,15,9,330,345
"Bolivia","Chuquisaca","Nor Cinti","Villa Charcas","ESCUELA SUPAS",-64.77631,-20.43394,57,17,314,371,11,4,282,293
"Bolivia","Chuquisaca","Nor Cinti","Villa Charcas","U.E. MOLLINI",-64.71598,-20.45341,17,1,57,74,3,1,52,55
"Bolivia","Chuquisaca","Nor Cinti","Villa Charcas","UNIDAD EDUCATIVA JOSE ANTONIO ZAMPA",-64.85761,-20.66362,78,10,682,760,84,13,575,659
"Bolivia","Chuquisaca","Oropeza","Poroma","COLEGIOMANUEL OVANDO SAN JUAN DE ORCAS",-65.31216,-18.73248,86,10,251,337,37,16,188,225
"Bolivia","Chuquisaca","Oropeza","Poroma","COLEGIO RAFAEL CAMPOS DE LUJE",-65.21857,-18.78213,49,3,186,235,35,5,143,178
"Bolivia","Chuquisaca","Oropeza","Poroma","ESCUELA CENTRAL CHALLCHA",-65.54505,-18.44033,64,2,296,360,89,13,192,281
"Bolivia","Chuquisaca","Oropeza","Poroma","ESCUELA KAYNACAS",-65.404,-18.86573,32,4,171,203,26,3,138,164
"Bolivia","Chuquisaca","Oropeza","Poroma","ESCUELA SAN SALVADOR DE POJPO",-65.32699,-18.79455,75,14,259,334,61,10,174,235
"Bolivia","Chuquisaca","Oropeza","Poroma","POSTA SANITARIA",-65.28516,-18.49988,15,0,23,38,4,1,18,22
"Bolivia","Chuquisaca","Oropeza","Poroma","PUESTO DE SALUD VIRU VIRU",-65.651,-18.38448,21,9,124,145,26,8,81,107
"Bolivia","Chuquisaca","Oropeza","Poroma","SUB ALCALDÍA DE SAPSE",-65.27885,-18.72523,36,7,152,188,43,3,99,142
"Bolivia","Chuquisaca","Oropeza","Poroma","U. EDU. SAN ANDRES DE POROMA",-65.42594,-18.53917,368,25,941,1309,278,51,587,865
"Bolivia","Chuquisaca","Oropeza","Poroma","UNIDAD EDUCATIVA CALIZAYA",-65.33015,-18.48993,11,1,104,115,20,3,80,100
"Bolivia","Chuquisaca","Oropeza","Poroma","UNIDAD EDUCATIVA CHIJMURI",-65.39856,-18.81042,38,8,146,184,34,3,101,135
"Bolivia","Chuquisaca","Oropeza","Poroma","UNIDAD EDUCATIVA COPAVILLQUE",-65.2855,-18.62391,90,3,292,382,48,16,225,273
"Bolivia","Chuquisaca","Oropeza","Poroma","UNIDAD EDUCATIVA CUCURI",-65.30397,-18.84813,34,8,212,246,43,9,152,195
"Bolivia","Chuquisaca","Oropeza","Poroma","UNIDAD EDUCATIVA HUAÑOMA",-65.59436,-18.45855,171,4,351,522,70,38,239,309
"Bolivia","Chuquisaca","Oropeza","Poroma","UNIDAD EDUCATIVA IRU KKOTA",-65.36794,-18.6862,53,11,192,245,42,7,132,174
"Bolivia","Chuquisaca","Oropeza","Poroma","UNIDAD EDUCATIVA LOS ALAMOS",-65.34219,-18.87337,29,12,225,254,53,5,155,208
"Bolivia","Chuquisaca","Oropeza","Poroma","UNIDAD EDUCATIVA PALAJLA",-65.46515,-18.45122,43,3,178,221,19,9,147,166
"Bolivia","Chuquisaca","Oropeza","Poroma","UNIDAD EDUCATIVA  PANGORASI",-65.39965,-18.60243,23,4,105,128,11,2,88,99
"Bolivia","Chuquisaca","Oropeza","Poroma","UNIDAD EDUCATIVA PIOCERA",-65.40269,-18.74838,21,3,111,132,20,2,86,106
"Bolivia","Chuquisaca","Oropeza","Poroma","UNIDAD EDUCATIVA SANABRIA",-65.33897,-18.93845,21,3,185,206,60,3,119,179
"Bolivia","Chuquisaca","Oropeza","Poroma","UNIDAD EDUCATIVA SIJCHA ALTA",-65.30686,-18.92584,13,3,128,141,17,1,107,124
"Bolivia","Chuquisaca","Oropeza","Poroma","UNIDAD EDUCATIVA URUGUAYO",-65.35072,-18.61396,13,2,104,117,10,4,88,98
"Bolivia","Chuquisaca","Oropeza","Poroma","UNIDAD EDUCATIVA YANANI",-65.43656,-18.59779,23,2,191,214,12,2,175,187
"Bolivia","Chuquisaca","Oropeza","Sucre","AASANA",-65.29323,-19.01331,650,58,5298,5948,3156,242,1842,4998
"Bolivia","Chuquisaca","Oropeza","Sucre","CAMPO DEPORTIVO 20 DE OCTUBRE",-65.28734,-19.02233,101,19,955,1056,600,27,309,909
"Bolivia","Chuquisaca","Oropeza","Sucre","CARCEL PUBLICA",-65.26225,-19.05368,52,0,172,224,97,4,71,168
"Bolivia","Chuquisaca","Oropeza","Sucre","COL. BERNARDO MONTEAGUDO",-65.25573,-19.04699,168,8,1134,1302,897,65,164,1061
"Bolivia","Chuquisaca","Oropeza","Sucre","COL. CARDENAL MAURER",-65.26183,-19.05324,275,10,1884,2159,1529,36,309,1838
"Bolivia","Chuquisaca","Oropeza","Sucre","COL. DON BOSCO",-65.26269,-19.04767,232,6,1365,1597,1121,24,214,1335
"Bolivia","Chuquisaca","Oropeza","Sucre","COLEGIO 23 DE MARZO",-65.2681,-19.04329,236,6,1573,1809,1198,48,321,1519
"Bolivia","Chuquisaca","Oropeza","Sucre","COLEGIO 24 DE SEPTIEMBRE - MARAGUA",-65.4332,-19.05204,78,15,275,353,50,20,190,240
"Bolivia","Chuquisaca","Oropeza","Sucre","COLEGIO DOMINGO SABIO",-65.27417,-19.04843,271,24,1829,2100,1228,74,503,1731
"Bolivia","Chuquisaca","Oropeza","Sucre","COLEGIO FE Y ALEGRIA",-65.26789,-19.03673,534,25,3944,4478,2832,132,955,3787
"Bolivia","Chuquisaca","Oropeza","Sucre","COLEGIO JUEZ BALTAZAR GARZÓN",-65.21569,-19.0804,34,11,492,526,218,26,237,455
"Bolivia","Chuquisaca","Oropeza","Sucre","COLEGIO JUNIN",-65.25817,-19.04907,226,6,1139,1365,943,22,168,1111
"Bolivia","Chuquisaca","Oropeza","Sucre","COLEGIO SIMÓN RODRÍGUEZ",-65.25462,-19.05121,332,4,1292,1624,1051,47,190,1241
"Bolivia","Chuquisaca","Oropeza","Sucre","COL. EMILIO HOSCHMAN",-65.26781,-19.01751,606,76,4854,5460,2608,289,1881,4489
"Bolivia","Chuquisaca","Oropeza","Sucre","COLISEO JORGE REVILLA ALDANA",-65.25701,-19.03738,189,9,1172,1361,921,26,216,1137
"Bolivia","Chuquisaca","Oropeza","Sucre","COL.JORGE REVILLA",-65.25858,-19.02505,714,44,5101,5815,3476,197,1384,4860
"Bolivia","Chuquisaca","Oropeza","Sucre","COL.MARIANO SERRANO",-65.25015,-19.04412,480,17,3392,3872,2667,67,641,3308
"Bolivia","Chuquisaca","Oropeza","Sucre","COL. SAGRADO CORAZON",-65.26104,-19.04679,218,4,1015,1233,849,19,143,992
"Bolivia","Chuquisaca","Oropeza","Sucre","COL. VICTORINO VEGA",-65.23779,-19.04786,623,40,4119,4742,2706,153,1220,3926
"Bolivia","Chuquisaca","Oropeza","Sucre","ESC. ANGEL BASPINEIRO",-65.31149,-19.00419,100,34,985,1085,397,68,486,883
"Bolivia","Chuquisaca","Oropeza","Sucre","ESC. ANICETO ARCE",-65.27341,-19.06394,778,39,4055,4833,2485,209,1322,3807
"Bolivia","Chuquisaca","Oropeza","Sucre","ESC. BENJAMIN GUZMAN",-65.25764,-19.03901,181,8,1433,1614,1102,37,286,1388
"Bolivia","Chuquisaca","Oropeza","Sucre","ESC. GUIDO VILLAGOMEZ",-65.28304,-19.02838,465,42,3786,4251,2348,177,1219,3567
"Bolivia","Chuquisaca","Oropeza","Sucre","ESC. HORNO KHASA",-65.25737,-19.01756,528,52,3914,4442,2197,200,1465,3662
"Bolivia","Chuquisaca","Oropeza","Sucre","ESC. JOSEFINA GOYTIA",-65.26051,-19.05899,177,14,1511,1688,1069,37,391,1460
"Bolivia","Chuquisaca","Oropeza","Sucre","ESC. LA RECOLETA",-65.25409,-19.05475,484,24,3405,3889,2508,126,747,3255
"Bolivia","Chuquisaca","Oropeza","Sucre","ESC.MARISCAL DE AYACUCHO",-65.25534,-19.0489,89,1,583,672,507,9,66,573
"Bolivia","Chuquisaca","Oropeza","Sucre","ESC. OVANDO",-65.2598,-19.0377,111,1,728,839,564,18,145,709
"Bolivia","Chuquisaca","Oropeza","Sucre","ESC. ROBERTO ALVARADO",-65.24728,-19.03056,630,31,4423,5053,2964,155,1273,4237
"Bolivia","Chuquisaca","Oropeza","Sucre","ESC.SAGRADA FAMILIA",-65.24627,-19.0241,671,41,4774,5445,3109,251,1373,4482
"Bolivia","Chuquisaca","Oropeza","Sucre","ESC. SAN JAVIER",-65.24428,-19.04221,353,10,3014,3367,2448,64,492,2940
"Bolivia","Chuquisaca","Oropeza","Sucre","ESC. SAN JUANILLO",-65.2558,-19.0316,1119,50,7280,8399,5102,255,1873,6975
"Bolivia","Chuquisaca","Oropeza","Sucre","ESC.TALLER DE INTEGRACION ETI",-65.23871,-19.04204,132,8,1257,1389,1001,31,217,1218
"Bolivia","Chuquisaca","Oropeza","Sucre","ESCUELA ARABATE",-65.15241,-19.07256,67,2,92,159,16,3,71,87
"Bolivia","Chuquisaca","Oropeza","Sucre","ESCUELA DANIEL CALVO",-65.26105,-19.04571,93,2,653,746,540,15,96,636
"Bolivia","Chuquisaca","Oropeza","Sucre","ESCUELA ELIZARDO PEREZ",-65.20616,-19.1318,35,5,255,290,92,15,143,235
"Bolivia","Chuquisaca","Oropeza","Sucre","ESCUELA FALAFAYA",-65.2095,-18.94874,43,6,191,234,85,18,82,167
"Bolivia","Chuquisaca","Oropeza","Sucre","ESCUELA FRAY GABRIEL MARIA LANDINI",-65.12765,-18.77743,119,39,608,727,185,26,358,543
"Bolivia","Chuquisaca","Oropeza","Sucre","ESCUELA FRAY GABRIEL MARISCAL",-65.1773,-18.63784,47,5,192,239,37,12,138,175
"Bolivia","Chuquisaca","Oropeza","Sucre","ESCUELA JOSÉ SAMPA",-65.17965,-18.89784,37,4,210,247,83,9,114,197
"Bolivia","Chuquisaca","Oropeza","Sucre","ESCUELA LLINFI",-65.30132,-18.98218,50,18,429,479,193,9,209,402
"Bolivia","Chuquisaca","Oropeza","Sucre","ESCUELA PUNILLA",-65.37293,-18.95657,32,6,235,267,110,12,107,217
"Bolivia","Chuquisaca","Oropeza","Sucre","ESCUELA SECCIONAL DE CHAUNACA",-65.43951,-18.99047,43,1,294,337,46,10,237,283
"Bolivia","Chuquisaca","Oropeza","Sucre","ESCUELA TUCSUPAYA",-65.27917,-19.0231,355,33,2798,3153,1781,144,840,2621
"Bolivia","Chuquisaca","Oropeza","Sucre","ESTACIÓN DE BOMBEROS",-65.2486,-19.04844,242,4,1870,2112,1433,38,395,1828
"Bolivia","Chuquisaca","Oropeza","Sucre","ESTADIUM PATRIA",-65.25877,-19.03283,550,20,3385,3935,2507,115,743,3250
"Bolivia","Chuquisaca","Oropeza","Sucre","FAC. DERECHO",-65.24686,-19.04547,351,3,2494,2845,1981,40,470,2451
"Bolivia","Chuquisaca","Oropeza","Sucre","FACULTAD DE MEDICINA",-65.26635,-19.04619,867,20,3949,4816,3035,109,785,3820
"Bolivia","Chuquisaca","Oropeza","Sucre","FACULTAD DE TECNOLOGÍA",-65.25661,-19.03967,728,22,3834,4562,2905,76,831,3736
"Bolivia","Chuquisaca","Oropeza","Sucre","FED. DE CHOFERES",-65.24286,-19.03716,419,22,3382,3801,2495,79,786,3281
"Bolivia","Chuquisaca","Oropeza","Sucre","FUNDACION PACHAMAMA",-65.26746,-19.04067,136,9,1120,1256,849,21,241,1090
"Bolivia","Chuquisaca","Oropeza","Sucre","H. VIRGEN DE LA HIEDRA",-65.27728,-19.03624,166,18,1533,1699,1025,60,430,1455
"Bolivia","Chuquisaca","Oropeza","Sucre","IGLESIA SAN MATÍAS",-65.26208,-19.03669,388,22,2753,3141,2097,64,570,2667
"Bolivia","Chuquisaca","Oropeza","Sucre","IPTK-N.AGUIRRE 560 / CERPI",-65.25272,-19.03685,341,10,2395,2736,1845,58,482,2327
"Bolivia","Chuquisaca","Oropeza","Sucre","JARDÍN DE NIÑOS SAN LÁZARO",-65.24966,-19.05094,248,15,1764,2012,1325,37,387,1712
"Bolivia","Chuquisaca","Oropeza","Sucre","KINDER ECHEVERRIA",-65.25982,-19.05163,144,0,925,1069,793,21,111,904
"Bolivia","Chuquisaca","Oropeza","Sucre","KINDER GERARDO VACA GUZMAN",-65.26248,-19.04274,84,3,501,585,396,11,91,487
"Bolivia","Chuquisaca","Oropeza","Sucre","KINDER MUNICIPAL",-65.26814,-19.05075,223,9,1704,1927,1313,42,340,1653
"Bolivia","Chuquisaca","Oropeza","Sucre","KINDER SAN VICENTE DE PAUL",-65.25596,-19.04462,265,7,1731,1996,1413,23,288,1701
"Bolivia","Chuquisaca","Oropeza","Sucre","KINDER SERRANO",-65.24963,-19.04423,98,2,640,738,491,15,132,623
"Bolivia","Chuquisaca","Oropeza","Sucre","LICEO MARÍA JOSEFA MUJIA",-65.26344,-19.04962,276,6,1720,1996,1367,48,299,1666
"Bolivia","Chuquisaca","Oropeza","Sucre","MERCADO YURAC YURAC",-65.27402,-19.02921,184,17,1677,1861,1092,89,479,1571
"Bolivia","Chuquisaca","Oropeza","Sucre","PLAZUELA SAN MATÍAS",-65.26157,-19.03634,271,14,1758,2029,1332,41,371,1703
"Bolivia","Chuquisaca","Oropeza","Sucre","SAL. MULT. BARRIO NUEVOS HORIZONTES",-65.24062,-19.07006,81,6,728,809,436,42,244,680
"Bolivia","Chuquisaca","Oropeza","Sucre","SAL.MULT. PLANTA DIESEL",-65.27349,-19.05489,194,3,1343,1537,1029,32,279,1308
"Bolivia","Chuquisaca","Oropeza","Sucre","SALON MULT. ALTO LOYOLA",-65.25202,-19.02552,224,24,1415,1639,905,56,430,1335
"Bolivia","Chuquisaca","Oropeza","Sucre","SALON MULTIFUNCIONAL AMERICA",-65.26705,-19.0604,176,21,1204,1380,737,47,399,1136
"Bolivia","Chuquisaca","Oropeza","Sucre","SALON MULTIFUNCIONAL EL ABRA",-65.24494,-19.06586,331,25,2380,2711,1506,98,751,2257
"Bolivia","Chuquisaca","Oropeza","Sucre","SALON MULTIFUNCIONAL EL NIÑO",-65.28127,-19.01439,61,4,533,594,395,10,124,519
"Bolivia","Chuquisaca","Oropeza","Sucre","SALON MULTIFUNCIONAL LA HOYADA",-65.26664,-19.05572,130,8,756,886,515,18,215,730
"Bolivia","Chuquisaca","Oropeza","Sucre","SALON MULTIFUNCIONAL PEDRO MEDRANO",-65.23917,-19.02556,19,2,319,338,189,10,118,307
"Bolivia","Chuquisaca","Oropeza","Sucre","SALON MULTIFUNCIONAL SAN FRANCISCO",-65.25436,-19.05559,113,5,1082,1195,826,28,223,1049
"Bolivia","Chuquisaca","Oropeza","Sucre","SALÓN MULTIFUNCIONAL SAN JUAN CACHIMAYU",-65.30952,-19.08966,7,2,132,139,62,3,65,127
"Bolivia","Chuquisaca","Oropeza","Sucre","SEMINARIO TEOLOGICO DEL SUR",-65.25397,-19.03208,322,16,2383,2705,1665,91,611,2276
"Bolivia","Chuquisaca","Oropeza","Sucre","TERMINAL DE BUSES",-65.24707,-19.0392,569,21,3822,4391,2986,73,742,3728
"Bolivia","Chuquisaca","Oropeza","Sucre","U.ED.FRANCISCO CERMEÑO",-65.25917,-19.02858,293,13,2239,2532,1692,49,485,2177
"Bolivia","Chuquisaca","Oropeza","Sucre","U. EDU. GUALBERTO VILLARROEL",-65.53341,-19.0159,157,24,846,1003,235,58,529,764
"Bolivia","Chuquisaca","Oropeza","Sucre","U.E. GASTÓN VILAR CASSO",-65.28537,-19.01114,35,8,639,674,370,38,223,593
"Bolivia","Chuquisaca","Oropeza","Sucre","U.E. LAS AMERICAS",-65.25094,-19.01372,664,53,4428,5092,2729,209,1437,4166
"Bolivia","Chuquisaca","Oropeza","Sucre","UNIDAD EDUCATIVA 6 DE JUNIO",-65.26705,-19.02696,635,59,4275,4910,2651,193,1372,4023
"Bolivia","Chuquisaca","Oropeza","Sucre","UNIDAD EDUCATIVA ALBERTO BOHORQUEZ",-65.29878,-19.02849,97,38,987,1084,397,72,480,877
"Bolivia","Chuquisaca","Oropeza","Sucre","UNIDAD EDUCATIVA ALEGRÍA",-65.27406,-18.99063,182,36,1414,1596,604,79,695,1299
"Bolivia","Chuquisaca","Oropeza","Sucre","UNIDAD EDUCATIVA CANTU MOLINO",-65.23275,-18.86053,30,3,154,184,36,5,110,146
"Bolivia","Chuquisaca","Oropeza","Sucre","UNIDAD EDUCATIVA CHUQUI CHUQUI",-65.1201,-18.82506,77,30,472,549,149,21,272,421
"Bolivia","Chuquisaca","Oropeza","Sucre","UNIDAD EDUCATIVA LA BARRANCA",-65.31851,-18.97461,40,12,451,491,189,24,226,415
"Bolivia","Chuquisaca","Oropeza","Sucre","UNIDAD EDUCATIVA LA PALMA",-65.12672,-18.95262,105,31,554,659,166,20,337,503
"Bolivia","Chuquisaca","Oropeza","Sucre","UNIDAD EDUCATIVA LUIS ESPINAL",-65.11092,-18.89592,58,8,457,515,184,15,250,434
"Bolivia","Chuquisaca","Oropeza","Sucre","UNIDAD EDUCATIVA QUILA QUILA",-65.377,-19.11972,126,20,454,580,183,38,213,396
"Bolivia","Chuquisaca","Oropeza","Sucre","UNIDAD EDUCATIVA RUFFO",-65.2886,-19.05783,61,17,648,709,311,33,287,598
"Bolivia","Chuquisaca","Oropeza","Sucre","UNIDAD EDUCATIVA SIMÓN BOLIVAR LA PALCA",-65.24233,-18.62139,27,1,95,122,21,3,70,91
"Bolivia","Chuquisaca","Oropeza","Sucre","UNIDAD EDUCATIVA SOICO",-65.26456,-18.81216,39,5,103,142,15,4,79,94
"Bolivia","Chuquisaca","Oropeza","Sucre","UNID. ED. HUGO POPPE ENTRAMBASAGUAS",-65.23246,-19.05145,390,39,2913,3303,1971,127,776,2747
"Bolivia","Chuquisaca","Oropeza","Sucre","UNID. ED. JOSE CLEMENTE MAURER",-65.23655,-19.08533,400,62,3216,3616,1716,122,1316,3032
"Bolivia","Chuquisaca","Oropeza","Sucre","UNID.EDUCATIVA VICTORIA DIEZ",-65.30588,-19.00942,689,137,5227,5916,2478,333,2279,4757
"Bolivia","Chuquisaca","Oropeza","Sucre","U.PEDAG.MARISCAL SUCRE",-65.26093,-19.03903,155,4,920,1075,743,21,152,895
"Bolivia","Chuquisaca","Oropeza","Yotala","CASA POSADA DE HUAYLLAS",-65.32174,-19.15824,63,6,188,251,34,8,140,174
"Bolivia","Chuquisaca","Oropeza","Yotala","CENTRO EDUCATIVO SANTA ROSA",-65.26758,-19.16187,184,8,887,1071,420,55,404,824
"Bolivia","Chuquisaca","Oropeza","Yotala","COLEGIO GREGORIO PACHECO",-65.26525,-19.16197,192,25,1040,1232,415,30,570,985
"Bolivia","Chuquisaca","Oropeza","Yotala","COLEGIO SAN ISIDRO DE ANFAYA",-65.21962,-19.25604,46,5,317,363,44,11,257,301
"Bolivia","Chuquisaca","Oropeza","Yotala","COLEGIO TASA PAMPA",-65.25967,-19.30862,22,2,200,222,11,4,183,194
"Bolivia","Chuquisaca","Oropeza","Yotala","ESCUELA ANTONIO TOVAR HINOJOSA",-65.17021,-19.30317,31,4,224,255,60,7,153,213
"Bolivia","Chuquisaca","Oropeza","Yotala","ESCUELA TIPAKA",-65.3103,-19.26145,18,0,133,151,25,6,102,127
"Bolivia","Chuquisaca","Oropeza","Yotala","POSTA DE SALUD Y SALÓN DE LA COMUNIDAD",-65.1908,-19.24057,17,0,132,149,14,3,115,129
"Bolivia","Chuquisaca","Oropeza","Yotala","UNIDAD EDUCATIVA CAMPANARIO",-65.26763,-19.10636,13,2,151,164,73,7,69,142
"Bolivia","Chuquisaca","Oropeza","Yotala","UNIDAD EDUCATIVA GERMAN BUSCH",-65.28329,-19.20276,37,3,188,225,71,5,109,180
"Bolivia","Chuquisaca","Oropeza","Yotala","UNIDAD EDUCATIVA JOSÉ VILLEGAS",-65.29339,-19.1495,16,0,135,151,29,4,102,131
"Bolivia","Chuquisaca","Oropeza","Yotala","UNIDAD EDUCATIVA TUERO CHICO",-65.21132,-19.33957,11,1,96,107,17,1,77,94
"Bolivia","Chuquisaca","Oropeza","Yotala","UNIDAD EDUCATIVA VICTOR SANDI",-65.24226,-19.15815,48,3,348,396,129,18,198,327
"Bolivia","Chuquisaca","Sur Cinti","Camataqui (Villa Abecia)","U. EDU. DANIEL SANCHEZ BUSTAMANTE",-65.2789,-21.0675,17,0,86,103,29,11,46,75
"Bolivia","Chuquisaca","Sur Cinti","Camataqui (Villa Abecia)","UNIDAD EDUCATIVA 23 DE MARZO",-65.23078,-20.97539,222,23,810,1032,282,49,456,738
"Bolivia","Chuquisaca","Sur Cinti","Camataqui (Villa Abecia)","UNIDAD EDUCATIVA 2 DE AGOSTO",-65.36425,-21.02694,24,4,116,140,6,0,106,112
"Bolivia","Chuquisaca","Sur Cinti","Camataqui (Villa Abecia)","UNIDAD EDUCATIVA ACHUMA",-65.3415,-20.9139,6,2,89,95,8,6,73,81
"Bolivia","Chuquisaca","Sur Cinti","Camataqui (Villa Abecia)","UNIDAD EDUCATIVA JAILIA",-65.27052,-20.93037,16,5,120,136,33,10,72,105
"Bolivia","Chuquisaca","Sur Cinti","Camataqui (Villa Abecia)","UNIDAD EDUCATIVA TARCANA",-65.26554,-21.0909,15,0,47,62,10,3,34,44
"Bolivia","Chuquisaca","Sur Cinti","Culpina","ESCUELA CAÑON VERDE",-64.23112,-21.13576,12,0,72,84,47,2,23,70
"Bolivia","Chuquisaca","Sur Cinti","Culpina","ESCUELA EL MANZANAL",-64.4059,-21.0985,45,1,59,104,7,0,51,58
"Bolivia","Chuquisaca","Sur Cinti","Culpina","U. EDU. JOSE ANTONIO ZAMPA",-64.94446,-20.8238,768,89,2870,3638,1084,121,1576,2660
"Bolivia","Chuquisaca","Sur Cinti","Culpina","UNIDAD EDUCATIVA EL CAMPAMENTO",-64.51948,-20.90218,45,2,132,177,29,2,99,128
"Bolivia","Chuquisaca","Sur Cinti","Culpina","UNIDAD EDUCATIVA EL MONTE",-64.91585,-21.00441,59,8,291,350,75,29,179,254
"Bolivia","Chuquisaca","Sur Cinti","Culpina","UNIDAD EDUCATIVA EL PALMAR",-64.31755,-20.85209,100,14,435,535,212,35,174,386
"Bolivia","Chuquisaca","Sur Cinti","Culpina","UNIDAD EDUCATIVA HUAJLITA",-64.60419,-20.82584,45,1,141,186,14,7,119,133
"Bolivia","Chuquisaca","Sur Cinti","Culpina","UNIDAD EDUCATIVA LA CIENEGA",-64.96812,-20.9327,15,1,59,74,24,5,29,53
"Bolivia","Chuquisaca","Sur Cinti","Culpina","UNIDAD EDUCATIVA LA CUEVA",-64.88244,-20.9315,45,3,158,203,21,6,128,149
"Bolivia","Chuquisaca","Sur Cinti","Culpina","UNIDAD EDUCATIVA LA LOMA",-64.72974,-20.85919,72,4,107,179,0,7,96,96
"Bolivia","Chuquisaca","Sur Cinti","Culpina","UNIDAD EDUCATIVA PILAYA",-64.689,-20.94015,36,7,57,93,14,2,34,48
"Bolivia","Chuquisaca","Sur Cinti","Culpina","UNIDAD EDUCATIVA PUCA LAJA",-64.64645,-20.77685,4,0,37,41,4,2,31,35
"Bolivia","Chuquisaca","Sur Cinti","Culpina","UNIDAD EDUCATIVA PUCA PAMPA",-64.5965,-20.77545,74,3,238,312,35,25,175,210
"Bolivia","Chuquisaca","Sur Cinti","Culpina","UNIDAD EDUCATIVA PUMA CKASA",-64.6648,-20.74907,64,1,87,151,12,6,68,80
"Bolivia","Chuquisaca","Sur Cinti","Culpina","UNIDAD EDUCATIVA SAJLINA",-64.99879,-20.80951,113,18,456,569,132,47,259,391
"Bolivia","Chuquisaca","Sur Cinti","Culpina","UNIDAD EDUCATIVA SALITRE",-64.90742,-20.90935,19,4,82,101,14,1,63,77
"Bolivia","Chuquisaca","Sur Cinti","Culpina","UNIDAD EDUCATIVA SAN FRANCISCO",-64.7111,-20.75573,54,7,78,132,16,4,51,67
"Bolivia","Chuquisaca","Sur Cinti","Culpina","UNIDAD EDUCATIVA SUMAYA",-64.78716,-20.75736,63,5,96,159,25,7,59,84
"Bolivia","Chuquisaca","Sur Cinti","Culpina","UNIDAD EDUCATIVA TOJLASA",-64.91499,-20.85254,91,12,367,458,103,31,221,324
"Bolivia","Chuquisaca","Sur Cinti","Las Carreras (Las carretas)","ESCUELA EL MONTE DE SANDOVAL",-65.21051,-21.16683,31,3,124,155,12,5,104,116
"Bolivia","Chuquisaca","Sur Cinti","Las Carreras (Las carretas)","ESCUELA MONTE DE TARAYA",-65.35029,-21.47675,8,0,24,32,0,0,24,24
"Bolivia","Chuquisaca","Sur Cinti","Las Carreras (Las carretas)","ESCUELA SOCPORA",-65.23065,-21.35275,3,2,47,50,16,3,26,42
"Bolivia","Chuquisaca","Sur Cinti","Las Carreras (Las carretas)","UNIDAD EDUCATIVA IMPORA",-65.27929,-21.36126,20,2,99,119,21,3,73,94
"Bolivia","Chuquisaca","Sur Cinti","Las Carreras (Las carretas)","UNIDAD EDUCATIVA JAIME MENDOZA",-65.21003,-21.2103,96,6,441,537,144,23,268,412
"Bolivia","Chuquisaca","Sur Cinti","Las Carreras (Las carretas)","UNIDAD EDUCATIVA LA TORRE",-65.2924,-21.2021,25,3,104,129,18,2,81,99
"Bolivia","Chuquisaca","Sur Cinti","Las Carreras (Las carretas)","UNIDAD EDUCATIVA LIME",-65.2624,-21.2043,42,1,160,202,18,3,138,156
"Bolivia","Chuquisaca","Sur Cinti","Las Carreras (Las carretas)","UNIDAD EDUCATIVA SAN JUAN",-65.21146,-21.21964,16,6,132,148,39,6,81,120
"Bolivia","Chuquisaca","Sur Cinti","Las Carreras (Las carretas)","UNIDAD EDUCATIVA SANTA ROSA",-65.22454,-21.32046,13,1,75,88,18,4,52,70
"Bolivia","Chuquisaca","Sur Cinti","Las Carreras (Las carretas)","UNIDAD EDUCATIVA TARAYA",-65.24155,-21.42857,8,0,95,103,32,5,58,90
"Bolivia","Chuquisaca","Tomina","El Villar","COLEGIO EDUARDO ABAROA",-64.31137,-19.6299,199,24,734,933,203,34,473,676
"Bolivia","Chuquisaca","Tomina","El Villar","ESCUELA SECCIONAL LA REVUELTA",-64.19889,-19.82226,65,8,435,500,106,19,302,408
"Bolivia","Chuquisaca","Tomina","El Villar","U.E. BARBECHOS",-64.29641,-19.5529,6,3,100,106,19,0,78,97
"Bolivia","Chuquisaca","Tomina","El Villar","UNIDAD EDUCATIVA EL DORADO",-64.3289,-19.79042,35,8,220,255,16,8,188,204
"Bolivia","Chuquisaca","Tomina","El Villar","UNIDAD EDUCATIVA SAN BLAS",-64.39065,-19.63341,38,0,135,173,7,5,123,130
"Bolivia","Chuquisaca","Tomina","Padilla","COLEGIO SAN PIO X",-64.3012,-19.30634,275,29,1520,1795,571,43,877,1448
"Bolivia","Chuquisaca","Tomina","Padilla","ESCUELA MANUEL A. PADILLA",-64.30116,-19.30746,292,35,1627,1919,606,59,927,1533
"Bolivia","Chuquisaca","Tomina","Padilla","NUCLEO ESCOLAR ADRIÁN MOYA TAPIA",-64.14172,-19.33275,103,2,235,338,47,4,182,229
"Bolivia","Chuquisaca","Tomina","Padilla","NUCLEO ESCOLAR HUMBERTO DELGADILLO",-64.1024,-19.56468,66,12,385,451,68,25,280,348
"Bolivia","Chuquisaca","Tomina","Padilla","U.E. CACIANO RODAS CARDENAS",-64.0046,-19.2876,19,0,90,109,15,2,73,88
"Bolivia","Chuquisaca","Tomina","Padilla","U.E. FRANZ TAMAYO",-64.23646,-19.50273,17,0,70,87,4,2,64,68
"Bolivia","Chuquisaca","Tomina","Padilla","U.E. MARISCAL SUCRE",-64.2164,-19.37816,15,1,75,90,18,7,49,67
"Bolivia","Chuquisaca","Tomina","Padilla","UNIDAD EDUCATIVA 29 DE MARZO",-64.21652,-19.24916,10,1,39,49,7,3,28,35
"Bolivia","Chuquisaca","Tomina","Padilla","UNIDAD EDUCATIVA 2 DE ABRIL LA CIENEGA",-64.29996,-19.21987,51,5,233,284,29,12,187,216
"Bolivia","Chuquisaca","Tomina","Padilla","UNIDAD EDUCATIVA SUSANA DURAN",-64.00618,-19.42285,16,4,85,101,17,3,61,78
"Bolivia","Chuquisaca","Tomina","Padilla","UNIDAD EDUCATIVA TELEMINA BARJA",-64.175,-19.4771,51,8,206,257,29,8,161,190
"Bolivia","Chuquisaca","Tomina","Sopachuy","COLEGIO 25 DE MAYO",-64.47521,-19.48693,125,12,529,654,169,20,328,497
"Bolivia","Chuquisaca","Tomina","Sopachuy","ESCUELA JUAN BOSING",-64.47478,-19.48648,155,18,740,895,228,44,450,678
"Bolivia","Chuquisaca","Tomina","Sopachuy","ESCUELA SIPICANI",-64.57142,-19.43305,28,1,230,258,13,3,213,226
"Bolivia","Chuquisaca","Tomina","Sopachuy","INTERNADO SANTA ROSA DE AMANCAYA",-64.55762,-19.32515,88,6,451,539,25,7,413,438
"Bolivia","Chuquisaca","Tomina","Sopachuy","U.E. PAMPAS PUNTA",-64.4611,-19.41523,9,0,143,152,23,6,114,137
"Bolivia","Chuquisaca","Tomina","Sopachuy","U.E. PASLAPAYA",-64.51927,-19.42884,3,1,109,112,2,5,101,103
"Bolivia","Chuquisaca","Tomina","Sopachuy","U.E. SAN JUAN DE HORCAS",-64.51885,-19.46673,8,1,123,131,5,3,114,119
"Bolivia","Chuquisaca","Tomina","Sopachuy","UNIDAD EDUCATIVA MAMA HUASI",-64.62706,-19.33403,2,0,176,178,1,1,174,175
"Bolivia","Chuquisaca","Tomina","Sopachuy","UNIDAD EDUCATIVA PAMPAS DEL CARMEN",-64.4129,-19.54599,30,1,108,138,7,3,97,104
"Bolivia","Chuquisaca","Tomina","Sopachuy","UNIDAD EDUCATIVA SECCIONAL MILANES",-64.47321,-19.5312,9,0,70,79,9,3,58,67
"Bolivia","Chuquisaca","Tomina","Tomina","ESCUELA LORENZO CATALA",-64.58754,-19.05812,36,4,288,324,35,13,236,271
"Bolivia","Chuquisaca","Tomina","Tomina","ESCUELA SIMÓN RODRIGUEZ",-64.47535,-19.35414,110,10,526,636,98,36,382,480
"Bolivia","Chuquisaca","Tomina","Tomina","U.E. ANTOFAGASTA",-64.44697,-19.25202,12,10,272,284,42,15,205,247
"Bolivia","Chuquisaca","Tomina","Tomina","U. E. SECCIONAL FAUSTINO SUAREZ",-64.56383,-19.18622,73,1,256,329,11,6,238,249
"Bolivia","Chuquisaca","Tomina","Tomina","UNIDAD EDUCATIVA EDUARDO AVAROA",-64.46201,-19.18713,294,35,1314,1608,393,58,828,1221
"Bolivia","Chuquisaca","Tomina","Tomina","UNIDAD EDUCATIVA KAWASIRI",-64.41315,-19.14396,12,2,74,86,11,3,58,69
"Bolivia","Chuquisaca","Tomina","Tomina","UNIDAD EDUCATIVA SECCIONAL FUERTE RUA",-64.49466,-19.24193,26,1,211,237,3,5,202,205
"Bolivia","Chuquisaca","Tomina","Tomina","UNIDAD EDUCATIVA VILLA FLORES",-64.55251,-19.30332,9,1,101,110,11,3,86,97
"Bolivia","Chuquisaca","Tomina","Tomina","UNIDA EDUCATIVA PUCARA",-64.5126,-19.05801,14,3,149,163,24,5,117,141
"Bolivia","Chuquisaca","Tomina","Villa Alcalá","ESCUELA OSCAR ALFARO",-64.33492,-19.5059,208,3,309,517,47,16,243,290
"Bolivia","Chuquisaca","Tomina","Villa Alcalá","UNIDAD EDUCATIVA ALCALA",-64.38977,-19.36522,167,22,880,1047,283,35,540,823
"Bolivia","Chuquisaca","Yamparaez","Tarabuco","COLEGIO ANICETO ARCE",-64.91212,-19.18131,337,49,1413,1750,469,95,800,1269
"Bolivia","Chuquisaca","Yamparaez","Tarabuco","COLEGIO NACIONAL MIXTO BOLIVIA",-64.90345,-19.06883,129,8,490,619,167,25,290,457
"Bolivia","Chuquisaca","Yamparaez","Tarabuco","COLEGIO PAMPA LUPIARA",-64.78364,-19.25895,131,10,523,654,170,14,329,499
"Bolivia","Chuquisaca","Yamparaez","Tarabuco","ESCUELA ALFREDO MARTINEZ RODAS",-64.86771,-19.02727,25,2,207,232,26,7,172,198
"Bolivia","Chuquisaca","Yamparaez","Tarabuco","ESCUELA COLLACAMANI",-64.90224,-19.25274,85,8,217,302,43,6,160,203
"Bolivia","Chuquisaca","Yamparaez","Tarabuco","ESCUELA GUSTAVO VALDIVIA DE PAJCHA",-65.03048,-18.97762,113,11,380,493,73,14,282,355
"Bolivia","Chuquisaca","Yamparaez","Tarabuco","ESCUELA TUNAS CHILLCA",-64.95135,-19.17794,42,4,164,206,9,3,148,157
"Bolivia","Chuquisaca","Yamparaez","Tarabuco","U. ED. SAN ANTONIO DE TOCA",-64.93372,-19.00779,9,1,119,128,23,5,90,113
"Bolivia","Chuquisaca","Yamparaez","Tarabuco","U. EDU. JAIME VILLA ZAMORA",-64.91453,-19.05788,46,18,312,358,74,8,212,286
"Bolivia","Chuquisaca","Yamparaez","Tarabuco","U. EDU. ROSALIA VDA. DE ANTEZANA",-64.91234,-19.18218,327,57,1488,1815,435,70,926,1361
"Bolivia","Chuquisaca","Yamparaez","Tarabuco","U. EDU. SALVADOR GÓMEZ RODRIGUEZ",-64.76074,-19.27787,46,7,166,212,21,10,128,149
"Bolivia","Chuquisaca","Yamparaez","Tarabuco","U. EDU. SAN JOSÉ DEL PAREDON",-64.83658,-19.25209,80,10,318,398,39,12,257,296
"Bolivia","Chuquisaca","Yamparaez","Tarabuco","UNIDAD EDUCATIVA CAYAMBUCO",-64.86732,-19.09398,22,1,162,184,12,10,139,151
"Bolivia","Chuquisaca","Yamparaez","Tarabuco","UNIDAD EDUCATIVA EL CARMEN",-64.99706,-19.06575,34,2,194,228,14,3,175,189
"Bolivia","Chuquisaca","Yamparaez","Tarabuco","UNIDAD EDUCATIVA LA CIENEGA",-64.99545,-19.15368,112,11,323,435,57,15,240,297
"Bolivia","Chuquisaca","Yamparaez","Tarabuco","UNIDAD EDUCATIVA SARUFAYA",-64.80127,-19.1101,56,10,254,310,32,5,207,239
"Bolivia","Chuquisaca","Yamparaez","Yamparez","COLEGIO ANA LEON DE HUASA CANCHA",-65.04116,-19.17783,72,3,319,391,45,15,256,301
"Bolivia","Chuquisaca","Yamparaez","Yamparez","COLEGIO GERARDO RIOS",-65.07349,-19.25555,77,9,360,437,89,12,250,339
"Bolivia","Chuquisaca","Yamparaez","Yamparez","ESCUELA EDUARDO SEMPERTEGUI",-65.11996,-19.18805,228,38,895,1123,329,58,470,799
"Bolivia","Chuquisaca","Yamparaez","Yamparez","ESCUELA JATUN CKAKA",-65.00366,-19.28829,39,7,213,252,8,4,194,202
"Bolivia","Chuquisaca","Yamparaez","Yamparez","U.E. PATA LLAJTA",-65.07769,-19.11113,4,2,103,107,13,4,84,97
"Bolivia","Chuquisaca","Yamparaez","Yamparez","UNIDAD EDUCATIVA CARAMA",-65.05508,-19.33958,17,1,147,164,10,4,132,142
"Bolivia","Chuquisaca","Yamparaez","Yamparez","UNIDAD EDUCATIVA PULKI AVAROA",-65.12865,-19.24094,124,16,473,597,92,20,345,437
"Bolivia","Chuquisaca","Yamparaez","Yamparez","UNIDAD EDUCATIVA SAJPAYA",-65.12679,-19.15392,21,10,372,393,32,21,309,341
"Bolivia","Chuquisaca","Yamparaez","Yamparez","UNIDAD EDUCATIVA SOTOMAYOR",-64.99535,-19.3425,106,5,620,726,146,21,448,594
"Bolivia","Chuquisaca","Zudáñez","Icla (Ricardo Mujia)","COLEGIO ANTONIO JOSÉ DE SUCRE",-64.79297,-19.36361,153,14,586,739,155,23,394,549
"Bolivia","Chuquisaca","Zudáñez","Icla (Ricardo Mujia)","COLEGIO ELIZARDO PEREZ",-64.78985,-19.29836,93,11,380,473,121,13,235,356
"Bolivia","Chuquisaca","Zudáñez","Icla (Ricardo Mujia)","COLEGIO ROSENDO LA FUENTE",-64.8336,-19.44706,192,0,66,258,10,0,56,66
"Bolivia","Chuquisaca","Zudáñez","Icla (Ricardo Mujia)","ESCUELA CANTAR GALLO",-64.69359,-19.51735,37,3,125,162,20,2,100,120
"Bolivia","Chuquisaca","Zudáñez","Icla (Ricardo Mujia)","ESCUELA JATUN MAYU",-64.72372,-19.40604,27,3,213,240,30,1,179,209
"Bolivia","Chuquisaca","Zudáñez","Icla (Ricardo Mujia)","ESCUELA RODEO",-64.73968,-19.44641,18,0,198,216,10,1,187,197
"Bolivia","Chuquisaca","Zudáñez","Icla (Ricardo Mujia)","ESCUELA SAN JACINTO",-64.7461,-19.32193,31,2,331,362,45,6,278,323
"Bolivia","Chuquisaca","Zudáñez","Icla (Ricardo Mujia)","ESCUELA SANTA LUCIA",-64.72717,-19.56465,27,0,69,96,11,0,58,69
"Bolivia","Chuquisaca","Zudáñez","Icla (Ricardo Mujia)","ESCUELA SUMALA",-64.78291,-19.63519,33,1,93,126,8,1,83,91
"Bolivia","Chuquisaca","Zudáñez","Icla (Ricardo Mujia)","ESCUELA THACO PAMPA",-64.7289,-19.38551,37,2,253,290,19,5,227,246
"Bolivia","Chuquisaca","Zudáñez","Icla (Ricardo Mujia)","U. EDU. SECCIONAL CHUNCA CANCHA BAJA",-64.69682,-19.58073,70,7,299,369,23,10,259,282
"Bolivia","Chuquisaca","Zudáñez","Icla (Ricardo Mujia)","UNIDAD EDUCATIVA SOROMA",-64.82072,-19.50851,18,0,140,158,3,2,135,138
"Bolivia","Chuquisaca","Zudáñez","Presto","ESCUELA ELISARDO PEREZ",-64.94286,-18.77106,85,13,304,389,88,13,190,278
"Bolivia","Chuquisaca","Zudáñez","Presto","ESCUELA JOSÉ MARÍA MARTÍNEZ",-64.87681,-18.74306,220,10,560,780,110,50,390,500
"Bolivia","Chuquisaca","Zudáñez","Presto","PUESTO DE SALUD PUNO KHASA",-64.80189,-18.89501,37,4,146,183,51,7,84,135
"Bolivia","Chuquisaca","Zudáñez","Presto","UNIDAD EDUCATIVA EL PALMAR",-64.9127,-18.6944,10,5,137,147,14,17,101,115
"Bolivia","Chuquisaca","Zudáñez","Presto","UNIDAD EDUCATIVA RICARDO MUJIA",-64.93723,-18.92988,316,35,1108,1424,340,52,681,1021
"Bolivia","Chuquisaca","Zudáñez","Presto","UNIDAD EDUCATIVA TOMOROCO",-64.88657,-18.97326,95,15,351,446,121,15,200,321
"Bolivia","Chuquisaca","Zudáñez","Villa Mojocoya","COLEGIO FRANZ TAMAYO",-64.61874,-18.83001,397,40,1850,2247,610,54,1146,1756
"Bolivia","Chuquisaca","Zudáñez","Villa Mojocoya","ESCUELA GUADALUPE",-64.56116,-18.9363,46,5,238,284,49,5,179,228
"Bolivia","Chuquisaca","Zudáñez","Villa Mojocoya","ESCUELA HILARION VIDES CHOQUE",-64.73502,-18.61781,39,4,237,276,26,2,205,231
"Bolivia","Chuquisaca","Zudáñez","Villa Mojocoya","ESCUELA JAIME MENDOZA",-64.51095,-18.87217,28,2,116,144,25,2,87,112
"Bolivia","Chuquisaca","Zudáñez","Villa Mojocoya","ESCUELA JORGE ANIBARRO ZAPATA",-64.62067,-18.91616,18,4,116,134,21,3,88,109
"Bolivia","Chuquisaca","Zudáñez","Villa Mojocoya","UNIDAD EDUCATIVA EDUARDO AVAROA",-64.61971,-18.76382,59,3,195,254,76,8,108,184
"Bolivia","Chuquisaca","Zudáñez","Villa Zudañez (Tacopaya)","COL. IGNACIO PRUDENCIO BUSTILLOS",-64.70309,-19.11358,254,40,1389,1643,280,46,1023,1303
"Bolivia","Chuquisaca","Zudáñez","Villa Zudañez (Tacopaya)","COL. JAIME DE ZUDAÑEZ",-64.70162,-19.11868,183,21,944,1127,244,41,638,882
"Bolivia","Chuquisaca","Zudáñez","Villa Zudañez (Tacopaya)","ESCUELA MANDINGA",-64.69581,-19.25081,25,4,142,167,11,9,118,129
"Bolivia","Chuquisaca","Zudáñez","Villa Zudañez (Tacopaya)","ESCUELA SAYAN CHACA",-64.63419,-19.24422,41,5,224,265,18,8,193,211
"Bolivia","Chuquisaca","Zudáñez","Villa Zudañez (Tacopaya)","UNIDAD EDUCATIVA CAPILLA LLAVE",-64.70795,-18.98042,36,0,69,105,1,1,67,68
"Bolivia","Chuquisaca","Zudáñez","Villa Zudañez (Tacopaya)","UNIDAD EDUCATIVA HUACA HUASI",-64.78075,-18.98111,14,2,141,155,14,1,124,138
"Bolivia","Cochabamba","Arani","Arani","ESCUELA GUALBERTO VILLARROEL",-65.77542,-17.57345,361,59,2584,2945,907,108,1510,2417
"Bolivia","Cochabamba","Arani","Arani","ESCUELA MIXTA POCOATA",-65.72654,-17.60998,82,16,385,467,86,21,262,348
"Bolivia","Cochabamba","Arani","Arani","LICEO DE SEÑORITAS ARANI",-65.77344,-17.57311,374,52,2410,2784,1009,80,1269,2278
"Bolivia","Cochabamba","Arani","Arani","UNIDAD EDUCATIVA COLLPACIACO",-65.76109,-17.60128,103,18,505,608,116,26,345,461
"Bolivia","Cochabamba","Arani","Vacas","ESCUELA EXPERIMENTAL VACAS",-65.58172,-17.57544,371,73,2590,2961,349,95,2073,2422
"Bolivia","Cochabamba","Arani","Vacas","ESCUELA SECCIONAL RODEO A",-65.63733,-17.6298,111,68,926,1037,90,26,742,832
"Bolivia","Cochabamba","Arani","Vacas","U.E. DAVID MORATO CAÑADAS",-65.64141,-17.53415,30,26,517,547,56,21,414,470
"Bolivia","Cochabamba","Arani","Vacas","UNIDAD EDUCATIVA TOTORAPAMPA",-65.55066,-17.67862,16,5,210,226,14,1,190,204
"Bolivia","Cochabamba","Arque","Arque","ESCUELA E INTERNADO DARIO ANTEZANA V.",-66.29219,-17.94894,98,1,548,646,7,22,518,525
"Bolivia","Cochabamba","Arque","Arque","ESCUELA JUANA AZURDUY - PONGO K'ASA",-66.55169,-17.71174,84,21,375,459,45,25,284,329
"Bolivia","Cochabamba","Arque","Arque","ESCUELA MARCELO QUIROGA SANTA CRUZ",-66.39861,-17.90448,172,11,638,810,65,54,508,573
"Bolivia","Cochabamba","Arque","Arque","ESCUELA NATANIEL AGUIRRE",-66.40426,-17.8204,145,24,746,891,82,32,608,690
"Bolivia","Cochabamba","Arque","Arque","U.E. SAN PEDRO",-66.41895,-17.85651,54,11,193,247,14,3,165,179
"Bolivia","Cochabamba","Arque","Arque","UNIDAD EDUCATIVA CHANGOLLA",-66.46826,-17.77408,26,4,298,324,11,6,277,288
"Bolivia","Cochabamba","Arque","Arque","UNIDAD EDUCATIVA HUAYCHA",-66.32418,-17.89401,24,2,321,345,9,12,298,307
"Bolivia","Cochabamba","Arque","Arque","UNIDAD ESCOLAR TUPAC KATARI - TARUJAYÑA",-66.47985,-17.69246,32,7,445,477,38,13,387,425
"Bolivia","Cochabamba","Arque","Tacopaya","ESCUELA ADOLFO MERCADO",-66.53604,-17.83581,114,22,1030,1144,120,40,848,968
"Bolivia","Cochabamba","Arque","Tacopaya","ESCUELA ELIZARDO PEREZ (TOTORAPAMPA)",-66.61689,-17.88263,66,11,713,779,67,50,585,652
"Bolivia","Cochabamba","Arque","Tacopaya","ESCUELA MARTIN CARDENAS (TUJUTA)",-66.73995,-17.71179,55,3,277,332,25,11,238,263
"Bolivia","Cochabamba","Arque","Tacopaya","ESCUELA SECCIONAL RENE BARRIENTOS",-66.67029,-17.79752,95,15,473,568,61,29,368,429
"Bolivia","Cochabamba","Arque","Tacopaya","ESCUELA VICENTE DONOSO (AGUAS CALIENTES)",-66.6131,-17.82217,35,5,327,362,29,11,282,311
"Bolivia","Cochabamba","Arque","Tacopaya","UNIDAD EDUCATIVA ANICETO ARCE",-66.5975,-17.76939,68,4,290,358,29,21,236,265
"Bolivia","Cochabamba","Arque","Tacopaya","UNIDAD EDUCATIVA AUQUIPAMPA",-66.53737,-17.78284,48,1,523,571,33,17,472,505
"Bolivia","Cochabamba","Arque","Tacopaya","UNIDAD EDUCATIVA MICHAYANI GRANDE",-66.70185,-17.86216,47,0,225,272,12,12,201,213
"Bolivia","Cochabamba","Ayopaya","Ayopaya (Villa de Independencia)","COLEGIO CHAMACOMA",-66.70333,-17.40771,95,6,474,569,67,24,377,444
"Bolivia","Cochabamba","Ayopaya","Ayopaya (Villa de Independencia)","COLEGIO SIMON BOLIVAR FE Y ALEGRIA",-66.81453,-17.38495,230,39,2038,2268,502,89,1408,1910
"Bolivia","Cochabamba","Ayopaya","Ayopaya (Villa de Independencia)","ESCUELA MARIANO BAPTISTA (CALCHANI)",-66.69013,-17.32464,101,19,641,742,33,51,538,571
"Bolivia","Cochabamba","Ayopaya","Ayopaya (Villa de Independencia)","U.E. JOSE MIGUEL LANZA",-66.82125,-17.08193,508,67,2313,2821,498,138,1610,2108
"Bolivia","Cochabamba","Ayopaya","Ayopaya (Villa de Independencia)","UNIDAD EDUCATIVA CHAPISUYO A",-66.62987,-17.35943,100,13,619,719,42,24,540,582
"Bolivia","Cochabamba","Ayopaya","Ayopaya (Villa de Independencia)","UNIDAD EDUCATIVA CHARAHUAYTU",-66.79765,-17.26413,161,45,1018,1179,167,52,754,921
"Bolivia","Cochabamba","Ayopaya","Ayopaya (Villa de Independencia)","UNIDAD EDUCATIVA MACHACA",-66.86737,-17.12325,42,5,225,267,34,9,177,211
"Bolivia","Cochabamba","Ayopaya","Ayopaya (Villa de Independencia)","UNIDAD EDUCATIVA POCANCHE",-66.83318,-16.93553,70,7,399,469,17,24,351,368
"Bolivia","Cochabamba","Ayopaya","Ayopaya (Villa de Independencia)","UNIDAD EDUCATIVA SABINO WALLKU",-66.73064,-17.11669,54,13,393,447,34,14,332,366
"Bolivia","Cochabamba","Ayopaya","Ayopaya (Villa de Independencia)","UNIDAD EDUCATIVA SISI PALERMO",-66.83698,-17.20461,42,5,335,377,34,50,246,280
"Bolivia","Cochabamba","Ayopaya","Ayopaya (Villa de Independencia)","UNIDAD EDUCATIVA TAPAZA",-66.74503,-17.17871,11,3,136,147,15,4,114,129
"Bolivia","Cochabamba","Ayopaya","Ayopaya (Villa de Independencia)","UNIDAD EDUCATIVA VILLA PUCARA",-66.96396,-16.99085,123,27,507,630,74,20,386,460
"Bolivia","Cochabamba","Ayopaya","Cocapata","COLEGIO SECUNDARIO COCAPATA",-66.67577,-16.79244,71,10,258,329,53,19,176,229
"Bolivia","Cochabamba","Ayopaya","Cocapata","ESCUELA 15 DE FEBRERO (EL CHORO)",-66.65108,-16.79413,109,3,605,714,134,23,445,579
"Bolivia","Cochabamba","Ayopaya","Cocapata","ESCUELA CHOQUECAMATA (FALSURI)",-66.63028,-16.83837,27,7,611,638,217,32,355,572
"Bolivia","Cochabamba","Ayopaya","Cocapata","ESCUELA OSCAR ALFARO - VILLA VINTO",-66.46751,-16.84676,189,7,873,1062,170,58,638,808
"Bolivia","Cochabamba","Ayopaya","Cocapata","ESCUELA PEDRO DOMINGO MURILLO -CALIENTES",-66.55274,-17.01225,91,8,471,562,80,30,353,433
"Bolivia","Cochabamba","Ayopaya","Cocapata","ESCUELA SECCIONAL MACHACAYMA",-66.40887,-16.89995,117,6,674,791,112,63,493,605
"Bolivia","Cochabamba","Ayopaya","Cocapata","NUCLEO ESCOLAR PEDRO LAIME CHUSPI",-66.66877,-16.86044,64,0,237,301,47,25,165,212
"Bolivia","Cochabamba","Ayopaya","Cocapata","NUCLEO GERMAN BUSCH (CHILLAVI)",-66.59884,-16.8523,21,5,166,187,31,7,123,154
"Bolivia","Cochabamba","Ayopaya","Cocapata","SEDE SUB - CENTRAL VISCACHAS",-66.45755,-17.10735,26,2,33,59,11,0,20,31
"Bolivia","Cochabamba","Ayopaya","Cocapata","UNIDAD EDUCATIVA CHIARAJE",-66.38669,-17.05231,16,2,225,241,41,18,164,205
"Bolivia","Cochabamba","Ayopaya","Cocapata","UNIDAD EDUCATIVA COLORADO",-66.87921,-15.88327,37,2,197,234,33,4,158,191
"Bolivia","Cochabamba","Ayopaya","Cocapata","UNIDAD EDUCATIVA EL CHORITO",-66.60498,-16.94332,18,3,208,226,58,9,138,196
"Bolivia","Cochabamba","Ayopaya","Cocapata","UNIDAD EDUCATIVA ICARI",-66.3419,-17.02058,52,2,313,365,77,10,224,301
"Bolivia","Cochabamba","Ayopaya","Cocapata","UNIDAD EDUCATIVA MARAVILLAS",-66.71464,-16.60081,67,9,366,433,43,17,297,340
"Bolivia","Cochabamba","Ayopaya","Cocapata","UNIDAD EDUCATIVA TOTORANI",-66.39165,-17.01361,45,2,349,394,38,3,306,344
"Bolivia","Cochabamba","Ayopaya","Cocapata","UNIDAD EDUCATIVA TUNARI (PUCARITA)",-66.73937,-16.93249,98,10,460,558,27,18,405,432
"Bolivia","Cochabamba","Ayopaya","Morochata","COLEGIO RENE BARRIENTOS ORTUÑO -PIUSILLA",-66.49365,-17.23084,91,18,575,666,121,24,412,533
"Bolivia","Cochabamba","Ayopaya","Morochata","ESCUELA 26 DE MAYO - CHAUPISUYO B",-66.55013,-17.30591,84,11,723,807,116,46,550,666
"Bolivia","Cochabamba","Ayopaya","Morochata","ESCUELA GILDARO ANTEZANA ROJAS",-66.60968,-17.18441,130,37,893,1023,88,47,721,809
"Bolivia","Cochabamba","Ayopaya","Morochata","ESCUELA HILARION GRAGEDA - YAYANI",-66.65623,-17.21181,121,30,707,828,118,53,506,624
"Bolivia","Cochabamba","Ayopaya","Morochata","ESCUELA JULIO ESPINOZA CANELAS-PUNACACHI",-66.61133,-17.25125,134,46,714,848,112,59,497,609
"Bolivia","Cochabamba","Ayopaya","Morochata","ESCUELA MARIANO BAPTISTA- MOROCHATA",-66.53392,-17.23173,151,27,1561,1712,177,94,1263,1440
"Bolivia","Cochabamba","Ayopaya","Morochata","UNIDAD EDUCATIVA HUMAMARCA",-66.5562,-17.10199,16,8,235,251,31,14,182,213
"Bolivia","Cochabamba","Ayopaya","Morochata","UNIDAD EDUCATIVA IGLESIANI",-66.50184,-17.31038,17,0,175,192,39,2,134,173
"Bolivia","Cochabamba","Ayopaya","Morochata","UNIDAD EDUCATIVA PUCARANI GRANDE",-66.66244,-17.08579,29,0,118,147,7,3,108,115
"Bolivia","Cochabamba","Bolívar","Bolívar","ESCUELA COYUMA",-66.74062,-18.08522,23,3,86,109,31,7,45,76
"Bolivia","Cochabamba","Bolívar","Bolívar","ESCUELA JORENKO VILLA VERDE",-66.66763,-17.98483,8,5,404,412,79,16,304,383
"Bolivia","Cochabamba","Bolívar","Bolívar","ESCUELA MEJILLONES",-66.68706,-18.08409,92,3,352,444,71,18,260,331
"Bolivia","Cochabamba","Bolívar","Bolívar","ESCUELA SAN JUAN DE LA COMUNA",-66.46785,-17.9682,29,4,137,166,25,9,99,124
"Bolivia","Cochabamba","Bolívar","Bolívar","ESCUELA SIMON BOLIVAR",-66.53779,-17.9682,147,14,641,788,161,35,431,592
"Bolivia","Cochabamba","Bolívar","Bolívar","ESCUELA TANGALIQUE",-66.5484,-18.02263,22,3,224,246,43,9,169,212
"Bolivia","Cochabamba","Bolívar","Bolívar","ESCUELA VILACAYMA",-66.57627,-17.96971,24,14,308,332,76,15,203,279
"Bolivia","Cochabamba","Bolívar","Bolívar","ESCUELA YARVICOYA",-66.51677,-18.01299,65,5,260,325,14,6,235,249
"Bolivia","Cochabamba","Bolívar","Bolívar","NUCLEO ESCOLAR CARPANI",-66.61453,-17.93365,20,3,467,487,68,20,376,444
"Bolivia","Cochabamba","Bolívar","Bolívar","UNIDAD EDUCATIVA CHALLOMA",-66.54604,-17.89978,24,3,185,209,46,13,123,169
"Bolivia","Cochabamba","Bolívar","Bolívar","UNIDAD EDUCATIVA VILAPAMPA",-66.69617,-18.049,4,0,198,202,54,9,135,189
"Bolivia","Cochabamba","Campero","Aiquile","ESCUELA 20 DE DICIEMBRE",-65.17914,-18.20377,436,56,2234,2670,970,111,1097,2067
"Bolivia","Cochabamba","Campero","Aiquile","ESCUELA MANUEL DE UGARTE",-65.18247,-18.20012,405,33,2026,2431,849,62,1082,1931
"Bolivia","Cochabamba","Campero","Aiquile","ESCUELA SIMON RODRIGUEZ",-65.18458,-18.20073,417,54,2337,2754,972,87,1224,2196
"Bolivia","Cochabamba","Campero","Aiquile","NUCLEO EDUCATIVO TIPAJARA",-65.27975,-18.13377,30,6,274,304,45,8,215,260
"Bolivia","Cochabamba","Campero","Aiquile","NUCLEO ESCOLAR EL CERCADO",-65.17767,-18.10226,78,13,326,404,36,8,269,305
"Bolivia","Cochabamba","Campero","Aiquile","NUCLEO ESCOLAR VILLA GRANADO",-65.03775,-18.20921,175,22,907,1082,143,32,710,853
"Bolivia","Cochabamba","Campero","Aiquile","UNIDAD EDUCATIVA CHAQUI MAYU",-65.28205,-18.26553,20,4,158,178,9,4,141,150
"Bolivia","Cochabamba","Campero","Aiquile","UNIDAD EDUCATIVA EJE PAMPA",-65.1711,-18.5389,52,11,284,336,31,17,225,256
"Bolivia","Cochabamba","Campero","Aiquile","UNIDAD EDUCATIVA ESTANZUELA",-64.8748,-18.33058,54,2,228,282,21,4,201,222
"Bolivia","Cochabamba","Campero","Aiquile","UNIDAD EDUCATIVA KEWIÑAL",-65.3177,-18.37376,27,11,188,215,50,15,112,162
"Bolivia","Cochabamba","Campero","Aiquile","UNIDAD EDUCATIVA LAGARPAMPA",-64.98984,-18.45282,71,3,214,285,13,4,194,207
"Bolivia","Cochabamba","Campero","Aiquile","UNIDAD EDUCATIVA LAIME",-65.09598,-18.45015,23,5,175,198,8,9,153,161
"Bolivia","Cochabamba","Campero","Aiquile","UNIDAD EDUCATIVA NOVILLERO",-65.23428,-18.30105,103,11,532,635,130,20,371,501
"Bolivia","Cochabamba","Campero","Aiquile","UNIDAD EDUCATIVA PANAMA",-65.10865,-18.30899,36,3,256,292,44,5,204,248
"Bolivia","Cochabamba","Campero","Aiquile","UNIDAD EDUCATIVA QUIROGA",-65.21684,-18.42329,165,24,849,1014,106,33,686,792
"Bolivia","Cochabamba","Campero","Omereque","ESCUELA CENTRAL PEÑA COLORADA",-64.87029,-18.17198,52,5,342,394,63,13,261,324
"Bolivia","Cochabamba","Campero","Omereque","ESCUELA SECCIONAL CHARI CHARI",-65.01819,-18.02485,12,3,67,79,23,5,36,59
"Bolivia","Cochabamba","Campero","Omereque","ESCUELA SECCIONAL PEREZ",-64.76694,-18.11378,21,2,167,188,32,6,127,159
"Bolivia","Cochabamba","Campero","Omereque","UNIDAD EDUCATIVA HUANACUNI GRANDE",-64.98838,-17.92877,22,2,162,184,22,2,136,158
"Bolivia","Cochabamba","Campero","Omereque","UNIDAD EDUCATIVA OMEREQUE",-64.90799,-18.1062,303,37,1547,1850,467,34,1009,1476
"Bolivia","Cochabamba","Campero","Omereque","UNIDAD EDUCATIVA PERERETA",-64.82058,-18.1318,28,5,178,206,42,9,122,164
"Bolivia","Cochabamba","Campero","Pasorapa","COLEGIO TTE.CNEL. NATANIEL VERDUGUEZ",-64.67598,-18.31635,181,11,748,929,404,26,307,711
"Bolivia","Cochabamba","Campero","Pasorapa","ESCUELA CENTRAL QUINORI",-64.39658,-18.50312,63,1,228,291,35,4,188,223
"Bolivia","Cochabamba","Campero","Pasorapa","SEDE SINDICAL YAJO PAMPA",-64.55951,-18.13656,2,0,37,39,14,0,23,37
"Bolivia","Cochabamba","Campero","Pasorapa","U.E. REDONDO",-64.31445,-18.50069,3,2,69,72,8,4,55,63
"Bolivia","Cochabamba","Campero","Pasorapa","UNIDAD EDUCATIVA PAMPAS",-64.51284,-18.40247,11,0,112,123,21,0,91,112
"Bolivia","Cochabamba","Campero","Pasorapa","UNIDAD EDUCATIVA SEIBAS",-64.57413,-18.49377,36,5,141,177,24,2,110,134
"Bolivia","Cochabamba","Capinota","Capinota","ESCUELA APILLAPAMPA",-66.2554,-17.8624,55,16,662,717,38,24,584,622
"Bolivia","Cochabamba","Capinota","Capinota","ESCUELA CENTRAL MARCAVI",-66.19489,-17.68572,38,14,320,358,20,10,276,296
"Bolivia","Cochabamba","Capinota","Capinota","ESCUELA VICTOR BARRIENTOS",-66.26445,-17.71407,716,109,4531,5247,1681,208,2533,4214
"Bolivia","Cochabamba","Capinota","Capinota","NUCLEO CENTRAL HORNOMA",-66.20175,-17.88647,38,19,363,401,9,8,327,336
"Bolivia","Cochabamba","Capinota","Capinota","UNIDAD EDUCATIVA CUSTODIO AYAVIRI",-66.28507,-17.72167,346,52,2853,3199,1223,93,1485,2708
"Bolivia","Cochabamba","Capinota","Capinota","UNIDAD EDUCATIVA GUSTAVO GARCIA (CHARAMO",-66.29135,-17.61348,91,23,719,810,229,29,438,667
"Bolivia","Cochabamba","Capinota","Capinota","UNIDAD EDUCATIVA JUANA AZURDUY DE PADILLA",-66.26445,-17.71408,103,5,421,524,116,18,282,398
"Bolivia","Cochabamba","Capinota","Capinota","UNIDAD EDUCATIVA TOCOHALLA",-66.13054,-17.86209,20,0,81,101,1,4,76,77
"Bolivia","Cochabamba","Capinota","Capinota","UNIDAD EDUCATIVA YATAMOCO",-66.27116,-17.73293,40,5,475,515,122,13,335,457
"Bolivia","Cochabamba","Capinota","Santivañez","DOMICILIO PARTICULAR",-66.26903,-17.55104,24,4,189,213,44,6,135,179
"Bolivia","Cochabamba","Capinota","Santivañez","ESCUELA PRUDENCIO ARAUCO (SANTIVAÑEZ)",-66.24799,-17.54894,249,24,1618,1867,434,45,1115,1549
"Bolivia","Cochabamba","Capinota","Santivañez","SUB CENTRAL ENRIQUE ENCINAS (EX CALERA)",-66.21689,-17.57849,73,5,509,582,61,13,430,491
"Bolivia","Cochabamba","Capinota","Santivañez","U. E. CASTOR ZAMBRANA HUAYÑACOTA",-66.20436,-17.53515,75,4,419,494,65,6,344,409
"Bolivia","Cochabamba","Capinota","Santivañez","UNIDAD EDUCATIVA CAPORAYA",-66.2821,-17.50345,31,9,247,278,25,5,208,233
"Bolivia","Cochabamba","Capinota","Santivañez","UNIDAD EDUCATIVA JOSE RIVERA",-66.26288,-17.61516,34,2,183,217,54,4,123,177
"Bolivia","Cochabamba","Capinota","Santivañez","UNIDAD EDUCATIVA PAMPA CHURIHUA",-66.14667,-17.61767,18,4,141,159,5,4,128,133
"Bolivia","Cochabamba","Capinota","Santivañez","UNIDAD EDUCATIVA ROCHA RANCHO",-66.18881,-17.54504,83,9,460,543,74,15,362,436
"Bolivia","Cochabamba","Capinota","Sicaya","ESCUELA GERMAN BUSCH",-66.35415,-17.74645,74,23,535,609,81,25,406,487
"Bolivia","Cochabamba","Capinota","Sicaya","NUCLEO HUMANISTICO SICAYA",-66.33362,-17.80072,110,24,817,927,69,42,682,751
"Bolivia","Cochabamba","Carrasco","Chimoré","ESCUELA GERÓNIMO UZEDA FE Y ALEGRIA",-65.15494,-16.99398,1485,117,7075,8560,1647,222,5089,6736
"Bolivia","Cochabamba","Carrasco","Chimoré","ESCUELA LA MISION",-65.14838,-16.71407,39,3,348,387,98,9,238,336
"Bolivia","Cochabamba","Carrasco","Chimoré","NUCLEO EDUCATIVO ENTRE RIOS TACUARAL",-65.20777,-17.08086,60,2,570,630,43,7,518,561
"Bolivia","Cochabamba","Carrasco","Chimoré","NUCLEO ESCOLAR PUERTO AURORA",-65.18625,-16.8472,62,18,475,537,56,11,390,446
"Bolivia","Cochabamba","Carrasco","Chimoré","UNIDAD EDUCATIVA CESAR ZAMA (CHIMORE)",-65.07787,-16.99658,162,21,1626,1788,154,32,1419,1573
"Bolivia","Cochabamba","Carrasco","Chimoré","UNIDAD EDUCATIVA EL CARMEN",-64.90653,-16.16878,32,1,98,130,23,5,69,92
"Bolivia","Cochabamba","Carrasco","Chimoré","UNIDAD EDUCATIVA PUERTO LAS FLORES",-64.67742,-16.40432,12,3,65,77,24,3,35,59
"Bolivia","Cochabamba","Carrasco","Chimoré","UNIDAD EDUCATIVA SAN ANDRÉS",-65.10363,-17.0901,59,5,543,602,25,12,501,526
"Bolivia","Cochabamba","Carrasco","Chimoré","UNIDAD EDUCATIVA SANTA ANITA",-64.82532,-16.11419,42,2,89,131,19,5,63,82
"Bolivia","Cochabamba","Carrasco","Chimoré","UNIDAD EDUCATIVA SANTA ISABEL",-64.72911,-16.50484,19,1,51,70,13,1,36,49
"Bolivia","Cochabamba","Carrasco","Chimoré","UNIDAD EDUCATIVA TRES ISLAS",-64.8566,-16.75232,30,5,170,200,27,3,135,162
"Bolivia","Cochabamba","Carrasco","Chimoré","UNIDAD EDUCATIVA TRINIDADCITO",-64.94166,-16.44957,8,0,61,69,31,0,30,61
"Bolivia","Cochabamba","Carrasco","Entre Ríos (Bulo Bulo)","COLEGIO FRANZ TAMAYO",-64.53572,-17.1993,1086,104,7861,8947,1358,224,6175,7533
"Bolivia","Cochabamba","Carrasco","Entre Ríos (Bulo Bulo)","COLEGIO NACIONAL SAN MARCOS",-64.35905,-17.25389,390,53,3533,3923,441,72,2967,3408
"Bolivia","Cochabamba","Carrasco","Entre Ríos (Bulo Bulo)","ESCUELA EDUARDO AVAROA (ISARZAMA)",-64.68122,-17.13931,202,12,2085,2287,130,27,1916,2046
"Bolivia","Cochabamba","Carrasco","Entre Ríos (Bulo Bulo)","U.E. ESTEBAN ARCE",-64.61887,-17.26742,9,4,254,263,7,8,235,242
"Bolivia","Cochabamba","Carrasco","Entre Ríos (Bulo Bulo)","U. E. JOSÉ CARRASCO (MANCO KAPAC)",-64.56224,-17.18527,270,33,2874,3144,243,48,2550,2793
"Bolivia","Cochabamba","Carrasco","Entre Ríos (Bulo Bulo)","U.E. NACIONAL AYACUCHO",-64.54228,-17.20041,7,0,66,73,10,0,56,66
"Bolivia","Cochabamba","Carrasco","Entre Ríos (Bulo Bulo)","UNIDAD EDUCATIVA RIO BLANCO",-64.45576,-17.22547,260,18,1278,1538,170,42,1048,1218
"Bolivia","Cochabamba","Carrasco","Pocona","CENTRO DE ATENCION AL TURISTA",-65.40996,-17.6073,12,5,369,381,34,9,321,355
"Bolivia","Cochabamba","Carrasco","Pocona","ESCUELA LADISLAO CABRERA",-65.34206,-17.66848,68,11,418,486,61,12,334,395
"Bolivia","Cochabamba","Carrasco","Pocona","NUCLEO ESCOLAR ISMAEL MONTES",-65.38327,-17.72318,80,14,821,901,104,26,677,781
"Bolivia","Cochabamba","Carrasco","Pocona","UNIDAD EDUCATIVA 6 DE AGOSTO",-65.37962,-17.52965,165,22,936,1101,139,44,731,870
"Bolivia","Cochabamba","Carrasco","Pocona","UNIDAD EDUCATIVA CHIMBOATA",-65.28564,-17.66047,24,3,402,426,46,12,341,387
"Bolivia","Cochabamba","Carrasco","Pocona","UNIDAD EDUCATIVA HUAYAPACHA",-65.40794,-17.55243,85,30,837,922,98,35,674,772
"Bolivia","Cochabamba","Carrasco","Pocona","UNIDAD EDUCATIVA JAVIER GONZALES",-65.50449,-17.61416,3,0,61,64,1,1,59,60
"Bolivia","Cochabamba","Carrasco","Pocona","UNIDAD EDUCATIVA LA TRANCA",-65.45638,-17.73257,10,4,109,119,8,0,97,105
"Bolivia","Cochabamba","Carrasco","Pocona","UNIDAD EDUCATIVA MONTE PUNCU",-65.30296,-17.58503,55,13,394,449,46,17,318,364
"Bolivia","Cochabamba","Carrasco","Pocona","UNIDAD EDUCATIVA POCONA",-65.41882,-17.67324,106,18,389,495,72,18,281,353
"Bolivia","Cochabamba","Carrasco","Pojo","COLEGIO VENANCIO LOSS",-64.86312,-17.75708,225,31,1448,1673,246,38,1133,1379
"Bolivia","Cochabamba","Carrasco","Pojo","NUCLEO ESCOLAR DURAZNILLO",-65.01938,-17.78679,39,3,142,181,14,2,123,137
"Bolivia","Cochabamba","Carrasco","Pojo","UNIDAD EDUCATIVA CHALLHUANI",-64.89679,-17.84557,73,0,648,721,13,34,601,614
"Bolivia","Cochabamba","Carrasco","Pojo","UNIDAD EDUCATIVA DIAN PAMPA",-64.70919,-17.71177,31,3,322,353,26,12,281,307
"Bolivia","Cochabamba","Carrasco","Pojo","UNIDAD EDUCATIVA JAIME LAREDO",-64.98014,-17.84581,5,1,104,109,5,3,95,100
"Bolivia","Cochabamba","Carrasco","Pojo","UNIDAD EDUCATIVA KARA HUASI - POJO",-64.74367,-17.73957,23,2,246,269,20,10,214,234
"Bolivia","Cochabamba","Carrasco","Pojo","UNIDAD EDUCATIVA LA HABANA",-64.92303,-17.7378,29,2,289,318,17,2,268,285
"Bolivia","Cochabamba","Carrasco","Pojo","UNIDAD EDUCATIVA PALCA C",-64.97747,-17.70329,20,2,511,531,17,4,488,505
"Bolivia","Cochabamba","Carrasco","Pojo","UNIDAD EDUCATIVA RODEO C",-64.78306,-17.83571,52,1,341,393,4,24,312,316
"Bolivia","Cochabamba","Carrasco","Pojo","UNIDAD EDUCATIVA THAGO LAGUNA",-64.86137,-17.95306,0,0,61,61,0,4,57,57
"Bolivia","Cochabamba","Carrasco","Pojo","UNIDAD EDUCATIVA YUTHUPAMPA",-64.99229,-17.74813,59,7,532,591,25,11,489,514
"Bolivia","Cochabamba","Carrasco","Puerto Villarroel","COLEGIO EDUARDO AVAROA (P.VILLARROEL)",-64.79533,-16.83211,297,17,1057,1354,336,18,686,1022
"Bolivia","Cochabamba","Carrasco","Puerto Villarroel","COLEGIO JUAN PABLO II (SACTA)",-64.76898,-17.11968,408,40,3634,4042,344,74,3176,3520
"Bolivia","Cochabamba","Carrasco","Puerto Villarroel","COLEGIO LIBERTAD",-64.84208,-17.07051,75,6,849,924,64,17,762,826
"Bolivia","Cochabamba","Carrasco","Puerto Villarroel","COLEGIO MARCELO QUIROGA SANTA CRUZ",-65.04104,-17.0115,245,17,2028,2273,215,41,1755,1970
"Bolivia","Cochabamba","Carrasco","Puerto Villarroel","ESCUELA AYOPAYA (P.VILLAROEL)",-65.00072,-16.90683,77,8,900,977,49,15,828,877
"Bolivia","Cochabamba","Carrasco","Puerto Villarroel","ESCUELA BUENAS NUEVAS (VALLE IVIRZA)",-64.91539,-17.11546,182,23,1235,1417,134,22,1056,1190
"Bolivia","Cochabamba","Carrasco","Puerto Villarroel","ESCUELA CENTRAL VILLA NUEVA",-65.00124,-17.11282,71,6,722,793,40,9,667,707
"Bolivia","Cochabamba","Carrasco","Puerto Villarroel","ESCUELA SENDA 6",-64.95086,-17.01844,130,18,1312,1442,84,25,1185,1269
"Bolivia","Cochabamba","Carrasco","Puerto Villarroel","ESCUELA TORIBIO CLAURE (V. HERMOSO)",-64.96452,-17.15555,204,14,1538,1742,156,26,1342,1498
"Bolivia","Cochabamba","Carrasco","Puerto Villarroel","UNIDAD EDUCATIVA 2 DE MARZO",-64.92152,-17.21806,56,4,670,726,30,9,627,657
"Bolivia","Cochabamba","Carrasco","Puerto Villarroel","UNIDAD EDUCATIVA BIARECUATÉ",-64.94436,-16.78322,31,0,59,90,5,0,54,59
"Bolivia","Cochabamba","Carrasco","Puerto Villarroel","UNIDAD EDUCATIVA CESAR ZAMA (P. VILLARRO",-65.07753,-16.99568,20,2,177,197,14,6,155,169
"Bolivia","Cochabamba","Carrasco","Puerto Villarroel","UNIDAD EDUCATIVA ISRAEL",-64.83989,-17.22177,38,7,536,574,45,8,476,521
"Bolivia","Cochabamba","Carrasco","Puerto Villarroel","UNIDAD EDUCATIVA JUANA AZURDUY DE PADILLA",-64.85532,-17.04719,90,3,527,617,79,10,435,514
"Bolivia","Cochabamba","Carrasco","Puerto Villarroel","UNIDAD EDUCATIVA SAN FRANCISCO DE ASIS",-64.85681,-17.03161,1395,123,9073,10468,1583,289,7078,8661
"Bolivia","Cochabamba","Carrasco","Puerto Villarroel","UNIDAD EDUCATIVA VALLE TUNARI",-64.69701,-17.26063,175,17,1599,1774,101,28,1453,1554
"Bolivia","Cochabamba","Carrasco","Totora","COLEGIO 8 DE SEPTIEMBRE",-65.08691,-17.71779,44,9,554,598,51,16,478,529
"Bolivia","Cochabamba","Carrasco","Totora","SEDE DE LA JUNTA VECINAL DE EPIZANA",-65.22901,-17.63718,72,12,785,857,95,28,650,745
"Bolivia","Cochabamba","Carrasco","Totora","SEDE SOCIAL YUNGAS DE VANDIOLA",-65.23582,-17.42609,74,8,477,551,130,12,327,457
"Bolivia","Cochabamba","Carrasco","Totora","UNIDAD EDUCATIVA ANTAQAWA",-65.13827,-17.87289,8,0,131,139,9,1,121,130
"Bolivia","Cochabamba","Carrasco","Totora","UNIDAD EDUCATIVA LAIME TORO",-65.05975,-17.66721,42,8,572,614,46,18,500,546
"Bolivia","Cochabamba","Carrasco","Totora","UNIDAD EDUCATIVA POTRERO",-65.04145,-17.88901,14,1,119,133,5,0,113,118
"Bolivia","Cochabamba","Carrasco","Totora","UNIDAD EDUCATIVA RODEO GRANDE",-65.13137,-17.66049,59,10,861,920,43,12,796,839
"Bolivia","Cochabamba","Carrasco","Totora","UNIDAD EDUCATIVA TIKA PAMPA",-65.25523,-17.7844,17,4,125,142,4,4,113,117
"Bolivia","Cochabamba","Carrasco","Totora","UNIDAD EDUCATIVA TIRAQUE C",-65.09571,-17.67045,14,4,305,319,16,4,281,297
"Bolivia","Cochabamba","Carrasco","Totora","UNIDA EDUCATIVA LA PAZ",-65.19115,-17.74041,425,48,2708,3133,516,83,2061,2577
"Bolivia","Cochabamba","Cercado","Cochabamba","CAMPO FERIAL",-66.12955,-17.41828,634,33,4556,5190,2374,149,2000,4374
"Bolivia","Cochabamba","Cercado","Cochabamba","(CÁRCEL) PENITENCIARIA SAN ANTONIO",-66.15704,-17.40325,92,2,151,243,70,6,73,143
"Bolivia","Cochabamba","Cercado","Cochabamba","(CÁRCEL) PENITENCIARIA SAN SEBASTIAN MUJERES",-66.16058,-17.39862,48,0,77,125,29,0,48,77
"Bolivia","Cochabamba","Cercado","Cochabamba","(CÁRCEL) PENITENCIARIA SAN SEBASTIAN  VARONES",-66.15989,-17.39794,84,1,192,276,61,10,120,181
"Bolivia","Cochabamba","Cercado","Cochabamba","CEMA CENTRO FRUTILLITAS",-66.20207,-17.38553,39,1,481,520,347,14,119,466
"Bolivia","Cochabamba","Cercado","Cochabamba","CENTRO EDUCATIVO P.  MARIA AUXILIADORA",-66.15949,-17.43581,703,41,5203,5906,2680,191,2291,4971
"Bolivia","Cochabamba","Cercado","Cochabamba","CENTRO EDUCATIVO SAN FRANCISCO DE ASIS",-66.16775,-17.41353,185,6,1313,1498,861,18,428,1289
"Bolivia","Cochabamba","Cercado","Cochabamba","CENTRO INMACULADA CONCEPCION",-66.15766,-17.37703,394,9,2504,2898,2142,37,316,2458
"Bolivia","Cochabamba","Cercado","Cochabamba","CENTRO INTEGRADO EL SALVADOR S-VERA CRUZ",-66.1243,-17.46039,436,26,2949,3385,1227,102,1594,2821
"Bolivia","Cochabamba","Cercado","Cochabamba","CENTRO KANATA",-66.15925,-17.41386,145,2,879,1024,560,25,292,852
"Bolivia","Cochabamba","Cercado","Cochabamba","CENTRO PARTICULAR GERONIMO DE OSORIO",-66.1866,-17.397,883,24,5680,6563,3767,147,1742,5509
"Bolivia","Cochabamba","Cercado","Cochabamba","COLEGIO ABAROA",-66.1585,-17.39535,540,12,3076,3616,2308,56,700,3008
"Bolivia","Cochabamba","Cercado","Cochabamba","COLEGIO ALBERT EINSTEIN",-66.17524,-17.38465,368,13,3155,3523,2474,98,570,3044
"Bolivia","Cochabamba","Cercado","Cochabamba","COLEGIO ALEMAN SANTA MARIA",-66.15275,-17.39123,351,8,2029,2380,1666,34,321,1987
"Bolivia","Cochabamba","Cercado","Cochabamba","COLEGIO AMOR DE DIOS",-66.15005,-17.40731,1164,33,6625,7789,4045,135,2412,6457
"Bolivia","Cochabamba","Cercado","Cochabamba","COLEGIO BOLIVAR",-66.1534,-17.39354,297,11,1610,1907,1191,20,388,1579
"Bolivia","Cochabamba","Cercado","Cochabamba","COLEGIO BOLIVIANO ARGENTINO",-66.15808,-17.39156,151,5,713,864,551,10,147,698
"Bolivia","Cochabamba","Cercado","Cochabamba","COLEGIO BRANCO PETRICEVIC",-66.18783,-17.37372,837,32,6224,7061,4425,146,1621,6046
"Bolivia","Cochabamba","Cercado","Cochabamba","COLEGIO BUENAS NUEVAS C",-66.14614,-17.41905,730,42,4605,5335,2290,140,2133,4423
"Bolivia","Cochabamba","Cercado","Cochabamba","COLEGIO CRISTO REY",-66.17203,-17.39057,590,9,4395,4985,3349,88,949,4298
"Bolivia","Cochabamba","Cercado","Cochabamba","COLEGIO DON BOSCO",-66.15103,-17.38246,694,15,4015,4709,3327,58,615,3942
"Bolivia","Cochabamba","Cercado","Cochabamba","COLEGIO FEDERICO FROEBEL",-66.14729,-17.36183,428,14,3451,3879,2475,76,886,3361
"Bolivia","Cochabamba","Cercado","Cochabamba","COLEGIO HISPANO BOLIVIANO",-66.15182,-17.39768,479,14,2579,3058,1866,66,633,2499
"Bolivia","Cochabamba","Cercado","Cochabamba","COLEGIO IRLANDES",-66.13731,-17.37605,71,1,536,607,447,8,80,527
"Bolivia","Cochabamba","Cercado","Cochabamba","COLEGIO ISMAEL MONTES O LUIS ESPINAL",-66.14464,-17.4156,562,33,3962,4524,1912,124,1893,3805
"Bolivia","Cochabamba","Cercado","Cochabamba","COLEGIO JAIME ESCALANTE",-66.15813,-17.368,188,9,1369,1557,1122,21,217,1339
"Bolivia","Cochabamba","Cercado","Cochabamba","COLEGIO LA SALLE",-66.1608,-17.38936,736,11,3643,4379,3037,45,550,3587
"Bolivia","Cochabamba","Cercado","Cochabamba","COLEGIO LA SALLE FISCAL",-66.16738,-17.40489,700,22,4983,5683,3548,98,1315,4863
"Bolivia","Cochabamba","Cercado","Cochabamba","COLEGIO LAURA VICUÑA",-66.19179,-17.4425,129,15,1094,1223,419,33,627,1046
"Bolivia","Cochabamba","Cercado","Cochabamba","COLEGIO LOYOLA",-66.14664,-17.38733,321,4,1795,2116,1486,28,277,1763
"Bolivia","Cochabamba","Cercado","Cochabamba","COLEGIO LUIS QUINTIN VILA",-66.1864,-17.37541,788,21,6106,6894,4295,189,1601,5896
"Bolivia","Cochabamba","Cercado","Cochabamba","COLEGIO MARISTA",-66.16205,-17.36185,580,16,4753,5333,3384,87,1266,4650
"Bolivia","Cochabamba","Cercado","Cochabamba","COLEGIO MARISTA NUESTRA SEÑORA DEL PILAR",-66.16751,-17.35473,778,26,5557,6335,3331,161,2039,5370
"Bolivia","Cochabamba","Cercado","Cochabamba","COLEGIO MARTIN CARDENAS",-66.13716,-17.41997,489,20,4069,4558,2209,94,1746,3955
"Bolivia","Cochabamba","Cercado","Cochabamba","COLEGIO MARYKNOLL",-66.16751,-17.37765,779,8,4947,5726,4183,64,692,4875
"Bolivia","Cochabamba","Cercado","Cochabamba","COLEGIO NACIONAL MIXTO COCHABAMBA",-66.17643,-17.36379,701,29,5441,6142,3787,92,1533,5320
"Bolivia","Cochabamba","Cercado","Cochabamba","COLEGIO PAULO VI",-66.16972,-17.3896,369,8,2610,2979,2079,52,471,2550
"Bolivia","Cochabamba","Cercado","Cochabamba","COLEGIO PIO XII",-66.15453,-17.40197,233,7,1454,1687,1045,21,381,1426
"Bolivia","Cochabamba","Cercado","Cochabamba","COLEGIO RICHARD VON WEIZACKER",-66.18177,-17.37842,305,10,2765,3070,2173,38,544,2717
"Bolivia","Cochabamba","Cercado","Cochabamba","COLEGIO SAN ANTONIO DE PUCARA",-66.1666,-17.45451,1458,92,8964,10422,3375,324,5173,8548
"Bolivia","Cochabamba","Cercado","Cochabamba","COLEGIO SAN FRANCISCO DE ASIS",-66.15719,-17.43316,813,34,5774,6587,3177,138,2425,5602
"Bolivia","Cochabamba","Cercado","Cochabamba","COLEGIO SAN FRANCISCO (VILLA PAGADOR)",-66.11565,-17.43498,820,66,5571,6391,1769,211,3525,5294
"Bolivia","Cochabamba","Cercado","Cochabamba","COLEGIO SAN RAFAEL",-66.13949,-17.39816,653,16,4393,5046,3310,49,1018,4328
"Bolivia","Cochabamba","Cercado","Cochabamba","COLEGIO SANTA LUISA MARILLAC",-66.12972,-17.42876,730,49,5518,6248,2277,172,3020,5297
"Bolivia","Cochabamba","Cercado","Cochabamba","COLEGIO SANTO DOMINGO SAVIO",-66.15925,-17.42091,297,16,2234,2531,1401,60,757,2158
"Bolivia","Cochabamba","Cercado","Cochabamba","COLEGIO SEBASTIAN PAGADOR",-66.11807,-17.4396,1528,101,11230,12758,3900,353,6876,10776
"Bolivia","Cochabamba","Cercado","Cochabamba","COLEGIO SERGIO ALMARAZ PAZ",-66.15983,-17.42155,766,23,5259,6025,3325,143,1768,5093
"Bolivia","Cochabamba","Cercado","Cochabamba","COLEGIO TECNICO HUMANISTICO ABAROA",-66.18008,-17.39791,147,6,1098,1245,738,23,331,1069
"Bolivia","Cochabamba","Cercado","Cochabamba","COLEGIO VENEZUELA",-66.17432,-17.38003,420,16,2985,3405,2348,52,569,2917
"Bolivia","Cochabamba","Cercado","Cochabamba","COLEGIO VENJAMNIN",-66.12346,-17.42547,264,29,2102,2366,892,70,1111,2003
"Bolivia","Cochabamba","Cercado","Cochabamba","COLEGIO YUGOSLAVIA ( EX MARISCAL SANTA CRUZ)",-66.15756,-17.4142,355,11,2438,2793,1665,53,709,2374
"Bolivia","Cochabamba","Cercado","Cochabamba","ESC. FISCAL JUAN XXIII A – JUANCITO PINTO",-66.20342,-17.3892,214,5,1650,1864,1081,31,533,1614
"Bolivia","Cochabamba","Cercado","Cochabamba","ESC. REPUBLICA DEL PERU O I. VASQUEZ",-66.16631,-17.41514,1100,29,6962,8062,4546,136,2251,6797
"Bolivia","Cochabamba","Cercado","Cochabamba","ESCUELA 6 DE AGOSTO",-66.17321,-17.48531,604,71,4681,5285,1408,160,3042,4450
"Bolivia","Cochabamba","Cercado","Cochabamba","ESCUELA ANTOFAGASTA",-66.18551,-17.38673,721,45,5926,6647,4016,133,1732,5748
"Bolivia","Cochabamba","Cercado","Cochabamba","ESCUELA BOLIVAR",-66.15719,-17.40203,239,5,1240,1479,857,19,359,1216
"Bolivia","Cochabamba","Cercado","Cochabamba","ESCUELA BUENAS NUEVAS A",-66.14575,-17.41985,411,25,2759,3170,1307,81,1346,2653
"Bolivia","Cochabamba","Cercado","Cochabamba","ESCUELA CAMARA JUNIOR",-66.15968,-17.42823,346,17,2088,2434,1166,78,827,1993
"Bolivia","Cochabamba","Cercado","Cochabamba","ESCUELA CARLOS MEDINACELI",-66.14594,-17.44799,765,40,5459,6224,2177,157,3085,5262
"Bolivia","Cochabamba","Cercado","Cochabamba","ESCUELA CEFERINO NAMUNCURA",-66.22959,-17.44222,181,8,1063,1244,381,34,640,1021
"Bolivia","Cochabamba","Cercado","Cochabamba","ESCUELA CENTRAL TAQUIÑA A",-66.17831,-17.34379,706,52,5677,6383,2965,161,2499,5464
"Bolivia","Cochabamba","Cercado","Cochabamba","ESCUELA CENTRAL TAQUIÑA C",-66.17863,-17.3427,686,30,5223,5909,2725,147,2321,5046
"Bolivia","Cochabamba","Cercado","Cochabamba","ESCUELA EUSEBIO TUDELA",-66.21059,-17.44574,450,48,3770,4220,1177,135,2410,3587
"Bolivia","Cochabamba","Cercado","Cochabamba","ESCUELA FISCAL JUAN XXIII A",-66.20212,-17.38982,540,14,4012,4552,2580,66,1352,3932
"Bolivia","Cochabamba","Cercado","Cochabamba","ESCUELA GERARDO VARGAS",-66.12848,-17.43969,872,64,5519,6391,1967,190,3298,5265
"Bolivia","Cochabamba","Cercado","Cochabamba","ESCUELA GUALBERTO VILLARROEL",-66.14348,-17.38926,292,4,1962,2254,1557,24,377,1934
"Bolivia","Cochabamba","Cercado","Cochabamba","ESCUELA GUTIERREZ MARISCAL",-66.19385,-17.39756,652,46,5679,6331,3301,162,2170,5471
"Bolivia","Cochabamba","Cercado","Cochabamba","ESCUELA HUMBERTO PORTOCARRERO",-66.14091,-17.45442,592,23,4078,4670,1757,127,2171,3928
"Bolivia","Cochabamba","Cercado","Cochabamba","ESCUELA IV CENTENARIO",-66.18991,-17.35495,698,33,5144,5842,3146,117,1848,4994
"Bolivia","Cochabamba","Cercado","Cochabamba","ESCUELA JOSE GABRIEL DE GUMUCIO",-66.16722,-17.38438,246,3,1779,2025,1468,32,276,1744
"Bolivia","Cochabamba","Cercado","Cochabamba","ESCUELA JOSE MARIA SANTIVAÑEZ",-66.17485,-17.36938,604,10,4205,4809,3397,48,750,4147
"Bolivia","Cochabamba","Cercado","Cochabamba","ESCUELA MARYKNOLL",-66.16147,-17.37132,172,1,1224,1396,1064,15,144,1208
"Bolivia","Cochabamba","Cercado","Cochabamba","ESCUELA MIXTA FISCAL TEMPORAL A",-66.15884,-17.36139,656,29,5205,5861,3175,152,1849,5024
"Bolivia","Cochabamba","Cercado","Cochabamba","ESCUELA OTTO FELIPE BRAWN",-66.18926,-17.36244,555,19,4174,4729,2655,97,1403,4058
"Bolivia","Cochabamba","Cercado","Cochabamba","ESCUELA RICARDO PRUDENCIO",-66.14006,-17.42105,449,22,2988,3437,1337,95,1534,2871
"Bolivia","Cochabamba","Cercado","Cochabamba","ESCUELA WALTER VALLEJO",-66.14645,-17.40012,240,3,1370,1610,861,30,476,1337
"Bolivia","Cochabamba","Cercado","Cochabamba","ESCUELA WILGE RODRIGUEZ",-66.15132,-17.39204,163,6,900,1063,676,22,196,872
"Bolivia","Cochabamba","Cercado","Cochabamba","INSTITUTO AMERICANO",-66.15434,-17.36889,933,22,5993,6926,4669,95,1207,5876
"Bolivia","Cochabamba","Cercado","Cochabamba","INSTITUTO EDUARDO LAREDO",-66.1526,-17.38101,454,2,2164,2618,1825,21,316,2141
"Bolivia","Cochabamba","Cercado","Cochabamba","LICEO ADELA ZAMUDIO",-66.16859,-17.39639,546,8,2869,3415,2130,77,654,2784
"Bolivia","Cochabamba","Cercado","Cochabamba","LICEO ELENA ARZE DE ARZE",-66.16439,-17.37035,568,11,3531,4099,2871,59,590,3461
"Bolivia","Cochabamba","Cercado","Cochabamba","LICEO GUINDALINA LOAYZA",-66.16626,-17.38111,153,7,1293,1446,1083,15,188,1271
"Bolivia","Cochabamba","Cercado","Cochabamba","LICEO  MERCEDES CANDIA DE OVANDO",-66.13917,-17.39435,551,19,3684,4235,2701,90,874,3575
"Bolivia","Cochabamba","Cercado","Cochabamba","SEMINARIO SAN JOSE",-66.19784,-17.38371,361,9,2916,3277,2014,69,824,2838
"Bolivia","Cochabamba","Cercado","Cochabamba","U.E. MADRE DE LA DIVINA PROVIDENCIA",-66.14977,-17.43951,31,4,443,474,186,17,236,422
"Bolivia","Cochabamba","Cercado","Cochabamba","U.E. NACIONAL SAN ISIDRO",-66.15123,-17.46888,545,57,4004,4549,1009,162,2776,3785
"Bolivia","Cochabamba","Cercado","Cochabamba","U. E. SAN NICOLAS CLUB DE LEONES",-66.15354,-17.4825,180,33,1796,1976,381,75,1307,1688
"Bolivia","Cochabamba","Cercado","Cochabamba","UNIDAD EDUCATIVA 14 DE SEPTIEMBRE",-66.18018,-17.36749,87,1,933,1020,708,15,209,917
"Bolivia","Cochabamba","Cercado","Cochabamba","UNIDAD EDUCATIVA 26 DE OCTUBRE",-66.12116,-17.42092,39,0,545,584,269,15,261,530
"Bolivia","Cochabamba","Cercado","Cochabamba","UNIDAD EDUCATIVA 9 DE MARZO",-66.10553,-17.44673,76,15,1007,1083,263,32,697,960
"Bolivia","Cochabamba","Cercado","Cochabamba","UNIDAD EDUCATIVA ALTO COCHABAMBA",-66.14483,-17.42332,48,4,422,470,132,13,273,405
"Bolivia","Cochabamba","Cercado","Cochabamba","UNIDAD EDUCATIVA AMERICA DEL SUR - MEJILLONES A",-66.13793,-17.42199,39,7,342,381,158,11,166,324
"Bolivia","Cochabamba","Cercado","Cochabamba","UNIDAD EDUCATIVA ANDRES BELLO",-66.15125,-17.4158,596,25,3737,4333,1845,91,1776,3621
"Bolivia","Cochabamba","Cercado","Cochabamba","UNIDAD EDUCATIVA ANTONIO DIEZ",-66.17933,-17.47178,93,14,1553,1646,522,57,960,1482
"Bolivia","Cochabamba","Cercado","Cochabamba","UNIDAD EDUCATIVA ATIY",-66.15207,-17.46361,124,12,1138,1262,378,26,722,1100
"Bolivia","Cochabamba","Cercado","Cochabamba","UNIDAD EDUCATIVA BARBARA LAMAS",-66.10529,-17.46267,469,55,3502,3971,796,151,2500,3296
"Bolivia","Cochabamba","Cercado","Cochabamba","UNIDAD EDUCATIVA BOLIVIA (LA MAICA)",-66.21881,-17.41461,145,9,1277,1422,351,42,875,1226
"Bolivia","Cochabamba","Cercado","Cochabamba","UNIDAD EDUCATIVA CATOLICO GUADALUPANO (EX CALIFORNIA AMERICAN SCHOOL)",-66.1447,-17.36928,367,11,2791,3158,2054,50,676,2730
"Bolivia","Cochabamba","Cercado","Cochabamba","UNIDAD EDUCATIVA CLUB DE LEONES",-66.16528,-17.36456,502,19,3494,3996,2514,73,888,3402
"Bolivia","Cochabamba","Cercado","Cochabamba","UNIDAD EDUCATIVA DANIEL SALAMANCA (EX COLEGIO NAL. MIXTO 6 DE AGOSTO)",-66.16353,-17.39569,82,3,583,665,448,10,122,570
"Bolivia","Cochabamba","Cercado","Cochabamba","UNIDAD EDUCATIVA DE LA FUERZA AEREA",-66.16742,-17.42138,196,3,658,854,397,19,239,636
"Bolivia","Cochabamba","Cercado","Cochabamba","UNIDAD EDUCATIVA DEMETRIO CANELAS",-66.20225,-17.42305,217,24,1874,2091,627,56,1167,1794
"Bolivia","Cochabamba","Cercado","Cochabamba","UNIDAD EDUCATIVA DIONISIO MORALES CHOQUE",-66.12429,-17.46519,929,91,7321,8250,1596,285,5349,6945
"Bolivia","Cochabamba","Cercado","Cochabamba","UNIDAD EDUCATIVA DOMINGO SAVIO (EX LORENZO FILHO)",-66.14401,-17.38117,218,1,1194,1412,939,26,228,1167
"Bolivia","Cochabamba","Cercado","Cochabamba","UNIDAD EDUCATIVA EL SALVADOR SAN JAVIER",-66.12055,-17.44695,584,38,3769,4353,1520,85,2126,3646
"Bolivia","Cochabamba","Cercado","Cochabamba","UNIDAD EDUCATIVA ESTADOS UNIDOS",-66.16256,-17.41906,219,11,1660,1879,1034,42,573,1607
"Bolivia","Cochabamba","Cercado","Cochabamba","UNIDAD EDUCATIVA ESTEBAN ARZE",-66.18428,-17.39833,431,8,3409,3840,2256,104,1041,3297
"Bolivia","Cochabamba","Cercado","Cochabamba","UNIDAD EDUCATIVA FACUNDO QUIROGA",-66.18948,-17.37427,47,3,366,413,274,8,81,355
"Bolivia","Cochabamba","Cercado","Cochabamba","UNIDAD EDUCATIVA FELIX CAPRILES",-66.18253,-17.40841,73,4,784,857,534,19,227,761
"Bolivia","Cochabamba","Cercado","Cochabamba","UNIDAD EDUCATIVA GARIBALDI",-66.19059,-17.35455,222,13,1744,1966,1027,25,679,1706
"Bolivia","Cochabamba","Cercado","Cochabamba","UNIDAD EDUCATIVA HNO PACIFICO FELETTI",-66.20975,-17.46777,98,13,905,1003,205,33,654,859
"Bolivia","Cochabamba","Cercado","Cochabamba","UNIDAD EDUCATIVA JOSE IGNACIO SANJINES",-66.20641,-17.38527,95,7,1050,1145,661,27,355,1016
"Bolivia","Cochabamba","Cercado","Cochabamba","UNIDAD EDUCATIVA JUAN JOSE TORREZ",-66.11476,-17.44767,149,17,1415,1564,442,40,916,1358
"Bolivia","Cochabamba","Cercado","Cochabamba","UNIDAD EDUCATIVA MARIA EMILIA RIQUELME (EX MARIA CRISTINA)",-66.20455,-17.39834,479,20,3711,4190,2143,117,1431,3574
"Bolivia","Cochabamba","Cercado","Cochabamba","UNIDAD EDUCATIVA MARIA JOSEFA MUJIA",-66.14333,-17.42708,325,42,2969,3294,862,119,1946,2808
"Bolivia","Cochabamba","Cercado","Cochabamba","UNIDAD EDUCATIVA NATANIEL AGUIRRE",-66.16888,-17.39892,22,1,332,354,237,8,86,323
"Bolivia","Cochabamba","Cercado","Cochabamba","UNIDAD EDUCATIVA NUEVA ESPERANZA",-66.17866,-17.48736,628,77,5669,6297,1543,230,3819,5362
"Bolivia","Cochabamba","Cercado","Cochabamba","UNIDAD EDUCATIVA NUEVA VERA CRUZ",-66.11756,-17.46273,420,21,2889,3309,1009,97,1762,2771
"Bolivia","Cochabamba","Cercado","Cochabamba","UNIDAD EDUCATIVA OBISPO ANAYA",-66.12938,-17.45243,340,21,2445,2785,1038,64,1322,2360
"Bolivia","Cochabamba","Cercado","Cochabamba","UNIDAD EDUCATIVA PRIMERO DE MAYO",-66.20525,-17.46752,798,74,5989,6787,1676,212,4027,5703
"Bolivia","Cochabamba","Cercado","Cochabamba","UNIDAD EDUCATIVA PROF. OSCAR ROJAS CABALLERO",-66.15136,-17.43501,34,2,318,352,157,6,153,310
"Bolivia","Cochabamba","Cercado","Cochabamba","UNIDAD EDUCATIVA RENE BARRIENTOS ORTUÑO",-66.11013,-17.47701,993,89,6018,7011,1732,243,3954,5686
"Bolivia","Cochabamba","Cercado","Cochabamba","UNIDAD EDUCATIVA RENE CRESPO",-66.151,-17.42624,95,6,823,918,275,33,509,784
"Bolivia","Cochabamba","Cercado","Cochabamba","UNIDAD EDUCATIVA ROSENDO PEÑA",-66.19244,-17.37992,45,1,481,526,361,12,107,468
"Bolivia","Cochabamba","Cercado","Cochabamba","UNIDAD EDUCATIVA SAN MIGUEL",-66.14757,-17.40514,471,22,2432,2903,1105,67,1238,2343
"Bolivia","Cochabamba","Cercado","Cochabamba","UNIDAD EDUCATIVA SAN MIGUEL ALTA TENSION",-66.13224,-17.43877,79,16,649,728,215,13,405,620
"Bolivia","Cochabamba","Cercado","Cochabamba","UNIDAD EDUCATIVA SANTA CRUZ - EDUARDO OCAMPO MOSCOSO",-66.15053,-17.41479,20,1,132,152,51,2,78,129
"Bolivia","Cochabamba","Cercado","Cochabamba","UNIDAD EDUCATIVA SANTA MARIA MICAELA",-66.17656,-17.40725,717,16,5180,5897,3518,125,1521,5039
"Bolivia","Cochabamba","Cercado","Cochabamba","UNIDAD EDUCATIVA SANTIAGO",-66.1651,-17.3495,383,23,3641,4024,1680,131,1807,3487
"Bolivia","Cochabamba","Cercado","Cochabamba","UNIDAD EDUCATIVA SIGLO XX - GABRIELA MISTRAL",-66.12198,-17.43334,140,16,1338,1478,485,38,799,1284
"Bolivia","Cochabamba","Cercado","Cochabamba","UNIDAD EDUCATIVA STEFANO HOTELLIER",-66.13995,-17.46966,184,24,1891,2075,487,75,1305,1792
"Bolivia","Cochabamba","Cercado","Cochabamba","UNIDAD EDUCATIVA VERDAD Y VIDA",-66.10658,-17.47467,235,33,2227,2462,598,80,1516,2114
"Bolivia","Cochabamba","Cercado","Cochabamba","UNIDAD EDUCATIVA VISION MUNDIAL",-66.1441,-17.43991,692,39,4831,5523,2164,146,2482,4646
"Bolivia","Cochabamba","Cercado","Cochabamba","UNIDAD EDUCATIVA VOCES LIBRES",-66.13216,-17.47402,23,7,329,352,66,9,247,313
"Bolivia","Cochabamba","Cercado","Cochabamba","UNIDAD EDU. EDUARDO LOPEZ O E.DON BOSCO",-66.17724,-17.4273,373,29,2362,2735,1017,57,1259,2276
"Bolivia","Cochabamba","Cercado","Cochabamba","UNIVERSIDAD CATOLICA",-66.14394,-17.37205,863,26,5636,6499,4383,97,1130,5513
"Bolivia","Cochabamba","Cercado","Cochabamba","UNIVERSIDAD UCATEC (EX CEIVO)",-66.13677,-17.37113,253,8,2127,2380,1606,38,475,2081
"Bolivia","Cochabamba","Chapare","Colomi","NUCLEO ESCOLAR CANDELARIA",-65.92474,-17.27441,156,31,1832,1988,331,88,1382,1713
"Bolivia","Cochabamba","Chapare","Colomi","NUCLEO ESCOLAR TABLAS MONTE",-65.99883,-17.0847,83,16,568,651,48,10,494,542
"Bolivia","Cochabamba","Chapare","Colomi","U.E. ROSARIO",-65.88084,-17.3183,3,3,87,90,36,1,47,83
"Bolivia","Cochabamba","Chapare","Colomi","UNIDAD EDUCATIVA CORANI PAMPA",-65.93583,-17.13022,106,19,1142,1248,205,41,877,1082
"Bolivia","Cochabamba","Chapare","Colomi","UNIDAD EDUCATIVA EL PALMAR",-65.74912,-17.18198,45,4,260,305,55,5,196,251
"Bolivia","Cochabamba","Chapare","Colomi","UNIDAD EDUCATIVA PARACTI (COLOMI)",-65.82558,-17.20783,60,5,516,576,172,25,314,486
"Bolivia","Cochabamba","Chapare","Colomi","UNIDAD EDUCATIVA PUCA MAYU (COLOMI)",-65.90272,-17.01873,1,0,8,9,0,0,8,8
"Bolivia","Cochabamba","Chapare","Colomi","UNIDAD EDUCATIVA SAMUEL FINA SAVIO",-65.8636,-17.34076,914,144,5977,6891,1880,370,3583,5463
"Bolivia","Cochabamba","Chapare","Sacaba","(CÁRCEL) PENITENCIARIA EL ABRA",-66.11572,-17.40493,65,1,223,288,56,4,162,218
"Bolivia","Cochabamba","Chapare","Sacaba","(CÁRCEL) PENITENCIARIA SAN PEDRO (SACABA)",-66.0414,-17.40583,51,2,105,156,21,3,79,100
"Bolivia","Cochabamba","Chapare","Sacaba","COLEGIO BOLIVIANO JAPONES",-66.09353,-17.37924,1004,54,7211,8215,4531,203,2423,6954
"Bolivia","Cochabamba","Chapare","Sacaba","COLEGIO FRANZ TAMAYO (CHIÑATA)",-65.98093,-17.43051,525,41,3978,4503,1427,154,2356,3783
"Bolivia","Cochabamba","Chapare","Sacaba","COLEGIO NATANIEL AGUIRRE",-65.83003,-17.37266,148,8,1266,1414,208,52,998,1206
"Bolivia","Cochabamba","Chapare","Sacaba","COLEGIO PUERTO MEJILLONES",-66.1301,-17.37218,576,26,4465,5041,2823,87,1529,4352
"Bolivia","Cochabamba","Chapare","Sacaba","COLEGIO QUINTANILLA",-66.10987,-17.3848,1591,97,10227,11818,5854,343,3933,9787
"Bolivia","Cochabamba","Chapare","Sacaba","COLEGIO RENE FERNANDEZ BECERRA",-65.91483,-17.42616,124,13,1040,1164,158,16,853,1011
"Bolivia","Cochabamba","Chapare","Sacaba","COLEGIO SEÑOR DE MAYO",-66.11799,-17.37354,919,33,6076,6995,4052,119,1872,5924
"Bolivia","Cochabamba","Chapare","Sacaba","ESCUELA 6 DE JUNIO - TACOPOCA",-66.02658,-17.41193,437,63,3749,4186,1461,150,2075,3536
"Bolivia","Cochabamba","Chapare","Sacaba","ESCUELA CARLOS PEREDO SANDOVAL",-66.05909,-17.3939,1065,98,7387,8452,3470,306,3513,6983
"Bolivia","Cochabamba","Chapare","Sacaba","ESCUELA COPACABANA",-66.10087,-17.39216,460,36,3588,4048,2090,106,1356,3446
"Bolivia","Cochabamba","Chapare","Sacaba","ESCUELA GERMAN BUSCH",-66.0383,-17.40434,745,56,4774,5519,2474,200,2044,4518
"Bolivia","Cochabamba","Chapare","Sacaba","ESCUELA GUADALUPE",-66.07703,-17.38369,843,31,5983,6826,3471,189,2292,5763
"Bolivia","Cochabamba","Chapare","Sacaba","ESCUELA JESUS TERCEROS",-66.12031,-17.38594,438,6,3210,3648,2324,71,809,3133
"Bolivia","Cochabamba","Chapare","Sacaba","ESCUELA MAN CESPED",-66.03825,-17.40714,911,69,6361,7272,3261,258,2773,6034
"Bolivia","Cochabamba","Chapare","Sacaba","ESCUELA NATALIO ARAUCO",-66.04586,-17.40147,675,49,4489,5164,2353,148,1939,4292
"Bolivia","Cochabamba","Chapare","Sacaba","ESCUELA RENE BARRIENTOS ORTUÑO (UCUCHI)",-65.92544,-17.4195,90,8,574,664,139,19,408,547
"Bolivia","Cochabamba","Chapare","Sacaba","INSTITUTO TECNICO SACABA (ITSA)",-66.04596,-17.40543,16,2,126,142,58,5,61,119
"Bolivia","Cochabamba","Chapare","Sacaba","LICEO DE SEÑORITAS SACABA",-66.04489,-17.40398,928,66,6075,7003,3243,194,2572,5815
"Bolivia","Cochabamba","Chapare","Sacaba","U.E. MARCELO QUIROGA SANTA CRUZ (PACATA)",-66.1184,-17.3762,15,1,161,176,104,2,54,158
"Bolivia","Cochabamba","Chapare","Sacaba","U.E. NUEVO AMANECER",-66.03468,-17.45286,29,11,603,632,130,48,414,544
"Bolivia","Cochabamba","Chapare","Sacaba","U.E. TUTIMAYU",-65.95177,-17.41679,49,16,878,927,269,27,566,835
"Bolivia","Cochabamba","Chapare","Sacaba","UNIDAD EDUCATIVA 27 DE AGOSTO",-66.05526,-17.41448,17,4,390,407,115,11,260,375
"Bolivia","Cochabamba","Chapare","Sacaba","UNIDAD EDUCATIVA BOLIVIANO BRITÁNICO",-66.02322,-17.40267,395,42,3050,3445,1205,108,1695,2900
"Bolivia","Cochabamba","Chapare","Sacaba","UNIDAD EDUCATIVA CEILAB",-66.073,-17.38945,14,2,167,181,110,7,48,158
"Bolivia","Cochabamba","Chapare","Sacaba","UNIDAD EDUCATIVA DEL VALLE",-66.1094,-17.38272,203,13,1838,2041,1097,42,686,1783
"Bolivia","Cochabamba","Chapare","Sacaba","UNIDAD EDUCATIVA EDMUNDO BOJANOWSKI",-66.12388,-17.37073,35,1,397,432,249,9,138,387
"Bolivia","Cochabamba","Chapare","Sacaba","UNIDAD EDUCATIVA ENTRE RIOS",-66.06012,-17.40147,9,3,167,176,50,10,104,154
"Bolivia","Cochabamba","Chapare","Sacaba","UNIDAD EDUCATIVA HERNÁN RIVERO FIORILO",-66.07921,-17.40404,177,17,1925,2102,859,57,992,1851
"Bolivia","Cochabamba","Chapare","Sacaba","UNIDAD EDUCATIVA ISRAELÍ EL ABRA",-66.10103,-17.40372,627,66,5585,6212,2018,217,3284,5302
"Bolivia","Cochabamba","Chapare","Sacaba","UNIDAD EDUCATIVA KANATA",-66.10153,-17.38585,89,3,708,797,560,16,129,689
"Bolivia","Cochabamba","Chapare","Sacaba","UNIDAD EDUCATIVA LARATI",-66.01265,-17.34382,30,6,773,803,93,11,663,756
"Bolivia","Cochabamba","Chapare","Sacaba","UNIDAD EDUCATIVA PAMPILLA",-66.0752,-17.18917,195,49,2082,2277,498,128,1407,1905
"Bolivia","Cochabamba","Chapare","Sacaba","UNIDAD EDUCATIVA RENÉ BARRIENTOS ORTUÑO",-66.11898,-17.37671,135,5,1137,1272,714,27,391,1105
"Bolivia","Cochabamba","Chapare","Sacaba","UNIDAD EDUCATIVA REPUBLICA DE ITALIA",-66.04491,-17.40258,156,15,1465,1621,637,34,779,1416
"Bolivia","Cochabamba","Chapare","Sacaba","UNIDAD EDUCATIVA ULINCATE",-65.98841,-17.4069,109,14,1042,1151,384,40,604,988
"Bolivia","Cochabamba","Chapare","Sacaba","UNIDAD EDUCATIVA VILLA GRACIELA",-66.13087,-17.37237,288,15,2428,2716,1496,43,874,2370
"Bolivia","Cochabamba","Chapare","Villa Tunari","COLEGIO FE Y ALEGRIA",-65.40147,-16.91353,164,18,1661,1825,199,43,1401,1600
"Bolivia","Cochabamba","Chapare","Villa Tunari","COLEGIO FRANCISCO VIGNAUD",-65.42472,-16.97513,119,5,521,640,170,7,339,509
"Bolivia","Cochabamba","Chapare","Villa Tunari","COLEGIO MIXTO TECNICO HUM. VILLA BOLIVAR",-65.74024,-16.62949,54,6,496,550,40,6,444,484
"Bolivia","Cochabamba","Chapare","Villa Tunari","COLEGIO NUEVA TACOPAYA",-65.67545,-16.56796,102,7,1124,1226,117,33,967,1084
"Bolivia","Cochabamba","Chapare","Villa Tunari","ESCUELA 27 DE MAYO",-65.30819,-16.74821,115,13,533,648,90,25,405,495
"Bolivia","Cochabamba","Chapare","Villa Tunari","ESCUELA CRISTAL MAYU",-65.64395,-17.00619,193,18,1595,1788,138,31,1408,1546
"Bolivia","Cochabamba","Chapare","Villa Tunari","ESCUELA ELIZARDO PEREZ",-65.64406,-16.73144,242,25,1966,2208,236,45,1660,1896
"Bolivia","Cochabamba","Chapare","Villa Tunari","ESCUELA LA ESTRELLA",-65.49522,-16.72417,47,3,573,620,49,17,504,553
"Bolivia","Cochabamba","Chapare","Villa Tunari","ESCUELA LA ESTRELLA (SAN GABRIEL)",-65.62708,-16.6753,281,4,2075,2356,163,37,1871,2034
"Bolivia","Cochabamba","Chapare","Villa Tunari","ESCUELA SAMUZABETI",-65.57269,-16.81616,201,12,2121,2322,133,49,1927,2060
"Bolivia","Cochabamba","Chapare","Villa Tunari","ESCUELA SAN ANTONIO DE VILLA TUNARI",-65.4173,-16.97306,359,17,1849,2208,607,44,1181,1788
"Bolivia","Cochabamba","Chapare","Villa Tunari","ESCUELA SAN JOSE (V.TUNARI)",-65.46657,-16.81087,152,5,1283,1435,69,17,1192,1261
"Bolivia","Cochabamba","Chapare","Villa Tunari","ESCUELA VILLA 14 DE SEPTIEMBRE",-65.34883,-16.84459,677,73,4890,5567,597,121,4099,4696
"Bolivia","Cochabamba","Chapare","Villa Tunari","NUCLEO ESCOLAR NUEVA AROMA",-65.82585,-16.56242,86,14,917,1003,60,4,839,899
"Bolivia","Cochabamba","Chapare","Villa Tunari","U. E. INDEPENDENCIA (VILLA TUNARI)",-65.79965,-16.4638,88,14,975,1063,41,13,907,948
"Bolivia","Cochabamba","Chapare","Villa Tunari","U.E. SAN BENITO",-65.5032,-16.53337,18,2,56,74,5,1,48,53
"Bolivia","Cochabamba","Chapare","Villa Tunari","U. E. SANTA ROSA DE LA BOCA",-64.7546,-15.93035,28,0,25,53,24,0,1,25
"Bolivia","Cochabamba","Chapare","Villa Tunari","UNIDAD EDUCATIVA 1RO DE MAYO",-65.42921,-16.64719,50,2,591,641,52,16,521,573
"Bolivia","Cochabamba","Chapare","Villa Tunari","UNIDAD EDUCATIVA 27 DE MAYO",-65.46113,-17.0208,18,1,326,344,12,2,311,323
"Bolivia","Cochabamba","Chapare","Villa Tunari","UNIDAD EDUCATIVA JATUN PAMPA",-65.5677,-17.00337,115,14,1017,1132,160,28,815,975
"Bolivia","Cochabamba","Chapare","Villa Tunari","UNIDAD EDUCATIVA MIXTA ETERAZAMA",-65.52284,-16.83394,535,52,4318,4853,672,112,3482,4154
"Bolivia","Cochabamba","Chapare","Villa Tunari","UNIDAD EDUCATIVA MOLETO ICOYA (V.TUNARI)",-65.8701,-16.4744,43,6,645,688,25,14,600,625
"Bolivia","Cochabamba","Chapare","Villa Tunari","UNIDAD EDUCATIVA PARACTITO",-65.46431,-17.03166,228,19,1648,1876,289,54,1286,1575
"Bolivia","Cochabamba","Chapare","Villa Tunari","UNIDAD EDUCATIVA PARACTI (VILLA TUNARI)",-65.82552,-17.20792,65,6,326,391,46,7,267,313
"Bolivia","Cochabamba","Chapare","Villa Tunari","UNIDAD EDUCATIVA PARAISO-TODO SANTOS",-65.29498,-16.90554,149,20,1507,1656,182,41,1264,1446
"Bolivia","Cochabamba","Chapare","Villa Tunari","UNIDAD EDUCATIVA SAN FRANCISCO KM 21",-65.33453,-16.76798,31,7,603,634,32,15,549,581
"Bolivia","Cochabamba","Chapare","Villa Tunari","UNIDAD EDUCATIVA SAN JOSE DE ANGOSTA",-65.90482,-16.42696,75,5,207,282,20,20,162,182
"Bolivia","Cochabamba","Chapare","Villa Tunari","UNIDAD EDUCATIVA SIMON RODRIGUEZ (EX PUCA MAYU (V. TUNARI))",-65.90272,-17.01873,65,9,501,566,44,12,436,480
"Bolivia","Cochabamba","Chapare","Villa Tunari","UNIDAD EDUCATIVA TOCOPILLA",-65.26644,-16.81101,33,7,378,411,22,10,339,361
"Bolivia","Cochabamba","Chapare","Villa Tunari","UNIDAD EDUCATIVA UNCIA",-65.73511,-16.52453,42,10,573,615,26,18,519,545
"Bolivia","Cochabamba","Chapare","Villa Tunari","UNIDAD EDUCATIVA VILLA NUEVA",-65.33994,-16.65689,21,1,314,335,27,10,276,303
"Bolivia","Cochabamba","Esteban Arce","Anzaldo","ESC. ESTEBAN ANDIA ESCOBAR - PACCHA PATA",-65.94566,-17.70326,29,6,157,186,29,7,115,144
"Bolivia","Cochabamba","Esteban Arce","Anzaldo","NUCLEO EDUCATIVO LA VIÑA",-65.85647,-17.96978,46,4,194,240,42,6,142,184
"Bolivia","Cochabamba","Esteban Arce","Anzaldo","U. E. SAN JOSE DE CALAZANS-LITORAL",-65.93351,-17.78299,405,93,2084,2489,570,102,1319,1889
"Bolivia","Cochabamba","Esteban Arce","Anzaldo","UNIDAD EDUCATIVA ALFAMAYU",-65.93799,-17.86563,9,1,68,77,2,2,63,65
"Bolivia","Cochabamba","Esteban Arce","Anzaldo","UNIDAD EDUCATIVA ARTURO SARMIENTO",-65.94575,-17.90018,47,3,252,299,31,16,202,233
"Bolivia","Cochabamba","Esteban Arce","Anzaldo","UNIDAD EDUCATIVA THAGO KASA",-65.82888,-17.89126,13,2,120,133,11,2,105,116
"Bolivia","Cochabamba","Esteban Arce","Arbieto","CENTRO EDUCATIVO GERMAN BUSCH - ARBIETO",-66.01723,-17.58551,372,33,1648,2020,467,62,1086,1553
"Bolivia","Cochabamba","Esteban Arce","Arbieto","ESCUELA SECCIONAL ARPITA",-66.07514,-17.56822,196,20,1007,1203,160,39,788,948
"Bolivia","Cochabamba","Esteban Arce","Arbieto","UNIDAD EDUCATIVA 6 DE JUNIO - MAMANACA",-66.05242,-17.58441,131,13,547,678,138,17,379,517
"Bolivia","Cochabamba","Esteban Arce","Arbieto","UNIDAD EDUCATIVA ANTONIO ARNEZ -ARANJUEZ",-65.97636,-17.5959,56,4,340,396,101,10,225,326
"Bolivia","Cochabamba","Esteban Arce","Arbieto","UNIDAD EDUCATIVA CARLOS CANELAS",-66.09542,-17.49024,262,40,2833,3095,515,128,2150,2665
"Bolivia","Cochabamba","Esteban Arce","Arbieto","UNIDAD ESCOLAR CASIMIRO LOPEZ T.",-66.08762,-17.51215,66,7,354,420,128,6,213,341
"Bolivia","Cochabamba","Esteban Arce","Sacabamba","ESCUELA ELISEO TORRICO - SACABAMBA",-65.77574,-17.81699,112,22,664,776,176,37,429,605
"Bolivia","Cochabamba","Esteban Arce","Sacabamba","ESCUELA SECCIONAL CHALLAQUE",-65.75699,-17.83179,32,5,228,260,57,14,152,209
"Bolivia","Cochabamba","Esteban Arce","Sacabamba","NUCLEO ESCOLAR QUEKOMA",-65.8235,-17.70307,46,10,263,309,22,8,223,245
"Bolivia","Cochabamba","Esteban Arce","Sacabamba","NUCLEO MATARANI",-65.80145,-17.80308,97,12,592,689,103,24,453,556
"Bolivia","Cochabamba","Esteban Arce","Sacabamba","UNIDAD EDUCATIVA APILLAPA",-65.85152,-17.76226,12,3,172,184,20,6,143,163
"Bolivia","Cochabamba","Esteban Arce","Tarata","COLEGIO MY. VICTOR USTARIZ",-66.02438,-17.60891,498,23,1636,2134,548,58,1007,1555
"Bolivia","Cochabamba","Esteban Arce","Tarata","ESCUELA ESTEBAN ARZE",-66.02402,-17.61324,206,25,1195,1401,327,46,797,1124
"Bolivia","Cochabamba","Esteban Arce","Tarata","ESCUELA LUIS TERRAZAS",-66.07424,-17.75421,36,3,182,218,7,6,166,173
"Bolivia","Cochabamba","Esteban Arce","Tarata","ESCUELA RENE BARRIENTOS O.",-66.02374,-17.61071,322,22,1254,1576,383,37,812,1195
"Bolivia","Cochabamba","Esteban Arce","Tarata","UNIDAD EDUCATIVA HUASA RANCHO",-65.96735,-17.61409,31,6,141,172,38,3,94,132
"Bolivia","Cochabamba","Esteban Arce","Tarata","UNIDAD EDUCATIVA HUAYCULI",-65.97934,-17.6437,87,8,537,624,59,14,456,515
"Bolivia","Cochabamba","Esteban Arce","Tarata","UNIDAD EDUCATIVA HUERTA MAYU",-66.11383,-17.63796,42,3,351,393,8,6,334,342
"Bolivia","Cochabamba","Germán Jordán","Cliza","COLEGIO JUAN DE DIOS BALDERRAMA",-65.93368,-17.59121,762,62,4482,5244,1702,131,2587,4289
"Bolivia","Cochabamba","Germán Jordán","Cliza","COLEGIO NACIONAL MIXTO UCUREÑA",-65.90669,-17.58086,264,29,2045,2309,630,42,1344,1974
"Bolivia","Cochabamba","Germán Jordán","Cliza","ESCUELA SUCRE",-65.9311,-17.59395,819,45,3548,4367,1273,112,2118,3391
"Bolivia","Cochabamba","Germán Jordán","Cliza","UNIDAD EDUCATIVA CHULLPAS",-65.94772,-17.60734,134,11,628,762,146,27,444,590
"Bolivia","Cochabamba","Germán Jordán","Cliza","UNIDAD EDUCATIVA HUASACALLE",-65.90952,-17.5931,75,13,537,612,151,11,362,513
"Bolivia","Cochabamba","Germán Jordán","Cliza","UNIDAD EDUCATIVA SANTA LUCIA",-65.9581,-17.58606,94,7,409,503,126,18,258,384
"Bolivia","Cochabamba","Germán Jordán","Toko","COLEGIO AMBROSINI",-65.92783,-17.62949,517,52,2421,2938,476,65,1828,2304
"Bolivia","Cochabamba","Germán Jordán","Toko","UNIDAD EDUCATIVA SICHES",-65.94588,-17.66759,37,8,206,243,29,8,161,190
"Bolivia","Cochabamba","Germán Jordán","Tolata","COLEGIO VICTOR ROSALES",-65.96407,-17.53315,426,35,1615,2041,526,66,988,1514
"Bolivia","Cochabamba","Germán Jordán","Tolata","ESCUELA SAN ISIDRO",-65.97154,-17.56319,110,14,348,458,82,14,238,320
"Bolivia","Cochabamba","Germán Jordán","Tolata","ESCUELA SANTA MARIA (CARCAJE)",-66.0082,-17.54546,427,25,1648,2075,692,64,867,1559
"Bolivia","Cochabamba","Mizque","Alalay","ESCUELA DR. DEMETRIO CANELAS",-65.60884,-17.76655,47,10,382,429,88,14,270,358
"Bolivia","Cochabamba","Mizque","Alalay","U. E. ABRAHAM FLORES VELASQUEZ",-65.69196,-17.72072,73,4,334,407,30,7,293,323
"Bolivia","Cochabamba","Mizque","Alalay","UNIDAD EDUCATIVA QUTURI",-65.5355,-17.7629,26,6,185,211,18,4,157,175
"Bolivia","Cochabamba","Mizque","Alalay","UNIDAD EDUCATIVA YANA KHAKHA",-65.60854,-17.85578,52,1,207,259,11,6,189,200
"Bolivia","Cochabamba","Mizque","Mizque","COLEGIO PEDRO IGNACIO RIVERO",-65.35332,-17.94529,629,74,4377,5006,1495,205,2603,4098
"Bolivia","Cochabamba","Mizque","Mizque","ESCUELA AGUADA",-65.30665,-18.00293,124,14,586,710,74,22,476,550
"Bolivia","Cochabamba","Mizque","Mizque","ESCUELA GUILLERMO VISCARRA",-65.30976,-17.91031,74,6,511,585,41,13,451,492
"Bolivia","Cochabamba","Mizque","Mizque","ESCUELA MIXTA DR. MARTIN CARDENAS",-65.54247,-18.22179,134,26,854,988,239,43,546,785
"Bolivia","Cochabamba","Mizque","Mizque","NUCLEO CENTRO SALVIA",-65.33526,-18.14982,22,4,248,270,16,9,219,235
"Bolivia","Cochabamba","Mizque","Mizque","NUCLEO ESCOLAR BETA RAQAY PAMPA",-65.38233,-18.19124,153,18,1127,1280,27,36,1046,1073
"Bolivia","Cochabamba","Mizque","Mizque","NUCLEO ESCOLAR LAGUNA GRANDE",-65.37489,-18.30198,104,19,827,931,40,18,750,790
"Bolivia","Cochabamba","Mizque","Mizque","NUCLEO JOSÉ CLAURE (U. E. SAN VICENTE)",-65.53803,-18.16495,61,3,353,414,23,8,319,342
"Bolivia","Cochabamba","Mizque","Mizque","SEDE CENTRAL CAMPESINA (KURI)",-65.45872,-17.83207,21,6,295,316,30,14,245,275
"Bolivia","Cochabamba","Mizque","Mizque","SEDE SINDICAL DE CHAHUARANI CHICO",-65.52352,-18.05988,7,8,211,218,13,10,180,193
"Bolivia","Cochabamba","Mizque","Mizque","SEDE SOCIAL DE TIPA TIPA",-65.26866,-18.09922,69,28,479,548,114,16,321,435
"Bolivia","Cochabamba","Mizque","Mizque","UNIDAD EDUCATIVA CAUTA",-65.43818,-18.09074,24,3,175,199,21,9,142,163
"Bolivia","Cochabamba","Mizque","Mizque","UNIDAD EDUCATIVA MOLINERO",-65.38817,-18.26225,56,9,299,355,17,14,259,276
"Bolivia","Cochabamba","Mizque","Mizque","UNIDAD EDUCATIVA SANTIAGO",-65.32516,-18.20377,20,8,313,333,14,10,281,295
"Bolivia","Cochabamba","Mizque","Mizque","UNIDAD EDUCATIVA THAGO THAGO",-65.3672,-17.9808,35,14,447,482,69,27,337,406
"Bolivia","Cochabamba","Mizque","Mizque","UNIDAD EDUCATIVA TIN TIN",-65.45436,-18.0311,114,18,699,813,135,23,523,658
"Bolivia","Cochabamba","Mizque","Mizque","UNIDAD EDUCATIVA UCHHAMA ALTA",-65.50367,-17.95332,9,0,139,148,5,1,133,138
"Bolivia","Cochabamba","Mizque","Vila Vila","ESCUELA HUMBERTO NOGALES",-65.62921,-17.98482,123,16,674,797,51,11,596,647
"Bolivia","Cochabamba","Mizque","Vila Vila","NUCLEO ESCOLAR SIQUIMIRA",-65.73359,-18.01842,37,3,386,423,12,4,367,379
"Bolivia","Cochabamba","Mizque","Vila Vila","NUCLEO ESCOLAR SIVINGANI",-65.68718,-17.91458,60,15,290,350,37,17,221,258
"Bolivia","Cochabamba","Mizque","Vila Vila","UNIDAD EDUCATIVA POCOTAICA",-65.78678,-17.93137,10,1,71,81,4,2,64,68
"Bolivia","Cochabamba","Punata","Cuchumuela (Villa Gualberto Villarroel)","ESCUELA CUCHU MUELA",-65.7948,-17.65219,64,9,578,642,225,20,324,549
"Bolivia","Cochabamba","Punata","Cuchumuela (Villa Gualberto Villarroel)","NUCLEO ESCOLAR YANA RUMI",-65.74833,-17.70206,36,8,256,292,26,7,215,241
"Bolivia","Cochabamba","Punata","Punata","ESCUELA ADELA ZAMUDIO",-65.83555,-17.54252,855,54,4243,5098,1989,207,1993,3982
"Bolivia","Cochabamba","Punata","Punata","ESCUELA ANDRES MARIA TORRICO",-65.8345,-17.54389,632,57,3452,4084,1480,160,1755,3235
"Bolivia","Cochabamba","Punata","Punata","LICEO JOSEFA M. GANDARILLAS (EX SUCRE)",-65.83789,-17.54791,650,47,3300,3950,1624,155,1474,3098
"Bolivia","Cochabamba","Punata","Punata","SEDE SINDICAL THACO",-65.82087,-17.55312,66,14,552,618,147,24,367,514
"Bolivia","Cochabamba","Punata","Punata","U. E. MANUEL A. VILLARROEL (EX BOLIVAR)",-65.83459,-17.54425,640,39,3571,4211,1654,165,1713,3367
"Bolivia","Cochabamba","Punata","Punata","U. E. RENE BARRIENTOS O. - LA VILLA",-65.81705,-17.51416,113,29,506,619,101,21,355,456
"Bolivia","Cochabamba","Punata","Punata","U. E. RUBEN FERRUFINO (CAMACHO RANCHO)",-65.84141,-17.56411,126,18,747,873,222,38,469,691
"Bolivia","Cochabamba","Punata","Punata","UNIDAD EDUCATIVA MAYOR ROCHA (YACANAHUYO",-65.84713,-17.55166,96,25,771,867,308,36,402,710
"Bolivia","Cochabamba","Punata","Punata","UNIDAD EDUCATIVA MOLLE HUMA",-65.8109,-17.52157,84,19,555,639,111,19,406,517
"Bolivia","Cochabamba","Punata","Punata","UNIDAD EDUCATIVA TAJAMAR",-65.86192,-17.55713,95,22,744,839,308,39,375,683
"Bolivia","Cochabamba","Punata","Punata","UNIDAD EDUCATIVA TAMBILLO CHICO",-65.8281,-17.57144,59,8,387,446,108,24,247,355
"Bolivia","Cochabamba","Punata","San Benito (Villa José Quintín Mendoza)","COLEGIO SIMON BOLIVAR (HUARICAYA)",-65.92278,-17.52582,142,22,999,1141,294,24,659,953
"Bolivia","Cochabamba","Punata","San Benito (Villa José Quintín Mendoza)","ESCUELA EXPERIMENTAL PARACAYA",-65.85702,-17.5135,329,44,2533,2862,688,93,1708,2396
"Bolivia","Cochabamba","Punata","San Benito (Villa José Quintín Mendoza)","U. E. 27 DE MAYO (EX JOSE B. PEREIRA)",-65.89712,-17.52321,441,46,3114,3555,1004,98,1966,2970
"Bolivia","Cochabamba","Punata","San Benito (Villa José Quintín Mendoza)","UNIDAD EDUCATIVA SUNCHU PAMPA",-65.91961,-17.55873,150,20,801,951,210,28,543,753
"Bolivia","Cochabamba","Punata","San Benito (Villa José Quintín Mendoza)","UNIDAD EDUCATIVA WAÑAKAHUA",-65.8343,-17.51407,46,6,518,564,130,22,360,490
"Bolivia","Cochabamba","Punata","Tacachi","UNIDAD EDUCATIVA TACACHI",-65.80265,-17.63962,88,6,471,559,178,24,263,441
"Bolivia","Cochabamba","Punata","Villa Rivero","COL TEC IND COMUNITARIO MARCELO QUIROGA",-65.87885,-17.60502,543,36,2422,2965,385,75,1926,2311
"Bolivia","Cochabamba","Punata","Villa Rivero","ESCUELA GUALBERTO VILLARROEL (V. RIVERO)",-65.81674,-17.61485,393,42,1776,2169,719,86,929,1648
"Bolivia","Cochabamba","Punata","Villa Rivero","UNIDAD EDUCATIVA MARTÍN CÁRDENAS HERMOSO",-65.86461,-17.62572,37,5,258,295,35,6,212,247
"Bolivia","Cochabamba","Quillacollo","Colcapirhua","COLEGIO MAX FERNANDEZ",-66.23126,-17.39577,720,28,5274,5994,2955,156,2135,5090
"Bolivia","Cochabamba","Quillacollo","Colcapirhua","ESCUELA JESUS LARA",-66.22623,-17.39318,575,25,4805,5380,2928,110,1742,4670
"Bolivia","Cochabamba","Quillacollo","Colcapirhua","INSTITUTO MARÍA CRISTINA",-66.21936,-17.39718,263,6,1638,1901,968,40,624,1592
"Bolivia","Cochabamba","Quillacollo","Colcapirhua","SEDE SOCIAL CALLAJ CHULLPA (COLCAPIRHUA)",-66.24318,-17.35337,57,8,449,506,213,22,206,419
"Bolivia","Cochabamba","Quillacollo","Colcapirhua","SEDE SOCIAL DE LA OTB MARTIN CARDENAS (EX COMPLEJO EL CARMEN)",-66.21273,-17.3792,36,3,223,259,118,5,97,215
"Bolivia","Cochabamba","Quillacollo","Colcapirhua","U. E. PROF. BENEDICTO DURÁN ORTÍZ",-66.22591,-17.38681,85,1,708,793,385,23,299,684
"Bolivia","Cochabamba","Quillacollo","Colcapirhua","UNIDAD EDUCATIVA DANIEL SALAMANCA",-66.24152,-17.38778,843,58,6585,7428,3511,198,2818,6329
"Bolivia","Cochabamba","Quillacollo","Colcapirhua","UNIDAD EDUCATIVA EL SAUSALITO",-66.21352,-17.38681,645,28,5005,5650,2809,167,2001,4810
"Bolivia","Cochabamba","Quillacollo","Colcapirhua","UNIDAD EDUCATIVA LA SAGRADA FAMILIA",-66.22238,-17.38265,120,14,1624,1744,904,36,670,1574
"Bolivia","Cochabamba","Quillacollo","Colcapirhua","UNIDAD EDUCATIVA SAN JOSÉ DE KAMI",-66.23543,-17.36735,574,43,4339,4913,1944,168,2184,4128
"Bolivia","Cochabamba","Quillacollo","Colcapirhua","UNIDAD EDUCATIVA SAN LORENZO",-66.24113,-17.38883,71,6,718,789,373,15,324,697
"Bolivia","Cochabamba","Quillacollo","Colcapirhua","UNIDAD EDUCATIVA SIMON BOLIVAR (SUMUNPAYA)",-66.23511,-17.40263,15,2,144,159,48,7,87,135
"Bolivia","Cochabamba","Quillacollo","Quillacollo","(CÁRCEL) PENAL SAN PABLO",-66.28239,-17.40005,34,1,107,141,40,1,65,105
"Bolivia","Cochabamba","Quillacollo","Quillacollo","CENTRO INTEGRAL NIÑO JESUS FE Y ALEGRIA",-66.25516,-17.38777,128,10,1113,1241,581,32,490,1071
"Bolivia","Cochabamba","Quillacollo","Quillacollo","CENTRO INTERNADO MISICUNI",-66.32189,-17.1263,21,7,289,310,76,12,194,270
"Bolivia","Cochabamba","Quillacollo","Quillacollo","COLEGIO CRISTINA PRADA",-66.27902,-17.39269,299,8,2508,2807,1593,68,839,2432
"Bolivia","Cochabamba","Quillacollo","Quillacollo","COLEGIO FRANZ TAMAYO",-66.28081,-17.38829,700,32,5075,5775,3034,106,1903,4937
"Bolivia","Cochabamba","Quillacollo","Quillacollo","COLEGIO NACIONAL CALAMA (NUEVA INFRAESTRUCTURA)",-66.27234,-17.41193,23,2,105,128,51,3,49,100
"Bolivia","Cochabamba","Quillacollo","Quillacollo","ESCUELA 12 DE SEPTIEMBRE",-66.27923,-17.41147,676,43,4621,5297,2097,118,2363,4460
"Bolivia","Cochabamba","Quillacollo","Quillacollo","ESCUELA ARTURO QUITÓN",-66.27569,-17.36401,446,34,3281,3727,1260,115,1872,3132
"Bolivia","Cochabamba","Quillacollo","Quillacollo","ESCUELA FELIX MARTINEZ",-66.2527,-17.38772,1055,244,9354,10409,4711,319,4080,8791
"Bolivia","Cochabamba","Quillacollo","Quillacollo","ESCUELA FIDELIA C. DE SANCHEZ",-66.28062,-17.39867,212,10,2271,2483,1508,45,708,2216
"Bolivia","Cochabamba","Quillacollo","Quillacollo","ESCUELA SIMÓN BOLIVAR",-66.27937,-17.3954,498,23,3673,4171,2084,107,1459,3543
"Bolivia","Cochabamba","Quillacollo","Quillacollo","ESCUELA TOMAS BATA",-66.28063,-17.40219,423,33,3703,4126,2039,113,1518,3557
"Bolivia","Cochabamba","Quillacollo","Quillacollo","INSTITUTO PARTICULAR QUILLACOLLO",-66.28365,-17.39573,410,21,3415,3825,2173,94,1127,3300
"Bolivia","Cochabamba","Quillacollo","Quillacollo","INSTITUTO TECNOLOGICO EL PASO",-66.2566,-17.34972,110,12,999,1109,376,28,583,959
"Bolivia","Cochabamba","Quillacollo","Quillacollo","KINDER MARISCAL JOSE BALLIVIAN",-66.26795,-17.40211,523,27,2359,2882,1182,62,1088,2270
"Bolivia","Cochabamba","Quillacollo","Quillacollo","LICEO AMÉRICA",-66.28165,-17.39895,617,25,4759,5376,3114,116,1504,4618
"Bolivia","Cochabamba","Quillacollo","Quillacollo","NORMAL SIMÓN RODRÍGUEZ (EX NUCLEO ESCOLAR PAUCARPATA)",-66.297,-17.36322,388,19,2532,2920,1087,96,1330,2417
"Bolivia","Cochabamba","Quillacollo","Quillacollo","TEOFILO VARGAS CANDIA B",-66.27607,-17.38605,493,23,4126,4619,2284,116,1703,3987
"Bolivia","Cochabamba","Quillacollo","Quillacollo","U. E. JOSE MIGUEL LANZA (ILLATACO)",-66.29857,-17.3701,149,17,1435,1584,441,45,932,1373
"Bolivia","Cochabamba","Quillacollo","Quillacollo","U. E. MILIVOY ETEROVIC MATENDA",-66.26927,-17.39382,272,13,1861,2133,1012,47,789,1801
"Bolivia","Cochabamba","Quillacollo","Quillacollo","U. E. RENE BARRIENOS ORTUÑO (MISICUNI)",-66.32351,-17.11721,45,14,504,549,141,30,319,460
"Bolivia","Cochabamba","Quillacollo","Quillacollo","UNIDAD EDUCATIVA BELLA VISTA",-66.28169,-17.32156,636,70,3889,4525,1131,194,2494,3625
"Bolivia","Cochabamba","Quillacollo","Quillacollo","UNIDAD EDUCATIVA EL PASO",-66.26698,-17.33861,973,78,6333,7306,2231,217,3807,6038
"Bolivia","Cochabamba","Quillacollo","Quillacollo","UNIDAD EDUCATIVA FLORA SALINAS HINOJOSA - AMALIA ECHALAR DE",-66.27919,-17.39159,0,0,16,16,10,0,6,16
"Bolivia","Cochabamba","Quillacollo","Quillacollo","UNIDAD EDUCATIVA HEROINAS",-66.27933,-17.40064,334,18,2434,2768,1302,77,1037,2339
"Bolivia","Cochabamba","Quillacollo","Quillacollo","UNIDAD EDUCATIVA IRONCOLLO",-66.28701,-17.36173,552,61,4171,4723,1610,151,2349,3959
"Bolivia","Cochabamba","Quillacollo","Quillacollo","UNIDAD EDUCATIVA LIRIUNI",-66.29985,-17.28487,10,3,188,198,29,9,147,176
"Bolivia","Cochabamba","Quillacollo","Quillacollo","UNIDAD EDUCATIVA MARIA AUXILIADORA",-66.24287,-17.32961,77,11,760,837,304,36,409,713
"Bolivia","Cochabamba","Quillacollo","Quillacollo","UNIDAD EDUCATIVA MARQUINA",-66.28875,-17.33999,365,39,2802,3167,907,135,1721,2628
"Bolivia","Cochabamba","Quillacollo","Quillacollo","UNIDAD EDUCATIVA MARTIN CARDENAS",-66.29568,-17.38804,153,9,1253,1406,565,63,616,1181
"Bolivia","Cochabamba","Quillacollo","Quillacollo","UNIDAD EDUCATIVA NESTOR ADRIAZOLA (EX COLEGIO NACIONAL CALAMA)",-66.28477,-17.39367,948,52,6841,7789,3587,252,2950,6537
"Bolivia","Cochabamba","Quillacollo","Quillacollo","UNIDAD EDUCATIVA VILLA DE URKUPIÑA",-66.28946,-17.4192,302,28,2780,3082,795,88,1869,2664
"Bolivia","Cochabamba","Quillacollo","Quillacollo","UNIDAD EDUCATIVA VILLA MODERNA",-66.2822,-17.3884,303,13,2050,2353,1045,43,949,1994
"Bolivia","Cochabamba","Quillacollo","Sipe Sipe","ESC. RENE BARRIENTOS ORTUÑO (ITAPAYA)",-66.32016,-17.58389,181,19,1139,1320,312,49,759,1071
"Bolivia","Cochabamba","Quillacollo","Sipe Sipe","ESCUELA BOLVIANA AMERICANA",-66.36395,-17.41975,293,40,2375,2668,635,90,1610,2245
"Bolivia","Cochabamba","Quillacollo","Sipe Sipe","ESCUELA SUCRE (SIPE SIPE)",-66.35757,-17.45498,881,88,6828,7709,2186,297,4257,6443
"Bolivia","Cochabamba","Quillacollo","Sipe Sipe","UNIDAD EDUCATIVA 3 DE ABRIL",-66.33532,-17.4215,112,16,1405,1517,447,54,888,1335
"Bolivia","Cochabamba","Quillacollo","Sipe Sipe","UNIDAD EDUCATIVA ANDRES UZEDA OCAMPO",-66.35824,-17.45489,65,7,469,534,146,11,305,451
"Bolivia","Cochabamba","Quillacollo","Sipe Sipe","UNIDAD EDUCATIVA CARAMARCA COLLPA",-66.305,-17.45254,68,28,586,654,176,21,361,537
"Bolivia","Cochabamba","Quillacollo","Sipe Sipe","UNIDAD EDUCATIVA  CAVILOMA",-66.34575,-17.43804,22,15,549,571,158,27,349,507
"Bolivia","Cochabamba","Quillacollo","Sipe Sipe","UNIDAD EDUCATIVA EDUARDO ABAROA",-66.34507,-17.56399,394,75,2474,2868,645,111,1643,2288
"Bolivia","Cochabamba","Quillacollo","Sipe Sipe","UNIDAD EDUCATIVA SAUCE RANCHO",-66.32941,-17.42615,735,72,4872,5607,1711,205,2884,4595
"Bolivia","Cochabamba","Quillacollo","Sipe Sipe","UNIDAD EDUCATIVA SUTICOLLO",-66.33573,-17.46679,417,25,2313,2730,1040,95,1153,2193
"Bolivia","Cochabamba","Quillacollo","Sipe Sipe","UNIDAD EDUCATIVA TORIBIO CLAURE",-66.37673,-17.44035,12,4,353,365,36,9,304,340
"Bolivia","Cochabamba","Quillacollo","Sipe Sipe","UNIDAD EDUCATIVA UCHU UCHU",-66.47109,-17.37553,14,0,440,454,4,21,415,419
"Bolivia","Cochabamba","Quillacollo","Sipe Sipe","UNIDAD EDUCATIVA VILOMA",-66.37477,-17.41203,225,26,1574,1799,283,54,1211,1494
"Bolivia","Cochabamba","Quillacollo","Tiquipaya","ALDEAS S.O.S",-66.19316,-17.35118,340,19,2682,3022,1473,101,1089,2562
"Bolivia","Cochabamba","Quillacollo","Tiquipaya","COLEGIO CRISTO NACIÓN (UE BOLIVIA JAPÓN)",-66.19818,-17.34682,21,0,94,115,71,0,23,94
"Bolivia","Cochabamba","Quillacollo","Tiquipaya","COLEGIO SAN MIGUEL (TIQUIPAYA)",-66.2195,-17.33651,688,45,4701,5389,2299,146,2211,4510
"Bolivia","Cochabamba","Quillacollo","Tiquipaya","COLEGIO SIMON BOLIVAR (TIQUIPAYA)",-66.22029,-17.33622,844,65,5884,6728,2635,209,2975,5610
"Bolivia","Cochabamba","Quillacollo","Tiquipaya","ESCUELA EUGENIA RAVASCO",-66.20742,-17.36253,152,16,1392,1544,776,26,574,1350
"Bolivia","Cochabamba","Quillacollo","Tiquipaya","ESCUELA ISAAC ATTIE",-66.1954,-17.36948,236,12,2034,2270,1278,47,697,1975
"Bolivia","Cochabamba","Quillacollo","Tiquipaya","ESCUELA SECCIONAL WARIPUCARA",-66.2721,-17.02783,16,0,101,117,4,2,95,99
"Bolivia","Cochabamba","Quillacollo","Tiquipaya","ESCUELA TORIBIO CLAURE",-66.20433,-17.34466,847,55,6649,7496,3403,202,2989,6392
"Bolivia","Cochabamba","Quillacollo","Tiquipaya","NUCLEO EDUCATIVO CHAPISIRCA",-66.14425,-17.14807,111,24,1001,1112,93,31,853,946
"Bolivia","Cochabamba","Quillacollo","Tiquipaya","UNIDAD EDUCATIVA CUATRO ESQUINAS",-66.23293,-17.35942,144,13,1279,1423,669,39,558,1227
"Bolivia","Cochabamba","Quillacollo","Tiquipaya","UNIDAD EDUCATIVA JESUS MAESTRO",-66.19382,-17.333,68,14,988,1056,412,35,527,939
"Bolivia","Cochabamba","Quillacollo","Tiquipaya","UNIDAD EDUCATIVA LIBERTAD",-66.19286,-17.34593,615,33,4959,5574,2443,159,2324,4767
"Bolivia","Cochabamba","Quillacollo","Tiquipaya","UNIDAD EDUCATIVA MONTECILLO",-66.34388,-16.97306,22,1,240,262,8,4,227,235
"Bolivia","Cochabamba","Quillacollo","Tiquipaya","UNIDAD EDUCATIVA NUESTRA SRA. DE ALTAGRACIA",-66.24353,-17.35297,47,5,335,382,156,15,159,315
"Bolivia","Cochabamba","Quillacollo","Vinto","ESCUELA ISMAEL MONTES",-66.32672,-17.3703,394,34,2914,3308,1177,162,1541,2718
"Bolivia","Cochabamba","Quillacollo","Vinto","ESCUELA MARTÍN CARDENAS",-66.31405,-17.40174,924,66,6104,7028,2607,210,3221,5828
"Bolivia","Cochabamba","Quillacollo","Vinto","ESCUELA MELCHOR CUADROS",-66.31646,-17.39582,1244,76,9163,10407,4501,378,4208,8709
"Bolivia","Cochabamba","Quillacollo","Vinto","NUCLEO ESCOLAR SIMON BOLIVAR (THIOMOKO)",-66.34605,-17.39735,86,21,839,925,136,44,638,774
"Bolivia","Cochabamba","Quillacollo","Vinto","UNIDAD EDUCATIVA ANOCARAIRE",-66.31851,-17.38117,411,55,3719,4130,1396,154,2114,3510
"Bolivia","Cochabamba","Quillacollo","Vinto","UNIDAD EDUCATIVA DAVID ARZABE",-66.31459,-17.39948,95,14,968,1063,359,45,550,909
"Bolivia","Cochabamba","Quillacollo","Vinto","UNIDAD EDUCATIVA KERAYA",-66.45165,-17.29583,30,3,286,316,13,5,265,278
"Bolivia","Cochabamba","Quillacollo","Vinto","UNIDAD EDUCATIVA REINO UNIDO",-66.33875,-17.38365,495,77,4437,4932,1328,227,2805,4133
"Bolivia","Cochabamba","Quillacollo","Vinto","UNIDAD EDUCATIVA SAGRADA FAMILIA",-66.31983,-17.39161,318,28,1980,2298,892,91,969,1861
"Bolivia","Cochabamba","Tapacarí","Tapacarí","ESCUELA  CHALLA GRANDE",-66.64311,-17.70757,43,17,344,387,107,30,190,297
"Bolivia","Cochabamba","Tapacarí","Tapacarí","ESCUELA CHUÑU CHUÑINI",-66.59262,-17.69916,7,2,420,427,28,6,384,412
"Bolivia","Cochabamba","Tapacarí","Tapacarí","ESCUELA MONSEÑOR ANGEL GELMI",-66.55774,-17.61193,80,12,464,544,17,13,422,439
"Bolivia","Cochabamba","Tapacarí","Tapacarí","NUCLEO ESCOLAR CHARAPAYA",-66.75413,-17.36775,41,1,233,274,8,4,220,228
"Bolivia","Cochabamba","Tapacarí","Tapacarí","NUCLEO ESCOLAR CONFITAL",-66.73165,-17.67827,43,10,397,440,37,20,330,367
"Bolivia","Cochabamba","Tapacarí","Tapacarí","U.E. ARASAYA",-66.59817,-17.4361,2,2,152,154,3,3,144,147
"Bolivia","Cochabamba","Tapacarí","Tapacarí","U.E. CHILLCA GRANDE",-66.63358,-17.59493,1,1,170,171,7,1,161,168
"Bolivia","Cochabamba","Tapacarí","Tapacarí","U.E. LACOLACONI",-66.83026,-17.65938,3,5,273,276,21,15,232,253
"Bolivia","Cochabamba","Tapacarí","Tapacarí","U.E. LACUYO",-66.68685,-17.63514,69,12,554,623,46,25,471,517
"Bolivia","Cochabamba","Tapacarí","Tapacarí","UNIDAD EDUCATIVA APHARUMIRI",-66.54695,-17.53054,17,0,184,201,0,9,175,175
"Bolivia","Cochabamba","Tapacarí","Tapacarí","UNIDAD EDUCATIVA CALLIRI",-66.48114,-17.53546,5,0,53,58,0,1,52,52
"Bolivia","Cochabamba","Tapacarí","Tapacarí","UNIDAD EDUCATIVA CENTRAL VILLA PEREIRA",-66.7868,-17.44669,80,20,532,612,43,24,445,488
"Bolivia","Cochabamba","Tapacarí","Tapacarí","UNIDAD EDUCATIVA CHULLPA K'ASA",-66.43821,-17.62975,23,0,184,207,13,6,165,178
"Bolivia","Cochabamba","Tapacarí","Tapacarí","UNIDAD EDUCATIVA JAPO K'ASA",-66.7634,-17.6955,84,9,749,833,60,24,656,716
"Bolivia","Cochabamba","Tapacarí","Tapacarí","UNIDAD EDUCATIVA KATARIRI",-66.51272,-17.63324,27,9,423,450,24,12,378,402
"Bolivia","Cochabamba","Tapacarí","Tapacarí","UNIDAD EDUCATIVA KJARKAS",-66.521,-17.69701,33,11,356,389,46,23,276,322
"Bolivia","Cochabamba","Tapacarí","Tapacarí","UNIDAD EDUCATIVA LLAVINI",-66.41062,-17.66616,20,1,327,347,47,11,268,315
"Bolivia","Cochabamba","Tapacarí","Tapacarí","UNIDAD EDUCATIVA NORBERTO JIMENEZ",-66.81584,-17.50673,119,17,391,510,42,23,309,351
"Bolivia","Cochabamba","Tapacarí","Tapacarí","UNIDAD EDUCATIVA RAMADAS",-66.47381,-17.55251,114,7,741,855,85,24,625,710
"Bolivia","Cochabamba","Tapacarí","Tapacarí","UNIDAD EDUCATIVA SAN ANTONIO",-66.83088,-17.54268,33,2,258,291,30,5,221,251
"Bolivia","Cochabamba","Tapacarí","Tapacarí","UNIDAD EDUCATIVA SUCRE",-66.62051,-17.5165,226,18,1465,1691,36,127,1284,1320
"Bolivia","Cochabamba","Tapacarí","Tapacarí","UNIDAD EDUCATIVA TUNAS VINTO-APHARUMIRI",-66.54695,-17.53053,75,6,514,589,10,25,473,483
"Bolivia","Cochabamba","Tapacarí","Tapacarí","UNIDAD EDUCATIVA WACA PLAYA",-66.48648,-17.45753,149,22,864,1013,55,23,764,819
"Bolivia","Cochabamba","Tiraque","Shinahota","ESCUELA GERMAN BUSCH",-65.24871,-16.99495,1092,99,6453,7545,1798,231,4325,6123
"Bolivia","Cochabamba","Tiraque","Shinahota","U.E. DEMETRIO CANELAS",-65.22605,-16.99467,10,3,249,259,23,3,220,243
"Bolivia","Cochabamba","Tiraque","Shinahota","U. E. MARCELO QUIROGA SANTA CRUZ",-65.22232,-17.07844,62,9,707,769,91,24,583,674
"Bolivia","Cochabamba","Tiraque","Shinahota","U.E. MARISCAL SUCRE",-65.2549,-16.99571,18,5,195,213,24,9,157,181
"Bolivia","Cochabamba","Tiraque","Shinahota","U.E. SAN LUIS",-65.28136,-16.95968,19,4,475,494,29,5,437,466
"Bolivia","Cochabamba","Tiraque","Shinahota","UNIDAD EDUCATIVA 4 DE ABRIL",-65.27142,-17.03861,15,1,326,341,16,8,301,317
"Bolivia","Cochabamba","Tiraque","Shinahota","UNIDAD EDUCATIVA CHURO GRANDE",-65.33322,-17.05208,12,1,222,234,11,4,206,217
"Bolivia","Cochabamba","Tiraque","Shinahota","UNIDAD EDUCATIVA IBUELO",-65.33987,-16.96962,400,29,1247,1647,203,24,991,1194
"Bolivia","Cochabamba","Tiraque","Shinahota","UNIDAD EDUCATIVA IVIRIZU VANDIOLA",-65.46212,-17.06077,61,9,388,449,55,11,313,368
"Bolivia","Cochabamba","Tiraque","Shinahota","UNIDAD EDUCATIVA MAJO PAMPA A",-65.36292,-17.03242,14,2,281,295,11,2,266,277
"Bolivia","Cochabamba","Tiraque","Shinahota","UNIDAD EDUCATIVA PUERTO AROMA",-65.17721,-17.12901,5,1,72,77,12,1,58,70
"Bolivia","Cochabamba","Tiraque","Shinahota","UNIDAD EDUCATIVA SAN ISIDRO",-65.32017,-16.99914,29,11,826,855,42,10,763,805
"Bolivia","Cochabamba","Tiraque","Tiraque","COLEGIO JUAN JOSE CARRASCO",-65.72145,-17.42393,833,150,5741,6574,1161,271,4159,5320
"Bolivia","Cochabamba","Tiraque","Tiraque","ESCUELA COTANI BAJO",-65.78638,-17.38104,64,13,802,866,119,80,590,709
"Bolivia","Cochabamba","Tiraque","Tiraque","ESCUELA KOARI (NUCLEO ESC. S. BOLIVAR)",-65.57632,-17.47923,174,19,1153,1327,119,62,953,1072
"Bolivia","Cochabamba","Tiraque","Tiraque","ESCUELA SECCIONAL PAIRUMANI",-65.48745,-17.4773,87,9,709,796,69,20,611,680
"Bolivia","Cochabamba","Tiraque","Tiraque","ESCUELA SECCIONAL SACABAMBILLA",-65.76513,-17.4795,40,7,367,407,54,25,281,335
"Bolivia","Cochabamba","Tiraque","Tiraque","NUCLEO ESCOLAR ILURI GRANDE",-65.82572,-17.39656,0,16,662,662,80,40,526,606
"Bolivia","Cochabamba","Tiraque","Tiraque","UNIDAD EDUCATIVA 3 DE AGOSTO",-65.46495,-17.54261,24,4,344,368,38,19,283,321
"Bolivia","Cochabamba","Tiraque","Tiraque","UNIDAD EDUCATIVA PALCA T",-65.77904,-17.41067,14,4,125,139,29,4,88,117
"Bolivia","Cochabamba","Tiraque","Tiraque","UNIDAD EDUCATIVA RODEO",-65.76229,-17.3932,26,17,307,333,40,21,229,269
"Bolivia","La Paz","Abel Iturralde","Ixiamas","ESC. ESPERANZA DEL MADIDI",-67.17106,-12.61393,46,4,130,176,58,0,68,126
"Bolivia","La Paz","Abel Iturralde","Ixiamas","ESC. GERMAN BUSCH",-68.12748,-13.76644,695,27,2273,2968,993,78,1175,2168
"Bolivia","La Paz","Abel Iturralde","Ixiamas","ESCUELA NUEVA IDIAMAS",-68.44615,-13.64052,7,0,10,17,2,0,8,10
"Bolivia","La Paz","Abel Iturralde","Ixiamas","ESCUELA PUERTO ARAONA",-67.77129,-12.52156,34,0,14,48,1,0,13,14
"Bolivia","La Paz","Abel Iturralde","Ixiamas","ESCUELA PUERTO PEREZ",-68.55753,-12.44095,85,0,134,219,111,2,21,132
"Bolivia","La Paz","Abel Iturralde","Ixiamas","ESCUELA TOMAS CATARI",-68.5165,-13.60102,16,1,110,126,11,1,97,108
"Bolivia","La Paz","Abel Iturralde","Ixiamas","ESCUELA VILLA FATIMA",-67.51065,-13.81614,4,0,25,29,16,0,9,25
"Bolivia","La Paz","Abel Iturralde","Ixiamas","ESC. UNIDAD EDUCATIVA DE TAHUA",-67.90891,-13.86159,19,0,107,126,50,1,56,106
"Bolivia","La Paz","Abel Iturralde","Ixiamas","SEDE DEL CARMEN DEL EMERO",-67.37585,-13.38387,10,0,65,75,61,0,4,65
"Bolivia","La Paz","Abel Iturralde","Ixiamas","U.E. MANURIMI",-67.69769,-12.04555,67,2,107,174,41,0,64,105
"Bolivia","La Paz","Abel Iturralde","Ixiamas","UNIDAD EDUCATIVA 10 DE ABRIL",-68.06606,-13.78335,3,2,72,75,39,2,29,68
"Bolivia","La Paz","Abel Iturralde","Ixiamas","UNIDAD EDUCATIVA EL TIGRE",-68.05921,-11.99998,23,0,53,76,31,1,21,52
"Bolivia","La Paz","Abel Iturralde","San Buenaventura","COL. TUMUPASA B",-67.88744,-14.14472,157,13,986,1143,414,22,537,951
"Bolivia","La Paz","Abel Iturralde","San Buenaventura","ESC. CHAUPY YACHAY HUASI",-68.05549,-14.21644,30,2,120,150,67,5,46,113
"Bolivia","La Paz","Abel Iturralde","San Buenaventura","ESCUELA JOSE MANUEL PANDO",-67.53542,-14.43845,580,38,2262,2842,941,71,1212,2153
"Bolivia","La Paz","Abel Iturralde","San Buenaventura","UNIDAD EDUCATIVA CENTRAL BUENA VISTA",-67.58383,-14.37968,32,4,157,189,52,3,98,150
"Bolivia","La Paz","Abel Iturralde","San Buenaventura","UNIDAD EDUCATIVA SAN MIGUEL",-67.52943,-14.4718,10,1,88,98,32,1,54,86
"Bolivia","La Paz","Aroma","Ayo Ayo","CASA DE GOBIERNO",-68.014,-17.18632,5,4,115,120,17,3,91,108
"Bolivia","La Paz","Aroma","Ayo Ayo","COL. AYO AYO",-68.00532,-17.09241,163,30,1714,1877,426,62,1196,1622
"Bolivia","La Paz","Aroma","Ayo Ayo","COLEGIO JOSÉ BALLIVIÁN",-68.08076,-17.17401,11,0,141,152,40,8,93,133
"Bolivia","La Paz","Aroma","Ayo Ayo","ESC. CALACACHI",-68.14827,-17.06024,45,10,492,537,194,13,275,469
"Bolivia","La Paz","Aroma","Ayo Ayo","ESC. FRANZ TAMAYO",-68.06002,-17.01099,73,15,789,862,230,22,522,752
"Bolivia","La Paz","Aroma","Ayo Ayo","ESC. STA. ROSA DE LIMA",-68.06953,-17.13371,46,6,282,328,75,7,194,269
"Bolivia","La Paz","Aroma","Calamarca","CASA DE GOBIERNO",-68.1799,-16.90021,80,6,1022,1102,295,65,656,951
"Bolivia","La Paz","Aroma","Calamarca","CASA DE GOBIERNO",-68.08315,-16.96971,80,6,1022,1102,295,65,656,951
"Bolivia","La Paz","Aroma","Calamarca","ESC. CENTRAL CHORITOTORA",-68.08884,-16.84568,47,18,404,451,52,18,316,368
"Bolivia","La Paz","Aroma","Calamarca","ESCUELA EDUARDO AVAROA",-68.16341,-16.85044,63,6,540,603,122,14,398,520
"Bolivia","La Paz","Aroma","Calamarca","PLAZA 14 DE SEPTIEMBRE",-68.11526,-16.90584,131,25,1422,1553,612,49,736,1348
"Bolivia","La Paz","Aroma","Calamarca","PLAZA 16 DE JULIO",-68.13773,-16.78787,43,5,470,513,120,30,315,435
"Bolivia","La Paz","Aroma","Calamarca","PLAZA 6 DE AGOSTO",-68.17797,-16.79795,70,22,1143,1213,325,50,746,1071
"Bolivia","La Paz","Aroma","Calamarca","PLAZA PRINCIPAL",-68.14911,-16.99117,49,9,497,546,150,22,316,466
"Bolivia","La Paz","Aroma","Calamarca","PLAZA TOTORANI",-68.17602,-16.96187,71,4,406,477,107,11,284,391
"Bolivia","La Paz","Aroma","Calamarca","U.E. JUAN JOSÉ TORREZ",-68.08725,-16.75592,32,16,439,471,109,20,294,403
"Bolivia","La Paz","Aroma","Calamarca","UNIDAD EDUCATIVA FRANZ TAMAYO",-68.1254,-16.85869,19,6,361,380,68,11,276,344
"Bolivia","La Paz","Aroma","Calamarca","UNIDAD EDUCATIVA SUCANAVI",-68.07444,-16.93009,5,3,139,144,46,6,84,130
"Bolivia","La Paz","Aroma","Collana","CASA SOCIAL",-68.23739,-16.84444,9,0,188,197,31,4,153,184
"Bolivia","La Paz","Aroma","Collana","SEDE SOCIAL",-68.28757,-16.88153,164,24,1652,1816,594,60,974,1568
"Bolivia","La Paz","Aroma","Collana","SEDE SOCIAL",-68.28442,-16.90426,164,24,1652,1816,594,60,974,1568
"Bolivia","La Paz","Aroma","Colquencha","ESC. LADISLAO CABRERA",-68.20877,-16.87736,80,13,743,823,172,32,526,698
"Bolivia","La Paz","Aroma","Colquencha","ESCUELA LITORAL",-68.22531,-16.95084,14,0,184,198,40,5,139,179
"Bolivia","La Paz","Aroma","Colquencha","PLAZA 15 DE AGOSTO",-68.24931,-16.93275,132,25,1862,1994,575,84,1178,1753
"Bolivia","La Paz","Aroma","Colquencha","SEDE SOCIAL",-68.27126,-16.91852,61,20,907,968,286,24,577,863
"Bolivia","La Paz","Aroma","Patacamaya","CASA DE GOBIERNO",-67.87502,-17.19816,27,2,300,327,48,8,242,290
"Bolivia","La Paz","Aroma","Patacamaya","COLEGIO 23 DE MARZO",-67.95469,-17.27477,20,0,487,507,90,11,386,476
"Bolivia","La Paz","Aroma","Patacamaya","COLEGIO FRANZ TAMAYO",-68.02139,-17.22715,53,16,546,599,109,17,404,513
"Bolivia","La Paz","Aroma","Patacamaya","ESC. ROBERTO PABON",-67.91753,-17.24177,967,89,6002,6969,1989,171,3753,5742
"Bolivia","La Paz","Aroma","Patacamaya","ESC. SECCIONAL JATUQUIRA",-67.85796,-17.26879,3,2,64,67,16,2,44,60
"Bolivia","La Paz","Aroma","Patacamaya","ESC. TAYPILLANGA",-67.90216,-17.30549,20,5,395,415,78,9,303,381
"Bolivia","La Paz","Aroma","Patacamaya","ESCUELA COLCHANI",-67.85081,-17.23891,3,15,432,435,85,21,311,396
"Bolivia","La Paz","Aroma","Patacamaya","NUCLEO EDUCATIVO BELEN IQUIACA",-67.94446,-17.1978,23,4,333,356,66,9,254,320
"Bolivia","La Paz","Aroma","Patacamaya","PLAZA 16 DE JULIO",-67.87547,-17.18134,28,3,398,426,80,12,303,383
"Bolivia","La Paz","Aroma","Patacamaya","SEDE MUNICIPAL",-67.82513,-17.22678,2,0,138,140,42,2,94,136
"Bolivia","La Paz","Aroma","Patacamaya","SEDE SOCIAL",-67.92398,-17.28475,43,11,434,477,94,15,314,408
"Bolivia","La Paz","Aroma","Patacamaya","SEDE SOCIAL",-67.9968,-17.24903,43,11,434,477,94,15,314,408
"Bolivia","La Paz","Aroma","Patacamaya","U.E. GERMAN BUSCH",-67.91753,-17.24177,40,5,484,524,210,11,258,468
"Bolivia","La Paz","Aroma","Patacamaya","UNIDAD EDUCATIVA MURUCHAPI",-67.82782,-17.13052,7,0,49,56,7,1,41,48
"Bolivia","La Paz","Aroma","Patacamaya","UNIDAD EDUCATIVA VISCACHANI",-67.9495,-17.17933,61,19,682,743,123,8,532,655
"Bolivia","La Paz","Aroma","Sica Sica (Villa Aroma)","CASA DE GOBIERNO",-67.8598,-17.34229,5,2,361,366,75,17,267,342
"Bolivia","La Paz","Aroma","Sica Sica (Villa Aroma)","COL. 6 DE JUNIO",-67.46742,-17.23661,2,0,151,153,0,0,151,151
"Bolivia","La Paz","Aroma","Sica Sica (Villa Aroma)","COLEGIO TAWANTINSUYO",-67.63738,-17.38684,11,2,371,382,79,8,282,361
"Bolivia","La Paz","Aroma","Sica Sica (Villa Aroma)","COL. NAL. SICA SICA",-67.7421,-17.33211,161,26,1285,1446,530,42,687,1217
"Bolivia","La Paz","Aroma","Sica Sica (Villa Aroma)","COL. TOMAS KATARI",-67.58031,-17.22041,2,3,305,307,21,7,274,295
"Bolivia","La Paz","Aroma","Sica Sica (Villa Aroma)","ESC. JOSE M. PANDO",-67.44505,-17.49286,61,3,447,508,87,4,353,440
"Bolivia","La Paz","Aroma","Sica Sica (Villa Aroma)","ESCUELA EDEN",-67.67335,-17.37538,276,32,2399,2675,700,96,1571,2271
"Bolivia","La Paz","Aroma","Sica Sica (Villa Aroma)","ESCUELA SIMON BOLIVAR",-67.5736,-17.39699,50,7,522,572,90,18,407,497
"Bolivia","La Paz","Aroma","Sica Sica (Villa Aroma)","PLAZA CANTON MACHACAMARCA",-67.59753,-17.45224,49,8,427,476,116,22,281,397
"Bolivia","La Paz","Aroma","Sica Sica (Villa Aroma)","PLAZA PRINCIPAL JARUMA",-67.57709,-17.26054,100,2,640,740,125,16,497,622
"Bolivia","La Paz","Aroma","Sica Sica (Villa Aroma)","PLAZA SAN FRANCISCO",-67.79234,-17.38375,27,1,222,249,40,1,180,220
"Bolivia","La Paz","Aroma","Sica Sica (Villa Aroma)","SEDE SOCIAL AYAMAYA",-67.7303,-17.3847,10,2,253,263,69,4,178,247
"Bolivia","La Paz","Aroma","Sica Sica (Villa Aroma)","UNIDAD EDUCATIVA BARTOLINA SISA A",-67.82572,-17.38552,17,1,191,208,34,1,155,189
"Bolivia","La Paz","Aroma","Sica Sica (Villa Aroma)","UNIDAD EDUCATIVA CHUACOLLO GRANDE",-67.6738,-17.2105,7,3,161,168,12,1,145,157
"Bolivia","La Paz","Aroma","Sica Sica (Villa Aroma)","UNIDAD EDUCATIVA CONANI",-67.52164,-17.43539,169,35,1726,1895,480,64,1147,1627
"Bolivia","La Paz","Aroma","Sica Sica (Villa Aroma)","UNIDAD EDUCATIVA PEDRO DOMINGO MURILLO",-67.51456,-17.48516,17,13,662,679,163,17,469,632
"Bolivia","La Paz","Aroma","Umala","CASA DE GOBIERNO",-67.9584,-17.4303,96,23,788,884,231,40,494,725
"Bolivia","La Paz","Aroma","Umala","CASA DE GOBIERNO",-68.03399,-17.33216,96,23,788,884,231,40,494,725
"Bolivia","La Paz","Aroma","Umala","COL. DE VENTILLA",-68.10613,-17.29234,21,5,312,333,68,9,230,298
"Bolivia","La Paz","Aroma","Umala","COL. NAL. MIXTO SAN JOSE",-67.93179,-17.39158,28,3,337,365,89,13,232,321
"Bolivia","La Paz","Aroma","Umala","ESCUELA SAN MIGUEL DE COPANI",-68.06709,-17.33392,32,8,248,280,45,14,181,226
"Bolivia","La Paz","Aroma","Umala","PLAZA 16 DE JULIO",-68.02159,-17.37343,77,9,478,555,133,18,318,451
"Bolivia","La Paz","Aroma","Umala","PLAZA HUARI BELEN 6 DE AGOSTO",-68.00945,-17.46336,69,2,428,497,79,6,341,420
"Bolivia","La Paz","Aroma","Umala","PLAZA VITUY VINTO",-68.17715,-17.36859,23,1,231,254,70,4,156,226
"Bolivia","La Paz","Aroma","Umala","SEDE SOCIAL",-68.11279,-17.35408,51,1,321,372,78,13,229,307
"Bolivia","La Paz","Aroma","Umala","U.E. KELLHUIRI",-68.15555,-17.32532,8,5,200,208,32,7,156,188
"Bolivia","La Paz","Aroma","Umala","UNIDAD EDUCATIVA LLANGA BELEN",-67.90632,-17.3479,35,4,238,273,89,8,137,226
"Bolivia","La Paz","Bautista Saavedra","Curva","CASA DE GOBIERNO",-69.03347,-15.10095,34,2,118,152,26,11,79,105
"Bolivia","La Paz","Bautista Saavedra","Curva","ESCUELA KAPNA",-68.90353,-14.95543,9,1,43,52,5,5,32,37
"Bolivia","La Paz","Bautista Saavedra","Curva","NUCLEO ESCOLAR UPINUAYA",-69.02789,-15.13118,18,4,86,104,13,2,67,80
"Bolivia","La Paz","Bautista Saavedra","Curva","RECINTO TAIPI CANUMA",-69.13345,-15.03614,0,0,189,189,18,2,169,187
"Bolivia","La Paz","Bautista Saavedra","Curva","SEDE COMUNAL",-68.87193,-14.87294,3,0,25,28,8,0,17,25
"Bolivia","La Paz","Bautista Saavedra","Curva","SEDE SOCIAL",-69.00313,-15.12604,65,8,255,320,52,25,170,222
"Bolivia","La Paz","Bautista Saavedra","Curva","SEDE SOCIAL",-69.00817,-15.12213,65,8,255,320,52,25,170,222
"Bolivia","La Paz","Bautista Saavedra","Curva","SEDE SOCIAL",-69.00968,-15.0953,65,8,255,320,52,25,170,222
"Bolivia","La Paz","Bautista Saavedra","General Juan José Pérez (Charazani)","CALLINSANI",-68.89539,-15.22253,22,8,153,175,21,4,120,141
"Bolivia","La Paz","Bautista Saavedra","General Juan José Pérez (Charazani)","CASA DE GOBIERNO",-68.94041,-15.13295,27,6,197,224,31,13,147,178
"Bolivia","La Paz","Bautista Saavedra","General Juan José Pérez (Charazani)","ESCUELA ATIQUE",-68.93712,-15.19225,7,3,64,71,7,1,53,60
"Bolivia","La Paz","Bautista Saavedra","General Juan José Pérez (Charazani)","ESCUELA CENTRAL MOYAPAMPA",-69.00706,-15.26653,22,2,132,154,28,11,91,119
"Bolivia","La Paz","Bautista Saavedra","General Juan José Pérez (Charazani)","ESCUELA CHARAZANI",-68.98535,-15.17054,116,31,590,706,130,41,388,518
"Bolivia","La Paz","Bautista Saavedra","General Juan José Pérez (Charazani)","ESCUELA GENERAL RAMON GONZALES",-69.0027,-15.19276,22,4,117,139,14,3,96,110
"Bolivia","La Paz","Bautista Saavedra","General Juan José Pérez (Charazani)","ESCUELA PAUJE YUYO",-68.45623,-15.05983,29,0,122,151,18,3,101,119
"Bolivia","La Paz","Bautista Saavedra","General Juan José Pérez (Charazani)","ESCUELA SECCIONAL CHARI",-69.041,-15.17468,0,4,141,141,13,8,116,129
"Bolivia","La Paz","Bautista Saavedra","General Juan José Pérez (Charazani)","ESCUELA SECCIONAL SIATHA",-68.68688,-15.20615,16,2,105,121,18,4,81,99
"Bolivia","La Paz","Bautista Saavedra","General Juan José Pérez (Charazani)","PLAZA 26 DE JULIO",-68.75932,-15.22727,16,3,91,107,15,9,64,79
"Bolivia","La Paz","Bautista Saavedra","General Juan José Pérez (Charazani)","PLAZA AMARKA",-69.05107,-15.22568,44,3,228,272,51,8,166,217
"Bolivia","La Paz","Bautista Saavedra","General Juan José Pérez (Charazani)","PLAZA PRINCIPAL AMARETE",-68.98066,-15.22867,121,26,1016,1137,156,49,785,941
"Bolivia","La Paz","Bautista Saavedra","General Juan José Pérez (Charazani)","SEDE SOCIAL",-69.00725,-15.14073,88,14,476,564,59,18,385,444
"Bolivia","La Paz","Bautista Saavedra","General Juan José Pérez (Charazani)","SEDE SOCIAL",-68.453,-15.13352,88,14,476,564,59,18,385,444
"Bolivia","La Paz","Bautista Saavedra","General Juan José Pérez (Charazani)","UNIDAD EDUCATIVA APACHETA",-69.12223,-15.14201,26,2,181,207,45,12,122,167
"Bolivia","La Paz","Bautista Saavedra","General Juan José Pérez (Charazani)","UNIDAD EDUCATIVA KALLURHUAYA",-68.84801,-15.1727,11,7,170,181,14,6,143,157
"Bolivia","La Paz","Camacho","Escoma","COLEGIO DON BOSCO",-69.1245,-15.64438,317,67,2520,2837,603,141,1709,2312
"Bolivia","La Paz","Camacho","Escoma","PLAZA 26 DE OCTUBRE",-69.15398,-15.6867,41,2,262,303,49,17,194,243
"Bolivia","La Paz","Camacho","Escoma","PLAZA PRINCIPAL",-69.16642,-15.65046,21,5,271,292,94,16,156,250
"Bolivia","La Paz","Camacho","Escoma","PLAZA PRINCIPAL DE COLLASUYO",-69.13799,-15.6649,1,2,121,122,30,0,89,119
"Bolivia","La Paz","Camacho","Humanata","COL. SAN FRANCISCO DE PADUA",-69.11379,-15.45604,246,62,1646,1892,381,165,1038,1419
"Bolivia","La Paz","Camacho","Humanata","COL. SANTA ANA DE CUTUCUTU",-69.18256,-15.43143,32,5,192,224,41,13,133,174
"Bolivia","La Paz","Camacho","Humanata","ESC. S.J. DE PACOLLO",-69.19728,-15.42445,13,1,220,233,58,7,154,212
"Bolivia","La Paz","Camacho","Mocomoco","COLEGIO CARIQUINA CHICO",-69.0692,-15.5392,21,3,133,154,24,9,97,121
"Bolivia","La Paz","Camacho","Mocomoco","COLEGIO TECNICO YOCARGUAYA",-69.0155,-15.58194,51,4,180,231,12,6,158,170
"Bolivia","La Paz","Camacho","Mocomoco","COL. SAN JOSE",-69.06486,-15.39754,19,7,352,371,84,15,246,330
"Bolivia","La Paz","Camacho","Mocomoco","COL. SAN LUIS WILA CALA",-69.04415,-15.35719,92,15,573,665,100,28,430,530
"Bolivia","La Paz","Camacho","Mocomoco","COL. TAJANI",-69.0649,-15.61726,37,14,438,475,105,30,289,394
"Bolivia","La Paz","Camacho","Mocomoco","ESC. QUILLIMA",-69.02345,-15.62034,14,0,363,377,73,14,276,349
"Bolivia","La Paz","Camacho","Mocomoco","ESC. SECCIONAL V. JACHATIRA",-69.03743,-15.53999,0,1,65,65,18,1,45,63
"Bolivia","La Paz","Camacho","Mocomoco","ESC. TUNTUNANI",-68.9683,-15.50293,24,3,102,126,18,2,79,97
"Bolivia","La Paz","Camacho","Mocomoco","ESC. UNIDAD EDUCATIVA PACAURES",-69.0611,-15.5844,67,25,528,595,83,21,399,482
"Bolivia","La Paz","Camacho","Mocomoco","NUCLEO ESCOLAR PUMANA",-69.02091,-15.51972,39,2,222,261,25,12,183,208
"Bolivia","La Paz","Camacho","Mocomoco","NÚCLEO ESCOLAR TAYPI AYCA",-69.08912,-15.5147,5,2,169,174,10,3,154,164
"Bolivia","La Paz","Camacho","Mocomoco","PLAZA MOCO MOCO",-68.99878,-15.45637,211,46,967,1178,262,78,581,843
"Bolivia","La Paz","Camacho","Mocomoco","PLAZA SANTIAGO DE ILAVE",-69.01241,-15.36129,79,19,464,543,75,23,347,422
"Bolivia","La Paz","Camacho","Mocomoco","SEDE SOCIAL",-69.08668,-15.61018,0,1,60,60,21,2,36,57
"Bolivia","La Paz","Camacho","Mocomoco","UNIDAD EDUCATIVA CAJCACHI",-69.0796,-15.59127,12,2,149,161,34,13,100,134
"Bolivia","La Paz","Camacho","Mocomoco","UNIDAD EDUCATIVA ITALAQUE",-69.04504,-15.47639,101,19,432,533,49,37,327,376
"Bolivia","La Paz","Camacho","Mocomoco","UNIDAD EDUCATIVA QUEÑI",-68.97206,-15.43503,56,8,199,255,60,15,116,176
"Bolivia","La Paz","Camacho","Puerto Acosta","COLEGIO NACIONAL MIXTO CHIÑAYA",-69.11092,-15.52736,89,24,447,536,102,29,292,394
"Bolivia","La Paz","Camacho","Puerto Acosta","COLEGIO NACIONAL SALLACUCHO",-69.20315,-15.49551,36,9,328,364,51,21,247,298
"Bolivia","La Paz","Camacho","Puerto Acosta","COL. NICOLAS ACOSTA",-69.25303,-15.53491,222,42,1690,1912,581,86,981,1562
"Bolivia","La Paz","Camacho","Puerto Acosta","ESC. COTA PATA",-69.21085,-15.61913,16,10,211,227,46,12,143,189
"Bolivia","La Paz","Camacho","Puerto Acosta","ESC. JUPANI",-69.25771,-15.49459,33,6,309,342,126,20,157,283
"Bolivia","La Paz","Camacho","Puerto Acosta","ESC. PUERTO BELEN",-69.28316,-15.59171,17,4,361,378,78,1,278,356
"Bolivia","La Paz","Camacho","Puerto Acosta","ESC. SECCIONAL CANCANANI",-69.10598,-15.479,9,2,56,65,4,0,50,54
"Bolivia","La Paz","Camacho","Puerto Acosta","ESCUELA CENTRO BELEN",-69.11071,-15.60047,19,6,232,251,68,10,148,216
"Bolivia","La Paz","Camacho","Puerto Acosta","ESCUELA CHACAHUARA",-69.31122,-15.49251,9,0,53,62,14,7,32,46
"Bolivia","La Paz","Camacho","Puerto Acosta","PLAZA PUERTO PARAJACHI",-69.20171,-15.62851,42,6,700,742,236,10,448,684
"Bolivia","La Paz","Camacho","Puerto Acosta","U.E. PARAJACHI II",-69.21049,-15.64598,12,0,147,159,41,6,100,141
"Bolivia","La Paz","Camacho","Puerto Acosta","UNIDAD EDUCATIVA CENTRO CALANGACHI",-69.25439,-15.63603,28,2,165,193,52,0,111,163
"Bolivia","La Paz","Camacho","Puerto Acosta","UNIDAD EDUCATIVA ORURILLO",-69.31892,-15.53868,9,2,144,153,58,8,76,134
"Bolivia","La Paz","Camacho","Puerto Carabuco","COLEGIO COTAÑANI",-68.96169,-15.61601,16,3,131,147,24,2,102,126
"Bolivia","La Paz","Camacho","Puerto Carabuco","COLEGIO MARTIN CARDENAS",-69.03745,-15.78911,215,25,1074,1289,355,64,630,985
"Bolivia","La Paz","Camacho","Puerto Carabuco","COLEGIO NACIONAL MIXTO CHUANI",-68.98556,-15.64204,33,7,347,380,75,23,242,317
"Bolivia","La Paz","Camacho","Puerto Carabuco","COLEGIO PASARANI",-68.9835,-15.57729,104,15,468,572,97,19,337,434
"Bolivia","La Paz","Camacho","Puerto Carabuco","ESC. MCAL. SUCRE",-68.96303,-15.6083,89,10,495,584,65,32,388,453
"Bolivia","La Paz","Camacho","Puerto Carabuco","ESC. S. M. DE YARICOA",-69.08703,-15.67951,28,8,232,260,50,22,152,202
"Bolivia","La Paz","Camacho","Puerto Carabuco","ESCUELA HUILACUNCA",-68.94692,-15.56903,62,19,296,358,53,13,211,264
"Bolivia","La Paz","Camacho","Puerto Carabuco","PLAZA PRINCIPAL COPUSQUIA",-68.95209,-15.66244,66,9,476,542,56,19,392,448
"Bolivia","La Paz","Camacho","Puerto Carabuco","PLAZA SISASANI",-68.98576,-15.81754,53,7,351,404,75,17,252,327
"Bolivia","La Paz","Camacho","Puerto Carabuco","UNID.EDU. URSULA GOYZUETA",-69.0638,-15.75902,216,37,1524,1740,381,83,1023,1404
"Bolivia","La Paz","Caranavi","Alto Beni","ESC. C. BELLA VISTA",-67.42459,-15.62154,67,6,483,550,130,30,317,447
"Bolivia","La Paz","Caranavi","Alto Beni","ESC. N. SARARIA",-67.51301,-15.39834,90,4,481,571,114,35,328,442
"Bolivia","La Paz","Caranavi","Alto Beni","ESCUELA CASERIO NUEVE",-67.39796,-15.59869,56,0,316,372,66,8,242,308
"Bolivia","La Paz","Caranavi","Alto Beni","ESCUELA PIQUENDO",-67.38728,-15.59628,95,6,638,733,128,28,476,604
"Bolivia","La Paz","Caranavi","Alto Beni","LOCAL AMAS DE CASA",-67.44894,-15.54566,31,7,227,258,60,3,157,217
"Bolivia","La Paz","Caranavi","Alto Beni","N. ESC. SAN ANTONIO",-67.17532,-15.6578,167,13,929,1096,154,21,741,895
"Bolivia","La Paz","Caranavi","Alto Beni","SEDE SOCIAL",-67.44275,-15.55506,107,14,577,684,138,15,410,548
"Bolivia","La Paz","Caranavi","Alto Beni","SEDE SOCIAL",-67.46413,-15.481,107,14,577,684,138,15,410,548
"Bolivia","La Paz","Caranavi","Alto Beni","UNIDAD EDUCATIVA PUENTE ALTO BENI",-67.3764,-15.56314,13,5,146,159,24,4,113,137
"Bolivia","La Paz","Caranavi","Alto Beni","UNIDAD EDUCATIVA VILLA EL PORVENIR",-67.24788,-15.60961,26,1,313,339,35,7,270,305
"Bolivia","La Paz","Caranavi","Alto Beni","UNIDAD EDUCATIVA VILLA LITORAL",-67.24664,-15.60868,20,4,266,286,22,11,229,251
"Bolivia","La Paz","Caranavi","Caranavi","COL. GUILLERMO MOLINA",-67.44241,-15.77615,204,14,911,1115,133,27,737,870
"Bolivia","La Paz","Caranavi","Caranavi","COL. JHON F. KENEDDY",-67.56451,-15.83448,1199,55,4839,6038,1946,141,2697,4643
"Bolivia","La Paz","Caranavi","Caranavi","COL. LOS ANDES",-67.57357,-15.75793,59,7,519,578,86,6,420,506
"Bolivia","La Paz","Caranavi","Caranavi","COL. MADRE MARIA FEDERICA",-67.56628,-15.83424,728,47,3533,4261,1531,105,1850,3381
"Bolivia","La Paz","Caranavi","Caranavi","COL. SAN LORENZO",-67.50715,-15.79369,95,5,903,998,129,23,746,875
"Bolivia","La Paz","Caranavi","Caranavi","ESC. CARRASCO LA RESERVA",-67.51271,-15.73402,199,20,1453,1652,153,38,1242,1395
"Bolivia","La Paz","Caranavi","Caranavi","ESC. C. DE CHOJNA",-67.56999,-15.95466,14,1,259,273,55,4,199,254
"Bolivia","La Paz","Caranavi","Caranavi","ESC. F. INCAHUARA",-67.59956,-15.97782,16,0,55,71,3,1,51,54
"Bolivia","La Paz","Caranavi","Caranavi","ESC. MSCAL. SANTA CRUZ",-67.4963,-15.74751,69,9,397,466,35,7,346,381
"Bolivia","La Paz","Caranavi","Caranavi","ESC. N. CHORO",-67.63139,-16.03343,23,2,133,156,36,4,91,127
"Bolivia","La Paz","Caranavi","Caranavi","ESC. P. DOMINGO MURILLO",-67.47856,-15.93649,263,19,1631,1894,334,55,1223,1557
"Bolivia","La Paz","Caranavi","Caranavi","ESC. SAN PEDRO",-67.61211,-16.00981,19,1,102,121,4,7,90,94
"Bolivia","La Paz","Caranavi","Caranavi","ESC. SECCIONAL SANTA ANA",-67.54862,-15.89038,73,9,367,440,57,10,291,348
"Bolivia","La Paz","Caranavi","Caranavi","ESC. SIMON BOLIVAR",-67.59677,-15.62007,162,19,770,932,136,33,582,718
"Bolivia","La Paz","Caranavi","Caranavi","ESC. TUPAC KATARI",-67.4232,-15.8093,84,8,484,568,66,13,397,463
"Bolivia","La Paz","Caranavi","Caranavi","ESCUELA CENTRAL VILLAMONTES",-67.31539,-15.8295,44,2,262,306,34,4,222,256
"Bolivia","La Paz","Caranavi","Caranavi","ESCUELA SIMON BOLIVAR DE SANTA FE",-67.62475,-15.80753,84,4,524,608,143,16,361,504
"Bolivia","La Paz","Caranavi","Caranavi","ESC. UYUNENSE",-67.58036,-15.86842,53,10,419,472,68,19,322,390
"Bolivia","La Paz","Caranavi","Caranavi","INSTITUTO AMERICANO",-67.56655,-15.8344,19,0,69,88,31,2,36,67
"Bolivia","La Paz","Caranavi","Caranavi","SEDE SOCIAL",-67.60384,-15.68305,170,6,1140,1310,137,75,922,1059
"Bolivia","La Paz","Caranavi","Caranavi","SEDE SOCIAL",-67.67484,-15.74946,170,6,1140,1310,137,75,922,1059
"Bolivia","La Paz","Caranavi","Caranavi","SEDE SOCIAL",-67.62841,-15.68759,170,6,1140,1310,137,75,922,1059
"Bolivia","La Paz","Caranavi","Caranavi","U. E. RENE ZENON PORTILLO CHAVARRIA",-67.54003,-15.77183,34,1,279,313,66,7,205,271
"Bolivia","La Paz","Caranavi","Caranavi","U.E. SUAZO",-67.56655,-15.8344,17,1,86,103,34,4,47,81
"Bolivia","La Paz","Caranavi","Caranavi","U.E. VENEZUELA",-67.56655,-15.8344,22,1,87,109,24,3,59,83
"Bolivia","La Paz","Caranavi","Caranavi","UNIDAD EDUCATIVA MANCHEGO",-67.60762,-15.852,15,1,163,178,60,2,100,160
"Bolivia","La Paz","Caranavi","Caranavi","UNIDAD EDUCATIVA NUEVA LLUSTA 2DA",-67.39731,-15.85297,51,3,317,368,38,7,269,307
"Bolivia","La Paz","Caranavi","Caranavi","UNIDAD EDUCATIVA SIMON BOLIVAR",-67.55769,-15.83356,647,26,2798,3445,1060,84,1628,2688
"Bolivia","La Paz","Franz Tamayo","Apolo","ESC. CENTRAL ATEN",-68.33105,-14.93176,44,8,245,289,139,17,81,220
"Bolivia","La Paz","Franz Tamayo","Apolo","ESC. CENTRAL INCA",-68.43272,-14.81314,49,6,240,289,75,11,148,223
"Bolivia","La Paz","Franz Tamayo","Apolo","ESC. MACHUA",-68.41223,-14.66684,25,7,162,187,56,13,86,142
"Bolivia","La Paz","Franz Tamayo","Apolo","ESC. MOJOS",-68.89278,-14.56084,2,2,25,27,5,1,17,22
"Bolivia","La Paz","Franz Tamayo","Apolo","ESC. NAZARIO PARDO VALLE",-68.51307,-14.63398,1132,137,4104,5236,2147,188,1632,3779
"Bolivia","La Paz","Franz Tamayo","Apolo","ESC. NAZARIO PARDO VALLE",-68.41825,-14.71928,1132,137,4104,5236,2147,188,1632,3779
"Bolivia","La Paz","Franz Tamayo","Apolo","ESC. PATA SAN ANTONIO",-68.65208,-14.56562,0,2,102,102,34,19,47,81
"Bolivia","La Paz","Franz Tamayo","Apolo","ESC. PUCHAHUI",-68.44442,-14.86157,75,6,378,453,168,16,188,356
"Bolivia","La Paz","Franz Tamayo","Apolo","ESC. SANTA CATALINA",-68.49142,-14.74016,99,15,363,462,130,23,195,325
"Bolivia","La Paz","Franz Tamayo","Apolo","ESCUELA CORREO",-68.44034,-14.95642,21,2,164,185,12,1,149,161
"Bolivia","La Paz","Franz Tamayo","Apolo","ESCUELA MUNAYPATA",-68.30943,-15.0214,50,5,222,272,78,4,135,213
"Bolivia","La Paz","Franz Tamayo","Apolo","UNIDADA EDUCATIVA TOREWA",-67.5419,-14.5968,45,0,21,66,8,1,12,20
"Bolivia","La Paz","Franz Tamayo","Apolo","UNIDAD EDUCATIVA INDIGENA TOREWA",-67.60982,-14.71774,15,0,18,33,3,1,14,17
"Bolivia","La Paz","Franz Tamayo","Pelechuco","ESC. CANTON SUCHES",-69.33424,-14.81951,38,3,173,211,78,7,85,163
"Bolivia","La Paz","Franz Tamayo","Pelechuco","ESC. COL. FRANZ TAMAYO",-69.27006,-15.06253,54,11,433,487,172,26,224,396
"Bolivia","La Paz","Franz Tamayo","Pelechuco","ESC. NAZARIO PARDO VALLE",-69.06972,-14.82036,100,13,606,706,249,34,310,559
"Bolivia","La Paz","Franz Tamayo","Pelechuco","ESC. PUINA",-69.13412,-14.61019,14,0,90,104,22,4,64,86
"Bolivia","La Paz","Franz Tamayo","Pelechuco","ESCUELA AGUA BLANCA",-69.10895,-14.8218,16,3,163,179,64,5,91,155
"Bolivia","La Paz","Franz Tamayo","Pelechuco","ESCUELA DE PUYO PUYO",-69.17246,-14.99942,13,2,171,184,106,3,60,166
"Bolivia","La Paz","Franz Tamayo","Pelechuco","ESCUELA SAN MIGUEL DE THAPI",-68.93021,-14.77682,19,0,103,122,63,4,36,99
"Bolivia","La Paz","Franz Tamayo","Pelechuco","ESCUELA SORAPATA",-68.97952,-14.79948,19,2,110,129,53,9,46,99
"Bolivia","La Paz","Franz Tamayo","Pelechuco","IGLESIA COPACABANA DE ANTIQUILLA",-69.28759,-14.88028,36,9,281,317,68,9,195,263
"Bolivia","La Paz","Franz Tamayo","Pelechuco","NUCLEO  EDUCATIVO HICHOCOLLO",-69.29661,-14.95523,12,2,220,232,70,14,134,204
"Bolivia","La Paz","Franz Tamayo","Pelechuco","SEDE DEL SINDICATO",-69.02939,-14.9247,73,2,278,351,81,27,168,249
"Bolivia","La Paz","General Jose Manuel","Catacora","ESC. THOLA COLLO",-69.55451,-17.23441,14,0,78,92,16,2,60,76
"Bolivia","La Paz","General Jose Manuel","Catacora","NUCLEO ESCOLAR CATACORA",-69.48728,-17.16064,40,0,187,227,37,6,144,181
"Bolivia","La Paz","General Jose Manuel","Catacora","NUCLEO ESCOLAR PAIRUMANI GRANDE",-69.4282,-17.32692,9,1,85,94,19,3,62,81
"Bolivia","La Paz","General Jose Manuel","Catacora","PLAZA 6 DE AGOSTO",-69.46824,-17.29597,7,1,84,91,6,0,77,83
"Bolivia","La Paz","General Jose Manuel","Santiago de Machaca","COLEGIO BAUTISTA SAAVEDRA",-69.25512,-17.206,42,0,100,142,10,1,89,99
"Bolivia","La Paz","General Jose Manuel","Santiago de Machaca","COLEGIO PEDRO KRAMER",-69.21403,-17.28709,14,0,49,63,13,1,35,48
"Bolivia","La Paz","General Jose Manuel","Santiago de Machaca","ESCUELA ATACUNI",-69.15105,-17.17518,5,0,54,59,2,0,52,54
"Bolivia","La Paz","General Jose Manuel","Santiago de Machaca","ESCUELA CENTRAL HUARI PHUJO",-69.04736,-17.13798,6,0,82,88,7,1,74,81
"Bolivia","La Paz","General Jose Manuel","Santiago de Machaca","ESCUELA SANTIAGO DE MACHACA",-69.19207,-17.06675,244,25,1208,1452,220,32,931,1151
"Bolivia","La Paz","General Jose Manuel","Santiago de Machaca","PLAZA VILLA EXALTACION",-69.27541,-17.24455,4,0,125,129,18,0,107,125
"Bolivia","La Paz","Gualberto Villarroel","Chacarilla","ESC. PUERTO AROMA",-68.16104,-17.46223,8,3,204,212,42,6,153,195
"Bolivia","La Paz","Gualberto Villarroel","Chacarilla","PLAZA CHACARILLA",-68.20435,-17.58085,53,1,279,332,47,10,221,268
"Bolivia","La Paz","Gualberto Villarroel","Chacarilla","PLAZA ROSAPATA",-68.10223,-17.49878,25,2,262,287,43,8,209,252
"Bolivia","La Paz","Gualberto Villarroel","Papel Pampa","CASA DE GOBIERNO",-67.82444,-17.66832,94,16,772,866,170,18,568,738
"Bolivia","La Paz","Gualberto Villarroel","Papel Pampa","CASA DE GOBIERNO",-67.76893,-17.81909,94,16,772,866,170,18,568,738
"Bolivia","La Paz","Gualberto Villarroel","Papel Pampa","ESC. TITUZA",-67.57115,-17.60931,9,2,88,97,17,3,66,83
"Bolivia","La Paz","Gualberto Villarroel","Papel Pampa","ESCUELA CIRCA CRUZANI",-67.62467,-17.71481,2,0,65,67,7,1,57,64
"Bolivia","La Paz","Gualberto Villarroel","Papel Pampa","ESCUELA COLQUE AMAYA ALTA",-67.78625,-17.57081,14,4,266,280,51,8,203,254
"Bolivia","La Paz","Gualberto Villarroel","Papel Pampa","PLAZA MOLLEBAMBA",-67.82986,-17.73928,55,7,622,677,123,15,477,600
"Bolivia","La Paz","Gualberto Villarroel","Papel Pampa","PLAZA PRINCIPAL UNO PATA",-67.71118,-17.69406,54,4,417,471,88,16,309,397
"Bolivia","La Paz","Gualberto Villarroel","Papel Pampa","PLAZA RIVERA ALTA",-67.66396,-17.59161,15,2,271,286,98,8,163,261
"Bolivia","La Paz","Gualberto Villarroel","Papel Pampa","SEDE SINDICAL",-67.6296,-17.74787,3,0,72,75,10,0,62,72
"Bolivia","La Paz","Gualberto Villarroel","Papel Pampa","SEDE SOCIAL CAYLLA CHURO",-67.56867,-17.6794,4,0,50,54,8,0,42,50
"Bolivia","La Paz","Gualberto Villarroel","Papel Pampa","UNIDAD EDUCATIVA PACOLLO",-67.8727,-17.78063,3,0,129,132,9,2,118,127
"Bolivia","La Paz","Gualberto Villarroel","Papel Pampa","UNIDAD EDUCATIVA SAN JOSE",-67.75399,-17.72414,25,4,183,208,53,2,124,177
"Bolivia","La Paz","Gualberto Villarroel","San Pedro de Curahuara","CASA COMUNAL",-68.05531,-17.53329,3,3,87,90,23,1,60,83
"Bolivia","La Paz","Gualberto Villarroel","San Pedro de Curahuara","CASA DE GOBIERNO",-68.04781,-17.65329,75,4,516,591,52,16,444,496
"Bolivia","La Paz","Gualberto Villarroel","San Pedro de Curahuara","COLEGIO HERNANDO SILES",-67.91642,-17.5809,79,6,530,609,52,21,451,503
"Bolivia","La Paz","Gualberto Villarroel","San Pedro de Curahuara","COLEGIO LUIS ESPINAL",-67.98427,-17.54257,46,1,377,423,30,2,344,374
"Bolivia","La Paz","Gualberto Villarroel","San Pedro de Curahuara","COLEGIO WISCO KARI",-67.96583,-17.72286,6,0,425,431,121,9,295,416
"Bolivia","La Paz","Gualberto Villarroel","San Pedro de Curahuara","ESC. CHILAGUALA",-68.01054,-17.47809,10,0,89,99,9,2,78,87
"Bolivia","La Paz","Gualberto Villarroel","San Pedro de Curahuara","ESC. JUAN CANCIO COLQUE",-68.10113,-17.65724,4,0,38,42,11,2,25,36
"Bolivia","La Paz","Gualberto Villarroel","San Pedro de Curahuara","PLAZA JANKO MARCA",-67.87048,-17.66836,0,0,397,397,0,4,393,393
"Bolivia","La Paz","Gualberto Villarroel","San Pedro de Curahuara","PLAZA PEDRO DOMINGO MURILLO",-67.87997,-17.63544,9,0,368,377,86,3,279,365
"Bolivia","La Paz","Gualberto Villarroel","San Pedro de Curahuara","PLAZA ROSARIO",-67.8949,-17.73604,4,0,313,317,5,20,288,293
"Bolivia","La Paz","Gualberto Villarroel","San Pedro de Curahuara","SEDE SINDICAL",-67.83096,-17.56285,0,2,88,88,5,3,78,83
"Bolivia","La Paz","Ingaví","Desaguadero","COL. BATALLON COLORADOS",-69.03388,-16.56696,310,26,2535,2845,1635,66,808,2443
"Bolivia","La Paz","Ingaví","Desaguadero","ESC. AZAFRANAL",-68.99149,-16.58226,27,3,289,316,90,6,190,280
"Bolivia","La Paz","Ingaví","Desaguadero","ESC. MCAL. ANDRES DE SANTA CRUZ",-68.95457,-16.58847,57,12,463,520,112,29,310,422
"Bolivia","La Paz","Ingaví","Desaguadero","UNIDAD EDUCATIVA SIMÓN BOLÍVAR",-68.93962,-16.63942,19,5,143,162,54,11,73,127
"Bolivia","La Paz","Ingaví","Guaqui","COLEGIO DANIEL SANCHEZ BUSTAMANTE",-68.83635,-16.59753,162,19,780,942,234,43,484,718
"Bolivia","La Paz","Ingaví","Guaqui","COL. TOMAS KATARI",-68.79683,-16.58405,165,47,1601,1766,335,59,1160,1495
"Bolivia","La Paz","Ingaví","Guaqui","ESC. ISMAEL MONTES",-68.85074,-16.59324,223,17,873,1096,281,41,534,815
"Bolivia","La Paz","Ingaví","Guaqui","UNIDAD EDUCATIVA WILACOLLO",-68.91432,-16.59871,17,4,168,185,38,9,117,155
"Bolivia","La Paz","Ingaví","Jesús de Machaca","COLEGIO CHAMA",-68.57966,-16.79505,17,6,292,309,78,10,198,276
"Bolivia","La Paz","Ingaví","Jesús de Machaca","COL. HOLANDA",-68.89614,-16.80193,38,7,415,453,110,18,280,390
"Bolivia","La Paz","Ingaví","Jesús de Machaca","COL. MEJILLONES",-68.80325,-16.82421,16,6,304,320,81,7,210,291
"Bolivia","La Paz","Ingaví","Jesús de Machaca","COL. REP. DE NORUEGA",-68.74157,-16.77844,31,15,376,407,98,8,255,353
"Bolivia","La Paz","Ingaví","Jesús de Machaca","ESC. FRANZ TAMAYO",-68.61249,-16.78762,0,2,107,107,22,3,80,102
"Bolivia","La Paz","Ingaví","Jesús de Machaca","ESC. NUCLEO CUIPA ESPANA DE MACHACA",-68.63845,-16.79134,4,6,273,277,27,9,231,258
"Bolivia","La Paz","Ingaví","Jesús de Machaca","ESC. SAN FELIPE DE CORPA",-68.8671,-16.67783,73,4,955,1028,135,36,780,915
"Bolivia","La Paz","Ingaví","Jesús de Machaca","ESC. SECC. KHONKHO",-68.67211,-16.7936,21,2,140,161,30,4,104,134
"Bolivia","La Paz","Ingaví","Jesús de Machaca","ESCUELA GERMAN BUSCH",-68.70154,-16.77555,22,4,334,356,62,9,259,321
"Bolivia","La Paz","Ingaví","Jesús de Machaca","PLAZA DEL PUEBLO",-68.76755,-16.77356,29,4,331,360,61,6,260,321
"Bolivia","La Paz","Ingaví","Jesús de Machaca","PLAZA PRINCIPAL",-68.80595,-16.74199,77,18,635,712,164,15,438,602
"Bolivia","La Paz","Ingaví","Jesús de Machaca","PLAZA VILLA ASUNCION DE MACHACA",-68.85337,-16.69936,27,2,378,405,95,6,275,370
"Bolivia","La Paz","Ingaví","Jesús de Machaca","POSTA SANITARIA",-68.63844,-16.84721,33,10,168,201,35,5,118,153
"Bolivia","La Paz","Ingaví","Jesús de Machaca","SEDE SOCIAL",-68.83674,-16.71817,33,7,428,461,93,24,304,397
"Bolivia","La Paz","Ingaví","Jesús de Machaca","SEDE SOCIAL",-68.5472,-16.81992,33,7,428,461,93,24,304,397
"Bolivia","La Paz","Ingaví","San Andrés de Machaca","COLEGIO BOLIVIANO JAPONES",-68.95058,-17.02766,46,3,171,217,17,3,148,165
"Bolivia","La Paz","Ingaví","San Andrés de Machaca","COLEGIO TUPAK KATARI DE CONCHACOLLO",-68.99821,-16.7345,10,1,257,267,59,5,192,251
"Bolivia","La Paz","Ingaví","San Andrés de Machaca","COL. VILLA PUSUMA ALTO MACHACA",-69.16449,-16.80326,23,3,153,176,17,2,131,148
"Bolivia","La Paz","Ingaví","San Andrés de Machaca","ESC. FRANZ TAMAYO",-69.09547,-16.73553,23,1,96,119,7,1,87,94
"Bolivia","La Paz","Ingaví","San Andrés de Machaca","ESC. LITORAL CHUNCARCOTA",-69.02103,-16.79199,9,3,127,136,23,6,95,118
"Bolivia","La Paz","Ingaví","San Andrés de Machaca","ESC. NUCLEO LAQUINAMAYA",-69.19246,-16.94843,43,3,238,281,47,3,185,232
"Bolivia","La Paz","Ingaví","San Andrés de Machaca","ESCUELA DE SAN ANDRES DE MACHACA",-68.96825,-16.95646,100,9,355,455,69,17,260,329
"Bolivia","La Paz","Ingaví","San Andrés de Machaca","PLAZA PRINCIPAL",-68.76829,-16.93683,21,8,169,190,51,4,106,157
"Bolivia","La Paz","Ingaví","San Andrés de Machaca","SEDE SOCIAL(COMUNIDAD MAURI)",-69.13435,-16.83909,10,1,110,120,16,0,93,109
"Bolivia","La Paz","Ingaví","San Andrés de Machaca","UNIDAD EDUCATIVA ANTAQUIRANI",-69.07945,-16.8683,4,1,79,83,20,1,57,77
"Bolivia","La Paz","Ingaví","San Andrés de Machaca","UNIDAD EDUCATIVA ROSA PATA ERBEN KALLA",-68.91935,-16.83392,9,1,143,152,27,7,108,135
"Bolivia","La Paz","Ingaví","Taraco","COL. NUCLEO FRAY JOSE ZAMPA",-68.82944,-16.43332,24,6,212,236,37,4,165,202
"Bolivia","La Paz","Ingaví","Taraco","COL. OVANDO CANDIA",-68.94234,-16.44834,40,16,562,602,90,30,426,516
"Bolivia","La Paz","Ingaví","Taraco","ESC. TARACO",-68.8576,-16.45572,158,24,1348,1506,269,60,995,1264
"Bolivia","La Paz","Ingaví","Taraco","SEDE SOCIAL",-68.79443,-16.43522,6,6,229,235,47,9,167,214
"Bolivia","La Paz","Ingaví","Tiahuanacu","COLEGIO JOSE BALLIVIAN",-68.74157,-16.44234,90,17,1170,1260,212,55,886,1098
"Bolivia","La Paz","Ingaví","Tiahuanacu","COLEGIO NACIONAL ARTURO POSNANSKI",-68.67873,-16.55647,311,56,3225,3536,900,175,2094,2994
"Bolivia","La Paz","Ingaví","Tiahuanacu","ESC. CENTRAL PILLAPI",-68.7683,-16.5035,57,13,957,1014,225,31,688,913
"Bolivia","La Paz","Ingaví","Viacha","CASA DE GOBIERNO",-68.25248,-16.80821,19,5,177,196,41,12,119,160
"Bolivia","La Paz","Ingaví","Viacha","COLEGIO BALLIVIAN",-68.29795,-16.65053,1101,111,8727,9828,3309,320,4987,8296
"Bolivia","La Paz","Ingaví","Viacha","COLEGIO JHONN F. KENNEDI",-68.17124,-16.77349,53,16,692,745,183,30,463,646
"Bolivia","La Paz","Ingaví","Viacha","COL. HACIA EL MAR",-68.24142,-16.75815,55,16,601,656,101,37,447,548
"Bolivia","La Paz","Ingaví","Viacha","COL. NAL. MIXTO CALAMA",-68.30962,-16.82777,32,14,398,430,93,17,274,367
"Bolivia","La Paz","Ingaví","Viacha","ESC. 18 DE NOVIEMBRE",-68.2989,-16.64955,463,43,3785,4248,1450,129,2163,3613
"Bolivia","La Paz","Ingaví","Viacha","ESC. ACHICA ARRIBA",-68.18732,-16.71439,48,6,767,815,179,47,535,714
"Bolivia","La Paz","Ingaví","Viacha","ESC. CENTRO TILATA",-68.23033,-16.58882,888,115,10123,11011,2890,388,6730,9620
"Bolivia","La Paz","Ingaví","Viacha","ESC. EVARISTO VALLE",-68.29871,-16.65074,563,69,5014,5577,1890,189,2866,4756
"Bolivia","La Paz","Ingaví","Viacha","ESC. SAN LUIS",-68.29977,-16.65029,379,32,3724,4103,1550,114,2028,3578
"Bolivia","La Paz","Ingaví","Viacha","ESC. VILIROCO",-68.24899,-16.61097,246,33,3367,3613,817,195,2322,3139
"Bolivia","La Paz","Ingaví","Viacha","PLAZA JOSE BALLIVIAN",-68.23183,-16.8031,20,5,309,329,87,11,206,293
"Bolivia","La Paz","Ingaví","Viacha","PLAZA PRINCIPAL",-68.42336,-16.81759,51,2,256,307,57,7,190,247
"Bolivia","La Paz","Ingaví","Viacha","SAN PEDRO DE CHONCHOCORO",-68.29809,-16.65042,18,0,111,129,62,1,48,110
"Bolivia","La Paz","Ingaví","Viacha","SEDE SOCIAL",-68.37337,-16.87176,4,4,160,164,37,6,113,150
"Bolivia","La Paz","Ingaví","Viacha","UNIDAD EDUCATIVA BATALLA DE INGAVI",-68.24085,-16.63196,15,3,58,73,20,1,34,54
"Bolivia","La Paz","Ingaví","Viacha","UNIDAD EDUCATIVA LITORAL",-68.29734,-16.85302,31,5,262,293,54,7,196,250
"Bolivia","La Paz","Ingaví","Viacha","UNIDAD EDUCATIVA TONCOPUJIO",-68.29401,-16.8719,6,4,160,166,18,4,134,152
"Bolivia","La Paz","Inquisivi","Cajuata","CASA DE GOBIERNO",-67.1912,-16.74741,128,24,1066,1194,132,26,884,1016
"Bolivia","La Paz","Inquisivi","Cajuata","CASA DE GOBIERNO",-67.26615,-16.62763,128,24,1066,1194,132,26,884,1016
"Bolivia","La Paz","Inquisivi","Cajuata","ESCUELA",-67.28862,-16.5991,62,11,374,436,60,10,293,353
"Bolivia","La Paz","Inquisivi","Cajuata","ESCUELA HUARITOLO",-67.20372,-16.72687,51,15,364,415,59,14,276,335
"Bolivia","La Paz","Inquisivi","Cajuata","UNIDAD EDUCATIVA CIRCUATA",-67.23114,-16.64647,97,18,808,905,155,35,600,755
"Bolivia","La Paz","Inquisivi","Cajuata","UNIDAD EDUCATIVA MIGUILLAS",-67.33664,-16.55579,55,5,357,412,25,1,326,351
"Bolivia","La Paz","Inquisivi","Cajuata","UNIDA EDUCATIVA CAJUATA",-67.17103,-16.69801,262,62,1722,1984,366,64,1230,1596
"Bolivia","La Paz","Inquisivi","Colquiri","CASA DE GOBIERNO",-66.98113,-17.55202,98,51,737,835,156,45,485,641
"Bolivia","La Paz","Inquisivi","Colquiri","CASA DE GOBIERNO",-66.90228,-17.38338,98,51,737,835,156,45,485,641
"Bolivia","La Paz","Inquisivi","Colquiri","CASA DE GOBIERNO",-66.93718,-17.58477,98,51,737,835,156,45,485,641
"Bolivia","La Paz","Inquisivi","Colquiri","COLEGIO ALTO DE LA ALIANZA",-66.8511,-17.5196,23,4,259,282,57,41,157,214
"Bolivia","La Paz","Inquisivi","Colquiri","COLEGIO SIMON BOLIVAR",-66.99767,-17.44226,62,12,553,615,114,31,396,510
"Bolivia","La Paz","Inquisivi","Colquiri","ESC. SIMON BOLIVAR",-66.9579,-17.54244,19,3,161,180,39,9,110,149
"Bolivia","La Paz","Inquisivi","Colquiri","ESCUELA ANICETO ARCE",-66.87982,-17.35054,24,9,205,229,37,7,152,189
"Bolivia","La Paz","Inquisivi","Colquiri","ESCUELA CAQUENA ENTRE RIOS",-67.00492,-17.32234,21,0,222,243,12,2,208,220
"Bolivia","La Paz","Inquisivi","Colquiri","ESCUELA CENTRAL UYUNI",-66.91545,-17.44477,39,37,280,319,68,20,155,223
"Bolivia","La Paz","Inquisivi","Colquiri","ESCUELA JOSE MIGUEL LANZA",-66.94537,-17.36096,80,19,618,698,119,13,467,586
"Bolivia","La Paz","Inquisivi","Colquiri","ESCUELA PIPINI",-66.92647,-17.48633,25,3,191,216,45,11,132,177
"Bolivia","La Paz","Inquisivi","Colquiri","ESCUELA SECCIONAL CHUALLA",-66.86385,-17.45984,11,0,157,168,31,4,122,153
"Bolivia","La Paz","Inquisivi","Colquiri","ESCUELA SECCIONAL CORIRI",-66.86787,-17.39233,15,3,92,107,14,4,71,85
"Bolivia","La Paz","Inquisivi","Colquiri","LADISLAO CABRERA",-67.13279,-17.38032,344,57,2869,3213,1250,153,1409,2659
"Bolivia","La Paz","Inquisivi","Colquiri","U.E. MARISCAL DE ZEPITA",-67.12341,-17.3896,174,29,1489,1663,602,68,790,1392
"Bolivia","La Paz","Inquisivi","Colquiri","UNIDAD EDUCATIVA MARQUIRIVI",-66.84624,-17.48428,16,0,205,221,37,3,165,202
"Bolivia","La Paz","Inquisivi","Ichoca","CASA DE GOBIERNO",-67.28601,-17.123,4,6,107,111,30,3,68,98
"Bolivia","La Paz","Inquisivi","Ichoca","ESC. CENTRAL LURUTA",-67.12575,-17.23102,29,3,156,185,43,3,107,150
"Bolivia","La Paz","Inquisivi","Ichoca","ESCUELA JOSE ANTONIO DE SUCRE",-67.30527,-17.25527,13,6,321,334,38,8,269,307
"Bolivia","La Paz","Inquisivi","Ichoca","ESCUELA PEDRO DOMINGO MURILLO",-67.25848,-17.18484,19,6,209,228,22,6,175,197
"Bolivia","La Paz","Inquisivi","Ichoca","ESCUELA REPUBLICA DE VENEZUELA",-67.08401,-17.15735,25,8,130,155,19,6,97,116
"Bolivia","La Paz","Inquisivi","Ichoca","UNIDAD EDUCATIVA",-67.18003,-17.14062,141,15,569,710,91,19,444,535
"Bolivia","La Paz","Inquisivi","Ichoca","UNIDAD EDUCATIVA GERMAN BUSCH",-67.17284,-17.24399,1,5,173,174,62,4,102,164
"Bolivia","La Paz","Inquisivi","Inquisivi","ESC. CENTRAL CAVARI",-66.99092,-17.07948,81,14,373,454,53,21,285,338
"Bolivia","La Paz","Inquisivi","Inquisivi","ESC. EDUARDO AVAROA",-66.922,-16.79497,77,8,374,451,24,12,330,354
"Bolivia","La Paz","Inquisivi","Inquisivi","ESC. PEDRO DOMINGO MURILLO",-67.13365,-16.87514,52,5,334,386,50,16,263,313
"Bolivia","La Paz","Inquisivi","Inquisivi","ESCUELA ELIODORO CAMACHO",-67.13739,-16.90743,149,13,777,926,244,39,481,725
"Bolivia","La Paz","Inquisivi","Inquisivi","ESCUELA SIMON BOLIVAR",-66.91412,-17.25326,67,37,245,312,39,15,154,193
"Bolivia","La Paz","Inquisivi","Inquisivi","PLAZA DE LA FERIA DE VILLA VICTORIA",-67.01423,-17.23652,15,0,86,101,10,1,75,85
"Bolivia","La Paz","Inquisivi","Inquisivi","PLAZA PRINCIPAL",-66.86905,-16.60352,126,5,576,702,50,8,513,563
"Bolivia","La Paz","Inquisivi","Inquisivi","PLAZA PRINCIPAL 16 DE JULIO",-66.94501,-16.51898,201,12,654,855,125,12,505,630
"Bolivia","La Paz","Inquisivi","Inquisivi","SEDE SOCIAL",-67.09277,-16.88889,26,2,80,106,28,1,49,77
"Bolivia","La Paz","Inquisivi","Inquisivi","SEDE SOCIAL",-67.08649,-16.69044,26,2,80,106,28,1,49,77
"Bolivia","La Paz","Inquisivi","Inquisivi","UNIDAD EDUCATIVA ESCOLA",-67.01402,-16.88219,79,8,446,525,57,11,370,427
"Bolivia","La Paz","Inquisivi","Inquisivi","UNIDAD EDUCATIVA KANAMARCA",-67.07207,-16.34529,44,3,212,256,25,4,180,205
"Bolivia","La Paz","Inquisivi","Inquisivi","UNIDAD EDUCATIVA MARISCAL SUCRE",-67.08443,-16.78866,13,2,140,153,22,3,113,135
"Bolivia","La Paz","Inquisivi","Inquisivi","UNIDAD EDUCATIVA SIGUAS",-66.93951,-17.17848,31,20,283,314,49,24,190,239
"Bolivia","La Paz","Inquisivi","Inquisivi","UNIDAD EDUCATIVA TUPAK KATARI",-67.07355,-16.99531,83,24,470,553,83,67,296,379
"Bolivia","La Paz","Inquisivi","Licoma Pampa","ESCUELA ELIODORO CAMACHO",-67.20383,-16.80501,149,25,821,970,134,37,625,759
"Bolivia","La Paz","Inquisivi","Licoma Pampa","ESCUELA MIXTA CHARAPAXI",-67.1801,-16.84146,29,1,175,204,16,4,154,170
"Bolivia","La Paz","Inquisivi","Quime","ESC. PONGO B2",-67.27655,-16.98723,18,7,192,210,34,9,142,176
"Bolivia","La Paz","Inquisivi","Quime","ESC. TEODOMIRO URQUIOLA",-67.21542,-16.97982,292,70,2265,2557,758,137,1300,2058
"Bolivia","La Paz","Inquisivi","Quime","ESCUELA HUAYNACOTA",-67.28345,-17.03332,0,1,26,26,10,0,15,25
"Bolivia","La Paz","Inquisivi","Quime","ESCUELA SIMON BOLIVAR",-67.33048,-16.93823,119,14,492,611,255,13,210,465
"Bolivia","La Paz","Inquisivi","Quime","ESCUELA U.E. TITIAMAYA",-67.1907,-16.92141,4,0,110,114,21,4,85,106
"Bolivia","La Paz","Inquisivi","Quime","UNIDAD EDUCATIVA CHOQUETANGA",-67.31809,-16.8389,49,16,412,461,116,16,264,380
"Bolivia","La Paz","Larecaja","Combaya","ESC. CENTRAL SOREJAYA",-68.76491,-15.8242,22,5,333,355,61,21,246,307
"Bolivia","La Paz","Larecaja","Combaya","ESC. NUCLEO TICAMBLAYA",-68.73175,-15.83537,23,18,186,209,46,8,114,160
"Bolivia","La Paz","Larecaja","Combaya","UNIDAD EDUCATIVA EDUARDO AVAROA",-68.7542,-15.80447,52,29,293,345,67,19,178,245
"Bolivia","La Paz","Larecaja","Combaya","UNIDAD EDUCATIVA HUAYCHO",-68.73401,-15.81383,17,6,170,187,7,10,147,154
"Bolivia","La Paz","Larecaja","Guanay","ESC. C. CRESPO",-67.8819,-15.50123,409,21,1763,2172,783,46,913,1696
"Bolivia","La Paz","Larecaja","Guanay","ESC. CENTRAL CARURA",-67.96386,-15.42661,72,9,465,537,127,8,321,448
"Bolivia","La Paz","Larecaja","Guanay","ESC. MARIAPU",-68.05544,-15.40095,5,1,72,77,54,2,15,69
"Bolivia","La Paz","Larecaja","Guanay","ESC. SAN JUAN DE CHALLANA",-67.86722,-15.50406,7,0,60,67,49,1,10,59
"Bolivia","La Paz","Larecaja","Guanay","ESC. SECC. DE POROMA",-67.876,-15.66636,33,3,156,189,32,1,120,152
"Bolivia","La Paz","Larecaja","Guanay","ESC. SECC. MIXTA LA FABULOSA",-68.24464,-16.07889,3,0,42,45,3,0,39,42
"Bolivia","La Paz","Larecaja","Guanay","ESC. SECC. TRAPICHEPONTE",-67.74178,-15.64004,42,3,182,224,36,3,140,176
"Bolivia","La Paz","Larecaja","Guanay","ESCUELA PABLO AMAYA",-68.21191,-15.97806,11,0,79,90,21,8,50,71
"Bolivia","La Paz","Larecaja","Guanay","ESCUELA PAJONAL VILAQUE",-68.05408,-15.41886,22,3,146,168,89,2,52,141
"Bolivia","La Paz","Larecaja","Guanay","LA AGUADA",-67.92878,-15.49115,25,0,181,206,108,1,72,180
"Bolivia","La Paz","Larecaja","Guanay","NUCLEO ESCOLAR DE AMAGUAYA",-68.25602,-15.95273,15,0,80,95,30,1,49,79
"Bolivia","La Paz","Larecaja","Guanay","SEDE SOCIAL",-67.85902,-15.60936,1,2,45,46,15,0,28,43
"Bolivia","La Paz","Larecaja","Guanay","SINDICATO",-68.22674,-16.06047,1,0,59,60,9,7,43,52
"Bolivia","La Paz","Larecaja","Guanay","UNIDAD EDUCATIVA ALTO CHIJINI",-67.88482,-15.41975,5,0,37,42,9,0,28,37
"Bolivia","La Paz","Larecaja","Guanay","UNIDAD EDUCATIVA BUENOS AIRES",-67.68906,-15.70198,32,3,222,254,67,3,149,216
"Bolivia","La Paz","Larecaja","Guanay","UNIDAD EDUCATIVA CANDELARIA",-67.94775,-15.4421,32,4,465,497,110,3,348,458
"Bolivia","La Paz","Larecaja","Guanay","UNIDAD EDUCATIVA NACIONAL GUANAY",-67.88155,-15.49581,457,27,1864,2321,823,65,949,1772
"Bolivia","La Paz","Larecaja","Guanay","UNIDAD EDUCATIVA YOLOSANI",-67.79774,-15.57438,14,1,82,96,20,2,59,79
"Bolivia","La Paz","Larecaja","Mapiri","COLEGIO 1º DE MAYO",-68.20412,-15.28964,95,6,534,629,195,12,321,516
"Bolivia","La Paz","Larecaja","Mapiri","ESC. 16 DE JULIO",-68.21772,-15.31103,466,39,1816,2282,756,63,958,1714
"Bolivia","La Paz","Larecaja","Mapiri","ESC. CENTRAL DE SANTA ROSA",-68.32465,-15.31801,497,19,1423,1920,510,44,850,1360
"Bolivia","La Paz","Larecaja","Mapiri","ESC. DE SARAMPIUNI",-68.22166,-15.3938,19,0,118,137,27,2,89,116
"Bolivia","La Paz","Larecaja","Mapiri","ESC. MONJE ZAPATA",-68.26091,-15.20526,98,6,419,517,112,17,284,396
"Bolivia","La Paz","Larecaja","Mapiri","ESCUELA CHIMATE",-68.1562,-15.3971,33,1,153,186,36,5,111,147
"Bolivia","La Paz","Larecaja","Mapiri","ESC. UNIDAD EDUCATIVA VILAQUE GRANDE",-68.1724,-15.3626,26,3,189,215,49,4,133,182
"Bolivia","La Paz","Larecaja","Quiabaya","ESC. MIXTA JULIO CORDERO",-68.70292,-15.63772,182,34,1025,1207,291,64,636,927
"Bolivia","La Paz","Larecaja","Sorata","COL. JUAN XXIII",-68.65056,-15.77354,235,59,1651,1886,550,74,968,1518
"Bolivia","La Paz","Larecaja","Sorata","ESC. CENTRAL CARAZANI",-68.76967,-15.73627,18,2,197,215,35,20,140,175
"Bolivia","La Paz","Larecaja","Sorata","ESC. CENTRAL CHEJE",-68.6847,-15.79368,39,1,292,331,23,5,263,286
"Bolivia","La Paz","Larecaja","Sorata","ESC. CENTRAL CHOJLLA",-68.35152,-15.8526,28,2,76,104,16,1,57,73
"Bolivia","La Paz","Larecaja","Sorata","ESC. CENTRAL DE YANI",-68.53834,-15.63402,96,12,601,697,382,36,171,553
"Bolivia","La Paz","Larecaja","Sorata","ESC. FERNANDO ELOY GUACHALLA",-68.65588,-15.80826,99,54,809,908,147,48,560,707
"Bolivia","La Paz","Larecaja","Sorata","ESC. NEMECIO AYALA",-68.7309,-15.713,31,8,181,212,35,8,130,165
"Bolivia","La Paz","Larecaja","Sorata","ESC. NUCLEO ABISPAYA",-68.69788,-15.7081,41,12,314,355,77,21,204,281
"Bolivia","La Paz","Larecaja","Sorata","ESC. NUCLEO COCOY",-68.44633,-15.78752,1,0,292,293,152,19,121,273
"Bolivia","La Paz","Larecaja","Sorata","ESC. NUCLEO LARIPATA",-68.66778,-15.75021,91,25,807,898,226,39,517,743
"Bolivia","La Paz","Larecaja","Sorata","ESC. NUCLEO SAN ANTONIO DE MILLIPA",-68.61856,-15.87464,15,7,790,805,229,22,532,761
"Bolivia","La Paz","Larecaja","Sorata","ESC. SECC. DE ANKOMA SUR",-68.5121,-15.74682,17,8,162,179,87,7,60,147
"Bolivia","La Paz","Larecaja","Sorata","ESC. SECCIONAL CHUSSI",-68.2317,-15.6224,2,1,166,168,28,1,136,164
"Bolivia","La Paz","Larecaja","Sorata","ESCUELA COMBILILI",-68.7889,-15.75265,8,0,83,91,33,6,44,77
"Bolivia","La Paz","Larecaja","Sorata","ESCUELA MACHACAMARCA",-68.78627,-15.72192,24,0,154,178,14,1,139,153
"Bolivia","La Paz","Larecaja","Sorata","ESCUELA PACOLLO",-68.64767,-15.85605,5,0,200,205,58,8,134,192
"Bolivia","La Paz","Larecaja","Sorata","ESCUELA SANTA MARIA",-68.21433,-15.58872,54,4,115,169,26,4,81,107
"Bolivia","La Paz","Larecaja","Sorata","ESC. UNIDAD EDUCATIVA OKARA",-68.3903,-15.67581,11,4,50,61,16,2,28,44
"Bolivia","La Paz","Larecaja","Sorata","H.A.M. DE SORATA",-68.64867,-15.77538,290,53,1733,2023,547,94,1039,1586
"Bolivia","La Paz","Larecaja","Tacacoma","COL. CENTRAL SAN AGUSTIN",-68.50902,-15.37926,75,11,346,421,77,18,240,317
"Bolivia","La Paz","Larecaja","Tacacoma","ESC. ANANEA",-68.6505,-15.5341,28,1,192,220,93,6,92,185
"Bolivia","La Paz","Larecaja","Tacacoma","ESC. CENTRAL CHUMISA",-68.65643,-15.58669,56,6,464,520,114,14,330,444
"Bolivia","La Paz","Larecaja","Tacacoma","ESCUELA PALLAYUNGA",-68.60498,-15.46068,60,1,212,272,48,10,153,201
"Bolivia","La Paz","Larecaja","Tacacoma","ESCUELA XVI DE JULIO",-68.64725,-15.59322,140,16,967,1107,467,54,430,897
"Bolivia","La Paz","Larecaja","Tacacoma","ESC. UNIDAD EDUCATIVA CAMILLAYA",-68.57066,-15.43699,17,3,81,98,24,1,53,77
"Bolivia","La Paz","Larecaja","Tacacoma","NUCLEO ESCOLAR INCACHACA",-68.47215,-15.32096,70,2,213,283,124,2,85,209
"Bolivia","La Paz","Larecaja","Tacacoma","PLAZA COLLABAMBA",-68.64456,-15.51472,19,2,111,130,67,7,35,102
"Bolivia","La Paz","Larecaja","Teoponte","COL. NAL. MIXTO TEOPONTE",-67.81804,-15.49505,263,23,1142,1405,404,22,693,1097
"Bolivia","La Paz","Larecaja","Teoponte","COL. NUCLEO TAJLIHUI",-67.70219,-15.67721,20,1,143,163,21,8,113,134
"Bolivia","La Paz","Larecaja","Teoponte","ESC.EDUARDO AVAROA",-67.64935,-15.67183,15,4,127,142,15,6,102,117
"Bolivia","La Paz","Larecaja","Teoponte","ESC. MIXTA TOMACHI",-67.73718,-15.47837,86,2,316,402,104,10,200,304
"Bolivia","La Paz","Larecaja","Teoponte","ESC.NUCLEO VILLA AROMA",-67.7086,-15.59438,33,4,371,404,56,10,301,357
"Bolivia","La Paz","Larecaja","Teoponte","NUCLEO RED UNO",-67.6581,-15.5712,12,1,59,71,4,2,52,56
"Bolivia","La Paz","Larecaja","Teoponte","SEDE SOCIAL",-67.60563,-15.41431,228,13,1044,1272,240,22,769,1009
"Bolivia","La Paz","Larecaja","Tipuani","ESC. 16 DE JULIO",-68.04258,-15.5816,225,7,651,876,204,10,430,634
"Bolivia","La Paz","Larecaja","Tipuani","ESC. EDUARDO AVAROA",-68.01199,-15.56615,478,18,1581,2059,646,37,880,1526
"Bolivia","La Paz","Larecaja","Tipuani","ESC. MIXTA GERMAN BUSCH",-68.00401,-15.56263,40,2,192,232,77,6,107,184
"Bolivia","La Paz","Larecaja","Tipuani","ESC. NESTOR PAZ ZAMORA",-68.0163,-15.51995,11,0,56,67,4,2,50,54
"Bolivia","La Paz","Larecaja","Tipuani","ESCUELA CHUQUINI",-68.08243,-15.61108,281,9,787,1068,198,15,565,763
"Bolivia","La Paz","Larecaja","Tipuani","UNIDAD EDUCATIVA PEDRO DOMINGO MURILLO",-68.10115,-15.59577,97,5,388,485,150,9,224,374
"Bolivia","La Paz","Loayza","Cairoma","COLEGIO GERMAN BUSCH",-67.54138,-16.90495,136,27,1065,1201,246,55,737,983
"Bolivia","La Paz","Loayza","Cairoma","COLEGIO LUIS ESPINAL",-67.57736,-16.92918,29,10,325,354,92,2,221,313
"Bolivia","La Paz","Loayza","Cairoma","ESCUELA DE SAYA",-67.54543,-16.71021,8,2,105,113,40,5,58,98
"Bolivia","La Paz","Loayza","Cairoma","ESCUELA TIENDA PATA",-67.50883,-16.886,14,1,126,140,38,5,82,120
"Bolivia","La Paz","Loayza","Cairoma","PLAZA LLOJA",-67.57372,-16.74774,22,1,184,206,10,1,172,182
"Bolivia","La Paz","Loayza","Cairoma","PLAZA TORRE PAMPA",-67.58032,-16.83131,63,8,346,409,67,10,261,328
"Bolivia","La Paz","Loayza","Cairoma","UNIDAD EDUCATIVA BARTOLINA SISA",-67.4908,-16.65928,23,0,118,141,13,8,97,110
"Bolivia","La Paz","Loayza","Cairoma","UNIDAD EDUCATIVA BOLIVAR",-67.54518,-16.87182,69,19,489,558,68,16,386,454
"Bolivia","La Paz","Loayza","Cairoma","UNIDAD EDUCATIVA BOLIVIA-VILOCO",-67.49796,-16.87398,159,5,706,865,165,22,514,679
"Bolivia","La Paz","Loayza","Cairoma","UNIDAD EDUCATIVA LIBERTAD",-67.56012,-16.81969,55,9,341,396,54,14,264,318
"Bolivia","La Paz","Loayza","Cairoma","UNIDAD EDUCATIVA SACANI",-67.61375,-16.94436,16,3,365,381,57,8,297,354
"Bolivia","La Paz","Loayza","Luribay","COLEGIO AZAMBO",-67.63184,-17.00489,29,4,371,400,66,13,288,354
"Bolivia","La Paz","Loayza","Luribay","COLEGIO VILLA LITORAL",-67.6229,-17.08772,37,2,383,420,47,8,326,373
"Bolivia","La Paz","Loayza","Luribay","COL. RVDO. VICTOR ARUAZO-PLAZA PRINCIPAL",-67.6609,-17.06249,88,10,630,718,135,19,466,601
"Bolivia","La Paz","Loayza","Luribay","ESCUELA ANQUIMOA",-67.66051,-16.99854,49,6,587,636,60,11,510,570
"Bolivia","La Paz","Loayza","Luribay","ESCUELA EL PORVENIR",-67.55268,-17.03213,44,3,617,661,107,12,495,602
"Bolivia","La Paz","Loayza","Luribay","ESCUELA MURMUNTANI",-67.5434,-17.08703,20,1,171,191,13,4,153,166
"Bolivia","La Paz","Loayza","Luribay","ESC. UNIDAD EDUCATIVA BRAVO",-67.68433,-16.95887,17,3,198,215,19,3,173,192
"Bolivia","La Paz","Loayza","Luribay","PLAZA 5 DE AGOSTO",-67.60162,-17.11526,64,5,422,486,57,11,349,406
"Bolivia","La Paz","Loayza","Luribay","PLAZA 6 DE AGOSTO",-67.68541,-17.13404,60,4,349,409,33,24,288,321
"Bolivia","La Paz","Loayza","Luribay","PLAZA TOTORA",-67.68784,-17.09565,5,0,90,95,11,0,79,90
"Bolivia","La Paz","Loayza","Luribay","UNIDAD EDUCATIVA COLLIRI",-67.7193,-17.04746,32,1,225,257,31,8,185,216
"Bolivia","La Paz","Loayza","Luribay","UNIDAD EDUCATIVA PEDRO DOMINGO MURILLO",-67.57441,-17.14605,88,8,596,684,94,3,491,585
"Bolivia","La Paz","Loayza","Luribay","UNIDAD EDUCATIVA POROMA",-67.54092,-17.17032,23,1,299,322,37,1,260,297
"Bolivia","La Paz","Loayza","Malla","ESCUELA SIMON BOLIVAR",-67.42189,-17.06216,3,0,99,102,3,2,94,97
"Bolivia","La Paz","Loayza","Malla","PLAZA 14 DE SEPTIEMBRE",-67.45062,-17.03962,13,2,408,421,55,5,346,401
"Bolivia","La Paz","Loayza","Malla","UNIDAD EDUCATIVA FRANZ TAMAYO",-67.49815,-16.9908,38,2,254,292,55,9,188,243
"Bolivia","La Paz","Loayza","Sapahaqui","ESCUELA EDUARDO AVAROA",-67.71152,-16.88625,43,2,413,456,44,5,362,406
"Bolivia","La Paz","Loayza","Sapahaqui","ESCUELA SIXILLA BAJA",-67.79269,-17.05937,0,1,325,325,42,2,280,322
"Bolivia","La Paz","Loayza","Sapahaqui","MURUHUTA",-67.83468,-17.10299,43,2,373,416,66,16,289,355
"Bolivia","La Paz","Loayza","Sapahaqui","PLAZA PRINCIPAL HUANCANE",-67.92168,-16.96859,13,2,321,334,52,5,262,314
"Bolivia","La Paz","Loayza","Sapahaqui","UNIDAD EDUCATIVA CHIVISIVI",-67.87543,-16.95139,49,7,565,614,86,4,468,554
"Bolivia","La Paz","Loayza","Sapahaqui","UNIDAD EDUCATIVA OCUIRI",-67.75996,-17.09802,21,0,228,249,20,6,202,222
"Bolivia","La Paz","Loayza","Sapahaqui","UNIDAD EDUCATIVA SAN MARCOS",-67.81051,-16.99369,192,11,1391,1583,215,51,1114,1329
"Bolivia","La Paz","Loayza","Sapahaqui","UNIDAD EDUCATIVA SAPAHAQUI",-67.95024,-16.88832,204,31,1625,1829,323,69,1202,1525
"Bolivia","La Paz","Loayza","Sapahaqui","UNIDAD EDUCATIVA TACOBAMBA",-67.93534,-16.89507,63,3,616,679,93,17,503,596
"Bolivia","La Paz","Loayza","Sapahaqui","UNIDAD EDUCATIVA URUPAYA",-67.86726,-16.83526,12,0,94,106,16,2,76,92
"Bolivia","La Paz","Loayza","Yaco","COLEGIO REPUBLICA VENEZUELA",-67.33579,-17.27501,43,5,589,632,169,21,394,563
"Bolivia","La Paz","Loayza","Yaco","ESCUELA CHALLOMA",-67.48557,-17.17411,22,2,235,257,12,5,216,228
"Bolivia","La Paz","Loayza","Yaco","ESCUELA UMALACO",-67.44422,-17.08424,4,1,74,78,8,1,64,72
"Bolivia","La Paz","Loayza","Yaco","PLAZA 14 DE SEPTIEMBRE",-67.37626,-17.18333,9,2,116,125,23,7,84,107
"Bolivia","La Paz","Loayza","Yaco","PLAZA CENTRAL",-67.33892,-17.17855,27,11,431,458,98,46,276,374
"Bolivia","La Paz","Loayza","Yaco","UNIDAD EDUCATIVA CHUCAMARCA",-67.45103,-17.09326,34,4,238,272,34,10,190,224
"Bolivia","La Paz","Loayza","Yaco","UNIDAD EDUCATIVA DANIEL GOMEZ GARCIA",-67.44017,-17.25055,36,7,284,320,50,20,207,257
"Bolivia","La Paz","Loayza","Yaco","UNIDAD EDUCATIVA GERMAN BUSCH",-67.34483,-17.1474,18,0,119,137,25,5,89,114
"Bolivia","La Paz","Loayza","Yaco","UNIDAD EDUCATIVA HURNUNI",-67.40517,-17.3487,12,1,240,252,87,5,147,234
"Bolivia","La Paz","Loayza","Yaco","UNIDAD EDUCATIVA SIMON BOLIVAR",-67.35043,-17.13314,0,7,137,137,38,5,87,125
"Bolivia","La Paz","Loayza","Yaco","UNIDAD EDUCATIVA YACO",-67.41138,-17.1584,84,13,368,452,78,25,252,330
"Bolivia","La Paz","Los Andes","Batallas","COLEGIO DON BOSCO",-68.46431,-16.31361,60,18,729,789,166,29,516,682
"Bolivia","La Paz","Los Andes","Batallas","COLEGIO TÉCNICO HUMANÍSTICO CHIRAPACA",-68.49313,-16.29834,21,4,406,427,136,16,250,386
"Bolivia","La Paz","Los Andes","Batallas","COL. FISCAL BOLIVIANO CUBANO",-68.52594,-16.30013,64,13,724,788,224,26,461,685
"Bolivia","La Paz","Los Andes","Batallas","COL. PEDRO DOMINGO MURILLO",-68.50931,-16.1562,62,11,535,597,213,23,288,501
"Bolivia","La Paz","Los Andes","Batallas","ESCUELA GENOVEVA RIOS",-68.53124,-16.30003,339,47,2937,3276,953,124,1813,2766
"Bolivia","La Paz","Los Andes","Batallas","PLAZA LA PAZ",-68.51289,-16.34104,36,4,566,602,193,19,350,543
"Bolivia","La Paz","Los Andes","Batallas","PLAZA PRINCIPAL",-68.54729,-16.10482,112,16,1192,1304,434,57,685,1119
"Bolivia","La Paz","Los Andes","Batallas","PLAZA PRINCIPAL",-68.46272,-16.2592,112,16,1192,1304,434,57,685,1119
"Bolivia","La Paz","Los Andes","Batallas","PLAZA TUPAC KATARI",-68.50398,-16.23213,75,17,642,717,150,35,440,590
"Bolivia","La Paz","Los Andes","Batallas","PLAZA TUQUIA",-68.46532,-16.21404,67,13,684,751,186,44,441,627
"Bolivia","La Paz","Los Andes","Batallas","PLAZA V. ASUNCION DE CALUYO",-68.51057,-16.32793,15,0,198,213,34,4,160,194
"Bolivia","La Paz","Los Andes","Batallas","SEDE SOCIAL",-68.56298,-16.25858,16,3,250,266,77,9,161,238
"Bolivia","La Paz","Los Andes","Laja","COL. PEDRO DOMINGO MURILLO",-68.38843,-16.53407,294,57,3397,3691,824,159,2357,3181
"Bolivia","La Paz","Los Andes","Laja","COL. TEC. HUMANISTICO TAMBILLO",-68.50755,-16.57151,56,13,515,571,151,28,323,474
"Bolivia","La Paz","Los Andes","Laja","ESC. QUINTUPATA",-68.50268,-16.62749,3,3,135,138,30,1,101,131
"Bolivia","La Paz","Los Andes","Laja","ESCUELA REPUBLICA DE IRAN",-68.30653,-16.52587,113,16,1084,1197,287,47,734,1021
"Bolivia","La Paz","Los Andes","Laja","MERCADO SAN JUAN",-68.46218,-16.69142,36,13,460,496,56,24,367,423
"Bolivia","La Paz","Los Andes","Laja","PLAZA CURVA PUCARA",-68.57091,-16.59581,22,12,579,601,99,21,447,546
"Bolivia","La Paz","Los Andes","Laja","PLAZA PRINCIPAL",-68.55198,-16.5294,38,22,1018,1056,176,53,767,943
"Bolivia","La Paz","Los Andes","Laja","PLAZA PRINCIPAL",-68.55477,-16.65492,38,22,1018,1056,176,53,767,943
"Bolivia","La Paz","Los Andes","Laja","PLAZA PRINCIPAL",-68.56635,-16.57367,38,22,1018,1056,176,53,767,943
"Bolivia","La Paz","Los Andes","Laja","U.E. CALLAMARCA",-68.57652,-16.6364,2,3,380,382,73,19,285,358
"Bolivia","La Paz","Los Andes","Laja","U.E. GUALBERTO VILLARROEL DE SACACANI",-68.50606,-16.68419,0,0,216,216,48,8,160,208
"Bolivia","La Paz","Los Andes","Laja","UNIDAD EDUCATIVA COPAJIRA",-68.44736,-16.59749,38,10,617,655,118,33,456,574
"Bolivia","La Paz","Los Andes","Pucarani","COLEGIO CHIARPATA",-68.52587,-16.35778,30,20,480,510,148,25,287,435
"Bolivia","La Paz","Los Andes","Pucarani","COLEGIO COHANA",-68.65945,-16.37055,25,16,685,710,136,25,508,644
"Bolivia","La Paz","Los Andes","Pucarani","COLEGIO MARIO GUTIERREZ",-68.5423,-16.40942,80,43,1028,1108,366,92,527,893
"Bolivia","La Paz","Los Andes","Pucarani","COLEGIO SAN SALVADOR",-68.37844,-16.37475,133,40,1707,1840,473,103,1091,1564
"Bolivia","La Paz","Los Andes","Pucarani","COL.NAL.CHOJÑA COLLO",-68.42926,-16.44215,17,9,393,410,128,35,221,349
"Bolivia","La Paz","Los Andes","Pucarani","ESC. CENTRAL CHIPAMAYA",-68.42702,-16.38573,34,7,457,491,140,21,289,429
"Bolivia","La Paz","Los Andes","Pucarani","ESC. JOSE SALMON BALLIVIAN",-68.47432,-16.39758,294,81,3005,3299,1094,162,1668,2762
"Bolivia","La Paz","Los Andes","Pucarani","ESCUELA ANTOFAGASTA",-68.33107,-16.42799,88,53,1728,1816,627,161,887,1514
"Bolivia","La Paz","Los Andes","Pucarani","ESCUELA CATAVI",-68.58923,-16.48189,61,22,675,736,193,30,430,623
"Bolivia","La Paz","Los Andes","Pucarani","ESCUELA CHOJASIVI",-68.69275,-16.44042,10,10,676,686,231,26,409,640
"Bolivia","La Paz","Los Andes","Pucarani","PLAZA 6 DE AGOSTO",-68.41537,-16.33457,120,31,1482,1602,323,63,1065,1388
"Bolivia","La Paz","Los Andes","Pucarani","PLAZA PRINCIPAL",-68.66112,-16.44403,67,16,725,792,110,11,588,698
"Bolivia","La Paz","Los Andes","Pucarani","PLAZA VILLA ROSARIO DE CORAPATA",-68.37347,-16.4377,72,22,920,992,390,47,461,851
"Bolivia","La Paz","Los Andes","Puerto Pérez","ESC. GUALBERTO VILLARROEL",-68.59356,-16.35726,65,6,453,518,151,26,270,421
"Bolivia","La Paz","Los Andes","Puerto Pérez","ESC. MIXTO 16 DE JULIO",-68.76075,-16.30686,62,27,874,936,173,36,638,811
"Bolivia","La Paz","Los Andes","Puerto Pérez","ESCUELA CENTRAL CASCACHI",-68.67452,-16.3437,37,13,518,555,91,35,379,470
"Bolivia","La Paz","Los Andes","Puerto Pérez","ESCUELA PUERTO PEREZ",-68.60112,-16.28587,90,20,1047,1137,243,26,758,1001
"Bolivia","La Paz","Los Andes","Puerto Pérez","ESCUELAS POPULARES DON BOSCO",-68.58698,-16.34699,28,2,314,342,91,9,212,303
"Bolivia","La Paz","Los Andes","Puerto Pérez","UNIDAD EDUCATIVA CUMANA",-68.63633,-16.34833,20,4,257,277,42,5,206,248
"Bolivia","La Paz","Manco Kapac","Copacabana","CENTRO DE SALUD SIRIPACA",-69.06173,-16.09907,39,7,243,282,25,3,208,233
"Bolivia","La Paz","Manco Kapac","Copacabana","COLEGIO CHALLA",-69.18937,-15.98997,64,12,938,1002,47,15,864,911
"Bolivia","La Paz","Manco Kapac","Copacabana","COL. NACIONAL MIXTO COPACABANA",-69.08396,-16.1632,569,57,3967,4536,1210,144,2556,3766
"Bolivia","La Paz","Manco Kapac","Copacabana","ESC. 16 DE JULIO",-69.0842,-16.20929,110,16,881,991,288,36,541,829
"Bolivia","La Paz","Manco Kapac","Copacabana","ESC. COL. TEC. HUMANISTICO HUACUYO",-69.03305,-16.17805,71,3,409,480,81,16,309,390
"Bolivia","La Paz","Manco Kapac","Copacabana","ESCUELA SECCIONAL SAMPAYA",-69.1012,-16.08231,44,7,321,365,47,15,252,299
"Bolivia","La Paz","Manco Kapac","Copacabana","ESCUELA VILLA ROSARIO",-68.98846,-16.14534,37,9,328,365,68,11,240,308
"Bolivia","La Paz","Manco Kapac","San Pedro de Tiquina","COLEGIO VILLA AMACARI",-68.86105,-16.25432,14,8,184,198,48,5,123,171
"Bolivia","La Paz","Manco Kapac","San Pedro de Tiquina","COL. SIMON BOLIVAR",-68.85252,-16.22503,260,19,1043,1303,306,53,665,971
"Bolivia","La Paz","Manco Kapac","San Pedro de Tiquina","ESC. MIXTA SAN PABLO DE TIQUINA",-68.84653,-16.21544,75,20,651,726,249,30,352,601
"Bolivia","La Paz","Manco Kapac","San Pedro de Tiquina","PLAZA 25 DE JUNIO",-68.88103,-16.26364,31,2,212,243,62,4,144,206
"Bolivia","La Paz","Manco Kapac","San Pedro de Tiquina","SEDE SOCIAL",-68.89336,-16.22142,52,8,303,355,55,7,233,288
"Bolivia","La Paz","Manco Kapac","Tito Yupanqui","COLEGIO NACIONAL MIXTO TITO YUPANQUI",-68.95449,-16.19247,122,25,653,775,215,21,392,607
"Bolivia","La Paz","Manco Kapac","Tito Yupanqui","ESCUELA HUATAPAMPA",-68.95433,-16.17676,14,1,165,179,39,8,117,156
"Bolivia","La Paz","Muñecas","Aucapata","COLEGIO 2 DE AGOSTO",-68.76146,-15.4182,101,10,391,492,52,22,307,359
"Bolivia","La Paz","Muñecas","Aucapata","ESCUELA DR. ANGEL GEMIO ERGUETA",-68.72099,-15.48481,66,2,169,235,51,16,100,151
"Bolivia","La Paz","Muñecas","Aucapata","IGLESIA SANTO DOMINGO",-68.72872,-15.4539,72,10,195,267,34,13,138,172
"Bolivia","La Paz","Muñecas","Aucapata","NUCLEO ESCOLAR YANAHUAYA",-68.6969,-15.45401,110,22,384,494,83,22,257,340
"Bolivia","La Paz","Muñecas","Aucapata","UNIDAD EDUCATIVA ROSARIO",-68.6216,-15.4223,168,12,489,657,91,20,366,457
"Bolivia","La Paz","Muñecas","Ayata","COL. NEMESIO ALIAGA BENAVENTE",-68.8305,-15.45652,245,60,811,1056,118,57,576,694
"Bolivia","La Paz","Muñecas","Ayata","ESC. SAN JUANITO",-68.75811,-15.3747,58,3,367,425,44,19,301,345
"Bolivia","La Paz","Muñecas","Ayata","ESCUELA CAMATA",-68.74616,-15.23502,79,17,385,464,72,18,278,350
"Bolivia","La Paz","Muñecas","Ayata","ESCUELA NUCLEO ELIZARDO PEREZ DE M.",-68.80567,-15.50827,81,30,444,525,97,28,289,386
"Bolivia","La Paz","Muñecas","Ayata","ESCUELA SAIHUANI",-68.77344,-15.44397,102,15,420,522,32,17,356,388
"Bolivia","La Paz","Muñecas","Ayata","ESCUELA SECCIONAL MULTIGRADO UPANI",-68.80933,-15.49444,52,5,276,328,7,29,235,242
"Bolivia","La Paz","Muñecas","Ayata","UNIDAD EDUCATIVA VILLA ROSARIO",-68.62227,-15.22997,0,3,87,87,13,3,68,81
"Bolivia","La Paz","Muñecas","Chuma","COLEGIO HUMANISTICO SOCOCONI",-68.87901,-15.7106,67,11,508,575,57,13,427,484
"Bolivia","La Paz","Muñecas","Chuma","COLEGIO POCOAYA",-68.91715,-15.4475,16,1,118,134,26,8,83,109
"Bolivia","La Paz","Muñecas","Chuma","CUSAHUAYA",-68.84715,-15.66148,7,3,206,213,14,3,186,200
"Bolivia","La Paz","Muñecas","Chuma","ESC. TIMUSI",-68.86244,-15.66374,31,1,266,297,35,7,223,258
"Bolivia","La Paz","Muñecas","Chuma","ESCUELA CENTRAL TITICACHI",-68.81434,-15.50673,63,10,409,472,88,21,290,378
"Bolivia","La Paz","Muñecas","Chuma","ESCUELA CHAJLAYA",-68.90194,-15.68445,57,5,535,592,104,20,406,510
"Bolivia","La Paz","Muñecas","Chuma","ESCUELA DE LUQUISANI",-68.81457,-15.51897,24,6,269,293,93,17,153,246
"Bolivia","La Paz","Muñecas","Chuma","ESCUELA DE TUILUNI",-68.92104,-15.48239,27,9,258,285,68,25,156,224
"Bolivia","La Paz","Muñecas","Chuma","ESCUELA MAXIMILIANO ORTIZ",-68.89848,-15.4816,252,37,830,1082,184,54,555,739
"Bolivia","La Paz","Muñecas","Chuma","ESCUELA PALOHUAYA",-68.8721,-15.63676,14,1,124,138,28,4,91,119
"Bolivia","La Paz","Muñecas","Chuma","PLAZA CAPAYQUE",-68.80988,-15.69481,13,4,212,225,18,9,181,199
"Bolivia","La Paz","Muñecas","Chuma","PLAZA JICHUHUAYA",-68.8353,-15.69286,13,0,104,117,20,1,83,103
"Bolivia","La Paz","Murillo","Achocalla","COLEGIO 16 DE AGOSTO",-68.17045,-16.55337,114,6,1115,1229,320,26,763,1083
"Bolivia","La Paz","Murillo","Achocalla","ESCUELA ASUNTA QUILLVIRI",-68.11919,-16.72616,81,18,1012,1093,238,67,689,927
"Bolivia","La Paz","Murillo","Achocalla","ESCUELA CHAÑOCAHUA",-68.14516,-16.63919,347,30,3694,4041,1028,129,2507,3535
"Bolivia","La Paz","Murillo","Achocalla","ESCUELA MARQUIRIVI",-68.15418,-16.5915,278,37,2011,2289,498,51,1425,1923
"Bolivia","La Paz","Murillo","Achocalla","ESCUELA VILLA CONCEPCION",-68.13874,-16.60526,28,9,522,550,101,27,385,486
"Bolivia","La Paz","Murillo","Achocalla","U. E.  ANTONIO DIAZ VILLAMIL",-68.16837,-16.57798,148,34,1803,1951,514,52,1203,1717
"Bolivia","La Paz","Murillo","Achocalla","U. E. RENE BARRIENTOS ORTUÑO",-68.1705,-16.56838,143,13,1235,1378,410,29,783,1193
"Bolivia","La Paz","Murillo","Achocalla","UNIDAD EDUCATIVA TUNI",-68.13835,-16.67672,26,2,348,374,69,7,270,339
"Bolivia","La Paz","Murillo","El Alto de La Paz","CENTRO EDUCATIVO CATOLICO MERCEDES",-68.2159,-16.56526,214,28,2435,2649,824,121,1462,2286
"Bolivia","La Paz","Murillo","El Alto de La Paz","COL 18 DE DICIEMBRE",-68.17837,-16.58624,338,27,3263,3601,1006,144,2086,3092
"Bolivia","La Paz","Murillo","El Alto de La Paz","COL 1RO DE MAYO",-68.19975,-16.53636,657,49,7853,8510,3644,396,3764,7408
"Bolivia","La Paz","Murillo","El Alto de La Paz","COL 25 DE JULIO",-68.18322,-16.58162,838,75,6599,7437,2202,295,4027,6229
"Bolivia","La Paz","Murillo","El Alto de La Paz","COL ATIPIRIS",-68.17815,-16.59096,321,40,2932,3253,866,149,1877,2743
"Bolivia","La Paz","Murillo","El Alto de La Paz","COL BASILL MILLER",-68.17461,-16.48812,230,19,2919,3149,1330,130,1440,2770
"Bolivia","La Paz","Murillo","El Alto de La Paz","COL BOLIVIA",-68.17217,-16.5416,467,46,4155,4622,1592,215,2302,3894
"Bolivia","La Paz","Murillo","El Alto de La Paz","COL CALAMA",-68.19262,-16.53144,626,52,7137,7763,2855,316,3914,6769
"Bolivia","La Paz","Murillo","El Alto de La Paz","COL EDUARDO AVAROA",-68.18268,-16.52774,319,22,2726,3045,1119,115,1470,2589
"Bolivia","La Paz","Murillo","El Alto de La Paz","COLEGIO 23 DE MARZO",-68.1777,-16.61965,770,87,6619,7389,1738,305,4489,6227
"Bolivia","La Paz","Murillo","El Alto de La Paz","COLEGIO 27 DE MAYO",-68.18954,-16.59973,595,88,5668,6263,1618,298,3664,5282
"Bolivia","La Paz","Murillo","El Alto de La Paz","COLEGIO 6 DE JUNIO",-68.20706,-16.55554,516,40,4530,5046,1597,147,2746,4343
"Bolivia","La Paz","Murillo","El Alto de La Paz","COLEGIO ADRIAN CASTILLO NAVA",-68.18089,-16.47932,842,92,8873,9715,3409,395,4977,8386
"Bolivia","La Paz","Murillo","El Alto de La Paz","COLEGIO ANDRES DE STA CRUZ",-68.21678,-16.48222,623,80,6837,7460,2609,386,3762,6371
"Bolivia","La Paz","Murillo","El Alto de La Paz","COLEGIO ANTONIO PAREDES CANDIA",-68.21078,-16.47959,918,144,10853,11771,3838,538,6333,10171
"Bolivia","La Paz","Murillo","El Alto de La Paz","COLEGIO BOLIVIA MAR",-68.19718,-16.58017,264,24,2518,2782,660,107,1727,2387
"Bolivia","La Paz","Murillo","El Alto de La Paz","COLEGIO DON BOSCO",-68.22162,-16.56328,746,78,7399,8145,2631,249,4441,7072
"Bolivia","La Paz","Murillo","El Alto de La Paz","COLEGIO FERNANDO NOGALES CASTRO",-68.23376,-16.52565,289,37,3484,3773,1511,133,1803,3314
"Bolivia","La Paz","Murillo","El Alto de La Paz","COLEGIO HUAYNA POTOSI",-68.18628,-16.47742,666,114,8029,8695,2771,410,4734,7505
"Bolivia","La Paz","Murillo","El Alto de La Paz","COLEGIO ILLIMANI",-68.20894,-16.54332,694,71,7226,7920,2297,267,4591,6888
"Bolivia","La Paz","Murillo","El Alto de La Paz","COLEGIO LUIS ESPINAL CAMPS",-68.22268,-16.52322,980,111,9286,10266,3175,314,5686,8861
"Bolivia","La Paz","Murillo","El Alto de La Paz","COLEGIO LUIS ESPINAL CAMPS (AEROPUERTO)",-68.19802,-16.51796,352,33,2977,3329,1046,156,1742,2788
"Bolivia","La Paz","Murillo","El Alto de La Paz","COLEGIO MARISCAL ANDRES DE SANTA CRUZ",-68.14963,-16.53367,133,16,1349,1482,748,42,543,1291
"Bolivia","La Paz","Murillo","El Alto de La Paz","COLEGIO MARTIN CARDENAS",-68.20902,-16.5227,1058,70,9815,10873,4851,385,4509,9360
"Bolivia","La Paz","Murillo","El Alto de La Paz","COLEGIO M QUIROGA SANTA CRUZ",-68.20879,-16.48692,295,158,4768,5063,1919,264,2427,4346
"Bolivia","La Paz","Murillo","El Alto de La Paz","COLEGIO NESTOR PAZ",-68.23247,-16.54344,495,45,4940,5435,1684,272,2939,4623
"Bolivia","La Paz","Murillo","El Alto de La Paz","COLEGIO PARTICULAR SAN MIGUEL",-68.21574,-16.49355,224,15,2154,2378,1059,100,980,2039
"Bolivia","La Paz","Murillo","El Alto de La Paz","COLEGIO PUERTO DEL ROSARIO",-68.19044,-16.54459,1107,83,10673,11780,4517,402,5671,10188
"Bolivia","La Paz","Murillo","El Alto de La Paz","COLEGIO PUERTO DEL ROSARIO",-68.19044,-16.54459,1107,83,10673,11780,4517,402,5671,10188
"Bolivia","La Paz","Murillo","El Alto de La Paz","COLEGIO SAN JOSE",-68.17645,-16.48123,876,111,10039,10915,4092,467,5369,9461
"Bolivia","La Paz","Murillo","El Alto de La Paz","COLEGIO WALTER ALPIRE 1ER PATIO",-68.21351,-16.49505,515,36,4904,5419,2435,204,2229,4664
"Bolivia","La Paz","Murillo","El Alto de La Paz","COLEGIO WALTER ALPIRE 2DO PATIO",-68.21351,-16.49505,233,30,3092,3325,1664,90,1308,2972
"Bolivia","La Paz","Murillo","El Alto de La Paz","COL ESPAÑA",-68.19041,-16.58716,1083,87,9120,10203,2893,393,5747,8640
"Bolivia","La Paz","Murillo","El Alto de La Paz","COL GRAN BRETAÑA",-68.18764,-16.49338,490,42,5632,6122,2556,229,2805,5361
"Bolivia","La Paz","Murillo","El Alto de La Paz","COL HEROES DEL PACIFICO",-68.15602,-16.52656,396,13,4315,4711,2896,119,1287,4183
"Bolivia","La Paz","Murillo","El Alto de La Paz","COL LIBERTADOR S. BOLIVAR",-68.17521,-16.52682,462,34,4467,4929,1991,177,2265,4256
"Bolivia","La Paz","Murillo","El Alto de La Paz","COL MUTUAL LA PAZ",-68.19092,-16.55765,361,43,4042,4403,1871,136,1992,3863
"Bolivia","La Paz","Murillo","El Alto de La Paz","COL PUERTO MEJILLONES",-68.15205,-16.52655,788,41,7782,8570,5150,204,2387,7537
"Bolivia","La Paz","Murillo","El Alto de La Paz","COL RAFAEL MENDOZA",-68.19506,-16.49104,492,48,4903,5395,2342,267,2246,4588
"Bolivia","La Paz","Murillo","El Alto de La Paz","COL. REPUBLICA DE ITALIA",-68.1873,-16.5898,215,25,2000,2215,636,91,1248,1884
"Bolivia","La Paz","Murillo","El Alto de La Paz","COL ROTARY CHUQUIAGO MARCA",-68.16711,-16.53573,1011,81,8411,9422,3437,350,4543,7980
"Bolivia","La Paz","Murillo","El Alto de La Paz","COL SANTA MARIA DE LOS ANGELES",-68.17751,-16.49472,613,57,6809,7422,3221,351,3180,6401
"Bolivia","La Paz","Murillo","El Alto de La Paz","COL SAN VICENTE DE PAUL",-68.20663,-16.50516,720,71,7407,8127,2690,299,4347,7037
"Bolivia","La Paz","Murillo","El Alto de La Paz","COL. TEC. HUMANISTICO JOSE BALLIVIAN",-68.1784,-16.48976,313,42,3459,3772,1487,184,1746,3233
"Bolivia","La Paz","Murillo","El Alto de La Paz","COL TOPATER",-68.19929,-16.5635,482,35,5105,5587,1886,196,2988,4874
"Bolivia","La Paz","Murillo","El Alto de La Paz","COL TUNARI",-68.19628,-16.49841,1276,134,13812,15088,5846,623,7209,13055
"Bolivia","La Paz","Murillo","El Alto de La Paz","COL VICENTE TEJADA",-68.15522,-16.51924,558,55,5652,6210,2603,228,2766,5369
"Bolivia","La Paz","Murillo","El Alto de La Paz","ESC BALLIVIAN",-68.17644,-16.49026,328,44,3921,4249,1573,201,2103,3676
"Bolivia","La Paz","Murillo","El Alto de La Paz","ESC BOLIVAR MUNICIPAL",-68.18821,-16.53657,303,36,3647,3950,1409,147,2055,3464
"Bolivia","La Paz","Murillo","El Alto de La Paz","ESC ELIZARDO PEREZ",-68.1898,-16.48761,428,43,4525,4953,1912,218,2352,4264
"Bolivia","La Paz","Murillo","El Alto de La Paz","ESC JUVENAL MARIACA",-68.17067,-16.49689,715,55,7081,7796,3574,293,3159,6733
"Bolivia","La Paz","Murillo","El Alto de La Paz","ESC LIBERTAD EN LAS AMERICAS",-68.15623,-16.53351,767,73,7221,7988,3007,258,3883,6890
"Bolivia","La Paz","Murillo","El Alto de La Paz","ESC LOS ANDES",-68.18398,-16.49493,304,34,3283,3587,1507,147,1595,3102
"Bolivia","La Paz","Murillo","El Alto de La Paz","ESC LUIS ESPINAL CAMPS",-68.16608,-16.4796,245,31,2568,2813,916,116,1505,2421
"Bolivia","La Paz","Murillo","El Alto de La Paz","ESC PRIMAVERA",-68.1945,-16.53725,174,13,1555,1729,685,64,793,1478
"Bolivia","La Paz","Murillo","El Alto de La Paz","ESC TARAPACA",-68.18806,-16.60872,554,71,5829,6383,1548,243,3967,5515
"Bolivia","La Paz","Murillo","El Alto de La Paz","ESCUELA 16 DE FEBRERO",-68.22742,-16.50302,661,95,7448,8109,2757,268,4328,7085
"Bolivia","La Paz","Murillo","El Alto de La Paz","ESCUELA BRASIL",-68.20975,-16.49082,456,38,5008,5464,2223,211,2536,4759
"Bolivia","La Paz","Murillo","El Alto de La Paz","ESCUELA GUAQUI",-68.17409,-16.47567,563,74,6164,6727,2203,301,3586,5789
"Bolivia","La Paz","Murillo","El Alto de La Paz","ESCUELA JUAN CARLOS FLORES BEDREGAL",-68.22012,-16.50096,693,95,7769,8462,3069,266,4339,7408
"Bolivia","La Paz","Murillo","El Alto de La Paz","ESCUELA JUAN CARLOS FLORES BEDREGAL",-68.22012,-16.50096,693,95,7769,8462,3069,266,4339,7408
"Bolivia","La Paz","Murillo","El Alto de La Paz","ESCUELA JUAN JOSE TORREZ",-68.17109,-16.47051,363,55,4053,4416,1349,196,2453,3802
"Bolivia","La Paz","Murillo","El Alto de La Paz","ESCUELA RAFAEL PABON",-68.17429,-16.46312,305,75,4175,4480,1240,279,2581,3821
"Bolivia","La Paz","Murillo","El Alto de La Paz","ESCUELA RAUL SALMON DE LA BARRA",-68.21005,-16.49883,282,31,3411,3693,1445,154,1781,3226
"Bolivia","La Paz","Murillo","El Alto de La Paz","ESCUELA REPUBLICA DE CHINA POPULAR",-68.23643,-16.50772,422,72,4824,5246,1516,168,3068,4584
"Bolivia","La Paz","Murillo","El Alto de La Paz","ESCUELA TEJADA TRIANGULAR",-68.15996,-16.52431,273,22,2802,3075,1340,107,1333,2673
"Bolivia","La Paz","Murillo","El Alto de La Paz","ESCUELA TUPAC KATARI",-68.19848,-16.48532,330,45,3613,3943,1557,150,1861,3418
"Bolivia","La Paz","Murillo","El Alto de La Paz","INSTITUTO EDUCATIVO JESUS DE NAZARETH",-68.21307,-16.52458,459,45,4099,4558,1855,130,2069,3924
"Bolivia","La Paz","Murillo","El Alto de La Paz","SEDE SOCIAL JUNTA VECINAL",-68.19644,-16.54614,155,21,1394,1549,521,34,818,1339
"Bolivia","La Paz","Murillo","El Alto de La Paz","SEDE VECINAL",-68.1711,-16.51802,39,3,471,510,281,18,169,450
"Bolivia","La Paz","Murillo","El Alto de La Paz","U.E. AMIGOS DEL CHACO",-68.20364,-16.52415,86,11,1048,1134,424,31,582,1006
"Bolivia","La Paz","Murillo","El Alto de La Paz","U.E. CRISTAL",-68.20247,-16.59457,68,12,1343,1411,390,32,909,1299
"Bolivia","La Paz","Murillo","El Alto de La Paz","U.E. FUERZA AEREA ARGENTINA",-68.25346,-16.49715,66,16,934,1000,283,46,589,872
"Bolivia","La Paz","Murillo","El Alto de La Paz","U.E. GRAL. ARMANDO ESCOBAR URIA",-68.15063,-16.52961,145,3,1622,1767,1077,52,490,1567
"Bolivia","La Paz","Murillo","El Alto de La Paz","U.E. OSCAR ALFARO",-68.23621,-16.48713,444,61,4838,5282,1745,229,2803,4548
"Bolivia","La Paz","Murillo","El Alto de La Paz","UE PARTICULAR INTERANDINO BOLIVIANO",-68.18138,-16.49701,34,2,196,230,99,8,87,186
"Bolivia","La Paz","Murillo","El Alto de La Paz","U.E. SAN ANDRES",-68.15803,-16.53902,165,13,1751,1916,724,56,958,1682
"Bolivia","La Paz","Murillo","El Alto de La Paz","U.E. TOKIO",-68.17825,-16.47219,254,22,2749,3003,901,195,1631,2532
"Bolivia","La Paz","Murillo","El Alto de La Paz","U. E. VILLA ADELA YUNGUYO",-68.21577,-16.52021,380,45,3453,3833,1447,167,1794,3241
"Bolivia","La Paz","Murillo","El Alto de La Paz","U. E. VILLA ADELA YUNGUYO",-68.21643,-16.51679,380,45,3453,3833,1447,167,1794,3241
"Bolivia","La Paz","Murillo","El Alto de La Paz","UNIDAD EDUCATIVA 12 DE OCTUBRE",-68.1631,-16.51261,455,32,4604,5059,2562,138,1872,4434
"Bolivia","La Paz","Murillo","El Alto de La Paz","UNIDAD EDUCATIVA 25 DE JULIO",-68.21799,-16.50818,450,53,4141,4591,1412,204,2472,3884
"Bolivia","La Paz","Murillo","El Alto de La Paz","UNIDAD EDUCATIVA 3 DE MAYO",-68.21262,-16.54766,509,72,5791,6300,1877,199,3643,5520
"Bolivia","La Paz","Murillo","El Alto de La Paz","UNIDAD EDUCATIVA 6 DE JUNIO",-68.22369,-16.53518,476,42,4617,5093,1571,163,2841,4412
"Bolivia","La Paz","Murillo","El Alto de La Paz","UNIDAD EDUCATIVA ADELA ZAMUDIO",-68.19314,-16.52711,174,19,2157,2331,883,87,1168,2051
"Bolivia","La Paz","Murillo","El Alto de La Paz","UNIDAD EDUCATIVA  ALTO DE LA ALIANZA",-68.18938,-16.52214,340,31,3555,3895,1476,146,1902,3378
"Bolivia","La Paz","Murillo","El Alto de La Paz","UNIDAD EDUCATIVA ANDRES BELLO",-68.16715,-16.51139,109,16,1031,1140,577,26,412,989
"Bolivia","La Paz","Murillo","El Alto de La Paz","UNIDAD EDUCATIVA ANDRES BELLO (U. E. 16 DE JULIO)",-68.16715,-16.51139,72,3,577,649,357,16,201,558
"Bolivia","La Paz","Murillo","El Alto de La Paz","UNIDAD EDUCATIVA ANICETO ARCE",-68.18877,-16.55329,177,30,1945,2122,776,62,1077,1853
"Bolivia","La Paz","Murillo","El Alto de La Paz","UNIDAD EDUCATIVA BAUTISTA SAAVEDRA",-68.23381,-16.48594,839,109,8195,9034,3042,352,4692,7734
"Bolivia","La Paz","Murillo","El Alto de La Paz","UNIDAD EDUCATIVA BRASILIA",-68.15981,-16.51867,424,31,4386,4810,2189,148,2018,4207
"Bolivia","La Paz","Murillo","El Alto de La Paz","UNIDAD EDUCATIVA CARLOS PALENQUE",-68.18768,-16.52626,334,21,3284,3618,1331,154,1778,3109
"Bolivia","La Paz","Murillo","El Alto de La Paz","UNIDAD EDUCATIVA DONOZO TORRES",-68.15047,-16.52236,360,20,3654,4014,2192,105,1337,3529
"Bolivia","La Paz","Murillo","El Alto de La Paz","UNIDAD EDUCATIVA ECOLOGICO LOS PINOS",-68.17538,-16.5999,506,47,4661,5167,1207,202,3205,4412
"Bolivia","La Paz","Murillo","El Alto de La Paz","UNIDAD EDUCATIVA EDUARDO AVAROA I",-68.29729,-16.49421,45,17,638,683,201,27,393,594
"Bolivia","La Paz","Murillo","El Alto de La Paz","UNIDAD EDUCATIVA EVA PERON",-68.15955,-16.50945,437,35,4267,4704,2171,150,1911,4082
"Bolivia","La Paz","Murillo","El Alto de La Paz","UNIDAD EDUCATIVA FRANZ TAMAYO",-68.25333,-16.50809,484,54,5632,6116,1700,232,3646,5346
"Bolivia","La Paz","Murillo","El Alto de La Paz","UNIDAD EDUCATIVA GRAN PODER",-68.19362,-16.55863,261,18,2224,2485,850,91,1265,2115
"Bolivia","La Paz","Murillo","El Alto de La Paz","UNIDAD EDUCATIVA ILLIMANI",-68.18507,-16.46561,441,56,4632,5073,1563,258,2755,4318
"Bolivia","La Paz","Murillo","El Alto de La Paz","UNIDAD EDUCATIVA INGAVI",-68.1793,-16.46868,421,55,4620,5041,1480,261,2824,4304
"Bolivia","La Paz","Murillo","El Alto de La Paz","UNIDAD EDUCATIVA INTEGRACION",-68.16405,-16.50175,310,25,2597,2907,1405,84,1083,2488
"Bolivia","La Paz","Murillo","El Alto de La Paz","UNIDAD EDUCATIVA JUAN CAPRILES",-68.15948,-16.5062,357,36,3402,3759,1632,96,1638,3270
"Bolivia","La Paz","Murillo","El Alto de La Paz","UNIDAD EDUCATIVA JUAN JOSE TORRES",-68.2122,-16.53901,522,59,5218,5740,1935,197,3027,4962
"Bolivia","La Paz","Murillo","El Alto de La Paz","UNIDAD EDUCATIVA LA PAZ",-68.20005,-16.52881,340,34,2798,3138,1226,106,1432,2658
"Bolivia","La Paz","Murillo","El Alto de La Paz","UNIDAD EDUCATIVA MARISCAL ANTONIO JOSE E",-68.22196,-16.47654,638,73,6087,6725,1994,312,3708,5702
"Bolivia","La Paz","Murillo","El Alto de La Paz","UNIDAD EDUCATIVA MERCEDES ELIO DE RIVERO",-68.23167,-16.55686,300,46,3477,3777,973,116,2342,3315
"Bolivia","La Paz","Murillo","El Alto de La Paz","UNIDAD EDUCATIVA NORUEGA",-68.19359,-16.4826,559,75,5561,6120,2065,300,3121,5186
"Bolivia","La Paz","Murillo","El Alto de La Paz","UNIDAD EDUCATIVA PABLO ZARATE VILLCA",-68.19443,-16.47187,23,4,403,426,126,22,251,377
"Bolivia","La Paz","Murillo","El Alto de La Paz","UNIDAD EDUCATIVA PROGRESO",-68.25311,-16.47828,449,97,5662,6111,1942,284,3339,5281
"Bolivia","La Paz","Murillo","El Alto de La Paz","UNIDAD EDUCATIVA REP. DEL URUGUAY",-68.27645,-16.51882,40,8,550,590,228,17,297,525
"Bolivia","La Paz","Murillo","El Alto de La Paz","UNIDAD EDUCATIVA REPUBLICA DE CUBA",-68.18736,-16.52857,425,64,5159,5584,1716,234,3145,4861
"Bolivia","La Paz","Murillo","El Alto de La Paz","UNIDAD EDUCATIVA REPUBLICA DE CUBA",-68.20181,-16.47474,425,64,5159,5584,1716,234,3145,4861
"Bolivia","La Paz","Murillo","El Alto de La Paz","UNIDAD EDUCATIVA REPUBLICA DE FRANCIA",-68.19515,-16.5501,686,64,6429,7115,2256,285,3824,6080
"Bolivia","La Paz","Murillo","El Alto de La Paz","UNIDAD EDUCATIVA SAN JUAN DE CALAMA",-68.19692,-16.52204,346,42,3643,3989,1473,121,2007,3480
"Bolivia","La Paz","Murillo","El Alto de La Paz","UNIDAD EDUCATIVA SAN LUIS",-68.20049,-16.54089,468,45,4851,5319,1876,169,2761,4637
"Bolivia","La Paz","Murillo","El Alto de La Paz","UNIDAD EDUCATIVA SAN ROQUE",-68.27818,-16.47489,1063,189,11300,12363,3640,629,6842,10482
"Bolivia","La Paz","Murillo","El Alto de La Paz","UNIDAD EDUCATIVA SANTA ROSA DE LIMA",-68.1677,-16.45551,179,21,1769,1948,504,121,1123,1627
"Bolivia","La Paz","Murillo","El Alto de La Paz","UNIDAD EDUCATIVA SANTIAGO I",-68.16467,-16.52485,481,31,4108,4589,1971,154,1952,3923
"Bolivia","La Paz","Murillo","El Alto de La Paz","UNIDAD EDUCATIVA TECNICA YUNGUYO",-68.22483,-16.49496,393,59,4853,5246,1809,184,2801,4610
"Bolivia","La Paz","Murillo","El Alto de La Paz","UNIDAD EDUCATIVA THE STRONGEST",-68.19981,-16.47943,191,23,2072,2263,743,113,1193,1936
"Bolivia","La Paz","Murillo","El Alto de La Paz","UNIDAD EDUCATIVA TUPAC AMARU",-68.20243,-16.57245,208,15,2137,2345,642,88,1392,2034
"Bolivia","La Paz","Murillo","El Alto de La Paz","UNIDAD EDUCATIVA UNION EUROPEA",-68.17921,-16.53997,1265,109,12979,14244,6059,474,6337,12396
"Bolivia","La Paz","Murillo","El Alto de La Paz","UNIDAD EDUCATIVA VILLA ALEMANIA",-68.20655,-16.51637,345,28,3017,3362,1348,116,1525,2873
"Bolivia","La Paz","Murillo","El Alto de La Paz","UNIDAD EDUCATIVA VILLA COOPERATIVA",-68.22495,-16.47322,415,83,4399,4814,1389,197,2730,4119
"Bolivia","La Paz","Murillo","El Alto de La Paz","UNID. EDUC.  M. QUIROGA SANTA CRUZ",-68.17841,-16.5187,242,32,2762,3004,1151,116,1463,2614
"Bolivia","La Paz","Murillo","Mecapaca","COLEGIO 6 DE JUNIO",-67.93151,-16.8046,5,0,270,275,38,1,231,269
"Bolivia","La Paz","Murillo","Mecapaca","COL. SAN SIMON DE AYACUCHO",-67.98664,-16.8034,67,9,353,420,77,13,254,331
"Bolivia","La Paz","Murillo","Mecapaca","ESCUELA EL PALOMAR",-68.00471,-16.7009,76,18,1072,1148,237,33,784,1021
"Bolivia","La Paz","Murillo","Mecapaca","ESCUELA HUARICANA ALTO",-67.93894,-16.73059,45,9,794,839,130,14,641,771
"Bolivia","La Paz","Murillo","Mecapaca","ESCUELA JANKOSUNI",-67.87069,-16.79541,8,0,252,260,29,1,222,251
"Bolivia","La Paz","Murillo","Mecapaca","ESCUELA SANTIAGO DE COLLANA",-67.96983,-16.66847,40,5,599,639,97,12,485,582
"Bolivia","La Paz","Murillo","Mecapaca","ESCUELA SIMONA MANZANEDA",-68.01966,-16.66984,204,17,1878,2082,571,49,1241,1812
"Bolivia","La Paz","Murillo","Mecapaca","PLAZA PRINCIPAL HUAJCHILLA",-68.05293,-16.62848,128,7,1429,1557,477,40,905,1382
"Bolivia","La Paz","Murillo","Mecapaca","UNIDAD EDUCATIVA LLUTO",-68.02113,-16.59331,20,11,267,287,35,21,200,235
"Bolivia","La Paz","Murillo","Mecapaca","UNIDAD EDUCATIVA MILLOCATO",-67.9091,-16.73255,19,2,315,334,37,5,271,308
"Bolivia","La Paz","Murillo","Mecapaca","UNID. EDUC. CONDOR DE LOS ANDES",-68.06098,-16.73627,14,4,336,350,38,9,285,323
"Bolivia","La Paz","Murillo","Nuestra Señora de La Paz","CANCHA DEPORTIVA",-68.108,-16.50108,488,31,4394,4882,2337,98,1928,4265
"Bolivia","La Paz","Murillo","Nuestra Señora de La Paz","CANCHA DEPORTIVA",-68.09735,-16.52828,488,31,4394,4882,2337,98,1928,4265
"Bolivia","La Paz","Murillo","Nuestra Señora de La Paz","(CÁRCEL) COF MIRAFLORES",-68.11906,-16.50092,19,1,37,56,24,0,12,36
"Bolivia","La Paz","Murillo","Nuestra Señora de La Paz","(CÁRCEL) COF OBRAJES",-68.10977,-16.52685,49,0,91,140,55,3,33,88
"Bolivia","La Paz","Murillo","Nuestra Señora de La Paz","(CÁRCEL) PANOPTICO",-68.13491,-16.50283,288,4,491,779,238,16,233,471
"Bolivia","La Paz","Murillo","Nuestra Señora de La Paz","C. E. ADVENTISTA BELLO HORIZONTE",-68.14233,-16.50962,49,3,276,325,170,4,99,269
"Bolivia","La Paz","Murillo","Nuestra Señora de La Paz","CENTRO DE CAPACITACION INTI PAXSI",-68.09966,-16.56521,147,20,1528,1675,906,25,577,1483
"Bolivia","La Paz","Murillo","Nuestra Señora de La Paz","COL. AMERICAN SCHOOL",-68.13224,-16.49319,174,5,1645,1819,1132,28,480,1612
"Bolivia","La Paz","Murillo","Nuestra Señora de La Paz","COL. AMOR DE DIOS",-68.11962,-16.51487,492,14,3097,3589,2449,48,586,3035
"Bolivia","La Paz","Murillo","Nuestra Señora de La Paz","COL. CANADA",-68.14336,-16.50653,338,23,3090,3428,1674,84,1309,2983
"Bolivia","La Paz","Murillo","Nuestra Señora de La Paz","COL. CARACAS",-68.10925,-16.49185,164,19,2109,2273,854,71,1165,2019
"Bolivia","La Paz","Murillo","Nuestra Señora de La Paz","COL. CERVANTES",-68.12268,-16.49229,241,5,2333,2574,1925,28,375,2300
"Bolivia","La Paz","Murillo","Nuestra Señora de La Paz","COL. COPACABANA",-68.116,-16.49115,615,41,6023,6638,3634,164,2184,5818
"Bolivia","La Paz","Murillo","Nuestra Señora de La Paz","COL. CRISTO REY",-68.11716,-16.49006,472,38,5029,5501,2771,162,2058,4829
"Bolivia","La Paz","Murillo","Nuestra Señora de La Paz","COL DANIEL SANCHEZ BUSTAMANTE",-68.14701,-16.50356,951,63,7627,8578,3660,200,3704,7364
"Bolivia","La Paz","Murillo","Nuestra Señora de La Paz","COL DANIEL SANCHEZ BUSTAMANTE",-68.14701,-16.50356,951,63,7627,8578,3660,200,3704,7364
"Bolivia","La Paz","Murillo","Nuestra Señora de La Paz","COLEGIO 6 DE JUNIO",-68.10533,-16.52268,749,37,7987,8736,5501,162,2287,7788
"Bolivia","La Paz","Murillo","Nuestra Señora de La Paz","COLEGIO  ADOLFO  COSTA DU RELS",-68.12815,-16.47907,937,107,9552,10489,3476,413,5556,9032
"Bolivia","La Paz","Murillo","Nuestra Señora de La Paz","COLEGIO AMORETTI",-68.12887,-16.51681,359,35,2687,3046,1965,62,625,2590
"Bolivia","La Paz","Murillo","Nuestra Señora de La Paz","COLEGIO ANTONIO DIAZ VILLAMIL",-68.13431,-16.49114,416,9,3298,3714,2229,59,1001,3230
"Bolivia","La Paz","Murillo","Nuestra Señora de La Paz","COLEGIO AVE MARIA",-68.11795,-16.47431,999,85,8459,9458,5018,223,3133,8151
"Bolivia","La Paz","Murillo","Nuestra Señora de La Paz","COLEGIO AVE MARIA",-68.11795,-16.47431,999,85,8459,9458,5018,223,3133,8151
"Bolivia","La Paz","Murillo","Nuestra Señora de La Paz","COLEGIO BOLIVAR",-68.13287,-16.50506,219,4,1926,2145,1410,37,475,1885
"Bolivia","La Paz","Murillo","Nuestra Señora de La Paz","COLEGIO CANADIENSE",-68.1338,-16.50349,138,5,1267,1405,932,10,320,1252
"Bolivia","La Paz","Murillo","Nuestra Señora de La Paz","COLEGIO DELIA GAMBARTE",-68.10197,-16.50602,214,14,1670,1884,661,96,899,1560
"Bolivia","La Paz","Murillo","Nuestra Señora de La Paz","COLEGIO DON BOSCO",-68.10194,-16.50008,480,37,4722,5202,2385,178,2122,4507
"Bolivia","La Paz","Murillo","Nuestra Señora de La Paz","COLEGIO FRANCIA",-68.1449,-16.48456,167,10,1655,1822,966,63,616,1582
"Bolivia","La Paz","Murillo","Nuestra Señora de La Paz","COLEGIO FRANCO BOLIVIANO",-68.07697,-16.53309,1454,27,9591,11045,7542,152,1870,9412
"Bolivia","La Paz","Murillo","Nuestra Señora de La Paz","COLEGIO GERMAN BUSCH",-68.14012,-16.4923,301,12,2679,2980,1835,71,761,2596
"Bolivia","La Paz","Murillo","Nuestra Señora de La Paz","COLEGIO HOLANDA",-68.15083,-16.49805,1282,103,11070,12352,5057,312,5598,10655
"Bolivia","La Paz","Murillo","Nuestra Señora de La Paz","COLEGIO HOLANDA",-68.15083,-16.49805,1282,103,11070,12352,5057,312,5598,10655
"Bolivia","La Paz","Murillo","Nuestra Señora de La Paz","COLEGIO IGNACIO CALDERON",-68.14203,-16.51064,448,30,4516,4964,2644,88,1754,4398
"Bolivia","La Paz","Murillo","Nuestra Señora de La Paz","COLEGIO IRENE NAVA",-68.11196,-16.46699,777,50,6498,7275,3348,174,2926,6274
"Bolivia","La Paz","Murillo","Nuestra Señora de La Paz","COLEGIO ITALIA",-68.16149,-16.49363,477,40,4954,5431,2332,142,2440,4772
"Bolivia","La Paz","Murillo","Nuestra Señora de La Paz","COLEGIO ITALIA",-68.16149,-16.49363,477,40,4954,5431,2332,142,2440,4772
"Bolivia","La Paz","Murillo","Nuestra Señora de La Paz","COLEGIO JERUSALEM",-68.10326,-16.50195,347,31,3295,3642,1462,119,1683,3145
"Bolivia","La Paz","Murillo","Nuestra Señora de La Paz","COLEGIO LUIS ALBERTO PABON",-68.13418,-16.49122,164,5,1608,1772,1018,58,527,1545
"Bolivia","La Paz","Murillo","Nuestra Señora de La Paz","COLEGIO MAX TOLEDO",-68.15351,-16.49414,694,62,6847,7541,3709,171,2905,6614
"Bolivia","La Paz","Murillo","Nuestra Señora de La Paz","COLEGIO MAX TOLEDO",-68.15351,-16.49414,694,62,6847,7541,3709,171,2905,6614
"Bolivia","La Paz","Murillo","Nuestra Señora de La Paz","COLEGIO NUESTRA SEÑORA DE FATIMA",-68.12103,-16.47554,260,12,2429,2689,1246,104,1067,2313
"Bolivia","La Paz","Murillo","Nuestra Señora de La Paz","COLEGIO RENE BARRIENTOS",-68.07787,-16.53858,404,10,2490,2894,2055,34,391,2446
"Bolivia","La Paz","Murillo","Nuestra Señora de La Paz","COLEGIO SAINT PETERS",-68.13634,-16.50428,171,36,1737,1908,1289,23,389,1678
"Bolivia","La Paz","Murillo","Nuestra Señora de La Paz","COLEGIO SAN IGNACIO",-68.09715,-16.53659,826,10,2927,3753,2340,40,537,2877
"Bolivia","La Paz","Murillo","Nuestra Señora de La Paz","COLEGIO SAN LUIS",-68.13464,-16.51359,570,27,6069,6639,3939,105,1998,5937
"Bolivia","La Paz","Murillo","Nuestra Señora de La Paz","COLEGIO SERGIO VILLEGAS",-68.09919,-16.51187,512,46,4716,5228,2035,165,2470,4505
"Bolivia","La Paz","Murillo","Nuestra Señora de La Paz","COLEGIO SIMON RODRIGUEZ",-68.12112,-16.47591,493,28,3834,4327,2054,80,1672,3726
"Bolivia","La Paz","Murillo","Nuestra Señora de La Paz","COLEGIO TOPATER",-68.10408,-16.49198,320,28,3267,3587,1508,93,1638,3146
"Bolivia","La Paz","Murillo","Nuestra Señora de La Paz","COLEGIO VILLARROEL",-68.14117,-16.49612,378,19,3172,3550,1967,79,1107,3074
"Bolivia","La Paz","Murillo","Nuestra Señora de La Paz","COLEGIO VILLARROEL",-68.14117,-16.4961,378,19,3172,3550,1967,79,1107,3074
"Bolivia","La Paz","Murillo","Nuestra Señora de La Paz","COL. EXPERIMENTAL HUGO DAVILA",-68.11927,-16.49929,531,19,4620,5151,3472,84,1045,4517
"Bolivia","La Paz","Murillo","Nuestra Señora de La Paz","COL. FELIPE 2DO. GUZMAN",-68.12112,-16.50593,420,4,2238,2658,1689,44,501,2190
"Bolivia","La Paz","Murillo","Nuestra Señora de La Paz","COL. FRANZ TAMAYO",-68.15231,-16.49047,621,43,6283,6904,3522,133,2585,6107
"Bolivia","La Paz","Murillo","Nuestra Señora de La Paz","COL. GREGORIO REYNOLDS",-68.13242,-16.51624,403,12,3564,3967,2513,106,933,3446
"Bolivia","La Paz","Murillo","Nuestra Señora de La Paz","COL. GUILLEN PINTO",-68.15572,-16.487,440,59,4970,5410,2167,111,2633,4800
"Bolivia","La Paz","Murillo","Nuestra Señora de La Paz","COL. HERSCHELL",-68.10605,-16.52725,639,23,4356,4995,3064,89,1180,4244
"Bolivia","La Paz","Murillo","Nuestra Señora de La Paz","COL. LORETTO",-68.07858,-16.5454,368,7,2531,2899,2168,35,321,2489
"Bolivia","La Paz","Murillo","Nuestra Señora de La Paz","COL. LUIS ESPINAL CAMPS",-68.14557,-16.52328,759,79,7471,8230,2797,297,4298,7095
"Bolivia","La Paz","Murillo","Nuestra Señora de La Paz","COL. LUIS VELASCO FLORES",-68.15797,-16.46071,80,21,1440,1520,428,37,954,1382
"Bolivia","La Paz","Murillo","Nuestra Señora de La Paz","COL. MARIA AUXILIADORA",-68.13763,-16.50292,224,14,2250,2474,1613,56,567,2180
"Bolivia","La Paz","Murillo","Nuestra Señora de La Paz","COL. MARIEN GARTEN",-68.16064,-16.49042,436,33,4756,5192,2232,115,2376,4608
"Bolivia","La Paz","Murillo","Nuestra Señora de La Paz","COL. NACIONAL AYACUCHO",-68.13404,-16.49409,257,5,1650,1907,1077,41,527,1604
"Bolivia","La Paz","Murillo","Nuestra Señora de La Paz","COL. SAN FRANCISCO",-68.13798,-16.49661,221,12,1804,2025,1268,48,476,1744
"Bolivia","La Paz","Murillo","Nuestra Señora de La Paz","COL. SAN JAVIER",-68.15145,-16.48675,205,9,2253,2458,1500,62,682,2182
"Bolivia","La Paz","Murillo","Nuestra Señora de La Paz","COL. SAN MARTIN",-68.14119,-16.49969,265,16,2143,2408,1349,50,728,2077
"Bolivia","La Paz","Murillo","Nuestra Señora de La Paz","COL. SANTA ANA",-68.13152,-16.49671,156,6,1384,1540,1065,15,298,1363
"Bolivia","La Paz","Murillo","Nuestra Señora de La Paz","COL SERGIO ALMARAZ",-68.11177,-16.49919,439,19,4025,4464,2262,126,1618,3880
"Bolivia","La Paz","Murillo","Nuestra Señora de La Paz","COMPLEJO DEPORTIVO CAMIRI",-68.11738,-16.47857,228,7,2261,2489,1551,40,663,2214
"Bolivia","La Paz","Murillo","Nuestra Señora de La Paz","COMPLEJO DEPORTIVO SAN LUIS",-68.13494,-16.5137,93,3,1118,1211,817,26,272,1089
"Bolivia","La Paz","Murillo","Nuestra Señora de La Paz","COOP. EDUCACIONAL SAN MARCOS LTDA",-68.13071,-16.49973,110,2,910,1020,639,19,250,889
"Bolivia","La Paz","Murillo","Nuestra Señora de La Paz","DIR DISTRITAL DE EDUCACION",-68.12583,-16.49939,296,13,2235,2531,1636,30,556,2192
"Bolivia","La Paz","Murillo","Nuestra Señora de La Paz","E.N.S.A.F.",-68.11926,-16.50412,249,6,2128,2377,1691,26,405,2096
"Bolivia","La Paz","Murillo","Nuestra Señora de La Paz","ESC. ABRAHAM LINCOLN",-68.14679,-16.47846,294,31,3303,3597,1529,109,1634,3163
"Bolivia","La Paz","Murillo","Nuestra Señora de La Paz","ESC. ALCIDES ARGUEDAS",-68.141,-16.50126,135,4,1163,1298,738,23,398,1136
"Bolivia","La Paz","Murillo","Nuestra Señora de La Paz","ESC. ALFREDO VARGAS",-68.12498,-16.48322,504,22,4654,5158,2764,167,1701,4465
"Bolivia","La Paz","Murillo","Nuestra Señora de La Paz","ESC. ALONZO DE MENDOZA",-68.12307,-16.50274,109,1,849,958,645,17,186,831
"Bolivia","La Paz","Murillo","Nuestra Señora de La Paz","ESC. ALONZO DE MENDOZA (U.E. BICHITO DE LUZ)",-68.12307,-16.50274,423,6,3195,3618,2488,82,619,3107
"Bolivia","La Paz","Murillo","Nuestra Señora de La Paz","ESC. ALTO TEMBLADERANI",-68.14673,-16.51458,152,13,1316,1468,444,41,818,1262
"Bolivia","La Paz","Murillo","Nuestra Señora de La Paz","ESC. CHUCURA",-68.10157,-16.27567,2,4,62,64,12,7,39,51
"Bolivia","La Paz","Murillo","Nuestra Señora de La Paz","ESC. CLUB DE LEONES",-68.15932,-16.49451,805,66,8556,9361,4139,267,4084,8223
"Bolivia","La Paz","Murillo","Nuestra Señora de La Paz","ESC. CLUB DE LEONES",-68.15932,-16.49451,805,66,8556,9361,4139,267,4084,8223
"Bolivia","La Paz","Murillo","Nuestra Señora de La Paz","ESC ECUADOR",-68.12662,-16.50871,403,12,2193,2596,1785,23,373,2158
"Bolivia","La Paz","Murillo","Nuestra Señora de La Paz","ESC. EDUARDO AVAROA",-68.14451,-16.49651,583,31,5181,5764,3038,133,1979,5017
"Bolivia","La Paz","Murillo","Nuestra Señora de La Paz","ESC. EDUCACIONAL LUIS  ERNEST",-68.15179,-16.46655,154,9,1860,2014,1069,52,730,1799
"Bolivia","La Paz","Murillo","Nuestra Señora de La Paz","ESC. FRANCISCO DE MIRANDA",-68.09369,-16.53112,429,42,4542,4971,1991,133,2376,4367
"Bolivia","La Paz","Murillo","Nuestra Señora de La Paz","ESC. GENOVEVA RIOS",-68.10799,-16.50161,561,34,5280,5841,2583,163,2500,5083
"Bolivia","La Paz","Murillo","Nuestra Señora de La Paz","ESC. GIL TAPIA RADA",-68.15082,-16.45705,358,52,4327,4685,2055,118,2102,4157
"Bolivia","La Paz","Murillo","Nuestra Señora de La Paz","ESC. GRAL. JOSE MANUEL PANDO",-68.14954,-16.50061,155,13,1820,1975,940,41,826,1766
"Bolivia","La Paz","Murillo","Nuestra Señora de La Paz","ESC IND PEDRO DOMINGO MURILLO",-68.15194,-16.47472,542,44,4544,5086,2448,135,1917,4365
"Bolivia","La Paz","Murillo","Nuestra Señora de La Paz","ESC. JOSE SANTOS",-68.14185,-16.53238,349,40,3453,3802,1248,124,2041,3289
"Bolivia","La Paz","Murillo","Nuestra Señora de La Paz","ESC. LADISLAO CABRERA",-68.14954,-16.50061,568,44,5104,5672,2501,170,2389,4890
"Bolivia","La Paz","Murillo","Nuestra Señora de La Paz","ESC LA MERCED",-68.11915,-16.46617,692,74,6376,7068,2523,180,3599,6122
"Bolivia","La Paz","Murillo","Nuestra Señora de La Paz","ESC. LIMANIPATA 10 DE JUNIO",-68.14423,-16.4425,113,14,1442,1555,421,35,972,1393
"Bolivia","La Paz","Murillo","Nuestra Señora de La Paz","ESC. MCAL SANTA CRUZ",-68.13808,-16.49557,78,3,660,738,412,12,233,645
"Bolivia","La Paz","Murillo","Nuestra Señora de La Paz","ESC. MSCAL ANDRES DE SANTA CRUZ",-67.67603,-15.76266,25,3,205,230,41,2,159,200
"Bolivia","La Paz","Murillo","Nuestra Señora de La Paz","ESC MSCAL ANTONIO JOSE DE SUCRE",-68.07882,-16.48678,57,21,722,779,183,12,506,689
"Bolivia","La Paz","Murillo","Nuestra Señora de La Paz","ESC NATALIA PALACIOS",-68.13138,-16.49431,311,20,2708,3019,1921,49,718,2639
"Bolivia","La Paz","Murillo","Nuestra Señora de La Paz","ESC. NICOLAS  FERNANDEZ NARANJO",-68.1405,-16.48321,803,90,8289,9092,3687,219,4293,7980
"Bolivia","La Paz","Murillo","Nuestra Señora de La Paz","ESC PABLO ITURRI",-68.10268,-16.45948,620,60,5124,5744,1729,178,3157,4886
"Bolivia","La Paz","Murillo","Nuestra Señora de La Paz","ESC PANAMA",-68.12434,-16.49475,450,7,3456,3906,2736,68,645,3381
"Bolivia","La Paz","Murillo","Nuestra Señora de La Paz","ESC. REMBERTO TAPIA",-68.14641,-16.50409,399,42,4556,4955,2112,146,2256,4368
"Bolivia","La Paz","Murillo","Nuestra Señora de La Paz","ESC. REPUBLICA DEL PERU",-68.12861,-16.50675,102,1,588,690,452,9,126,578
"Bolivia","La Paz","Murillo","Nuestra Señora de La Paz","ESC. RURAL CANAVIRI",-68.13701,-16.17418,26,8,187,213,54,2,123,177
"Bolivia","La Paz","Murillo","Nuestra Señora de La Paz","ESC. SAGRADO CORAZON DE JESUS",-68.14336,-16.50653,683,56,7063,7746,2748,200,4059,6807
"Bolivia","La Paz","Murillo","Nuestra Señora de La Paz","ESC. SAN JOSE",-68.12814,-16.52707,348,21,3872,4220,2099,95,1657,3756
"Bolivia","La Paz","Murillo","Nuestra Señora de La Paz","ESC. SAN MARTIN",-68.11597,-16.49783,666,42,6132,6798,3862,233,1995,5857
"Bolivia","La Paz","Murillo","Nuestra Señora de La Paz","ESC. SAN MIGUEL",-68.14462,-16.54603,51,6,488,539,115,13,354,469
"Bolivia","La Paz","Murillo","Nuestra Señora de La Paz","ESC SANTA ROSA DE LIMA",-68.03819,-16.53689,448,63,5381,5829,1329,192,3797,5126
"Bolivia","La Paz","Murillo","Nuestra Señora de La Paz","ESC. SERGIO SUAREZ",-68.13206,-16.48701,670,57,6254,6924,2747,164,3286,6033
"Bolivia","La Paz","Murillo","Nuestra Señora de La Paz","ESCUELA 13 DE JUNIO CHINCHAYA",-68.08366,-16.48442,56,18,653,709,132,19,484,616
"Bolivia","La Paz","Murillo","Nuestra Señora de La Paz","ESCUELA 6 DE AGOSTO",-68.11748,-16.49531,236,18,2365,2601,1569,49,729,2298
"Bolivia","La Paz","Murillo","Nuestra Señora de La Paz","ESCUELA AGUSTIN ASPIAZU",-68.12946,-16.50753,447,11,3167,3614,2455,62,639,3094
"Bolivia","La Paz","Murillo","Nuestra Señora de La Paz","ESCUELA ALTO ACHUMANI",-68.05845,-16.51433,618,46,6259,6877,3573,129,2511,6084
"Bolivia","La Paz","Murillo","Nuestra Señora de La Paz","ESCUELA CALLAPA (PLAZA DE CALLAPA)",-68.09043,-16.49957,140,13,1291,1431,327,55,896,1223
"Bolivia","La Paz","Murillo","Nuestra Señora de La Paz","ESCUELA CHASQUIPAMPA",-68.04555,-16.54921,1021,79,10620,11641,4104,312,6125,10229
"Bolivia","La Paz","Murillo","Nuestra Señora de La Paz","ESCUELA CIUDAD DEL NIÑO",-68.09786,-16.49375,223,18,2315,2538,1129,111,1057,2186
"Bolivia","La Paz","Murillo","Nuestra Señora de La Paz","ESCUELA ELOY ALVAREZ PLATA",-68.14813,-16.48382,157,2,1559,1716,1077,35,445,1522
"Bolivia","La Paz","Murillo","Nuestra Señora de La Paz","ESCUELA JOHN F. KENNEDY",-68.1515,-16.47704,139,5,1301,1440,764,29,503,1267
"Bolivia","La Paz","Murillo","Nuestra Señora de La Paz","ESCUELA JUAN PABLO II",-68.1031,-16.53394,318,14,2822,3140,2154,39,615,2769
"Bolivia","La Paz","Murillo","Nuestra Señora de La Paz","ESCUELA PEDRO POVEDA",-68.11266,-16.5103,408,22,3418,3826,1789,96,1511,3300
"Bolivia","La Paz","Murillo","Nuestra Señora de La Paz","ESCUELA PEDRO POVEDA",-68.11266,-16.5103,408,22,3418,3826,1789,96,1511,3300
"Bolivia","La Paz","Murillo","Nuestra Señora de La Paz","ESCUELA PILOTO NACIONES UNIDAS",-68.1187,-16.49925,132,7,1191,1323,877,20,287,1164
"Bolivia","La Paz","Murillo","Nuestra Señora de La Paz","ESCUELA REPUBLICA DE JAPON",-68.14366,-16.51144,634,47,5956,6590,2582,191,3136,5718
"Bolivia","La Paz","Murillo","Nuestra Señora de La Paz","ESCUELA REPUBLICA DE JAPON",-68.14366,-16.51144,634,47,5956,6590,2582,191,3136,5718
"Bolivia","La Paz","Murillo","Nuestra Señora de La Paz","ESCUELA REPUBLICA DEL BRASIL",-68.14114,-16.49013,263,13,2453,2716,1571,57,812,2383
"Bolivia","La Paz","Murillo","Nuestra Señora de La Paz","ESCUELA ROSEMARI DE BARRIENTOS",-68.08743,-16.52519,1191,18,7850,9041,6275,101,1456,7731
"Bolivia","La Paz","Murillo","Nuestra Señora de La Paz","ESCUELA SANTA ROSA LA FLORIDA",-68.09236,-16.54617,605,19,3640,4245,2534,57,1030,3564
"Bolivia","La Paz","Murillo","Nuestra Señora de La Paz","ESCUELA SUPERIOR DE FORMACIÓN DE MAESTROS SIMON BOLIVAR",-68.11337,-16.51854,255,16,2820,3075,1843,70,891,2734
"Bolivia","La Paz","Murillo","Nuestra Señora de La Paz","ESCUELA VICTOR PAZ ESTENSORO",-68.08412,-16.51657,324,24,2934,3258,1563,77,1270,2833
"Bolivia","La Paz","Murillo","Nuestra Señora de La Paz","ESC. WALTER STRAUB",-68.06351,-16.54204,534,13,4299,4833,2707,135,1444,4151
"Bolivia","La Paz","Murillo","Nuestra Señora de La Paz","FACULTAD DE TECNOLOGIA (U.M.S.A)",-68.12685,-16.50758,216,3,1075,1291,883,17,172,1055
"Bolivia","La Paz","Murillo","Nuestra Señora de La Paz","INSTITUTO AMERICANO",-68.13234,-16.50628,518,32,4253,4771,3290,107,824,4114
"Bolivia","La Paz","Murillo","Nuestra Señora de La Paz","INSTITUTO AMERICANO",-68.13234,-16.50628,518,32,4253,4771,3290,107,824,4114
"Bolivia","La Paz","Murillo","Nuestra Señora de La Paz","INSTITUTO AMERICANO OBRAJES",-68.10566,-16.52666,469,17,4081,4550,3137,79,848,3985
"Bolivia","La Paz","Murillo","Nuestra Señora de La Paz","INSTITUTO DOMINGO SAVIO",-68.08488,-16.53951,377,11,1687,2064,1337,26,313,1650
"Bolivia","La Paz","Murillo","Nuestra Señora de La Paz","INSTITUTO MENDEZ ARCOS",-68.13995,-16.5042,356,10,3726,4082,2767,62,887,3654
"Bolivia","La Paz","Murillo","Nuestra Señora de La Paz","KINDER. BOLIVIA",-68.14942,-16.45182,203,20,2238,2441,942,57,1219,2161
"Bolivia","La Paz","Murillo","Nuestra Señora de La Paz","KINDER FLORA PEREZ DE SAAVEDRA",-68.14472,-16.48339,137,18,1613,1750,895,50,650,1545
"Bolivia","La Paz","Murillo","Nuestra Señora de La Paz","KINDER NAZARIO PARDO",-68.12493,-16.51608,213,8,1861,2074,1047,61,745,1792
"Bolivia","La Paz","Murillo","Nuestra Señora de La Paz","LICEO BOLIVIA",-68.13096,-16.51116,181,6,1296,1477,1035,31,224,1259
"Bolivia","La Paz","Murillo","Nuestra Señora de La Paz","LICEO LA PAZ",-68.13188,-16.50126,184,2,1210,1394,881,24,303,1184
"Bolivia","La Paz","Murillo","Nuestra Señora de La Paz","LICEO TEC.H. NUESTRA SRA DE LA PAZ",-68.13543,-16.49124,220,4,1729,1949,1161,41,523,1684
"Bolivia","La Paz","Murillo","Nuestra Señora de La Paz","PARQUE MIRADOR KILLI KILLI",-68.12752,-16.49444,269,19,2437,2706,1555,89,774,2329
"Bolivia","La Paz","Murillo","Nuestra Señora de La Paz","PLAZA DANIEL RODRIGUEZ",-68.09914,-16.53118,240,9,2405,2645,1329,54,1013,2342
"Bolivia","La Paz","Murillo","Nuestra Señora de La Paz","POLIFUNCIONAL SAN ISIDRO (IGLESIA SAN ISIDRO)",-68.107,-16.51307,176,17,1566,1742,814,47,688,1502
"Bolivia","La Paz","Murillo","Nuestra Señora de La Paz","SEDE JUNTA VECINAL",-68.11436,-16.50176,47,8,587,634,247,6,326,573
"Bolivia","La Paz","Murillo","Nuestra Señora de La Paz","SEDE SOCIAL CAJA FERROVIARIA",-68.15063,-16.44667,111,11,1350,1461,414,30,895,1309
"Bolivia","La Paz","Murillo","Nuestra Señora de La Paz","SEDE SOCIAL CARPANI",-68.0458,-16.45051,42,27,491,533,34,10,420,454
"Bolivia","La Paz","Murillo","Nuestra Señora de La Paz","SEDE SOCIAL DE CUSICANCHA",-68.16608,-16.48517,113,15,1205,1318,476,49,665,1141
"Bolivia","La Paz","Murillo","Nuestra Señora de La Paz","SEDE SOCIAL PLAN AUTOPISTA",-68.14625,-16.45818,164,16,1598,1762,775,45,762,1537
"Bolivia","La Paz","Murillo","Nuestra Señora de La Paz","SEDE SOCIAL PURA PURA",-68.15314,-16.47277,222,7,2201,2423,1105,64,1025,2130
"Bolivia","La Paz","Murillo","Nuestra Señora de La Paz","SEDE SOCIAL VILLA LITORAL",-68.10748,-16.50479,91,15,1008,1099,466,22,505,971
"Bolivia","La Paz","Murillo","Nuestra Señora de La Paz","SEMINARIO NAZARENO",-68.09364,-16.55968,101,1,554,655,427,8,118,545
"Bolivia","La Paz","Murillo","Nuestra Señora de La Paz","TECNICO AYACUCHO",-68.12161,-16.48541,1357,58,11903,13260,8561,237,3047,11608
"Bolivia","La Paz","Murillo","Nuestra Señora de La Paz","TECNICO AYACUCHO",-68.12161,-16.48541,1357,58,11903,13260,8561,237,3047,11608
"Bolivia","La Paz","Murillo","Nuestra Señora de La Paz","U. E. ABRAHAM REYES (FE Y ALEGRIA)",-68.16405,-16.48898,555,58,5865,6420,2519,167,3121,5640
"Bolivia","La Paz","Murillo","Nuestra Señora de La Paz","U. E. ANDINA",-68.11532,-16.46878,252,16,1986,2238,1079,39,852,1931
"Bolivia","La Paz","Murillo","Nuestra Señora de La Paz","U.E. CARLOS SALINAS",-68.13042,-16.4982,60,2,503,563,326,14,161,487
"Bolivia","La Paz","Murillo","Nuestra Señora de La Paz","U.E. EL PEDREGAL (URB. PEDREGAL)",-68.05286,-16.54382,86,10,1091,1177,375,35,671,1046
"Bolivia","La Paz","Murillo","Nuestra Señora de La Paz","U. E. FF. AA. DE LA NACIÓN",-68.08987,-16.52197,358,17,2923,3281,1732,76,1098,2830
"Bolivia","La Paz","Murillo","Nuestra Señora de La Paz","U.E. FILADELFIA",-68.16099,-16.50017,53,11,763,816,279,36,437,716
"Bolivia","La Paz","Murillo","Nuestra Señora de La Paz","U.E. GRAN BRETAÑA",-68.10885,-16.5197,10,0,76,86,43,1,32,75
"Bolivia","La Paz","Murillo","Nuestra Señora de La Paz","U. E. KINDER CAROLA IÑIGUEZ (FE Y ALEGRIA)",-68.16422,-16.48865,188,10,1615,1803,658,32,915,1573
"Bolivia","La Paz","Murillo","Nuestra Señora de La Paz","U. E. PANTALEON DALENCE",-68.14204,-16.51047,165,10,1890,2055,1199,44,637,1836
"Bolivia","La Paz","Murillo","Nuestra Señora de La Paz","U.E. SAN ANDRÉS",-68.07038,-16.53759,348,11,2701,3049,2009,59,622,2631
"Bolivia","La Paz","Murillo","Nuestra Señora de La Paz","U.E. WALDO BALLIVIAN",-68.11192,-16.5086,461,24,5077,5538,2780,169,2104,4884
"Bolivia","La Paz","Murillo","Nuestra Señora de La Paz","UNIDAD EDUCATIVA 24 DE JUNIO",-68.10389,-16.49494,554,47,5633,6187,2554,215,2817,5371
"Bolivia","La Paz","Murillo","Nuestra Señora de La Paz","UNIDAD EDUCATIVA ARABE DE EGIPTO",-68.1409,-16.4971,150,13,1683,1833,1044,26,600,1644
"Bolivia","La Paz","Murillo","Nuestra Señora de La Paz","UNIDAD EDUCATIVA CARLOS MEDINACELLI",-68.14066,-16.51231,484,20,4452,4936,2561,134,1737,4298
"Bolivia","La Paz","Murillo","Nuestra Señora de La Paz","UNIDAD EDUCATIVA CRISTIANA VIDA NUEVA",-68.11804,-16.48913,257,13,2715,2972,1681,66,955,2636
"Bolivia","La Paz","Murillo","Nuestra Señora de La Paz","UNIDAD EDUCATIVA FABRIL 18 DE MAYO",-68.14603,-16.49241,321,14,2914,3235,1856,67,977,2833
"Bolivia","La Paz","Murillo","Nuestra Señora de La Paz","UNIDAD EDUCATIVA FABRIL 18 DE MAYO",-68.14603,-16.49241,321,14,2914,3235,1856,67,977,2833
"Bolivia","La Paz","Murillo","Nuestra Señora de La Paz","UNIDAD EDUCATIVA JUPAPINA",-68.0744,-16.58935,144,11,1176,1320,524,40,601,1125
"Bolivia","La Paz","Murillo","Nuestra Señora de La Paz","UNIDAD EDUCATIVA LITORAL A",-68.151,-16.47124,374,23,3347,3721,1673,96,1555,3228
"Bolivia","La Paz","Murillo","Nuestra Señora de La Paz","UNIDAD EDUCATIVA LOS PINOS",-68.07632,-16.54179,663,13,4322,4985,3695,100,514,4209
"Bolivia","La Paz","Murillo","Nuestra Señora de La Paz","UNIDAD EDUCATIVA MALLASA",-68.08762,-16.57032,169,17,1674,1843,775,36,846,1621
"Bolivia","La Paz","Murillo","Nuestra Señora de La Paz","UNIDAD EDUCATIVA PRIVADA LA PAZ",-68.14587,-16.4988,151,12,1459,1610,796,35,616,1412
"Bolivia","La Paz","Murillo","Nuestra Señora de La Paz","UNIDAD EDUCATIVA PRIVADA LA PAZ",-68.14587,-16.4988,151,12,1459,1610,796,35,616,1412
"Bolivia","La Paz","Murillo","Nuestra Señora de La Paz","UNIDAD EDUCATIVA PUERTO RICO",-68.13956,-16.51244,345,30,3573,3918,1885,120,1538,3423
"Bolivia","La Paz","Murillo","Nuestra Señora de La Paz","UNIDAD EDUCATIVA REPUBLICA DE CHINA",-68.1278,-16.4945,300,16,2812,3112,1704,69,1023,2727
"Bolivia","La Paz","Murillo","Nuestra Señora de La Paz","UNIDAD EDUCATIVA REPUBLICA DE CUBA",-68.13556,-16.50287,334,14,2639,2973,1903,50,672,2575
"Bolivia","La Paz","Murillo","Nuestra Señora de La Paz","UNIDAD EDUCATIVA ROSARIO (URB. EL ROSARIO)",-68.11529,-16.52871,24,1,507,531,284,11,211,495
"Bolivia","La Paz","Murillo","Nuestra Señora de La Paz","UNIDAD EDUCATIVA SAN JOSE (U. E. MANUEL B. MARIACA)",-68.15286,-16.48993,284,15,3352,3636,1943,70,1324,3267
"Bolivia","La Paz","Murillo","Nuestra Señora de La Paz","UNIDAD EDUCATIVA VALLE HERMOSO",-68.10799,-16.4883,256,23,3022,3278,1358,80,1561,2919
"Bolivia","La Paz","Murillo","Nuestra Señora de La Paz","UNIDAD EDUCATIVA VILLA HARCA",-68.04404,-16.09133,35,6,291,326,101,13,171,272
"Bolivia","La Paz","Murillo","Nuestra Señora de La Paz","UNID. EDUC. 20 DE OCTUBRE N° 1",-68.16086,-16.46114,107,21,1283,1390,354,30,878,1232
"Bolivia","La Paz","Murillo","Nuestra Señora de La Paz","UNID EDUCATIVA BETESTA",-68.04996,-16.54382,227,25,2750,2977,952,99,1674,2626
"Bolivia","La Paz","Murillo","Nuestra Señora de La Paz","UNID. EDUC. HUGO BANZER SUAREZ",-68.14326,-16.51199,178,15,1665,1843,909,28,713,1622
"Bolivia","La Paz","Murillo","Nuestra Señora de La Paz","UNID. EDUC. JAIME ESCALANTE",-68.14835,-16.51145,414,55,3784,4198,1398,106,2225,3623
"Bolivia","La Paz","Murillo","Nuestra Señora de La Paz","UNID. EDUC. JOAQUIN HERNANN",-68.02591,-16.54834,95,25,1081,1176,172,19,865,1037
"Bolivia","La Paz","Murillo","Nuestra Señora de La Paz","UNID. EDUC. JORGE VARGAS",-68.13081,-16.53269,213,11,2192,2405,1060,93,1028,2088
"Bolivia","La Paz","Murillo","Nuestra Señora de La Paz","UNID. EDUC. RAUL SALMON DE LA BARRA",-68.1396,-16.52271,293,31,2955,3248,1034,97,1793,2827
"Bolivia","La Paz","Murillo","Palca","COL PEDRO DOMINGO MURILLO",-67.95261,-16.56124,247,50,1923,2170,259,95,1519,1778
"Bolivia","La Paz","Murillo","Palca","ESCUELA CAYIMBAYA",-67.75253,-16.71384,53,15,595,648,162,31,387,549
"Bolivia","La Paz","Murillo","Palca","ESCUELA COHONI",-67.83873,-16.7112,152,46,1329,1481,147,76,1060,1207
"Bolivia","La Paz","Murillo","Palca","ESCUELA COTAÑA",-67.71759,-16.72519,50,6,542,592,76,14,446,522
"Bolivia","La Paz","Murillo","Palca","ESCUELA QUILLIHUAYA",-67.90135,-16.66606,107,17,935,1042,111,29,778,889
"Bolivia","La Paz","Murillo","Palca","ESCUELA TAHUAPALCA",-67.87465,-16.72088,39,12,498,537,54,15,417,471
"Bolivia","La Paz","Murillo","Palca","ESCUELA TIRATA",-67.78961,-16.76238,29,0,257,286,25,0,232,257
"Bolivia","La Paz","Murillo","Palca","UNIDAD EDUCATIVA UNI",-67.9979,-16.5432,46,13,755,801,73,34,635,708
"Bolivia","La Paz","Nor Yungas","Coripata","CASA CULTURAL SAN JUAN DE CORIPATA",-67.56571,-16.25786,39,7,498,537,70,9,412,482
"Bolivia","La Paz","Nor Yungas","Coripata","COLEGIO ANDRES DE SANTA CRUZ",-67.64132,-16.27026,284,34,2254,2538,856,133,1231,2087
"Bolivia","La Paz","Nor Yungas","Coripata","COLEGIO FRAZ TAMAYO FE Y ALEGRIA",-67.6668,-16.28096,146,12,1020,1166,419,58,531,950
"Bolivia","La Paz","Nor Yungas","Coripata","COLEGIO SANTIAGO TOCORONI",-67.55057,-16.26809,112,8,907,1019,193,32,674,867
"Bolivia","La Paz","Nor Yungas","Coripata","ESCUELA CAPITAN LUIS REVERO SANCHEZ",-67.60426,-16.31971,709,67,4092,4801,1462,156,2407,3869
"Bolivia","La Paz","Nor Yungas","Coripata","ESCUELA MILLUHUAYA ALTO",-67.61317,-16.37393,74,6,735,809,194,20,515,709
"Bolivia","La Paz","Nor Yungas","Coroico","CASA DE GOBIERNO",-67.7733,-16.11081,68,5,472,540,145,24,298,443
"Bolivia","La Paz","Nor Yungas","Coroico","COL. TEC. HUM. CRUZ LOMA",-67.6988,-16.19916,89,10,853,942,226,32,585,811
"Bolivia","La Paz","Nor Yungas","Coroico","ESC. FELIX REYES ORTIZ",-67.72715,-16.18757,363,35,1842,2205,754,80,973,1727
"Bolivia","La Paz","Nor Yungas","Coroico","ESCUELA FRANZ TAMAYO",-67.73856,-16.14407,84,9,487,571,133,13,332,465
"Bolivia","La Paz","Nor Yungas","Coroico","ESCUELA JHON F. KENNEDY",-67.68882,-16.07204,53,7,513,566,96,17,393,489
"Bolivia","La Paz","Nor Yungas","Coroico","ESCUELA PACOLLO",-67.79175,-16.20483,104,8,633,737,148,25,452,600
"Bolivia","La Paz","Nor Yungas","Coroico","ESCUELA SANTA ROSA DE QUILO QUILO",-67.81871,-16.03682,57,8,706,763,111,19,568,679
"Bolivia","La Paz","Nor Yungas","Coroico","ESCUELA UNDUAVI",-67.90942,-16.31096,7,1,58,65,13,4,40,53
"Bolivia","La Paz","Nor Yungas","Coroico","U.E. YOLOSA",-67.74015,-16.23356,62,6,424,486,129,9,280,409
"Bolivia","La Paz","Nor Yungas","Coroico","UNIDAD EDUCATIVA PUENTE ARMAS",-67.64138,-16.03312,78,4,441,519,77,11,349,426
"Bolivia","La Paz","Nor Yungas","Coroico","UNIDAD EDU. SAN PEDRO",-67.72571,-16.19051,361,40,2079,2440,833,77,1129,1962
"Bolivia","La Paz","Omasuyos","Achacachi","CASA DE GOBIERNO",-68.81913,-16.16913,61,26,744,805,206,33,479,685
"Bolivia","La Paz","Omasuyos","Achacachi","COLEGIO ANTOFAGASTA",-68.69424,-15.9962,48,14,695,743,198,24,459,657
"Bolivia","La Paz","Omasuyos","Achacachi","COLEGIO FRANZ TAMAYO",-68.74367,-15.92973,63,26,882,945,209,41,606,815
"Bolivia","La Paz","Omasuyos","Achacachi","COLEGIO MARISCAL SANTA CRUZ",-68.68538,-16.04263,489,72,3710,4199,1320,204,2114,3434
"Bolivia","La Paz","Omasuyos","Achacachi","COLEGIO OMASUYOS",-68.68598,-16.04657,386,76,3572,3958,1253,182,2061,3314
"Bolivia","La Paz","Omasuyos","Achacachi","COLEGIO SIMON BOLIVAR",-68.59965,-16.0757,16,3,403,419,121,33,246,367
"Bolivia","La Paz","Omasuyos","Achacachi","COLEGIO SUÑASIVI",-68.64019,-15.98684,84,14,641,725,140,49,438,578
"Bolivia","La Paz","Omasuyos","Achacachi","ESC. SIMON BOLIVIAR",-68.69108,-16.04526,299,80,2719,3018,969,141,1529,2498
"Bolivia","La Paz","Omasuyos","Achacachi","ESCUELA AJLLATA GRANDE",-68.7886,-16.02371,96,37,1289,1385,515,50,687,1202
"Bolivia","La Paz","Omasuyos","Achacachi","ESCUELA APLICACION HUARIZATA",-68.66218,-15.97352,191,40,1450,1641,508,89,813,1321
"Bolivia","La Paz","Omasuyos","Achacachi","ESCUELA APURAYA",-68.74739,-16.0668,49,18,759,808,190,33,518,708
"Bolivia","La Paz","Omasuyos","Achacachi","ESCUELA BELEN",-68.70184,-16.01776,49,11,490,539,112,22,345,457
"Bolivia","La Paz","Omasuyos","Achacachi","ESCUELA CENTRAL CASAMAYA",-68.59995,-16.04042,32,6,354,386,85,27,236,321
"Bolivia","La Paz","Omasuyos","Achacachi","ESCUELA KILLOSA",-68.70744,-15.93228,10,0,126,136,35,7,84,119
"Bolivia","La Paz","Omasuyos","Achacachi","ESCUELA VILLA LIPE",-68.75453,-16.05257,55,17,672,727,166,40,449,615
"Bolivia","La Paz","Omasuyos","Achacachi","ESCUELA WALATA CHICO",-68.65627,-15.93059,31,6,260,291,60,5,189,249
"Bolivia","La Paz","Omasuyos","Achacachi","NUCLEO ECOLAR MURUMAMANI",-68.69246,-15.90919,19,2,499,518,84,14,399,483
"Bolivia","La Paz","Omasuyos","Achacachi","NUCLEO EDUCATIVO TAHARI",-68.6852,-15.95393,8,2,421,429,138,17,264,402
"Bolivia","La Paz","Omasuyos","Achacachi","NÚCLEO ESCOLAR CHALLUYO",-68.61758,-15.99023,20,14,435,455,91,21,309,400
"Bolivia","La Paz","Omasuyos","Achacachi","NUCLEO TACAMARA",-68.61773,-16.02135,88,17,831,919,193,51,570,763
"Bolivia","La Paz","Omasuyos","Achacachi","PLAZA VILLA ASUNCION DE CORPAPUTO",-68.55613,-16.0707,65,14,503,568,115,20,354,469
"Bolivia","La Paz","Omasuyos","Ancoraimes","COLEGIO CAJIATA",-68.85471,-15.91954,4,4,324,328,32,11,277,309
"Bolivia","La Paz","Omasuyos","Ancoraimes","COLEGIO MACAMACA",-68.94691,-15.83644,37,6,663,700,116,22,519,635
"Bolivia","La Paz","Omasuyos","Ancoraimes","ESCUELA FRANZ TAMAYO",-68.90729,-15.89587,186,29,1152,1338,298,74,751,1049
"Bolivia","La Paz","Omasuyos","Ancoraimes","ESCUELA SECCIONAL CHIÑAJA",-68.83353,-15.76956,1,2,94,95,14,2,76,90
"Bolivia","La Paz","Omasuyos","Ancoraimes","ESCUELA SOTALAYA",-68.83341,-15.92723,3,8,316,319,53,8,247,300
"Bolivia","La Paz","Omasuyos","Ancoraimes","ESCUELA TURRINI",-68.89091,-15.87126,14,3,288,302,67,10,208,275
"Bolivia","La Paz","Omasuyos","Ancoraimes","MOROCOLLO PLAZA PRINCIPAL",-68.88557,-15.91232,103,23,909,1012,222,49,615,837
"Bolivia","La Paz","Omasuyos","Ancoraimes","NUCLEO ESCOLAR DE PATAPATANI",-68.82576,-15.78231,5,1,109,114,17,1,90,107
"Bolivia","La Paz","Omasuyos","Ancoraimes","PLAZA 14 DE FEBRERO",-68.81345,-15.88548,95,10,955,1050,184,37,724,908
"Bolivia","La Paz","Omasuyos","Ancoraimes","SEDE SOCIAL CHOJÑAPATA",-68.87042,-15.79118,7,0,97,104,20,1,76,96
"Bolivia","La Paz","Omasuyos","Ancoraimes","SEDE SOCIAL INKA CATURAPI",-68.82888,-15.76071,20,8,285,305,105,3,169,274
"Bolivia","La Paz","Omasuyos","Ancoraimes","TEC. HUMANISTA POCOATA GRANDE",-68.79222,-15.94282,31,13,597,628,138,24,422,560
"Bolivia","La Paz","Omasuyos","Chúa Cocani","CASA DE GOBIERNO",-68.76876,-16.1837,53,7,480,533,162,14,297,459
"Bolivia","La Paz","Omasuyos","Chúa Cocani","ESCUELA CHUA COCANI",-68.74966,-16.18941,150,11,725,875,265,31,418,683
"Bolivia","La Paz","Omasuyos","Chúa Cocani","ESCUELA CORPACHILAYA",-68.71874,-16.19794,39,5,330,369,120,10,195,315
"Bolivia","La Paz","Omasuyos","Chúa Cocani","UNIDAD EDUCATIVA COMPI",-68.7893,-16.17562,55,21,704,759,166,32,485,651
"Bolivia","La Paz","Omasuyos","Huarina","CASA DE GOBIERNO",-68.57069,-16.24477,46,2,380,426,78,6,294,372
"Bolivia","La Paz","Omasuyos","Huarina","ESCUELA APUVILLQUE MOROCOLLO",-68.64399,-16.13322,38,12,312,350,75,23,202,277
"Bolivia","La Paz","Omasuyos","Huarina","ESCUELA BERNABE LEDEZMA",-68.54478,-16.12266,57,13,574,631,182,26,353,535
"Bolivia","La Paz","Omasuyos","Huarina","ESCUELA MARISCAL DE SANTA CRUZ",-68.60149,-16.19093,305,49,2169,2474,705,103,1312,2017
"Bolivia","La Paz","Omasuyos","Huarina","ESCUELA UNIDAD EDUCATIVAO COROMATA BAJA",-68.56112,-16.15195,35,8,323,358,113,11,191,304
"Bolivia","La Paz","Omasuyos","Huatajata","COLEGIO NACIONAL MIXTO HUATAJATA",-68.70113,-16.2081,170,26,1382,1552,536,51,769,1305
"Bolivia","La Paz","Omasuyos","Huatajata","ESCUELA SANCA JAHUIRA",-68.66814,-16.21417,28,13,329,357,111,14,191,302
"Bolivia","La Paz","Omasuyos","Santiago de Huata","COLEGIO CENTRAL POREJONI",-68.83286,-16.10552,36,14,329,365,51,7,257,308
"Bolivia","La Paz","Omasuyos","Santiago de Huata","COLEGIO SANTIAGO DE HUATA",-68.81879,-16.05531,191,71,1619,1810,532,94,922,1454
"Bolivia","La Paz","Omasuyos","Santiago de Huata","ESCUELA WATARI",-68.86102,-16.07956,25,5,189,214,44,13,127,171
"Bolivia","La Paz","Omasuyos","Santiago de Huata","PLAZA WICHI WICHI",-68.87871,-16.09691,51,9,541,592,125,17,390,515
"Bolivia","La Paz","Pacajes","Calacoto","COL. ANTOFAGASTA",-69.04382,-17.42133,14,3,179,193,46,5,125,171
"Bolivia","La Paz","Pacajes","Calacoto","COL. CAMACHO",-68.75751,-17.42726,66,2,156,222,28,2,124,152
"Bolivia","La Paz","Pacajes","Calacoto","COLEGIO FRANZ TAMAYO",-68.85695,-17.30775,27,0,223,250,51,3,169,220
"Bolivia","La Paz","Pacajes","Calacoto","COLEGIO HEROES DEL PACIFICO",-68.76153,-17.86703,6,1,125,131,25,0,99,124
"Bolivia","La Paz","Pacajes","Calacoto","COLEGIO PLAYA VINTO",-68.91974,-17.76429,15,3,107,122,14,1,89,103
"Bolivia","La Paz","Pacajes","Calacoto","COL. HUARISCATA",-68.80087,-17.83315,26,0,142,168,13,1,128,141
"Bolivia","La Paz","Pacajes","Calacoto","COL. J. SARCO KRAMER",-68.81659,-17.42351,39,3,135,174,34,2,96,130
"Bolivia","La Paz","Pacajes","Calacoto","ESC. LAGUNA BLANCA",-68.61784,-17.6079,7,0,127,134,18,3,106,124
"Bolivia","La Paz","Pacajes","Calacoto","ESC. N. LERCO",-68.47871,-17.5797,32,2,205,237,42,6,155,197
"Bolivia","La Paz","Pacajes","Calacoto","ESC. PABLO LAVADENS",-68.63289,-17.28291,97,4,445,542,114,18,309,423
"Bolivia","La Paz","Pacajes","Calacoto","ESCUELA ACHAVICO",-68.92034,-17.41066,5,1,56,61,8,2,45,53
"Bolivia","La Paz","Pacajes","Calacoto","ESCUELA PLAYA VERDE",-68.56482,-17.37746,19,2,185,204,30,4,149,179
"Bolivia","La Paz","Pacajes","Calacoto","ESC. ULLOMA",-68.49041,-17.4915,10,2,181,191,50,2,127,177
"Bolivia","La Paz","Pacajes","Calacoto","PLAZA AUDIENCIA",-68.6291,-17.47268,19,3,368,387,72,2,291,363
"Bolivia","La Paz","Pacajes","Calacoto","PLAZA CHALLUYO",-69.03053,-17.35813,22,4,113,135,33,3,73,106
"Bolivia","La Paz","Pacajes","Calacoto","PLAZA PRINCIPAL",-68.91343,-17.47115,30,2,110,140,10,3,95,105
"Bolivia","La Paz","Pacajes","Calacoto","SEDE SOCIAL MAX TOLEDO",-68.68167,-17.2371,33,1,149,182,34,3,111,145
"Bolivia","La Paz","Pacajes","Caquiaviri","COL. CALLA LLALLAGUA",-68.68002,-16.92397,34,0,142,176,14,5,123,137
"Bolivia","La Paz","Pacajes","Caquiaviri","ESC. ACHIRI",-69.00089,-17.21467,226,17,874,1100,226,27,604,830
"Bolivia","La Paz","Pacajes","Caquiaviri","ESC. ANTAQUIRA VILLA BELEN",-68.66805,-17.08638,41,2,279,320,66,4,207,273
"Bolivia","La Paz","Pacajes","Caquiaviri","ESC. CALAMA QUINTAVI",-68.86324,-17.26844,5,0,32,37,12,0,20,32
"Bolivia","La Paz","Pacajes","Caquiaviri","ESC. CAQUIAVIRI",-68.60491,-17.02134,202,23,908,1110,210,31,644,854
"Bolivia","La Paz","Pacajes","Caquiaviri","ESC. CENTRAL",-68.57354,-16.90038,44,3,320,364,54,11,252,306
"Bolivia","La Paz","Pacajes","Caquiaviri","ESC. CHOJNA PAMPA DE VICHAYA",-68.71049,-17.12527,2,0,103,105,29,0,74,103
"Bolivia","La Paz","Pacajes","Caquiaviri","ESC. JIHUACUTA",-68.78035,-17.1179,46,8,336,382,62,14,252,314
"Bolivia","La Paz","Pacajes","Caquiaviri","ESC. VILLA CHOCOROSI",-68.84946,-17.14096,32,4,213,245,80,5,124,204
"Bolivia","La Paz","Pacajes","Caquiaviri","NUCLEO ESCOLAR VICHAYA",-68.66454,-16.85874,37,5,342,379,98,9,230,328
"Bolivia","La Paz","Pacajes","Caquiaviri","PLAZA 14 DE SEPTIEMBRE",-68.71069,-16.90587,18,4,262,280,37,3,218,255
"Bolivia","La Paz","Pacajes","Caquiaviri","PLAZA SAN MIGUEL",-68.7556,-17.03869,37,3,318,355,80,10,225,305
"Bolivia","La Paz","Pacajes","Caquiaviri","SEDE SOCIAL",-68.94909,-17.09862,20,2,62,82,25,1,34,59
"Bolivia","La Paz","Pacajes","Charaña","COLEGIO EDUARDO AVAROA",-69.44685,-17.59194,183,9,599,782,218,16,356,574
"Bolivia","La Paz","Pacajes","Charaña","COL. TEC. HUMANISTICO TOPATER",-69.10415,-17.43627,5,0,72,77,26,2,44,70
"Bolivia","La Paz","Pacajes","Charaña","ESC. CHINOCAVI",-69.33294,-17.72286,14,1,84,98,14,1,68,82
"Bolivia","La Paz","Pacajes","Charaña","ESC. EDUARDO AVAROA",-69.24786,-17.5377,3,0,42,45,14,2,26,40
"Bolivia","La Paz","Pacajes","Charaña","ESC. GUALBERTO VILLARROEL",-69.11758,-17.51751,5,1,51,56,8,2,40,48
"Bolivia","La Paz","Pacajes","Charaña","ESC. RIO BLANCO",-69.07213,-17.8919,25,3,136,161,61,5,67,128
"Bolivia","La Paz","Pacajes","Charaña","ESC. SICUANI CONDOROCA",-69.46599,-17.4963,26,1,123,149,19,1,102,121
"Bolivia","La Paz","Pacajes","Comanche","COLEGIO COMANCHE",-68.42522,-16.95766,138,18,938,1076,244,38,638,882
"Bolivia","La Paz","Pacajes","Comanche","COL. TOCOPILLA CANTUYO",-68.50373,-16.83876,24,3,324,348,68,10,243,311
"Bolivia","La Paz","Pacajes","Comanche","ESC. KELLA KELLA",-68.41179,-16.9197,5,2,126,131,53,3,68,121
"Bolivia","La Paz","Pacajes","Comanche","SEDE SOCIAL",-68.46437,-17.07932,37,6,289,326,84,5,194,278
"Bolivia","La Paz","Pacajes","Comanche","SEDE SOCIAL",-68.54688,-16.92686,37,6,289,326,84,5,194,278
"Bolivia","La Paz","Pacajes","Coro Coro","CASA DE  GOBIERNO",-68.49454,-17.2455,21,3,279,300,73,12,191,264
"Bolivia","La Paz","Pacajes","Coro Coro","COL. CANCASILLA",-68.60786,-17.10883,18,2,121,139,36,3,80,116
"Bolivia","La Paz","Pacajes","Coro Coro","COLEGIO JOSE MANUEL PANDO",-68.49117,-17.2136,37,8,389,426,93,17,271,364
"Bolivia","La Paz","Pacajes","Coro Coro","COL. JAYUMA LLALLAGUA",-68.48241,-17.29913,9,2,128,137,37,2,87,124
"Bolivia","La Paz","Pacajes","Coro Coro","ESC. PEDRO DOMINGO MURILLO",-68.2065,-17.1975,0,2,191,191,30,9,150,180
"Bolivia","La Paz","Pacajes","Coro Coro","ESC. SECCIONAL ANCO AQUE",-68.19199,-17.17361,1,7,331,332,91,7,226,317
"Bolivia","La Paz","Pacajes","Coro Coro","ESC. TOPOHOCO",-68.24099,-17.16903,19,14,316,335,58,18,226,284
"Bolivia","La Paz","Pacajes","Coro Coro","ESC. VICENTA JUARISTE EGUINO",-68.45507,-17.1773,244,9,1228,1472,313,58,848,1161
"Bolivia","La Paz","Pacajes","Coro Coro","NUCLEO ESC. CENTRAL ENEQUELLA",-68.15412,-17.14132,32,3,297,329,77,4,213,290
"Bolivia","La Paz","Pacajes","Coro Coro","PLAZA APOSTOL SANTIAGO",-68.13311,-17.18174,37,17,289,326,70,16,186,256
"Bolivia","La Paz","Pacajes","Coro Coro","PLAZA CANTON ROSAPATA",-68.58238,-17.21777,30,2,136,166,29,4,101,130
"Bolivia","La Paz","Pacajes","Coro Coro","PLAZA MEJILLONES",-68.50258,-17.08385,50,6,279,329,79,5,189,268
"Bolivia","La Paz","Pacajes","Coro Coro","PLAZA PRINCIPAL",-68.64835,-17.14039,33,4,194,227,34,9,147,181
"Bolivia","La Paz","Pacajes","Nazacara de Pacajes","PLAZA PRINCIPAL",-68.76462,-16.93795,56,3,275,331,49,7,216,265
"Bolivia","La Paz","Pacajes","Santiago de Callapa","COL.TECNICO HUMANISTICO TUPAC AMARU",-68.33572,-17.34924,37,5,161,198,39,6,111,150
"Bolivia","La Paz","Pacajes","Santiago de Callapa","ESC. HUAYLLAPANTA",-68.26348,-17.27865,9,3,86,95,27,3,53,80
"Bolivia","La Paz","Pacajes","Santiago de Callapa","ESC. HUICHURAYA",-68.43911,-17.33394,15,2,115,130,30,3,80,110
"Bolivia","La Paz","Pacajes","Santiago de Callapa","ESC. N. CANUHUTA",-68.47823,-17.42123,50,2,291,341,65,4,220,285
"Bolivia","La Paz","Pacajes","Santiago de Callapa","ESC. POQUEVILLQUE",-68.27715,-17.32858,17,1,118,135,23,4,90,113
"Bolivia","La Paz","Pacajes","Santiago de Callapa","ESCUELA LIBERTADOR SIMON BOLIVIAR",-68.2121,-17.43119,12,1,150,162,41,2,106,147
"Bolivia","La Paz","Pacajes","Santiago de Callapa","ESCUELA ROMERO PAMPA",-68.23565,-17.35947,23,4,231,254,75,7,145,220
"Bolivia","La Paz","Pacajes","Santiago de Callapa","PLAZA 29 DE JUNIO",-68.18311,-17.36895,17,6,273,290,67,14,186,253
"Bolivia","La Paz","Pacajes","Santiago de Callapa","PLAZA SANTIAGO DE CALLAPA",-68.35594,-17.4794,145,11,449,594,113,19,306,419
"Bolivia","La Paz","Pacajes","Santiago de Callapa","PLAZA VILLA PUCHUNI",-68.31937,-17.2838,24,4,169,193,52,5,108,160
"Bolivia","La Paz","Pacajes","Santiago de Callapa","P. S. FRANCISCO YARIBAY",-68.41264,-17.24828,54,0,225,279,44,3,178,222
"Bolivia","La Paz","Pacajes","Santiago de Callapa","UNIDAD EDUCATIVA HUAJRUMA",-68.39203,-17.57708,7,0,76,83,31,1,44,75
"Bolivia","La Paz","Pacajes","Waldo Ballivián","PATIO HISTORICO TUMARAPI",-68.18797,-17.08567,68,9,919,987,207,35,668,875
"Bolivia","La Paz","Sur Yungas","Chulumani (Villa de la Libertad)","CASA DE GOBIERNO",-67.58398,-16.3884,66,11,536,602,122,10,393,515
"Bolivia","La Paz","Sur Yungas","Chulumani (Villa de la Libertad)","COLEGIO AGUSTIN ASPIAZU",-67.52634,-16.40942,810,48,4209,5019,1510,168,2483,3993
"Bolivia","La Paz","Sur Yungas","Chulumani (Villa de la Libertad)","COLEGIO GRAL.ARMANDO ESCOBAR URIA",-67.51199,-16.43177,85,6,648,733,237,18,387,624
"Bolivia","La Paz","Sur Yungas","Chulumani (Villa de la Libertad)","COLEGIO JUAN RAMOS DE TAGMA",-67.47916,-16.37452,88,9,756,844,250,29,468,718
"Bolivia","La Paz","Sur Yungas","Chulumani (Villa de la Libertad)","ESC. COLOPAMPA",-67.53527,-16.28799,6,3,136,142,20,1,112,132
"Bolivia","La Paz","Sur Yungas","Chulumani (Villa de la Libertad)","PLAZA PRINCIPAL",-67.50503,-16.44271,29,6,445,474,80,14,345,425
"Bolivia","La Paz","Sur Yungas","Chulumani (Villa de la Libertad)","U.E. TÉCNICO HUMANÍSTICO PASTO PATA",-67.47044,-16.36745,95,11,725,820,263,24,427,690
"Bolivia","La Paz","Sur Yungas","Chulumani (Villa de la Libertad)","UNIDAD EDUCATIVA HUANCANE",-67.53661,-16.3786,238,18,1579,1817,437,64,1060,1497
"Bolivia","La Paz","Sur Yungas","Irupana (Villa de Lanza)","CANCHA DE UNION HUIRI",-67.35191,-16.30181,41,9,450,491,47,13,381,428
"Bolivia","La Paz","Sur Yungas","Irupana (Villa de Lanza)","COLEGIO TTE.CNL. RAFAEL PABON",-67.79365,-16.57078,221,27,865,1086,328,28,482,810
"Bolivia","La Paz","Sur Yungas","Irupana (Villa de Lanza)","COL. NUCLEO ROSARIO",-67.6368,-16.65357,19,3,178,197,41,5,129,170
"Bolivia","La Paz","Sur Yungas","Irupana (Villa de Lanza)","ESC. CENTRAL LA PLAZUELA",-67.40361,-16.52655,50,2,273,323,69,5,197,266
"Bolivia","La Paz","Sur Yungas","Irupana (Villa de Lanza)","ESC. T.C. RAFAEL PABON",-67.34905,-16.49079,26,2,170,196,28,5,135,163
"Bolivia","La Paz","Sur Yungas","Irupana (Villa de Lanza)","ESC. VICTOR CENTELLAS",-67.4448,-16.42614,48,15,330,378,123,8,184,307
"Bolivia","La Paz","Sur Yungas","Irupana (Villa de Lanza)","ESC. VICTORIO LANZA",-67.43213,-16.40116,62,8,553,615,134,76,335,469
"Bolivia","La Paz","Sur Yungas","Irupana (Villa de Lanza)","PLAZA 25 DE JULIO",-67.70308,-16.60368,49,15,342,391,64,9,254,318
"Bolivia","La Paz","Sur Yungas","Irupana (Villa de Lanza)","U. E. AGUSTIN ASPIAZU",-67.45403,-16.47174,471,54,2962,3433,978,111,1819,2797
"Bolivia","La Paz","Sur Yungas","Irupana (Villa de Lanza)","U.E. CHICALOMA",-67.4781,-16.4439,100,29,730,830,232,28,441,673
"Bolivia","La Paz","Sur Yungas","Irupana (Villa de Lanza)","U.E. CURIHUATI",-67.53439,-16.62459,12,1,102,114,31,1,69,100
"Bolivia","La Paz","Sur Yungas","Irupana (Villa de Lanza)","U.E. NUCLEO ALEJANDRO PEREZ",-67.39616,-16.48061,11,1,119,130,22,5,91,113
"Bolivia","La Paz","Sur Yungas","Irupana (Villa de Lanza)","U.E. SIQUILJARA",-67.43041,-16.4995,4,0,49,53,7,5,37,44
"Bolivia","La Paz","Sur Yungas","Irupana (Villa de Lanza)","UNIDAD EDUCATIVA TACA",-67.59009,-16.6741,14,23,247,261,51,9,164,215
"Bolivia","La Paz","Sur Yungas","La Asunta","CASA DE GOBIERNO",-67.16822,-16.02656,74,7,437,511,130,12,288,418
"Bolivia","La Paz","Sur Yungas","La Asunta","CASA DE GOBIERNO",-67.42729,-16.3161,74,7,437,511,130,12,288,418
"Bolivia","La Paz","Sur Yungas","La Asunta","COLEGIO LAS MERCEDES",-67.34164,-16.28541,156,24,1110,1266,239,16,831,1070
"Bolivia","La Paz","Sur Yungas","La Asunta","COLEGIO PEDRO DOMINGO MURILLO",-67.17278,-15.99563,156,30,1193,1349,296,29,838,1134
"Bolivia","La Paz","Sur Yungas","La Asunta","ESC. BATALLON COLORADOS",-67.23377,-16.24007,61,6,344,405,63,14,261,324
"Bolivia","La Paz","Sur Yungas","La Asunta","ESC. PEDRO DOMINGO MURILLO",-67.23003,-16.17662,70,18,594,664,97,20,459,556
"Bolivia","La Paz","Sur Yungas","La Asunta","ESC. RENE BARRIENTOS ORTUNO",-67.19631,-16.12306,868,75,4955,5823,1599,235,3046,4645
"Bolivia","La Paz","Sur Yungas","La Asunta","ESCUELA PUERTO RICO",-67.23912,-15.91417,169,22,904,1073,268,26,588,856
"Bolivia","La Paz","Sur Yungas","La Asunta","ESC. YANAMAYU",-67.24638,-16.25433,66,11,479,545,94,12,362,456
"Bolivia","La Paz","Sur Yungas","La Asunta","PLAZA 5 DE AGOSTO",-67.32188,-16.29534,92,8,686,778,130,23,525,655
"Bolivia","La Paz","Sur Yungas","La Asunta","PLAZA PRINCIPAL",-67.28065,-16.28432,17,10,498,515,92,19,377,469
"Bolivia","La Paz","Sur Yungas","La Asunta","PLAZA PRINCIPAL PICHARI",-67.1724,-16.03647,33,1,172,205,28,1,142,170
"Bolivia","La Paz","Sur Yungas","La Asunta","SEDE SOCIAL 16 DE JULIO",-67.21876,-15.98921,94,13,604,698,66,18,507,573
"Bolivia","La Paz","Sur Yungas","La Asunta","SEDE SOCIAL CHARIA",-67.17044,-16.06197,76,6,627,703,139,17,465,604
"Bolivia","La Paz","Sur Yungas","La Asunta","SEDE SOCIAL - ESC. FISCAL CALIZAYA",-67.17819,-16.20132,102,15,857,959,287,34,521,808
"Bolivia","La Paz","Sur Yungas","La Asunta","U.E. SANTA ROSA",-67.29982,-16.29054,34,3,420,454,42,13,362,404
"Bolivia","La Paz","Sur Yungas","La Asunta","UNIDAD EDUCATIVA CENTRAL QUINUNI",-67.12872,-16.24596,180,33,1240,1420,297,44,866,1163
"Bolivia","La Paz","Sur Yungas","La Asunta","UNIDAD EDUCATIVA NUEVOS HORIZONTES",-67.0814,-16.07017,59,9,353,412,79,9,256,335
"Bolivia","La Paz","Sur Yungas","La Asunta","UNIDAD EDUCATIVA SIGUANI GRANDE",-67.1498,-16.02148,157,12,782,939,155,15,600,755
"Bolivia","La Paz","Sur Yungas","Palos Blancos","COLEGIO GRAL.JUAN JOSE TORREZ",-67.15504,-15.43328,93,8,438,531,95,18,317,412
"Bolivia","La Paz","Sur Yungas","Palos Blancos","COLEGIO INICUA ALTO",-67.21655,-15.49705,240,26,1316,1556,198,42,1050,1248
"Bolivia","La Paz","Sur Yungas","Palos Blancos","ESC. CENTRAL SAPECHO",-67.33434,-15.55851,175,12,932,1107,202,28,690,892
"Bolivia","La Paz","Sur Yungas","Palos Blancos","ESC. FRANZ TAMAYO",-66.97848,-15.79254,129,7,568,697,93,28,440,533
"Bolivia","La Paz","Sur Yungas","Palos Blancos","ESC. MAPURICHUQUI",-67.38571,-15.53334,13,0,104,117,10,2,92,102
"Bolivia","La Paz","Sur Yungas","Palos Blancos","ESC. REMOLINOS",-67.10275,-15.70205,20,4,165,185,28,2,131,159
"Bolivia","La Paz","Sur Yungas","Palos Blancos","ESC. SAN MIGUEL DE HUACHI",-67.13039,-15.67505,117,7,556,673,148,21,380,528
"Bolivia","La Paz","Sur Yungas","Palos Blancos","ESC. SANTA ANA DE MOSETENES",-67.42593,-15.51087,61,13,519,580,101,17,388,489
"Bolivia","La Paz","Sur Yungas","Palos Blancos","ESC. SECC. PUERTO CARMEN",-67.10754,-15.72647,76,3,513,589,53,15,442,495
"Bolivia","La Paz","Sur Yungas","Palos Blancos","ESCUELA 13 DE MAYO",-67.05286,-15.7359,75,8,370,445,70,7,285,355
"Bolivia","La Paz","Sur Yungas","Palos Blancos","ESCUELA COCOCHI",-67.03598,-15.76373,76,4,517,593,46,9,458,504
"Bolivia","La Paz","Sur Yungas","Palos Blancos","ESCUELA UNIDAD EDUCATIVA POPOY",-67.16382,-15.64156,87,4,507,594,91,11,401,492
"Bolivia","La Paz","Sur Yungas","Palos Blancos","ESC. UNI. EDUCATIVA PALOS BLANCOS",-67.24989,-15.58425,754,39,3769,4523,1274,160,2296,3570
"Bolivia","La Paz","Sur Yungas","Yanacachi","AGENCIA CANTONAL",-67.67539,-16.40772,18,2,195,213,43,5,145,188
"Bolivia","La Paz","Sur Yungas","Yanacachi","ESC. EDUARDO AVAROA",-67.77512,-16.40746,84,5,727,811,161,19,542,703
"Bolivia","La Paz","Sur Yungas","Yanacachi","ESCUELA PUENTE VILLA",-67.64563,-16.40512,125,7,605,730,113,27,458,571
"Bolivia","La Paz","Sur Yungas","Yanacachi","UNIDAD ED. FELIX ERNESTO MOSCOSO",-67.73924,-16.39802,105,20,837,942,162,40,615,777
"Bolivia","Oruro","Abaroa","Challapata","CASA COMUNAL",-66.867,-18.81626,4,3,52,56,17,4,28,45
"Bolivia","Oruro","Abaroa","Challapata","COL. NEMECIO BARRIENTOS",-66.41433,-18.8165,93,52,1851,1944,183,92,1524,1707
"Bolivia","Oruro","Abaroa","Challapata","COL. SIMON BOLIVAR",-66.2065,-19.07044,133,23,724,857,184,53,464,648
"Bolivia","Oruro","Abaroa","Challapata","ESC. ELIZARDO PEREZ",-66.63439,-18.78513,35,5,201,236,65,11,120,185
"Bolivia","Oruro","Abaroa","Challapata","ESC. GUALBERTO VILLARROEL",-66.17815,-19.14781,57,6,487,544,131,30,320,451
"Bolivia","Oruro","Abaroa","Challapata","ESC. GUALBERTO VILLARROEL",-66.17815,-19.14781,57,6,487,544,131,30,320,451
"Bolivia","Oruro","Abaroa","Challapata","IGLESIA",-66.75696,-18.90541,77,27,481,558,134,26,294,428
"Bolivia","Oruro","Abaroa","Challapata","U.E. ANTOFAGASTA",-66.76142,-18.9058,156,18,984,1140,464,54,448,912
"Bolivia","Oruro","Abaroa","Challapata","U. E. CHIRITAMBO",-66.49629,-18.74333,6,0,37,43,9,8,20,29
"Bolivia","Oruro","Abaroa","Challapata","U. E. CHURACANI",-66.6879,-18.88193,17,3,190,207,94,8,85,179
"Bolivia","Oruro","Abaroa","Challapata","U. E. COCHUYO",-66.19255,-19.04616,15,6,176,191,26,12,132,158
"Bolivia","Oruro","Abaroa","Challapata","U. E. CRUCE AGUAS CALIENTES",-66.59532,-18.75354,23,16,336,359,105,23,192,297
"Bolivia","Oruro","Abaroa","Challapata","U. E. EDUARDO AVAROA",-66.77432,-18.89956,455,46,2647,3102,1299,159,1143,2442
"Bolivia","Oruro","Abaroa","Challapata","U.E. GERMAN BUSCH",-66.64656,-18.83978,15,3,175,190,77,13,82,159
"Bolivia","Oruro","Abaroa","Challapata","U.E. HUANCANE",-66.87584,-18.70498,33,7,353,386,153,32,161,314
"Bolivia","Oruro","Abaroa","Challapata","U.E. MONS. RICARDO BENI MORO",-66.77174,-18.89699,218,23,1153,1371,559,63,508,1067
"Bolivia","Oruro","Abaroa","Challapata","U. E. REPUBLICA ARGENTINA",-66.77376,-18.89994,480,63,2859,3339,1366,218,1212,2578
"Bolivia","Oruro","Abaroa","Challapata","U. E. SAN JUAN DE DIOS",-66.77537,-18.89861,375,36,2256,2631,1116,125,979,2095
"Bolivia","Oruro","Abaroa","Challapata","U. E. WILAÑEQUE",-66.87421,-18.79802,5,2,63,68,14,4,43,57
"Bolivia","Oruro","Abaroa","Santuario de Quillacas","COL. NAL. MIXTO SEVARUYO",-66.8639,-19.36308,91,17,762,853,194,30,521,715
"Bolivia","Oruro","Abaroa","Santuario de Quillacas","ESC. SORAGA",-66.81366,-19.37804,29,1,236,265,30,4,201,231
"Bolivia","Oruro","Abaroa","Santuario de Quillacas","U.E. SANTUARIO DE QUILLACAS",-66.9434,-19.23514,100,14,679,779,171,16,478,649
"Bolivia","Oruro","Carangas","Choque Cota","ESC. JOSE BALLIVIAN",-67.89426,-18.09751,147,10,493,640,85,13,385,470
"Bolivia","Oruro","Carangas","Choque Cota","U.E. GERMAN BUSCH",-67.9801,-18.24933,16,0,63,79,8,0,55,63
"Bolivia","Oruro","Carangas","Corque","COL.  JOSE TRIFIRO",-67.68045,-18.34875,433,22,1058,1491,262,38,736,998
"Bolivia","Oruro","Carangas","Corque","COL. QUITA QUITA",-67.59264,-18.57433,20,1,125,145,28,1,95,123
"Bolivia","Oruro","Carangas","Corque","ESC. CENTRAL ANDAPATA LUPE",-67.7664,-18.57256,23,2,134,157,41,1,90,131
"Bolivia","Oruro","Carangas","Corque","ESC. ELIZARDO PEREZ",-67.96458,-18.42258,4,0,192,196,39,1,152,191
"Bolivia","Oruro","Carangas","Corque","ESC. GERMAN BUSCH",-67.63393,-18.19181,3,0,124,127,39,2,83,122
"Bolivia","Oruro","Carangas","Corque","ESC. RAFAEL PABON",-67.86765,-18.61046,5,2,314,319,77,8,227,304
"Bolivia","Oruro","Carangas","Corque","ESC. SECCIONAL VILLA NUEVA",-67.52446,-18.50015,2,0,90,92,10,1,79,89
"Bolivia","Oruro","Carangas","Corque","ESC. SECCIONAL VILLA REMEDIOS",-67.53616,-18.34178,12,9,103,115,15,2,77,92
"Bolivia","Oruro","Carangas","Corque","NUCLEO JANCOCALA",-67.63593,-18.40875,19,3,119,138,29,4,83,112
"Bolivia","Oruro","Carangas","Corque","PROYECTO CRISTIAN CHILDRENS",-67.89956,-18.54068,37,4,348,385,73,7,264,337
"Bolivia","Oruro","Carangas","Corque","U. E. CONDORIRI",-67.87078,-18.28468,3,0,143,146,14,5,124,138
"Bolivia","Oruro","Carangas","Corque","U. E. EDUARDO AVAROA",-67.93131,-18.25961,8,2,108,116,23,2,81,104
"Bolivia","Oruro","Carangas","Corque","U.E. FRANZ TAMAYO",-67.92997,-18.34328,2,0,199,201,11,1,187,198
"Bolivia","Oruro","Carangas","Corque","U. E. FRANZ TAMAYO - VILLA ESPERANZA.-",-67.79691,-18.69382,37,2,227,264,37,2,186,223
"Bolivia","Oruro","Carangas","Corque","U.E. HUAYLLAPACHA",-67.78386,-18.20815,11,0,109,120,9,1,99,108
"Bolivia","Oruro","Carangas","Corque","U.E. HUAYLLOCO",-67.60744,-18.62654,41,3,157,198,34,4,116,150
"Bolivia","Oruro","Carangas","Corque","U.E. ISMAEL MONTES",-67.63055,-18.2567,9,0,123,132,27,2,94,121
"Bolivia","Oruro","Carangas","Corque","U.E. VILLA COPACABANA",-67.58656,-18.33602,23,1,205,228,63,4,137,200
"Bolivia","Oruro","Carangas","Corque","U.E. VILLA TARUCACHI",-67.69584,-18.17327,33,2,135,168,15,3,115,130
"Bolivia","Oruro","Cercado","Caracollo","CASA COMUNAL",-67.36098,-17.5586,27,6,232,259,52,6,168,220
"Bolivia","Oruro","Cercado","Caracollo","ESC. ARCA DE NOE",-67.14415,-17.53467,27,5,221,248,52,9,155,207
"Bolivia","Oruro","Cercado","Caracollo","ESC. CASIMIRO OLAÑETA",-67.71239,-17.75884,15,6,98,113,23,1,68,91
"Bolivia","Oruro","Cercado","Caracollo","ESC. CENTRAL HORENCO",-67.08439,-17.67966,41,13,508,549,114,30,351,465
"Bolivia","Oruro","Cercado","Caracollo","ESC. ELIZARDO PEREZ",-67.23847,-17.7678,25,6,325,350,76,20,223,299
"Bolivia","Oruro","Cercado","Caracollo","ESC. GUALBERTO VILLARROEL",-67.60866,-17.84485,2,1,156,158,48,7,100,148
"Bolivia","Oruro","Cercado","Caracollo","ESC. MARISCAL SUCRE",-67.21998,-17.63756,576,68,4543,5119,1534,200,2741,4275
"Bolivia","Oruro","Cercado","Caracollo","ESC. RENE BERNAL ESCALANTE",-67.26373,-17.41522,26,8,227,253,35,9,175,210
"Bolivia","Oruro","Cercado","Caracollo","ESC. SECCIONAL ANCOTANGA",-67.41176,-17.80681,10,3,108,118,45,1,59,104
"Bolivia","Oruro","Cercado","Caracollo","ESC. TUPAC KATARI",-67.32282,-17.67462,4,0,35,39,4,1,30,34
"Bolivia","Oruro","Cercado","Caracollo","PLAZA 21 DE SEPTIEMBRE",-67.63667,-17.79293,11,1,182,193,52,1,128,180
"Bolivia","Oruro","Cercado","Caracollo","U. E. ADELA ZAMUDIO B",-67.61005,-17.79552,0,1,66,66,14,0,51,65
"Bolivia","Oruro","Cercado","Caracollo","U.E. ALEMANIA",-67.29485,-17.58746,66,8,484,550,117,23,336,453
"Bolivia","Oruro","Cercado","Caracollo","U.E. AYACUCHO",-67.32822,-17.88792,52,11,267,319,94,12,150,244
"Bolivia","Oruro","Cercado","Caracollo","U.E. FLORENCIO ALVARADO",-67.67155,-17.89358,10,6,203,213,49,6,142,191
"Bolivia","Oruro","Cercado","Caracollo","U.E. JAIME LAREDO UNZUETA",-67.29126,-17.76572,3,5,55,58,12,0,38,50
"Bolivia","Oruro","Cercado","Caracollo","U.E. LITORAL",-67.21841,-17.63715,141,11,632,773,202,35,384,586
"Bolivia","Oruro","Cercado","Caracollo","U.E. MARISCAL SUCRE B",-67.49707,-17.77807,134,14,707,841,232,28,433,665
"Bolivia","Oruro","Cercado","Caracollo","U.E. MAX FERNANDEZ",-67.10453,-17.55754,38,3,436,474,98,9,326,424
"Bolivia","Oruro","Cercado","Caracollo","U.E. OTTO SAUCEDO RIVERA",-67.3471,-17.80727,20,2,156,176,70,8,76,146
"Bolivia","Oruro","Cercado","Caracollo","U.ESC. MARCELO QUIROGA SANTA CRUZ",-67.3585,-17.954,25,1,192,217,43,1,147,190
"Bolivia","Oruro","Cercado","Caracollo","U.E. SEBASTIAN PAGADOR",-67.32516,-17.52224,40,5,342,382,68,12,257,325
"Bolivia","Oruro","Cercado","Caracollo","U.E. SIMON BOLIVAR PRIMARIO",-67.65617,-17.79859,45,6,342,387,105,28,203,308
"Bolivia","Oruro","Cercado","Caracollo","U. E. VICTOR PAZ ESTENSORO",-67.22767,-17.52121,18,1,83,101,33,3,46,79
"Bolivia","Oruro","Cercado","El Choro","ESC. GUALBERTO VILLARROEL",-67.1244,-18.28041,30,8,229,259,83,5,133,216
"Bolivia","Oruro","Cercado","El Choro","ESC. JOSE BALLIVIAN",-67.23971,-18.07711,100,12,470,570,107,20,331,438
"Bolivia","Oruro","Cercado","El Choro","ESC. SEBASTIAN  PAGADOR",-67.11596,-18.35524,115,12,573,688,132,41,388,520
"Bolivia","Oruro","Cercado","El Choro","PLAZA PRINCIPAL",-67.16006,-18.20486,43,3,241,284,73,13,152,225
"Bolivia","Oruro","Cercado","El Choro","U. E. SAN FELIPE DE CHAITAVI",-67.19747,-18.2947,13,2,164,177,56,6,100,156
"Bolivia","Oruro","Cercado","Oruro","(CÁRCEL) PENAL SAN PEDRO.-",-67.11382,-17.94748,51,5,177,228,87,2,83,170
"Bolivia","Oruro","Cercado","Oruro","CEMEI.-",-67.10611,-17.95222,62,3,565,627,374,17,171,545
"Bolivia","Oruro","Cercado","Oruro","CENTRO DE ALFABETIZACION HUAJARA III.-",-67.09458,-17.94664,52,7,453,505,213,16,217,430
"Bolivia","Oruro","Cercado","Oruro","CENTRO DE MADRES VILLA DORINA.-  (U.ESC. GTANJA CAPACHOS)",-67.0959,-17.93653,51,2,529,580,219,21,287,506
"Bolivia","Oruro","Cercado","Oruro","CENTRO EDUCATIVO ALCIRA CARDONA.-",-67.13569,-17.98138,301,20,2236,2537,1192,72,952,2144
"Bolivia","Oruro","Cercado","Oruro","CENTRO EDUCATIVO LUIS ESPINAL.-",-67.10418,-17.97677,133,6,1049,1182,638,39,366,1004
"Bolivia","Oruro","Cercado","Oruro","COL. ANICETO ARCE.-",-67.10963,-17.95758,239,11,1749,1988,1161,39,538,1699
"Bolivia","Oruro","Cercado","Oruro","COL. DONATO VASQUEZ",-67.11268,-17.96753,167,16,1394,1561,1032,28,318,1350
"Bolivia","Oruro","Cercado","Oruro","COLEGIO JESUS MARIA FE Y ALEGRIA.-",-67.1079,-17.95973,127,4,1082,1209,843,11,224,1067
"Bolivia","Oruro","Cercado","Oruro","COL. IGNACIO LEON.-",-67.11066,-17.96957,271,9,2057,2328,1535,47,466,2001
"Bolivia","Oruro","Cercado","Oruro","COL. JORGE OBLITAS.-",-67.11667,-17.97098,218,5,1470,1688,1017,48,400,1417
"Bolivia","Oruro","Cercado","Oruro","COL. MARCOS BELTRAN AVILA.-",-67.12161,-17.98581,323,13,1753,2076,949,52,739,1688
"Bolivia","Oruro","Cercado","Oruro","COL. MIXTO SAN JOSE.-",-67.1077,-17.96691,108,5,902,1010,553,19,325,878
"Bolivia","Oruro","Cercado","Oruro","COL. NAL. ANTONIO JOSE DE SAINZ.-",-67.11235,-17.97625,296,9,1926,2222,1206,61,650,1856
"Bolivia","Oruro","Cercado","Oruro","COL. NAL. JUAN MISAEL SARACHO.-",-67.10977,-17.96565,212,7,1694,1906,1283,34,370,1653
"Bolivia","Oruro","Cercado","Oruro","COL. NAL. MIXTO BOLIVIA.-",-67.11076,-17.96816,635,27,3246,3881,1758,98,1363,3121
"Bolivia","Oruro","Cercado","Oruro","COL. NAL. MIXTO CARMEN GUZMAN DE MIER",-67.09805,-17.96961,716,42,5553,6269,2944,258,2309,5253
"Bolivia","Oruro","Cercado","Oruro","COL.NAL.MIXTO MEJILLONES (V. CHALLACOLLO)",-67.13516,-18.00865,237,14,1290,1527,473,85,718,1191
"Bolivia","Oruro","Cercado","Oruro","COL. NAL. SIMON BOLIVAR.-",-67.11548,-17.97176,308,12,2228,2536,1608,43,565,2173
"Bolivia","Oruro","Cercado","Oruro","COL. PARTICULAR ANGLO AMERICANO.-",-67.12007,-17.96936,288,12,2233,2521,1432,66,723,2155
"Bolivia","Oruro","Cercado","Oruro","COL. PARTICULAR BOLIVIA JAPON-.",-67.11596,-17.96645,200,11,1473,1673,1003,28,431,1434
"Bolivia","Oruro","Cercado","Oruro","COL. PARTICULAR LA SALLE.-",-67.12745,-17.98239,341,18,2698,3039,1614,99,967,2581
"Bolivia","Oruro","Cercado","Oruro","COL. PARTICULAR NACIONES UNIDAS.-",-67.11937,-17.9807,108,9,691,799,354,96,232,586
"Bolivia","Oruro","Cercado","Oruro","COL. PARTICULAR REEKIE.-",-67.1146,-17.97336,196,8,1654,1850,1229,34,383,1612
"Bolivia","Oruro","Cercado","Oruro","ESC. FRANZ TAMAYO (LOS PINOS).-",-67.13069,-17.9254,133,17,1159,1292,421,34,687,1108
"Bolivia","Oruro","Cercado","Oruro","ESC. JACINTO RODRIGUEZ (LA AURORA).-",-67.12757,-17.91296,359,22,3129,3488,1641,108,1358,2999
"Bolivia","Oruro","Cercado","Oruro","ESC. JUAN PABLO.-",-67.13759,-17.97069,435,34,2906,3341,1374,92,1406,2780
"Bolivia","Oruro","Cercado","Oruro","ESC. MIXTA FERROVIARIA.-",-67.1043,-17.96417,438,23,3645,4083,2496,74,1052,3548
"Bolivia","Oruro","Cercado","Oruro","FAC. DE DERECHO (ESC. 10 DE FEBRERO)",-67.10728,-17.96463,88,5,716,804,515,7,189,704
"Bolivia","Oruro","Cercado","Oruro","FACULTAD DE AGRONOMIA-.",-67.1356,-17.99495,136,3,827,963,371,25,428,799
"Bolivia","Oruro","Cercado","Oruro","FACULTAD DE MEDICINA.-",-67.11997,-17.95705,285,15,2294,2579,1257,93,929,2186
"Bolivia","Oruro","Cercado","Oruro","FACULTAD TECNICA.-",-67.10745,-17.95388,269,18,2399,2668,1640,56,685,2325
"Bolivia","Oruro","Cercado","Oruro","FUNDACION INFOCAL.-",-67.13299,-17.97652,157,9,1200,1357,648,28,515,1163
"Bolivia","Oruro","Cercado","Oruro","INICIAL CARMEN GUZMAN DE MIER-.",-67.09798,-17.96936,51,4,407,458,217,16,170,387
"Bolivia","Oruro","Cercado","Oruro","INST. DE APRENDIZAJE INDUSTRIAL - I.A.I.",-67.10339,-17.95443,432,26,3789,4221,2091,115,1557,3648
"Bolivia","Oruro","Cercado","Oruro","INST. NORMAL SUPERIOR ANGEL MENDOZA J.",-67.11544,-17.95136,279,16,2280,2559,1330,74,860,2190
"Bolivia","Oruro","Cercado","Oruro","KINDER CHIRIPUJIO-.",-67.13878,-17.97487,58,5,317,375,161,6,145,306
"Bolivia","Oruro","Cercado","Oruro","KINDER EDITH ZAMORA DE PAZ",-67.06566,-17.59109,91,7,642,733,310,10,315,625
"Bolivia","Oruro","Cercado","Oruro","KINDER JUANCITO PINTO.-",-67.1338,-17.97651,222,23,1612,1834,865,51,673,1538
"Bolivia","Oruro","Cercado","Oruro","LICEO ANTOFAGASTA.-",-67.11086,-17.95904,130,3,1109,1239,753,28,325,1078
"Bolivia","Oruro","Cercado","Oruro","LICEO TEC. HUMANISTICO ADOLFO BALLIVIAN",-67.11545,-17.97227,124,6,997,1121,697,20,274,971
"Bolivia","Oruro","Cercado","Oruro","U.E. ABY AYALA  (MAGDALENA POSTEL II)",-67.0858,-17.96687,34,1,402,436,203,13,185,388
"Bolivia","Oruro","Cercado","Oruro","U. E. ALTO ORURO-.",-67.11981,-17.97776,90,7,657,747,270,35,345,615
"Bolivia","Oruro","Cercado","Oruro","U.E. BOLIVIA VINTO.-",-67.06182,-17.97608,590,73,4246,4836,1541,406,2226,3767
"Bolivia","Oruro","Cercado","Oruro","U. E. CARMELA CERRUTO-.",-67.12911,-17.98492,75,6,423,498,206,18,193,399
"Bolivia","Oruro","Cercado","Oruro","U. E. EDUARDO AVAROA",-67.10896,-17.96172,202,10,1711,1913,1309,44,348,1657
"Bolivia","Oruro","Cercado","Oruro","U. E. EJERCITO NACIONAL.-",-67.11467,-17.94708,452,31,3461,3913,1885,105,1440,3325
"Bolivia","Oruro","Cercado","Oruro","U.E. EL CARMEN",-67.06756,-17.97467,128,12,1135,1263,479,51,593,1072
"Bolivia","Oruro","Cercado","Oruro","U. E. GUIDO VILLAGOMEZ.-",-67.12384,-17.95729,193,15,1750,1943,819,66,850,1669
"Bolivia","Oruro","Cercado","Oruro","U. E. HIJOS DEL SOL II",-67.14334,-17.97866,68,5,293,361,98,75,115,213
"Bolivia","Oruro","Cercado","Oruro","U.E. HUAJARA",-67.09364,-17.94298,389,44,3361,3750,1680,121,1516,3196
"Bolivia","Oruro","Cercado","Oruro","U. E. JESUS DE NAZARETH.-",-67.09926,-17.98237,425,41,3179,3604,1434,156,1548,2982
"Bolivia","Oruro","Cercado","Oruro","U. E. JOHN F. KENNEDY",-67.11703,-17.95129,448,28,3490,3938,1760,138,1564,3324
"Bolivia","Oruro","Cercado","Oruro","U. E. JOSE IGNACIO DE SANJINEZ.-",-67.11224,-17.97953,442,20,3127,3569,1909,88,1110,3019
"Bolivia","Oruro","Cercado","Oruro","U. E. JOSE MARIA SIERRA GALVARRO.-",-67.10973,-17.97574,491,26,3831,4322,2450,94,1261,3711
"Bolivia","Oruro","Cercado","Oruro","U. E. JUAN VELEZ DE CORDOBA (INCA POZO).",-67.12063,-17.94589,175,19,1556,1731,634,72,831,1465
"Bolivia","Oruro","Cercado","Oruro","U. E. KANTUTA II (JOSERMO MURILLO)-.",-67.10438,-17.94779,283,49,2285,2568,969,131,1136,2105
"Bolivia","Oruro","Cercado","Oruro","U.E. LOS ANGELES DE NAZARIA IGNACIA",-67.0696,-17.97254,133,9,952,1085,306,36,601,907
"Bolivia","Oruro","Cercado","Oruro","U. E. LUIS MARIO CAREAGA.-",-67.06567,-17.59111,652,57,3966,4618,1685,131,2093,3778
"Bolivia","Oruro","Cercado","Oruro","U.E. MARCELO QUIROGA SANTA CRUZ",-67.11663,-17.93236,43,5,649,692,291,15,338,629
"Bolivia","Oruro","Cercado","Oruro","U.E. MARIA  DE NAZARETH",-67.0949,-17.98389,194,22,1558,1752,566,97,873,1439
"Bolivia","Oruro","Cercado","Oruro","U. E. MCAL. ANDRES DE SANTA CRUZ.-",-67.11391,-17.95798,361,25,2527,2888,1422,83,997,2419
"Bolivia","Oruro","Cercado","Oruro","U. E. MCAL. ANTONIO JOSE DE SUCRE.-",-67.11536,-17.96788,328,16,2490,2818,1720,42,712,2432
"Bolivia","Oruro","Cercado","Oruro","U.E. MEJILLONES II(SECUNDARIO)",-67.13734,-18.00333,59,5,340,399,118,28,189,307
"Bolivia","Oruro","Cercado","Oruro","U. E. MISAEL PACHECO LOMA.-",-67.10031,-17.96391,194,6,1567,1761,932,47,582,1514
"Bolivia","Oruro","Cercado","Oruro","U. E. MOVIMIENTO SIN TECHO",-67.07934,-17.97713,507,61,3764,4271,947,165,2591,3538
"Bolivia","Oruro","Cercado","Oruro","U.E. NAL. MIXTO HUAJARA SECUNDARIO",-67.09364,-17.94298,106,13,924,1030,362,114,435,797
"Bolivia","Oruro","Cercado","Oruro","U.E. NIÑO QUIRQUINCHO FELIZ",-67.03982,-17.97784,188,23,1463,1651,551,113,776,1327
"Bolivia","Oruro","Cercado","Oruro","U. E. ORURO OTAWA (SECUNDARIA)",-67.10309,-17.97182,213,17,1686,1899,905,40,724,1629
"Bolivia","Oruro","Cercado","Oruro","U. E. OSCAR UNZAGA DE LA VEGA.-",-67.11453,-17.94222,446,43,3640,4086,1752,198,1647,3399
"Bolivia","Oruro","Cercado","Oruro","U. E. OSCAR UNZAGA DE LA VEGA II",-67.1145,-17.9421,183,15,1168,1351,558,42,553,1111
"Bolivia","Oruro","Cercado","Oruro","U.E. PARTICULAR ARRIETA",-67.11098,-17.9635,27,1,301,328,215,8,77,292
"Bolivia","Oruro","Cercado","Oruro","U.E. SAN LUIS",-67.07831,-17.93586,49,8,414,463,126,49,231,357
"Bolivia","Oruro","Cercado","Oruro","U. E. SANTA ROSA.-",-67.07967,-17.97144,339,24,2098,2437,1054,111,909,1963
"Bolivia","Oruro","Cercado","Oruro","U. ESC. BENEMERITOS DE LA PATRIA.-",-67.12161,-17.98581,230,14,1568,1798,698,61,795,1493
"Bolivia","Oruro","Cercado","Oruro","U. ESC. DIOS ES AMOR.-",-67.09901,-17.98909,99,20,887,986,317,30,520,837
"Bolivia","Oruro","Cercado","Oruro","U. ESC. EL KASSO - EL PROGRESO.-",-67.08046,-17.97144,32,7,281,313,85,10,179,264
"Bolivia","Oruro","Cercado","Oruro","U. ESC. EL PATICO.-",-67.08788,-17.93559,16,8,270,286,96,15,151,247
"Bolivia","Oruro","Cercado","Oruro","U. ESC. FRANCISCO FAJARDO.-",-67.10979,-17.95128,248,10,2030,2278,1172,75,773,1945
"Bolivia","Oruro","Cercado","Oruro","U. ESC. HIJOS DEL SOL (PLAN 500)",-67.14334,-17.97866,325,13,1820,2145,727,53,1027,1754
"Bolivia","Oruro","Cercado","Oruro","U. ESC. KANTUTA.-",-67.10198,-17.94742,586,69,4563,5149,2098,302,2094,4192
"Bolivia","Oruro","Cercado","Oruro","U. ESC. LUIS LLOSA - ESPAÑA.-",-67.10973,-17.96015,100,0,987,1087,700,20,267,967
"Bolivia","Oruro","Cercado","Oruro","U. ESC. MELVIN JONES",-67.11378,-17.94639,254,17,1955,2209,1168,79,691,1859
"Bolivia","Oruro","Cercado","Oruro","U. ESC. ORURO OTAWA (PRIMARIA)",-67.10278,-17.97236,290,24,2604,2894,1561,61,958,2519
"Bolivia","Oruro","Cercado","Oruro","U. ESC. SAN IGNACIO DE LOYOLA.-",-67.10327,-17.97707,621,33,4667,5288,2581,131,1922,4503
"Bolivia","Oruro","Cercado","Oruro","U. ESC. SAN ISIDRO",-67.08199,-17.9849,202,34,1756,1958,632,83,1007,1639
"Bolivia","Oruro","Cercado","Oruro","U. ESC. SAN JUAN DE DIOS.-",-67.0648,-17.98498,65,13,664,729,214,27,410,624
"Bolivia","Oruro","Cercado","Oruro","U. ESC. SANTA ANA I  ARENALES.-",-67.08875,-17.9662,47,4,504,551,213,16,271,484
"Bolivia","Oruro","Cercado","Oruro","U. ESC. SEBASTIAN PAGADOR(PRIMARIO)",-67.10513,-17.96682,190,15,1580,1770,1041,41,483,1524
"Bolivia","Oruro","Cercado","Oruro","U. ESC. URU URU.-",-67.13344,-17.97674,319,9,2200,2519,1130,91,970,2100
"Bolivia","Oruro","Cercado","Oruro","U.E. SOCAMANI-.",-67.04722,-17.96745,107,22,857,964,258,58,519,777
"Bolivia","Oruro","Cercado","Oruro","U.E. TOMAS BARRON.-",-67.11607,-17.93777,926,88,7014,7940,3184,304,3438,6622
"Bolivia","Oruro","Cercado","Oruro","U. E. VIRGEN DEL MAR II.-",-67.0981,-17.95885,251,26,2376,2627,1278,131,941,2219
"Bolivia","Oruro","Cercado","Oruro","U.E. VIRGEN DEL MAR III",-67.0981,-17.95885,37,1,142,179,91,2,48,139
"Bolivia","Oruro","Cercado","Soracachi","COL. EDUARDO AVAROA",-66.93476,-17.90583,31,5,480,511,160,23,292,452
"Bolivia","Oruro","Cercado","Soracachi","COL. NAL. IRUMA",-66.95744,-17.82625,34,6,354,388,112,21,215,327
"Bolivia","Oruro","Cercado","Soracachi","COL. NAL. MIXTO SORACACHI",-67.04009,-17.80021,98,19,844,942,298,59,468,766
"Bolivia","Oruro","Cercado","Soracachi","ESC. CACHI CACHI",-66.90673,-17.92398,25,14,298,323,108,14,162,270
"Bolivia","Oruro","Cercado","Soracachi","ESC. CARLOS BELTRAN MORALES",-66.74974,-17.84505,41,3,283,324,38,8,234,272
"Bolivia","Oruro","Cercado","Soracachi","ESC. CENTRAL PARIA",-67.02174,-17.82162,67,14,696,763,216,40,426,642
"Bolivia","Oruro","Cercado","Soracachi","ESC. ELIZARDO PEREZ",-66.92491,-17.94757,15,3,244,259,59,18,164,223
"Bolivia","Oruro","Cercado","Soracachi","ESC. LITORAL",-66.8653,-17.87313,10,0,189,199,20,4,165,185
"Bolivia","Oruro","Cercado","Soracachi","ESC. MULTIGRADO CULLCUPAMPA",-66.84515,-17.81123,33,5,221,254,56,24,136,192
"Bolivia","Oruro","Cercado","Soracachi","ESC. SECCIONAL CONDORCHINOCA",-66.92383,-17.81707,21,6,259,280,47,10,196,243
"Bolivia","Oruro","Cercado","Soracachi","ESC. SECCIONAL SAN JUAN PAMPA",-67.02293,-17.80466,40,5,292,332,130,11,146,276
"Bolivia","Oruro","Cercado","Soracachi","ESC. SIMON BOLIVAR",-66.95678,-17.63055,69,7,335,404,87,17,224,311
"Bolivia","Oruro","Cercado","Soracachi","ESC. SIMON BOLIVAR",-66.93806,-17.64721,69,7,335,404,87,17,224,311
"Bolivia","Oruro","Cercado","Soracachi","PLAZA DE TOLAPALCA",-66.839,-17.85507,43,8,321,364,62,17,234,296
"Bolivia","Oruro","Cercado","Soracachi","PLAZA TENIENTE BULLAIN",-67.00915,-17.9779,42,17,867,909,266,49,535,801
"Bolivia","Oruro","Cercado","Soracachi","U. E. CALAPATA",-67.07857,-17.81657,8,2,225,233,66,9,148,214
"Bolivia","Oruro","Cercado","Soracachi","U.E. EDUARDO AVAROA",-66.95867,-18.05556,45,6,486,531,120,17,343,463
"Bolivia","Oruro","Cercado","Soracachi","U.E. FRANZ TAMAYO",-67.03432,-17.68199,23,6,120,143,34,7,73,107
"Bolivia","Oruro","Cercado","Soracachi","U. E. JATITA",-67.15078,-17.74948,22,3,199,221,51,2,143,194
"Bolivia","Oruro","Cercado","Soracachi","U. E. K'ASA HUASA",-67.01914,-18.04029,16,11,232,248,90,15,116,206
"Bolivia","Oruro","Cercado","Soracachi","U. E. MCAL. ANTONIO JOSE DE SUCRE",-66.99371,-17.6637,6,0,134,140,43,9,82,125
"Bolivia","Oruro","Cercado","Soracachi","U. ESC. SIMON BOLIVAR",-66.88591,-17.77803,22,7,211,233,48,9,147,195
"Bolivia","Oruro","Ladislao Cabrera","Pampa Aullagas","ESC. FRANZ TAMAYO",-67.14696,-19.40474,3,0,140,143,47,7,86,133
"Bolivia","Oruro","Ladislao Cabrera","Pampa Aullagas","ESC. MARIA SANCHEZ FERNANDEZ",-67.06307,-19.19442,136,26,960,1096,279,42,613,892
"Bolivia","Oruro","Ladislao Cabrera","Pampa Aullagas","U.E. GUALBERTO VILLARROEL",-67.06329,-19.28214,28,2,268,296,90,7,169,259
"Bolivia","Oruro","Ladislao Cabrera","Salinas de Garcí Mendoza","COL. ANTOFAGASTA",-67.73315,-19.52218,55,6,465,520,110,17,332,442
"Bolivia","Oruro","Ladislao Cabrera","Salinas de Garcí Mendoza","COL. FRANZ TAMAYO",-67.67596,-19.63522,228,15,1143,1371,351,61,716,1067
"Bolivia","Oruro","Ladislao Cabrera","Salinas de Garcí Mendoza","ESC. AMERICA SAN MARTIN",-67.59932,-19.27503,46,3,198,244,49,7,139,188
"Bolivia","Oruro","Ladislao Cabrera","Salinas de Garcí Mendoza","ESC. CENTRAL PUQUI",-67.37225,-19.57412,45,6,349,394,54,12,277,331
"Bolivia","Oruro","Ladislao Cabrera","Salinas de Garcí Mendoza","ESC. ILDEFONSO MURGUIA",-67.94785,-19.71597,7,3,54,61,4,0,47,51
"Bolivia","Oruro","Ladislao Cabrera","Salinas de Garcí Mendoza","ESC. VILLA ESPERANZA",-67.28278,-19.39601,21,2,183,204,47,9,125,172
"Bolivia","Oruro","Ladislao Cabrera","Salinas de Garcí Mendoza","PLAZA PRINCIPAL",-67.76024,-19.25545,6,3,161,167,104,4,50,154
"Bolivia","Oruro","Ladislao Cabrera","Salinas de Garcí Mendoza","U.E. BOLIVIA LUCA",-67.8995,-19.59013,17,1,73,90,9,1,62,71
"Bolivia","Oruro","Ladislao Cabrera","Salinas de Garcí Mendoza","U. E. CONCEPCION DE BELEN",-67.88071,-19.19479,26,1,86,112,46,4,35,81
"Bolivia","Oruro","Ladislao Cabrera","Salinas de Garcí Mendoza","U.E. GERMAN BUSCH",-67.57353,-19.85675,4,0,41,45,11,2,28,39
"Bolivia","Oruro","Ladislao Cabrera","Salinas de Garcí Mendoza","U.E. OTTO SAUCEDO RIVERA",-67.42625,-19.13229,142,12,754,896,232,43,467,699
"Bolivia","Oruro","Litoral","Cruz de Machacamarca","AMB. COMITE CIVICO",-68.34784,-18.80327,1,0,78,79,18,2,58,76
"Bolivia","Oruro","Litoral","Cruz de Machacamarca","CASA COMUNAL",-68.05518,-18.69846,5,0,97,102,40,2,55,95
"Bolivia","Oruro","Litoral","Cruz de Machacamarca","ESC. CRUZ DE MACHACAMARCA",-67.75741,-18.74025,12,11,192,204,83,1,97,180
"Bolivia","Oruro","Litoral","Cruz de Machacamarca","ESC. TCNL. RAFAEL PABON.-",-68.27777,-18.77197,0,0,119,119,29,1,89,118
"Bolivia","Oruro","Litoral","Escara","CASA COMUNAL",-68.16998,-18.85891,5,2,82,87,34,2,44,78
"Bolivia","Oruro","Litoral","Escara","CASA DEL NOTARIO",-68.20262,-18.80862,0,2,155,155,54,2,97,151
"Bolivia","Oruro","Litoral","Escara","U.E. FRANZ TAMAYO",-68.16997,-18.85826,37,32,317,354,137,5,143,280
"Bolivia","Oruro","Litoral","Esmeralda","ESC. SEBASTIAN PAGADOR",-68.25356,-18.88226,8,1,185,193,77,0,107,184
"Bolivia","Oruro","Litoral","Esmeralda","IGLESIA",-67.93938,-18.92884,10,2,182,192,65,1,114,179
"Bolivia","Oruro","Litoral","Esmeralda","IGLESIA",-68.28327,-18.84608,10,2,182,192,65,1,114,179
"Bolivia","Oruro","Litoral","Esmeralda","U.E. PEDRO DOMINGO MURILLO",-68.20913,-18.91374,1,0,118,119,53,0,65,118
"Bolivia","Oruro","Litoral","Huachacalla","ESC. FE Y ALEGRIA",-68.26381,-18.79456,313,3,341,654,125,9,204,329
"Bolivia","Oruro","Litoral","Yunguyo de Litoral","ESC. JOSE BALLIVIAN",-68.31896,-18.85273,32,0,94,126,43,6,45,88
"Bolivia","Oruro","Mejillones","Carangas","ESC. ELIODORO VILLAZON",-68.62348,-18.93954,29,0,139,168,61,1,77,138
"Bolivia","Oruro","Mejillones","La Rivera","U.E. LA RIVERA",-68.63965,-19.0056,0,3,250,250,124,2,121,245
"Bolivia","Oruro","Mejillones","Todos Santos","U.E. EDUARDO AVAROA",-68.7207,-19.0161,62,5,192,254,63,3,121,184
"Bolivia","Oruro","Nor Carangas","Huayllamarca (Santiago de Huayllamarca)","COL. CHOJÑOHUMA",-67.99887,-17.75547,10,5,118,128,23,2,88,111
"Bolivia","Oruro","Nor Carangas","Huayllamarca (Santiago de Huayllamarca)","COL. LLANQUERA",-67.69202,-17.98834,75,4,423,498,106,12,301,407
"Bolivia","Oruro","Nor Carangas","Huayllamarca (Santiago de Huayllamarca)","ESC. GERMAN BUSCH",-67.63836,-18.05427,24,2,140,164,59,4,75,134
"Bolivia","Oruro","Nor Carangas","Huayllamarca (Santiago de Huayllamarca)","ESC. JESUS BELEN",-68.02042,-17.79224,4,0,119,123,34,2,83,117
"Bolivia","Oruro","Nor Carangas","Huayllamarca (Santiago de Huayllamarca)","ESC. TUNUPA",-67.88644,-17.80342,30,2,197,227,51,6,138,189
"Bolivia","Oruro","Nor Carangas","Huayllamarca (Santiago de Huayllamarca)","PLAZA PRINCIPAL",-67.9429,-17.83473,103,16,685,788,153,23,493,646
"Bolivia","Oruro","Nor Carangas","Huayllamarca (Santiago de Huayllamarca)","U. E. MEJILLONES",-67.91051,-17.86477,16,0,125,141,27,5,93,120
"Bolivia","Oruro","Nor Carangas","Huayllamarca (Santiago de Huayllamarca)","U.E. PEDRO DOMINGO MURILLO",-67.8089,-17.91016,27,7,298,325,89,3,199,288
"Bolivia","Oruro","Nor Carangas","Huayllamarca (Santiago de Huayllamarca)","U. E. SAN MIGUEL",-67.74892,-17.9582,17,7,392,409,123,12,250,373
"Bolivia","Oruro","Nor Carangas","Huayllamarca (Santiago de Huayllamarca)","U.E. SEBASTIAN PAGADOR",-67.85006,-17.99825,24,0,125,149,30,1,94,124
"Bolivia","Oruro","Pantaleón Dalence","Machacamarca","COL. P. D. MURILLO.-",-67.01683,-18.17177,247,32,1563,1810,542,53,936,1478
"Bolivia","Oruro","Pantaleón Dalence","Machacamarca","ESC. ADOLFO MIER",-67.00506,-18.10496,30,1,194,224,68,8,117,185
"Bolivia","Oruro","Pantaleón Dalence","Machacamarca","ESC. GERMAN BUSCH",-66.96426,-18.16933,89,9,398,487,130,14,245,375
"Bolivia","Oruro","Pantaleón Dalence","Villa Huanuni","COL. AYACUCHO",-66.84127,-18.28592,584,47,3859,4443,1144,193,2475,3619
"Bolivia","Oruro","Pantaleón Dalence","Villa Huanuni","ESC. DANIEL SANCHEZ BUSTAMANTE",-66.81483,-18.27406,27,2,130,157,47,9,72,119
"Bolivia","Oruro","Pantaleón Dalence","Villa Huanuni","ESC. EDUARDO AVAROA",-66.83648,-18.28687,514,57,4060,4574,1162,179,2662,3824
"Bolivia","Oruro","Pantaleón Dalence","Villa Huanuni","ESC. FRANZ TAMAYO",-66.84327,-18.28328,342,39,2940,3282,823,133,1945,2768
"Bolivia","Oruro","Pantaleón Dalence","Villa Huanuni","ESC. HUALLATIRI",-66.57692,-18.26101,29,3,189,218,31,3,152,183
"Bolivia","Oruro","Pantaleón Dalence","Villa Huanuni","ESC. OSCAR ALFARO",-66.84819,-18.07138,32,6,247,279,119,10,112,231
"Bolivia","Oruro","Pantaleón Dalence","Villa Huanuni","PLAZA PRINCIPAL",-66.74792,-18.36819,24,1,249,273,50,8,190,240
"Bolivia","Oruro","Pantaleón Dalence","Villa Huanuni","U.E. 12 DE ABRIL",-66.83877,-18.28987,121,6,358,479,134,18,200,334
"Bolivia","Oruro","Pantaleón Dalence","Villa Huanuni","U.E. MARISCAL SUCRE DE TARUCAMARCA",-66.74748,-18.27423,2,2,90,92,8,6,74,82
"Bolivia","Oruro","Pantaleón Dalence","Villa Huanuni","U.E. TAYAQUIRA",-66.68075,-18.28287,22,9,324,346,45,6,264,309
"Bolivia","Oruro","Pantaleón Dalence","Villa Huanuni","U.E. VENEZUELA",-66.83852,-18.28969,42,1,237,279,122,7,107,229
"Bolivia","Oruro","Pantaleón Dalence","Villa Huanuni","U.E. VICTOR MANUEL AYLLON",-66.79549,-18.15128,41,3,230,271,72,16,139,211
"Bolivia","Oruro","Poopó","Antequera (Bolívar)","ESC. MARISCAL ANTONIO JOSE DE SUCRE",-66.75814,-18.60952,11,2,137,148,42,5,88,130
"Bolivia","Oruro","Poopó","Antequera (Bolívar)","ESC. SEBASTIAN PAGADOR",-66.84234,-18.47896,136,19,1065,1201,557,51,438,995
"Bolivia","Oruro","Poopó","Antequera (Bolívar)","PLAZA 2 DE FEBRERO",-66.74583,-18.57221,14,5,141,155,58,8,70,128
"Bolivia","Oruro","Poopó","Paza","COL. JUAN LECHIN OQUENDO",-66.87602,-18.49693,82,7,534,616,201,17,309,510
"Bolivia","Oruro","Poopó","Paza","COL. OSCAR UNZAGA DE LA VEGA",-66.9222,-18.59495,145,16,849,994,337,42,454,791
"Bolivia","Oruro","Poopó","Paza","COL. URMIRI",-66.87689,-18.57802,15,1,117,132,68,1,47,115
"Bolivia","Oruro","Poopó","Paza","ESC. MARISCAL SUCRE.-",-66.75761,-18.69305,114,18,758,872,216,76,448,664
"Bolivia","Oruro","Poopó","Paza","U.E. GUILLERMO GUTIERREZ",-66.88187,-18.52423,23,7,261,284,100,6,148,248
"Bolivia","Oruro","Poopó","Poopó (Villa Poopó)","ESC. EDUARDO AVAROA",-66.99586,-18.28933,26,5,114,140,29,8,72,101
"Bolivia","Oruro","Poopó","Poopó (Villa Poopó)","ESC. ISMAEL MONTES",-66.96783,-18.37966,276,47,2328,2604,760,113,1408,2168
"Bolivia","Oruro","Poopó","Poopó (Villa Poopó)","ESC. MARISCAL SUCRE",-66.82631,-18.37954,13,2,111,124,22,7,80,102
"Bolivia","Oruro","Poopó","Poopó (Villa Poopó)","ESC. PUÑACA",-67.01503,-18.40687,5,0,55,60,5,3,47,52
"Bolivia","Oruro","Poopó","Poopó (Villa Poopó)","PLAZA SIMON BOLIVAR",-66.85959,-18.29434,75,10,414,489,112,20,272,384
"Bolivia","Oruro","Poopó","Poopó (Villa Poopó)","U.E. GERMAN BUSCH",-66.96021,-18.49657,0,0,49,49,11,2,36,47
"Bolivia","Oruro","Poopó","Poopó (Villa Poopó)","U.E. LIBERTADOR SIMON BOLIVAR",-66.97563,-18.45356,5,5,106,111,16,0,85,101
"Bolivia","Oruro","Sabaya","Chipaya","ESC. PUENTE TOPATER",-67.91399,-19.03246,41,1,114,155,11,5,97,108
"Bolivia","Oruro","Sabaya","Chipaya","ESC. SAN IGNACIO",-68.0725,-19.09496,20,0,70,90,6,1,63,69
"Bolivia","Oruro","Sabaya","Chipaya","U.E. SANTA ANA",-68.08934,-19.04418,227,9,411,638,129,8,265,394
"Bolivia","Oruro","Sabaya","Coipasa","U.E. COIPASA",-68.27831,-19.2763,36,3,346,382,186,4,153,339
"Bolivia","Oruro","Sabaya","Sabaya","CASA COMUNAL",-68.73852,-18.73852,1,0,167,168,118,0,49,167
"Bolivia","Oruro","Sabaya","Sabaya","CASA COMUNAL",-68.47369,-19.00466,1,0,167,168,118,0,49,167
"Bolivia","Oruro","Sabaya","Sabaya","CASA DEL NOTARIO",-68.5004,-19.06247,14,0,91,105,61,1,29,90
"Bolivia","Oruro","Sabaya","Sabaya","ESC. EDUARDO AVAROA",-68.87798,-19.03987,0,4,30,30,8,4,14,22
"Bolivia","Oruro","Sabaya","Sabaya","ESC. FELIX FERNANDEZ",-68.52093,-18.96744,4,0,97,101,67,0,30,97
"Bolivia","Oruro","Sabaya","Sabaya","ESC. FRANZ TAMAYO",-68.35445,-19.19073,0,2,298,298,183,4,109,292
"Bolivia","Oruro","Sabaya","Sabaya","ESC. FRANZ TAMAYO",-68.31431,-18.76981,0,2,298,298,183,4,109,292
"Bolivia","Oruro","Sabaya","Sabaya","ESC. GERMAN BUSCH",-68.61129,-18.82781,11,0,201,212,80,2,119,199
"Bolivia","Oruro","Sabaya","Sabaya","ESC. GUALBERTO VILLARROEL",-68.78839,-18.57318,2,3,107,109,35,2,67,102
"Bolivia","Oruro","Sabaya","Sabaya","ESC. ILDEFONSO MURGUIA",-68.89094,-18.69991,8,1,199,207,104,1,93,197
"Bolivia","Oruro","Sabaya","Sabaya","ESC. JOSE MARIA EGUES CUELLAR",-68.37302,-19.01429,145,8,404,549,192,20,184,376
"Bolivia","Oruro","Sabaya","Sabaya","ESC. JOSE MARIA MONTAÑO",-68.53316,-18.90277,2,0,113,115,92,0,21,113
"Bolivia","Oruro","Sabaya","Sabaya","ESC. JOSE MERIDA MONTAÑO",-68.64622,-18.70486,15,0,103,118,78,1,24,102
"Bolivia","Oruro","Sabaya","Sabaya","ESC. PITACOLLO",-68.59029,-19.05312,3,1,85,88,14,0,70,84
"Bolivia","Oruro","Sabaya","Sabaya","ESC. SEBASTIAN  PAGADOR",-68.37182,-19.01886,0,3,154,154,105,1,45,150
"Bolivia","Oruro","Sabaya","Sabaya","ESC. VERALINES",-68.55422,-19.20341,4,0,121,125,90,2,29,119
"Bolivia","Oruro","Sabaya","Sabaya","IGLESIA",-68.80792,-18.79146,0,0,54,54,32,0,22,54
"Bolivia","Oruro","Sabaya","Sabaya","PLAZA 25 DE JULIO MIRAFLORES",-68.54026,-18.65128,0,0,33,33,20,0,13,33
"Bolivia","Oruro","Sabaya","Sabaya","PLAZA SIMON BOLIVAR",-68.52158,-18.8665,12,0,67,79,41,0,26,67
"Bolivia","Oruro","Sabaya","Sabaya","U. E.  CONCEPCION COMUJO",-68.38916,-19.21006,2,1,104,106,67,0,36,103
"Bolivia","Oruro","Sabaya","Sabaya","U.E. JOSE ANTONIO ARCE",-68.68381,-18.44296,24,0,126,150,80,0,46,126
"Bolivia","Oruro","Sabaya","Sabaya","U.E. LIBERTADOR SIMON BOLIVAR",-68.61559,-19.27332,69,5,224,293,121,13,85,206
"Bolivia","Oruro","Sabaya","Sabaya","U.E. MARIA EVANS CUELLAR",-68.34265,-19.09297,6,0,120,126,96,1,23,119
"Bolivia","Oruro","Sabaya","Sabaya","U.E. PEDRO DOMINGO MURILLO",-68.53796,-18.92385,3,0,138,141,90,2,46,136
"Bolivia","Oruro","Sajama","Curahuara de Carangas","COL. BOLIVIA",-68.97609,-18.13643,46,4,160,206,74,7,75,149
"Bolivia","Oruro","Sajama","Curahuara de Carangas","ESC. EDUARDO SAGARNAGA",-68.41264,-17.84149,592,39,1589,2181,355,73,1122,1477
"Bolivia","Oruro","Sajama","Curahuara de Carangas","U.E. HACIA EL MAR",-68.83837,-18.00538,7,0,67,74,17,0,50,67
"Bolivia","Oruro","Sajama","Curahuara de Carangas","U.E. LITORAL B",-68.93645,-18.2223,29,1,148,177,56,6,85,141
"Bolivia","Oruro","Sajama","Turco","CASA COMUNAL",-68.94479,-18.53836,11,0,57,68,18,0,39,57
"Bolivia","Oruro","Sajama","Turco","ESC. CENTRAL TURCO",-68.19347,-18.18156,204,16,956,1160,212,23,705,917
"Bolivia","Oruro","Sajama","Turco","ESC. GUALBERTO VILLARROEL - IRUNI.-",-68.5331,-18.60372,2,0,40,42,6,0,34,40
"Bolivia","Oruro","Sajama","Turco","ESC. WALBERTO VILLARROEL",-68.62778,-18.34289,5,0,31,36,6,1,24,30
"Bolivia","Oruro","Sajama","Turco","NUCLEO ESCOLAR TITIRI",-68.33176,-18.38792,23,0,73,96,6,6,61,67
"Bolivia","Oruro","Sajama","Turco","U.E. ASUNCION DE HUAJRIRE",-68.37857,-18.21539,1,0,21,22,5,1,15,20
"Bolivia","Oruro","Sajama","Turco","U.E. EDUARDO AVAROA",-67.94069,-18.01298,21,1,96,117,16,2,77,93
"Bolivia","Oruro","Sajama","Turco","U.E. PEDRO DOMINGO MURILLO A",-68.71188,-18.17634,64,5,377,441,59,10,303,362
"Bolivia","Oruro","Sajama","Turco","U.E. PORVENIR",-68.94597,-18.35423,43,1,283,326,108,13,161,269
"Bolivia","Oruro","San Pedro De Totora","San Pedro de Totora","COL. NAL. CALAZAYA",-68.29729,-17.66094,64,7,295,359,30,6,252,282
"Bolivia","Oruro","San Pedro De Totora","San Pedro de Totora","COMEDOR ESCOLAR",-68.31258,-17.89262,17,1,100,117,29,4,66,95
"Bolivia","Oruro","San Pedro De Totora","San Pedro de Totora","ESC. CENTRAL SORA SORA",-68.10621,-17.9355,13,2,223,236,24,4,193,217
"Bolivia","Oruro","San Pedro De Totora","San Pedro de Totora","ESC. FRANZ TAMAYO",-68.09863,-17.82198,10,1,185,195,30,3,151,181
"Bolivia","Oruro","San Pedro De Totora","San Pedro de Totora","ESC. LITORAL DE CULTA.-",-68.03839,-17.97308,29,0,197,226,18,9,170,188
"Bolivia","Oruro","San Pedro De Totora","San Pedro de Totora","ESC. MARQUIRIVI",-67.9737,-17.95451,13,0,69,82,26,2,41,67
"Bolivia","Oruro","San Pedro De Totora","San Pedro de Totora","U.E. CENTRO REVITO",-68.02218,-17.91033,7,0,76,83,18,2,56,74
"Bolivia","Oruro","San Pedro De Totora","San Pedro de Totora","U.E. ROMEROCOTA",-68.25556,-17.92027,0,2,77,77,4,14,57,61
"Bolivia","Oruro","San Pedro De Totora","San Pedro de Totora","U.E. SEBASTIAN PAGADOR",-68.28579,-17.79087,14,1,127,141,13,1,112,125
"Bolivia","Oruro","San Pedro De Totora","San Pedro de Totora","U.E. TOTORA",-68.14532,-17.7922,149,17,789,938,119,46,607,726
"Bolivia","Oruro","San Pedro De Totora","San Pedro de Totora","U.E. VINO HUTA",-68.2402,-17.8328,12,1,132,144,14,2,115,129
"Bolivia","Oruro","Saucarí","Toledo","CASA COMUNAL",-67.42073,-18.08936,27,0,115,142,41,3,71,112
"Bolivia","Oruro","Saucarí","Toledo","CASA COMUNAL",-67.00774,-18.14512,27,0,115,142,41,3,71,112
"Bolivia","Oruro","Saucarí","Toledo","CASA COMUNAL CENTRAL MOLLOCO",-67.49101,-18.40378,4,4,77,81,14,1,58,72
"Bolivia","Oruro","Saucarí","Toledo","CASA DEL NOTARIO",-67.58843,-18.20439,13,0,67,80,18,1,48,66
"Bolivia","Oruro","Saucarí","Toledo","COL. NACIONAL TOLEDO",-67.4108,-18.1808,250,14,998,1248,299,37,648,947
"Bolivia","Oruro","Saucarí","Toledo","ESC. EDUARDO AVAROA",-67.58844,-18.20436,10,1,95,105,26,17,51,77
"Bolivia","Oruro","Saucarí","Toledo","ESC. ELIZARDO PEREZ 1",-67.28907,-18.29798,32,2,137,169,31,5,99,130
"Bolivia","Oruro","Saucarí","Toledo","ESC. GERMAN BUSCH 1",-67.54126,-18.26623,31,1,139,170,54,5,79,133
"Bolivia","Oruro","Saucarí","Toledo","ESC. GERMAN BUSCH II",-67.40559,-18.50244,1,0,123,124,24,5,94,118
"Bolivia","Oruro","Saucarí","Toledo","ESC. ISAC PORTO CARRERA",-67.59666,-18.02896,38,2,149,187,28,2,117,145
"Bolivia","Oruro","Saucarí","Toledo","ESC. M. M. VACA GUZMAN.-",-67.2721,-17.47592,70,5,282,352,87,9,181,268
"Bolivia","Oruro","Saucarí","Toledo","ESC. PUMASARA",-67.35503,-18.6561,21,0,120,141,19,3,98,117
"Bolivia","Oruro","Saucarí","Toledo","U.E. ANTONIO JOSE DE SUCRE",-67.51073,-18.37418,10,0,38,48,11,0,27,38
"Bolivia","Oruro","Saucarí","Toledo","U.E. BARTOLINA SISA",-67.46616,-18.43586,6,1,101,107,21,2,77,98
"Bolivia","Oruro","Saucarí","Toledo","U.E. FRANZ TAMAYO",-67.59203,-18.1406,5,0,45,50,16,2,27,43
"Bolivia","Oruro","Saucarí","Toledo","U. E. GUALBERTO VILLARROEL",-67.49483,-17.94513,17,2,121,138,27,1,91,118
"Bolivia","Oruro","Saucarí","Toledo","U.E. MARCELO QUIROGA SANTA CRUZ",-67.40546,-18.39192,20,1,61,81,9,0,51,60
"Bolivia","Oruro","Saucarí","Toledo","U.E. OTTO SAUCEDO",-67.5033,-18.48854,5,2,125,130,31,2,90,121
"Bolivia","Oruro","Saucarí","Toledo","U. ESC. TIJLLACAHUA",-67.46854,-17.94667,19,0,69,88,26,3,40,66
"Bolivia","Oruro","Sebastian Pagador","Santiago de Huari","COL. MIXTO GUALBERTO VILLARROEL",-66.77557,-19.00875,215,27,1528,1743,585,126,790,1375
"Bolivia","Oruro","Sebastian Pagador","Santiago de Huari","ESC. CAICO BOLIVAR",-66.75815,-19.25462,9,1,88,97,39,1,47,86
"Bolivia","Oruro","Sebastian Pagador","Santiago de Huari","ESC. CALACOTA",-66.46594,-19.14192,8,0,69,77,16,3,50,66
"Bolivia","Oruro","Sebastian Pagador","Santiago de Huari","ESC. CASTILLA HUMA",-66.71346,-19.14007,38,4,229,267,86,9,130,216
"Bolivia","Oruro","Sebastian Pagador","Santiago de Huari","ESC. CONDO K",-66.8055,-19.17203,14,2,140,154,67,3,68,135
"Bolivia","Oruro","Sebastian Pagador","Santiago de Huari","ESC. LLAPALLAPANI",-66.81982,-19.01081,17,2,117,134,25,6,84,109
"Bolivia","Oruro","Sebastian Pagador","Santiago de Huari","ESC. VICHAJ LUPE",-66.7529,-19.25462,42,1,245,287,68,12,164,232
"Bolivia","Oruro","Sebastian Pagador","Santiago de Huari","NUCLEO ESCOLAR BOLIVIA",-66.74451,-19.15185,14,1,284,298,50,3,230,280
"Bolivia","Oruro","Sebastian Pagador","Santiago de Huari","NUCLEO MARCA LAGUNILLAS",-66.27309,-19.23056,34,7,472,506,107,23,335,442
"Bolivia","Oruro","Sebastian Pagador","Santiago de Huari","U. E. LUCUMPAYA",-66.69658,-19.29461,8,0,57,65,10,1,46,56
"Bolivia","Oruro","Sebastian Pagador","Santiago de Huari","U.E. NAZACARA",-66.48449,-19.15744,0,3,121,121,41,7,70,111
"Bolivia","Oruro","Sebastian Pagador","Santiago de Huari","U.E. SAN PEDRO DE CONDO",-66.74747,-19.04341,105,9,553,658,205,24,315,520
"Bolivia","Oruro","Sebastian Pagador","Santiago de Huari","U. E. URMIRI DE QUILLACAS",-66.72021,-19.22743,39,3,211,250,43,4,161,204
"Bolivia","Oruro","Sebastian Pagador","Santiago de Huari","U. E. VILLA VERDE",-66.76753,-19.11843,23,3,130,153,43,2,82,125
"Bolivia","Oruro","Sur Carangas","Andamarca (Santiago de Andamarca)","ESC. SEBASTIAN PAGADOR",-67.50749,-18.77982,183,24,688,871,200,12,452,652
"Bolivia","Oruro","Sur Carangas","Andamarca (Santiago de Andamarca)","U.E. MEJILLONES",-67.50016,-18.87049,84,25,540,624,111,8,396,507
"Bolivia","Oruro","Sur Carangas","Andamarca (Santiago de Andamarca)","U.E. ORINOCA",-67.25661,-18.96682,110,3,804,914,64,11,726,790
"Bolivia","Oruro","Sur Carangas","Belén de Andamarca","COL. TEC. HUMANISTICO SIMON BOLIVAR",-67.64007,-18.8171,46,7,330,376,123,7,193,316
"Bolivia","Oruro","Sur Carangas","Belén de Andamarca","ESC. ANICETO ARCE",-67.75741,-18.74025,0,4,178,178,36,5,133,169
"Bolivia","Oruro","Sur Carangas","Belén de Andamarca","ESC. ELIZARDO PEREZ",-67.67679,-18.76107,11,0,101,112,20,3,78,98
"Bolivia","Oruro","Sur Carangas","Belén de Andamarca","U.E. BOLIVIA",-67.69051,-18.75176,16,7,183,199,38,9,129,167
"Bolivia","Oruro","Tomas Barrón","Eucaliptus","COL. NAL. EUCALIPTUS",-67.51264,-17.59574,6,1,62,68,11,0,50,61
"Bolivia","Oruro","Tomas Barrón","Eucaliptus","ESC. HUANCAROMA",-67.49158,-17.66445,18,0,121,139,18,0,103,121
"Bolivia","Oruro","Tomas Barrón","Eucaliptus","ESC. MARISCAL ANTONIO JOSE DE SUCRE",-67.39827,-17.62614,24,4,167,191,19,3,141,160
"Bolivia","Oruro","Tomas Barrón","Eucaliptus","ESC. TUPAC KATARI",-67.45214,-17.5953,4,2,200,204,36,6,156,192
"Bolivia","Oruro","Tomas Barrón","Eucaliptus","U.E. BENEDETO VINCENTI",-67.50977,-17.59444,216,21,1308,1524,381,32,874,1255
"Bolivia","Oruro","Tomas Barrón","Eucaliptus","U.E. MACHACAMARCA",-67.35824,-17.64213,10,0,105,115,11,4,90,101
"Bolivia","Oruro","Tomas Barrón","Eucaliptus","U.E. QUELCATA",-67.48569,-17.56117,56,13,325,381,55,8,249,304
"Bolivia","Pando","Abuná","Ingavi (Humaita)","U.E. DERREPENTE",-66.94105,-10.93787,0,0,68,68,37,12,19,56
"Bolivia","Pando","Abuná","Ingavi (Humaita)","U.E. HUMAITA",-66.44747,-10.82152,119,2,372,491,178,7,185,363
"Bolivia","Pando","Abuná","Ingavi (Humaita)","U.E. INGAVI",-66.82959,-10.95218,44,4,99,143,43,3,49,92
"Bolivia","Pando","Abuná","Ingavi (Humaita)","U.E. LAS AMALIAS",-66.79862,-10.97642,5,0,25,30,1,1,23,24
"Bolivia","Pando","Abuná","Santa Rosa del Abun","U.E. ABUNA",-67.45408,-10.60663,141,5,236,377,114,8,109,223
"Bolivia","Pando","Abuná","Santa Rosa del Abun","U.E. AUGUSTO GUTIERREZ BANZER",-67.35876,-10.85149,1,0,80,81,20,2,58,78
"Bolivia","Pando","Abuná","Santa Rosa del Abun","U.E. GENOVEVA RÍOS",-67.42355,-10.9903,63,5,223,286,45,2,171,216
"Bolivia","Pando","Abuná","Santa Rosa del Abun","U.E. PEDRO DOMINGO MURRILLO",-67.32189,-10.64891,16,0,100,116,8,0,92,100
"Bolivia","Pando","Abuná","Santa Rosa del Abun","U.E.  ZACARIAS MORENO",-67.48418,-10.87283,41,0,203,244,127,2,74,201
"Bolivia","Pando","Federico Román","Nuevo Manoa (Nueva Esperanza)","U.E. GRAL. FEDERICO ROMÁN",-65.50873,-10.47329,103,1,148,251,95,2,50,145
"Bolivia","Pando","Federico Román","Nuevo Manoa (Nueva Esperanza)","U.E. LA GRAN CRUZ",-65.40121,-10.36206,19,2,61,80,7,1,51,58
"Bolivia","Pando","Federico Román","Nuevo Manoa (Nueva Esperanza)","U.E.  MANUEL ESTREMADOIRO MARTINEZ",-65.34017,-10.05819,213,1,270,483,159,3,107,266
"Bolivia","Pando","Federico Román","Nuevo Manoa (Nueva Esperanza)","U.E.  MONTE SINAI",-65.31994,-10.25371,30,9,137,167,11,6,111,122
"Bolivia","Pando","Federico Román","Nuevo Manoa (Nueva Esperanza)","U.E. RUFINO CHAO",-65.59814,-10.53096,44,3,52,96,30,0,19,49
"Bolivia","Pando","Federico Román","Santos Mercado","19 DE OCTUBRE",-66.15702,-10.52243,181,2,367,548,177,6,182,359
"Bolivia","Pando","Federico Román","Santos Mercado","U.E. 11 DE SEPTIEMBRE",-66.40456,-10.258,54,1,170,224,50,2,117,167
"Bolivia","Pando","Federico Román","Santos Mercado","U.E.  23 DE MARZO",-66.30795,-10.4217,116,5,347,463,169,9,164,333
"Bolivia","Pando","Federico Román","Villa Nueva (Loma Alta)","U.E.  ANDRES IDAGUA",-65.96667,-10.79472,161,6,476,637,216,7,247,463
"Bolivia","Pando","Federico Román","Villa Nueva (Loma Alta)","U.E. ENAREVENA",-66.10579,-10.57579,9,0,51,60,28,0,23,51
"Bolivia","Pando","Federico Román","Villa Nueva (Loma Alta)","U.E. JUANA AZURDUY DE PADILLA",-66.15096,-10.79327,39,3,77,116,31,0,43,74
"Bolivia","Pando","Federico Román","Villa Nueva (Loma Alta)","U.E.  ROBERTO GONZALES",-65.88841,-10.6848,57,5,184,241,76,1,102,178
"Bolivia","Pando","Madre De Dios","El Sena","U.E.  2 DE AGOSTO",-67.05062,-11.45478,6,4,71,77,51,2,14,65
"Bolivia","Pando","Madre De Dios","El Sena","U.E. 4 DE AGOSTO",-67.01925,-12.17563,26,1,86,112,26,1,58,84
"Bolivia","Pando","Madre De Dios","El Sena","U.E. DE PEKIN",-67.65797,-12.00184,43,1,72,115,43,1,27,70
"Bolivia","Pando","Madre De Dios","El Sena","U.E. EL SENA",-67.24951,-11.48288,498,19,1417,1915,740,25,633,1373
"Bolivia","Pando","Madre De Dios","El Sena","U.E. EL TURI (RIO MANURAPE)",-67.28406,-11.69199,4,2,46,50,27,4,13,40
"Bolivia","Pando","Madre De Dios","El Sena","U.E. LAS MERCEDES",-67.27101,-11.87276,7,2,73,80,35,1,35,70
"Bolivia","Pando","Madre De Dios","El Sena","U.E. PALMA REAL",-67.72301,-11.65824,67,2,174,241,89,5,78,167
"Bolivia","Pando","Madre De Dios","El Sena","U.E. REMANSO",-67.29217,-11.76813,6,1,66,72,20,0,45,65
"Bolivia","Pando","Madre De Dios","El Sena","U.E. SAN FRANCISCO",-67.31672,-12.17345,50,5,166,216,53,6,102,155
"Bolivia","Pando","Madre De Dios","El Sena","U.E. SANTA ELENA",-67.48461,-11.78688,17,2,62,79,17,0,43,60
"Bolivia","Pando","Madre De Dios","El Sena","U.E. SANTA ROSA",-67.38081,-12.04853,30,0,54,84,25,0,29,54
"Bolivia","Pando","Madre De Dios","Puerto Gonzalo Moreno","U.E. 2 DE AGOSTO",-66.41665,-11.36894,29,1,141,170,44,4,92,136
"Bolivia","Pando","Madre De Dios","Puerto Gonzalo Moreno","U.E. AGUA DULCE",-66.20935,-11.00872,71,0,134,205,61,2,71,132
"Bolivia","Pando","Madre De Dios","Puerto Gonzalo Moreno","U.E. LUZ EN EL CAMINO",-66.17489,-11.08213,419,13,992,1411,426,29,524,950
"Bolivia","Pando","Madre De Dios","Puerto Gonzalo Moreno","U.E. MIRAFLORES",-66.40204,-11.10459,33,2,168,201,37,2,127,164
"Bolivia","Pando","Madre De Dios","Puerto Gonzalo Moreno","U.E. PEDRO HERRERA",-66.13277,-11.03917,184,5,501,685,266,7,223,489
"Bolivia","Pando","Madre De Dios","Puerto Gonzalo Moreno","U.E.  PORTACHUELO DIOS ES AMOR",-66.26447,-11.31525,108,8,329,437,50,4,267,317
"Bolivia","Pando","Madre De Dios","San Lorenzo","ESCUELA EDUARDO ABAROA",-66.95135,-11.30087,11,0,74,85,50,1,23,73
"Bolivia","Pando","Madre De Dios","San Lorenzo","U.E. 21 DE SEPTIEMBRE",-66.93037,-11.5493,9,0,60,69,24,0,36,60
"Bolivia","Pando","Madre De Dios","San Lorenzo","U.E.  24 DE SEPTIEMBRE",-66.9321,-11.72435,248,13,785,1033,256,13,503,759
"Bolivia","Pando","Madre De Dios","San Lorenzo","U.E. 27 DE MAYO",-66.81934,-11.2835,19,5,144,163,35,5,99,134
"Bolivia","Pando","Madre De Dios","San Lorenzo","U.E. 6 DE AGOSTO",-66.80107,-11.51633,0,0,118,118,0,1,117,117
"Bolivia","Pando","Madre De Dios","San Lorenzo","U.E.  6 DE JUNIO",-66.84736,-11.30354,9,1,62,71,2,0,59,61
"Bolivia","Pando","Madre De Dios","San Lorenzo","U.E.  BRUNO RACUA",-66.98441,-11.34711,12,0,81,93,38,6,37,75
"Bolivia","Pando","Madre De Dios","San Lorenzo","U.E. DE IBERIA",-66.74494,-11.69689,11,1,30,41,9,0,20,29
"Bolivia","Pando","Madre De Dios","San Lorenzo","U.E. DE ROSARIO",-66.93926,-12.29388,33,0,52,85,27,0,25,52
"Bolivia","Pando","Madre De Dios","San Lorenzo","U.E.  FEDERICO HECKER",-66.9248,-12.17911,27,0,70,97,31,1,38,69
"Bolivia","Pando","Madre De Dios","San Lorenzo","U.E. GALILEA",-66.56686,-11.41806,34,5,146,180,39,7,95,134
"Bolivia","Pando","Madre De Dios","San Lorenzo","U.E.  GENOVEVA RIOS",-66.80064,-11.27083,23,0,55,78,29,3,23,52
"Bolivia","Pando","Madre De Dios","San Lorenzo","U.E. GREGORIA DESTRE MATURANA",-66.5792,-11.1674,19,2,165,184,58,2,103,161
"Bolivia","Pando","Madre De Dios","San Lorenzo","U.E. NUEVO HORIZONTE",-66.67747,-11.44474,1,0,43,44,20,1,22,42
"Bolivia","Pando","Madre De Dios","San Lorenzo","U.E. PTO. COPACABANA",-66.68026,-11.54849,99,1,113,212,57,9,46,103
"Bolivia","Pando","Madre De Dios","San Lorenzo","U.E.  SOLEDAD",-66.9871,-11.57613,66,2,173,239,73,2,96,169
"Bolivia","Pando","Madre De Dios","San Lorenzo","U.E. VISTA ALEGRE",-66.6041,-11.3245,35,2,202,237,97,4,99,196
"Bolivia","Pando","Manuripi","Filadelfia","U.E. ALTA GRACIA",-68.25834,-11.60331,89,1,39,128,3,0,35,38
"Bolivia","Pando","Manuripi","Filadelfia","U.E. BUYUYO",-68.80491,-11.61425,14,1,127,141,33,4,89,122
"Bolivia","Pando","Manuripi","Filadelfia","U.E. CHIVE",-68.58688,-12.39163,93,9,220,313,105,8,98,203
"Bolivia","Pando","Manuripi","Filadelfia","U.E. CURICHON",-68.56036,-12.00636,24,4,101,125,48,0,49,97
"Bolivia","Pando","Manuripi","Filadelfia","U.E. DE HOLANDA",-68.71101,-11.76399,46,2,185,231,56,8,119,175
"Bolivia","Pando","Manuripi","Filadelfia","U.E. DE LA CRUZ",-68.10158,-11.98084,7,0,32,39,9,1,22,31
"Bolivia","Pando","Manuripi","Filadelfia","U.E. FILADELFIA",-68.74851,-11.32842,105,3,346,451,156,5,182,338
"Bolivia","Pando","Manuripi","Filadelfia","U.E.  FLORIDA",-68.63426,-12.19954,7,1,90,97,34,0,55,89
"Bolivia","Pando","Manuripi","Filadelfia","U.E.  JUANCITO PINTO",-68.98754,-11.87768,51,4,208,259,82,3,119,201
"Bolivia","Pando","Manuripi","Filadelfia","U.E. LUZ DE AMERICA",-68.6104,-12.12153,10,1,114,124,52,4,57,109
"Bolivia","Pando","Manuripi","Filadelfia","U.E. NUEVA ALIANZA",-68.35039,-11.37201,57,1,288,345,126,4,157,283
"Bolivia","Pando","Manuripi","Filadelfia","U.E. NUEVA EMPRESA",-68.81753,-11.49919,57,5,326,383,131,3,187,318
"Bolivia","Pando","Manuripi","Filadelfia","U.E. SAN ANTONIO",-68.58239,-12.04789,4,1,48,52,16,0,31,47
"Bolivia","Pando","Manuripi","Filadelfia","U.E. UCIA",-68.97458,-11.75343,14,5,67,81,5,0,57,62
"Bolivia","Pando","Manuripi","Filadelfia","U.E. VILLA AMERICA",-68.49368,-11.61459,14,1,93,107,44,3,45,89
"Bolivia","Pando","Manuripi","Filadelfia","U.E. VILLA BELLA",-68.72463,-11.44835,30,3,131,161,73,1,54,127
"Bolivia","Pando","Manuripi","Puerto Rico","U.E. BATRAJA",-67.32244,-11.29704,27,4,216,243,105,5,102,207
"Bolivia","Pando","Manuripi","Puerto Rico","U.E. DE LAS ARENAS",-67.69072,-11.58415,195,0,21,216,4,0,17,21
"Bolivia","Pando","Manuripi","Puerto Rico","U.E. DE PALESTINA",-67.09533,-11.03269,21,0,56,77,25,0,31,56
"Bolivia","Pando","Manuripi","Puerto Rico","U.E.  GERMAN BUSCH",-67.17651,-11.30694,0,7,396,396,151,57,181,332
"Bolivia","Pando","Manuripi","Puerto Rico","U.E. HIROSHIMA",-67.83469,-11.39288,7,0,24,31,17,1,6,23
"Bolivia","Pando","Manuripi","Puerto Rico","U.E.  LA SALLE EMETERIO RUIZ",-67.5565,-11.10394,735,18,1582,2317,735,42,787,1522
"Bolivia","Pando","Manuripi","Puerto Rico","U.E.  LOS MANDARINOS",-67.44718,-11.24423,1,2,28,29,11,2,13,24
"Bolivia","Pando","Manuripi","Puerto Rico","U.E. MANCHESTER",-67.999,-11.47539,39,0,59,98,41,0,18,59
"Bolivia","Pando","Manuripi","Puerto Rico","U.E.  SAN ANTONIO",-67.39052,-11.29652,7,0,85,92,15,3,67,82
"Bolivia","Pando","Manuripi","Puerto Rico","U.E.  SILVERIO ROJAS GONZALES",-66.75974,-11.58043,13,2,96,109,37,0,57,94
"Bolivia","Pando","Manuripi","San Pedro","U.E.  12 DE ABRIL",-66.18632,-10.82638,120,2,155,275,90,3,60,150
"Bolivia","Pando","Manuripi","San Pedro","U.E. FORTALEZA",-66.32966,-10.84701,140,0,177,317,77,1,99,176
"Bolivia","Pando","Manuripi","San Pedro","U.E.  JORGE HAENSEL",-66.44067,-10.94822,20,2,135,155,86,1,46,132
"Bolivia","Pando","Nicolás Suárez","Bella Flor","ESC. SANTA ELENA",-67.82802,-11.04349,7,0,11,18,6,0,5,11
"Bolivia","Pando","Nicolás Suárez","Bella Flor","U.E. BUENA VISTA",-67.67737,-11.09413,45,1,80,125,46,1,32,78
"Bolivia","Pando","Nicolás Suárez","Bella Flor","U.E. DE FLORIDA",-67.63081,-11.11081,5,0,18,23,1,0,17,18
"Bolivia","Pando","Nicolás Suárez","Bella Flor","U.E.  HUGO ANTEQUERA",-67.89793,-11.08514,94,4,320,414,178,9,129,307
"Bolivia","Pando","Nicolás Suárez","Bella Flor","U.E. JORGE BENITO VERA",-67.27247,-10.31881,154,2,277,431,132,7,136,268
"Bolivia","Pando","Nicolás Suárez","Bella Flor","U.E.  KM. 35 DE KARAMANU",-68.34393,-11.14225,62,5,251,313,84,6,156,240
"Bolivia","Pando","Nicolás Suárez","Bella Flor","U.E.  KM. 60 DE SAN ANTONIO",-68.09121,-11.16999,48,4,143,191,50,0,89,139
"Bolivia","Pando","Nicolás Suárez","Bella Flor","U.E. MAPAJO",-67.6199,-10.62717,30,1,69,99,32,0,36,68
"Bolivia","Pando","Nicolás Suárez","Bella Flor","U.E. SANTA LOURDES",-68.47906,-11.13931,23,0,103,126,50,2,51,101
"Bolivia","Pando","Nicolás Suárez","Bella Flor","U.E. SIMON BOLÍVAR",-67.61858,-10.90335,15,0,142,157,37,5,100,137
"Bolivia","Pando","Nicolás Suárez","Bolpebra (Mukden)","U.E. BIOCEANICA",-69.37039,-11.13272,45,1,123,168,74,1,47,121
"Bolivia","Pando","Nicolás Suárez","Bolpebra (Mukden)","U.E. DE BOLPEBRA",-69.56477,-10.94741,21,2,76,97,25,4,45,70
"Bolivia","Pando","Nicolás Suárez","Bolpebra (Mukden)","U.E. DE MUKDEN",-69.02858,-11.1877,48,3,222,270,168,6,45,213
"Bolivia","Pando","Nicolás Suárez","Bolpebra (Mukden)","U.E. DE YAMINAHUA",-69.42874,-10.93892,21,0,57,78,16,4,37,53
"Bolivia","Pando","Nicolás Suárez","Bolpebra (Mukden)","U.E.  GENOVEVA RIOS",-69.06962,-11.28025,62,3,218,280,111,3,101,212
"Bolivia","Pando","Nicolás Suárez","Bolpebra (Mukden)","U.E. NUEVA CANAÁN",-69.22169,-11.14435,49,0,74,123,26,3,45,71
"Bolivia","Pando","Nicolás Suárez","Bolpebra (Mukden)","U.E. SAN MIGUEL",-69.48006,-10.95564,4,0,12,16,0,0,12,12
"Bolivia","Pando","Nicolás Suárez","Bolpebra (Mukden)","U.E.  SANTA LUCIA",-69.01627,-11.25383,21,0,101,122,55,6,40,95
"Bolivia","Pando","Nicolás Suárez","Bolpebra (Mukden)","U.E. TRES ESTRELLAS",-69.27618,-11.33935,15,0,65,80,28,1,36,64
"Bolivia","Pando","Nicolás Suárez","Cobija","CARCEL PUBLICA (VILLA BUSCH)",-68.78143,-11.08489,37,2,131,168,61,4,64,125
"Bolivia","Pando","Nicolás Suárez","Cobija","KINDER VICTOR LEON ARUETA (VACA DIEZ MEDIO)",-68.76038,-11.02101,82,1,280,362,195,7,77,272
"Bolivia","Pando","Nicolás Suárez","Cobija","U. E. 11 DE OCTUBRE",-68.75275,-11.01869,404,10,1729,2133,1009,47,663,1672
"Bolivia","Pando","Nicolás Suárez","Cobija","U. E.  AMERICA",-68.75782,-11.01896,121,6,541,662,353,20,162,515
"Bolivia","Pando","Nicolás Suárez","Cobija","U. E. COBIJA",-68.77015,-11.03708,761,16,2513,3274,1543,61,893,2436
"Bolivia","Pando","Nicolás Suárez","Cobija","U.E. DE BELLA VISTA",-68.78143,-11.08489,184,9,920,1104,462,21,428,890
"Bolivia","Pando","Nicolás Suárez","Cobija","U.E. DEFENSORES DEL ACRE",-68.76064,-11.02505,535,21,2110,2645,1216,46,827,2043
"Bolivia","Pando","Nicolás Suárez","Cobija","U.E. GERMAN BUSCH",-67.17651,-11.30694,190,7,954,1144,543,18,386,929
"Bolivia","Pando","Nicolás Suárez","Cobija","U. E. INSTITUTO AMERICANO",-68.75738,-11.02217,161,3,694,855,454,19,218,672
"Bolivia","Pando","Nicolás Suárez","Cobija","U. E. JOSÉ MANUEL PANDO",-68.75738,-11.02217,546,28,2464,3010,1387,72,977,2364
"Bolivia","Pando","Nicolás Suárez","Cobija","U. E. JUANA AZURDUY DE PADILLA",-68.77395,-11.03823,194,1,502,696,318,8,175,493
"Bolivia","Pando","Nicolás Suárez","Cobija","U. E. MANUELA ROJAS",-68.77524,-11.03517,367,15,1822,2189,1158,57,592,1750
"Bolivia","Pando","Nicolás Suárez","Cobija","U.E. MARIANO BAPTISTA (EDIFICIO SEDUCA)",-68.7578,-11.02304,233,4,916,1149,592,44,276,868
"Bolivia","Pando","Nicolás Suárez","Cobija","U. E. MARISCAL SUCRE",-68.75624,-11.01813,615,21,2466,3081,1265,66,1114,2379
"Bolivia","Pando","Nicolás Suárez","Cobija","U.E. NUEVA ESPERANZA",-68.88235,-11.1152,16,0,84,100,53,3,28,81
"Bolivia","Pando","Nicolás Suárez","Cobija","U. E. ROGELIA MENACHO DE BALCAZAR",-68.74956,-11.01224,356,17,1672,2028,967,50,638,1605
"Bolivia","Pando","Nicolás Suárez","Cobija","U. E. SIMON BOLIVAR",-68.78709,-11.03764,170,6,1195,1365,638,33,518,1156
"Bolivia","Pando","Nicolás Suárez","Cobija","U. E. SOFIA CALPIÑEIRO",-68.75566,-11.01603,564,11,2347,2911,1518,65,753,2271
"Bolivia","Pando","Nicolás Suárez","Cobija","U. E. VACA DIEZ (INTERMEDIO)",-68.76405,-11.02211,136,156,842,978,394,19,273,667
"Bolivia","Pando","Nicolás Suárez","Cobija","U. E. VACA DIEZ (MEDIO)",-68.76039,-11.02054,166,0,576,742,379,20,177,556
"Bolivia","Pando","Nicolás Suárez","Cobija","U.E. VILLA CRUZ",-68.77383,-11.03098,595,19,2955,3550,1735,84,1117,2852
"Bolivia","Pando","Nicolás Suárez","Porvenir","U.E. BRUNO RACUA",-68.68311,-11.23532,288,9,1125,1413,462,29,625,1087
"Bolivia","Pando","Nicolás Suárez","Porvenir","U.E.  GUTEMBERT CRUZ",-68.84592,-11.22069,33,1,191,224,108,1,81,189
"Bolivia","Pando","Nicolás Suárez","Porvenir","U.E. MONS. SANTISTEBAN",-68.68311,-11.23532,264,9,953,1217,435,13,496,931
"Bolivia","Pando","Nicolás Suárez","Porvenir","U.E. VILLA BELLA",-68.724,-11.2168,95,4,584,679,245,9,326,571
"Bolivia","Potosí","Alonso de Ibáñez","Caripuyo","ESC. CATARI",-66.557,-18.152,21,0,100,121,10,5,85,95
"Bolivia","Potosí","Alonso de Ibáñez","Caripuyo","ESC. CHAICURIRI",-66.63818,-18.22252,25,1,104,129,19,1,83,102
"Bolivia","Potosí","Alonso de Ibáñez","Caripuyo","ESC. CHALVIRI",-66.51712,-18.19005,37,11,160,197,15,8,126,141
"Bolivia","Potosí","Alonso de Ibáñez","Caripuyo","ESC. CHOJLLA",-66.58522,-18.208,10,2,277,287,13,32,230,243
"Bolivia","Potosí","Alonso de Ibáñez","Caripuyo","ESC. COTANA",-66.57648,-18.09925,113,25,466,579,55,13,373,428
"Bolivia","Potosí","Alonso de Ibáñez","Caripuyo","ESC. EDUARDO AVAROA",-66.47403,-18.2329,187,65,815,1002,109,38,603,712
"Bolivia","Potosí","Alonso de Ibáñez","Caripuyo","ESC. HUANACHACA",-66.53834,-18.10201,15,3,141,156,5,2,131,136
"Bolivia","Potosí","Alonso de Ibáñez","Caripuyo","ESC. HUANACOMA",-66.49527,-18.15723,23,19,376,399,76,20,261,337
"Bolivia","Potosí","Alonso de Ibáñez","Caripuyo","ESC. JANCKO JANCKO",-66.59177,-18.17574,66,4,311,377,50,29,228,278
"Bolivia","Potosí","Alonso de Ibáñez","Caripuyo","ESC. JUNTAVI",-66.50504,-18.23312,53,7,401,454,11,11,372,383
"Bolivia","Potosí","Alonso de Ibáñez","Sacaca (Villa de Sacaca)","COL. JOSE ALONZO DE IBAÑEZ",-66.38387,-18.06966,512,52,1970,2482,779,146,993,1772
"Bolivia","Potosí","Alonso de Ibáñez","Sacaca (Villa de Sacaca)","ESC. CARCOMA",-66.31796,-17.98507,92,0,491,583,16,1,474,490
"Bolivia","Potosí","Alonso de Ibáñez","Sacaca (Villa de Sacaca)","ESC. CHARCA",-66.309,-18.29,22,3,230,252,121,6,100,221
"Bolivia","Potosí","Alonso de Ibáñez","Sacaca (Villa de Sacaca)","ESC. COLLOMA",-66.34437,-18.3256,15,3,105,120,32,5,65,97
"Bolivia","Potosí","Alonso de Ibáñez","Sacaca (Villa de Sacaca)","ESC. DE OVEJERIA",-66.23547,-18.14605,46,5,701,747,88,27,581,669
"Bolivia","Potosí","Alonso de Ibáñez","Sacaca (Villa de Sacaca)","ESC. ITURATA",-66.2449,-18.01211,27,3,260,287,18,10,229,247
"Bolivia","Potosí","Alonso de Ibáñez","Sacaca (Villa de Sacaca)","ESC. JARUMA",-66.49641,-18.05654,14,8,309,323,125,18,158,283
"Bolivia","Potosí","Alonso de Ibáñez","Sacaca (Villa de Sacaca)","ESC. LAYTOCO",-66.30727,-18.14706,21,0,276,297,4,8,264,268
"Bolivia","Potosí","Alonso de Ibáñez","Sacaca (Villa de Sacaca)","ESC. LAYUPAMPA",-66.40737,-17.99987,41,25,439,480,52,23,339,391
"Bolivia","Potosí","Alonso de Ibáñez","Sacaca (Villa de Sacaca)","ESC. SILLU SILLU",-66.46011,-18.09924,3,4,440,443,22,9,405,427
"Bolivia","Potosí","Alonso de Ibáñez","Sacaca (Villa de Sacaca)","ESC. VILA SIRCA",-66.32172,-18.34239,28,4,115,143,36,6,69,105
"Bolivia","Potosí","Alonso de Ibáñez","Sacaca (Villa de Sacaca)","ESC. VILA VILA",-66.34768,-18.15004,27,3,623,650,28,26,566,594
"Bolivia","Potosí","Alonso de Ibáñez","Sacaca (Villa de Sacaca)","SACANI",-66.18929,-18.09043,10,0,373,383,19,7,347,366
"Bolivia","Potosí","Alonso de Ibáñez","Sacaca (Villa de Sacaca)","TARHUA CHAPI",-66.40738,-18.19324,65,24,565,630,54,27,460,514
"Bolivia","Potosí","Alonso de Ibáñez","Sacaca (Villa de Sacaca)","U.E. BOLIVIA",-66.41556,-18.09067,5,2,174,179,1,9,162,163
"Bolivia","Potosí","Alonso de Ibáñez","Sacaca (Villa de Sacaca)","U.E. CAMACACHI",-66.3724,-18.11655,0,1,90,90,0,0,89,89
"Bolivia","Potosí","Alonso de Ibáñez","Sacaca (Villa de Sacaca)","U.E. JAYU JAYU",-66.37892,-18.16083,2,10,155,157,4,5,136,140
"Bolivia","Potosí","Alonso de Ibáñez","Sacaca (Villa de Sacaca)","U.E. LLAPA LLAPA",-66.3597,-18.09612,2,2,82,84,6,1,73,79
"Bolivia","Potosí","Antonio Quijarro","Porco","ESC. AGUA CASTILLA",-65.99281,-19.76802,148,16,1148,1296,844,43,245,1089
"Bolivia","Potosí","Antonio Quijarro","Porco","U.E. ANTONIO QUIJARRO DE CARMA",-65.83518,-19.78734,27,1,128,155,109,6,12,121
"Bolivia","Potosí","Antonio Quijarro","Porco","U.E. CONCEPCION DE CHAQUILLA",-66.17165,-19.915,5,0,89,94,44,1,44,88
"Bolivia","Potosí","Antonio Quijarro","Porco","U.E. GUALBERTO VILLARROEL DE CHICHUYO",-65.97169,-19.90254,22,1,113,135,62,5,45,107
"Bolivia","Potosí","Antonio Quijarro","Porco","U.E. JOSE MARIA LINARES",-65.98714,-19.79856,161,13,1042,1203,729,31,269,998
"Bolivia","Potosí","Antonio Quijarro","Porco","U.E. SAN ANTONIO DE TORCUYO",-65.79976,-19.77843,3,2,100,103,72,4,22,94
"Bolivia","Potosí","Antonio Quijarro","Porco","U.E. SAN GABRIEL DE CONDORIRI",-65.92919,-19.74775,33,1,117,150,92,1,23,115
"Bolivia","Potosí","Antonio Quijarro","Porco","U.E. SAN JOSE DE TOPALA",-65.90455,-19.80483,17,0,117,134,76,6,35,111
"Bolivia","Potosí","Antonio Quijarro","Porco","U.E. SANTA MARIA DE CHURCUITA",-65.81611,-19.84111,24,2,119,143,82,3,32,114
"Bolivia","Potosí","Antonio Quijarro","Porco","U.E. SANTA ROSA",-65.98714,-19.79856,199,23,1244,1443,841,46,334,1175
"Bolivia","Potosí","Antonio Quijarro","Tomave","COL. ELIZARDO PEREZ A",-66.31324,-20.14378,65,19,573,638,221,23,310,531
"Bolivia","Potosí","Antonio Quijarro","Tomave","COL. SIMON RODRIGUEZ CARREÑO",-66.13405,-20.04367,35,2,184,219,96,6,80,176
"Bolivia","Potosí","Antonio Quijarro","Tomave","COL. TOMAS FRIAS",-66.53149,-20.0643,129,33,438,567,224,21,160,384
"Bolivia","Potosí","Antonio Quijarro","Tomave","ESC. MARISCAL SUCRE",-66.7066,-19.74305,75,14,394,469,179,21,180,359
"Bolivia","Potosí","Antonio Quijarro","Tomave","U.E. 10 DE NOVIEMBRE",-66.5676,-20.21303,20,1,115,135,46,3,65,111
"Bolivia","Potosí","Antonio Quijarro","Tomave","U.E. 1RO. DE MAYO",-66.39316,-20.35149,27,3,142,169,60,8,71,131
"Bolivia","Potosí","Antonio Quijarro","Tomave","U.E. 31 DE OCTUBRE",-66.34953,-19.78253,14,1,128,142,77,5,45,122
"Bolivia","Potosí","Antonio Quijarro","Tomave","U.E. DANIEL CAMPOS",-66.2225,-20.26551,37,8,144,181,55,6,75,130
"Bolivia","Potosí","Antonio Quijarro","Tomave","U.E. EDUARDO ABAROA",-66.17575,-19.98652,14,3,133,147,58,5,67,125
"Bolivia","Potosí","Antonio Quijarro","Tomave","U.E. ELIZARDO PEREZ",-66.19482,-20.41101,12,1,98,110,40,4,53,93
"Bolivia","Potosí","Antonio Quijarro","Tomave","U.E. FRANZ TAMAYO",-66.16724,-20.0438,89,5,498,587,222,14,257,479
"Bolivia","Potosí","Antonio Quijarro","Tomave","U.E. FRANZ TAMAYO",-66.38166,-20.09554,89,5,498,587,222,14,257,479
"Bolivia","Potosí","Antonio Quijarro","Tomave","U.E. FRANZ TAMAYO",-66.26527,-19.82753,89,5,498,587,222,14,257,479
"Bolivia","Potosí","Antonio Quijarro","Tomave","U.E. GERMAN BUSCH",-66.04766,-20.07577,39,1,267,306,71,13,182,253
"Bolivia","Potosí","Antonio Quijarro","Tomave","U.E. GERMAN BUSCH",-66.26482,-19.89234,39,1,267,306,71,13,182,253
"Bolivia","Potosí","Antonio Quijarro","Tomave","U.E. JUANA AZURDUY DE PADILLA",-66.36832,-20.50186,7,1,35,42,14,2,18,32
"Bolivia","Potosí","Antonio Quijarro","Tomave","U.E. JULIO LAREDO",-66.17559,-20.12856,23,3,125,148,19,2,101,120
"Bolivia","Potosí","Antonio Quijarro","Tomave","U.E. MARISCAL DE AYACUCHO",-66.56905,-19.69648,43,6,115,158,63,6,40,103
"Bolivia","Potosí","Antonio Quijarro","Tomave","U.E. MARISCAL JOSE DE SUCRE",-66.12498,-20.07338,129,18,499,628,242,14,225,467
"Bolivia","Potosí","Antonio Quijarro","Tomave","U.E. RAFAEL PABON",-66.09256,-20.00132,22,4,86,108,25,5,52,77
"Bolivia","Potosí","Antonio Quijarro","Tomave","U.E. RICARDO CRUZ",-65.92126,-20.07895,67,3,164,231,47,11,103,150
"Bolivia","Potosí","Antonio Quijarro","Tomave","U.E. SIMON BOLIVAR",-66.24822,-19.90882,11,3,266,277,36,26,201,237
"Bolivia","Potosí","Antonio Quijarro","Tomave","U.E. SIMON BOLIVAR",-66.22723,-19.87498,11,3,266,277,36,26,201,237
"Bolivia","Potosí","Antonio Quijarro","Tomave","U.E. TOMAS FRIAS",-66.30714,-19.96937,27,15,191,218,78,4,94,172
"Bolivia","Potosí","Antonio Quijarro","Uyuni (Thola Pampa)","SUB SEDE UNIV. ECONOMIA",-66.82623,-20.46294,301,33,1661,1962,712,68,848,1560
"Bolivia","Potosí","Antonio Quijarro","Uyuni (Thola Pampa)","U.E.ALTO ALIANZA",-66.43998,-19.54232,4,0,36,40,23,4,9,32
"Bolivia","Potosí","Antonio Quijarro","Uyuni (Thola Pampa)","U.E. ANTONIO QUIJARRO",-66.82595,-20.45747,654,41,3074,3728,1678,139,1216,2894
"Bolivia","Potosí","Antonio Quijarro","Uyuni (Thola Pampa)","U.E. EDUARDO AVAROA",-66.85102,-20.36443,21,3,241,262,149,12,77,226
"Bolivia","Potosí","Antonio Quijarro","Uyuni (Thola Pampa)","U.E. FRANZ TAMAYO",-66.92651,-20.11757,23,4,160,183,94,11,51,145
"Bolivia","Potosí","Antonio Quijarro","Uyuni (Thola Pampa)","U.E. GERMAN BUSCH",-66.93522,-20.30083,48,4,339,387,183,13,139,322
"Bolivia","Potosí","Antonio Quijarro","Uyuni (Thola Pampa)","U.E. GUALBERTO VILLARROEL",-67.06178,-19.53462,61,10,312,373,161,28,113,274
"Bolivia","Potosí","Antonio Quijarro","Uyuni (Thola Pampa)","U.E. JAIME DE ZUDAÑES",-66.82595,-20.45747,736,45,3224,3960,1718,113,1348,3066
"Bolivia","Potosí","Antonio Quijarro","Uyuni (Thola Pampa)","U.E. JUANA AZURDUY DE PADILLA",-67.0053,-19.61859,9,1,94,103,50,2,41,91
"Bolivia","Potosí","Antonio Quijarro","Uyuni (Thola Pampa)","U.E. JUAN SANJINEZ",-67.16636,-19.68052,63,42,490,553,250,15,183,433
"Bolivia","Potosí","Antonio Quijarro","Uyuni (Thola Pampa)","U.E. KATARINA KRSUL",-66.81326,-19.52889,120,26,718,838,476,27,189,665
"Bolivia","Potosí","Antonio Quijarro","Uyuni (Thola Pampa)","U.E. MARISCAL BRAUN",-66.68245,-19.51538,31,5,316,347,137,20,154,291
"Bolivia","Potosí","Antonio Quijarro","Uyuni (Thola Pampa)","U.E. MARISCAL DE AYACUCHO",-66.3906,-20.81844,36,8,177,213,57,9,103,160
"Bolivia","Potosí","Antonio Quijarro","Uyuni (Thola Pampa)","U.E. POTOSI",-66.82595,-20.45747,233,24,1350,1583,706,71,549,1255
"Bolivia","Potosí","Antonio Quijarro","Uyuni (Thola Pampa)","U.E. PULACAYO A",-66.70123,-20.39232,34,7,219,253,105,11,96,201
"Bolivia","Potosí","Antonio Quijarro","Uyuni (Thola Pampa)","U.E. RICARDO RODRIGUEZ",-66.89848,-19.89956,52,11,279,331,126,13,129,255
"Bolivia","Potosí","Antonio Quijarro","Uyuni (Thola Pampa)","U.E. RIO MULATO",-66.77838,-19.69697,71,20,437,508,213,16,188,401
"Bolivia","Potosí","Antonio Quijarro","Uyuni (Thola Pampa)","U.E. UYUNI A",-66.81758,-20.45736,321,27,1851,2172,1044,65,715,1759
"Bolivia","Potosí","Charcas","San Pedro de Buena Vista","COLEG. NAL. CHARCAS",-65.981,-18.26995,855,167,2189,3044,517,100,1405,1922
"Bolivia","Potosí","Charcas","San Pedro de Buena Vista","ESC. ARAKANI",-65.94547,-18.44892,1,2,156,157,0,2,152,152
"Bolivia","Potosí","Charcas","San Pedro de Buena Vista","ESC. CHIRO CKASA",-66.18792,-18.26068,267,58,1164,1431,257,92,757,1014
"Bolivia","Potosí","Charcas","San Pedro de Buena Vista","ESC. IPOTE",-65.76811,-18.33076,1,0,73,74,0,1,72,72
"Bolivia","Potosí","Charcas","San Pedro de Buena Vista","ESC. MARTIN CALA",-65.68661,-18.55701,9,0,194,203,2,1,191,193
"Bolivia","Potosí","Charcas","San Pedro de Buena Vista","ESC. MOSCARI",-66.00932,-18.36224,218,11,526,744,13,4,498,511
"Bolivia","Potosí","Charcas","San Pedro de Buena Vista","ESC. ÑEQUETA",-66.21066,-18.28477,153,60,516,669,76,20,360,436
"Bolivia","Potosí","Charcas","San Pedro de Buena Vista","ESC. QUINAMARA",-65.843,-18.236,160,3,269,429,11,23,232,243
"Bolivia","Potosí","Charcas","San Pedro de Buena Vista","ESC. SAN MARCOS",-65.71427,-18.49057,105,0,617,722,5,0,612,617
"Bolivia","Potosí","Charcas","San Pedro de Buena Vista","ESC. SAPACARI",-66.24672,-18.3837,62,10,163,225,40,7,106,146
"Bolivia","Potosí","Charcas","San Pedro de Buena Vista","ESC. SECCIONAL ESKENCACHI",-66.164,-18.427,95,40,424,519,65,18,301,366
"Bolivia","Potosí","Charcas","San Pedro de Buena Vista","ESC. SORA SORA",-66.272,-18.19449,3,1,62,65,12,1,48,60
"Bolivia","Potosí","Charcas","San Pedro de Buena Vista","ESC. TORACARI",-66.13522,-18.13033,246,30,559,805,158,29,342,500
"Bolivia","Potosí","Charcas","San Pedro de Buena Vista","ESCUELA SECCIONAL COTA COTA",-66.21744,-18.34191,23,2,268,291,20,5,241,261
"Bolivia","Potosí","Charcas","San Pedro de Buena Vista","NUCLEO EDUCATIVO BANDURIRI",-66.0399,-18.15632,7,4,358,365,11,7,336,347
"Bolivia","Potosí","Charcas","San Pedro de Buena Vista","NUCLEO ESCOLAR MICANI",-65.83389,-18.3693,114,12,917,1031,13,3,889,902
"Bolivia","Potosí","Charcas","Toro Toro","ESC. PALLA PALLA",-65.52338,-18.32186,55,3,412,467,16,6,387,403
"Bolivia","Potosí","Charcas","Toro Toro","ESC. SECCIONAL",-65.77195,-18.19173,36,2,390,426,13,4,371,384
"Bolivia","Potosí","Charcas","Toro Toro","ESC. SECCIONAL AÑAHUANI",-65.64471,-18.23354,64,9,350,414,17,7,317,334
"Bolivia","Potosí","Charcas","Toro Toro","ESC. SECCIONAL CARASI",-65.68874,-18.31779,142,7,453,595,39,12,395,434
"Bolivia","Potosí","Charcas","Toro Toro","ESC. TORO TORO",-65.79198,-18.02429,451,37,1814,2265,347,77,1353,1700
"Bolivia","Potosí","Charcas","Toro Toro","ESC. TORO TORO",-65.76296,-18.13375,451,37,1814,2265,347,77,1353,1700
"Bolivia","Potosí","Charcas","Toro Toro","ESC. YAMBATA",-65.91856,-18.05247,61,3,282,343,25,8,246,271
"Bolivia","Potosí","Charcas","Toro Toro","NUCLEO POCO SUCO",-65.73625,-18.25639,49,4,257,306,11,6,236,247
"Bolivia","Potosí","Chayanta","Colquechaca","COLEG. TOMAS CATARI",-66.0375,-18.8177,642,157,1752,2394,211,131,1253,1464
"Bolivia","Potosí","Chayanta","Colquechaca","ESC. AYOMA",-66.14678,-18.86896,185,45,452,637,69,28,310,379
"Bolivia","Potosí","Chayanta","Colquechaca","ESC. CENTRAL ULUCHI",-66.14444,-18.95846,166,47,864,1030,150,65,602,752
"Bolivia","Potosí","Chayanta","Colquechaca","ESC. GUADALUPE",-65.79741,-18.69036,143,4,555,698,21,2,528,549
"Bolivia","Potosí","Chayanta","Colquechaca","ESC. GUALBERTO VILLARROEL TITIRI",-65.97601,-18.97547,31,3,145,176,7,6,129,136
"Bolivia","Potosí","Chayanta","Colquechaca","ESC. JACINTO PINTO DE PHUTINA",-66.21133,-18.83524,207,13,637,844,88,19,517,605
"Bolivia","Potosí","Chayanta","Colquechaca","ESC. JAIME MENDOZA",-66.20398,-18.9043,69,8,674,743,66,95,505,571
"Bolivia","Potosí","Chayanta","Colquechaca","ESC. JAMANCHIRI",-65.8834,-18.70837,29,3,141,170,5,13,120,125
"Bolivia","Potosí","Chayanta","Colquechaca","ESC. JUNIN",-66.00296,-18.69715,269,44,893,1162,355,84,410,765
"Bolivia","Potosí","Chayanta","Colquechaca","ESC. MARCELO QUIRVES",-66.05211,-18.97724,110,50,338,448,69,39,180,249
"Bolivia","Potosí","Chayanta","Colquechaca","ESC. MEJILLONES DE CAYARANI",-65.94516,-18.74131,32,2,279,311,17,47,213,230
"Bolivia","Potosí","Chayanta","Colquechaca","ESC. ROSARIO",-65.97795,-18.77202,59,26,418,477,41,17,334,375
"Bolivia","Potosí","Chayanta","Colquechaca","ESC. SALINAS",-66.11065,-19.01487,69,28,711,780,101,33,549,650
"Bolivia","Potosí","Chayanta","Colquechaca","ESC. S.BOLIVAR CHOQUECAYARA",-66.23908,-18.92873,35,19,208,243,46,22,121,167
"Bolivia","Potosí","Chayanta","Colquechaca","ESC. SECCIONAL SALINAS DE MACHA",-66.11683,-18.9747,41,0,150,191,22,11,117,139
"Bolivia","Potosí","Chayanta","Colquechaca","OFIC. CORREGIMIENTO",-65.84781,-18.56566,231,17,484,715,37,11,419,456
"Bolivia","Potosí","Chayanta","Colquechaca","TOMAYCURI",-65.90958,-18.85932,153,26,508,661,118,26,338,456
"Bolivia","Potosí","Chayanta","Colquechaca","U.E. AYACUCHO DE SICUTA",-65.80147,-18.59073,19,6,238,257,4,6,222,226
"Bolivia","Potosí","Chayanta","Colquechaca","U.E. MILLURI",-66.15628,-18.90602,4,1,100,104,14,10,75,89
"Bolivia","Potosí","Chayanta","Colquechaca","U.E. ROBERTO ALVARADO",-66.0021,-18.70359,235,50,881,1116,414,68,349,763
"Bolivia","Potosí","Chayanta","Ocurí","COLEGIO DANIEL SALAMANCA",-65.79628,-18.8428,338,62,843,1181,256,60,465,721
"Bolivia","Potosí","Chayanta","Ocurí","COL. NAC. MARCELO QUIROGA SANTA CRUZ",-65.79628,-18.8428,364,40,850,1214,226,91,493,719
"Bolivia","Potosí","Chayanta","Ocurí","ESC. KARA KARA",-65.70093,-18.81138,102,33,337,439,84,21,199,283
"Bolivia","Potosí","Chayanta","Ocurí","ESC. MARAGUA",-65.77851,-18.95468,268,32,515,783,171,59,253,424
"Bolivia","Potosí","Chayanta","Ocurí","ESC ROCO ROCO",-65.84806,-18.79057,17,2,84,101,8,4,70,78
"Bolivia","Potosí","Chayanta","Ocurí","ESC. SECCIONAL MARCOMA",-65.65381,-18.95084,87,22,326,413,90,19,195,285
"Bolivia","Potosí","Chayanta","Ocurí","ESC. SIMON BOLIVAR DE PEANA",-65.785,-18.719,54,6,366,420,31,16,313,344
"Bolivia","Potosí","Chayanta","Ocurí","ESC. YURIMATA",-65.69332,-18.93946,63,18,237,300,55,13,151,206
"Bolivia","Potosí","Chayanta","Ocurí","U.E. CHAUPI LOMA",-65.77997,-19.00577,3,2,65,68,15,11,37,52
"Bolivia","Potosí","Chayanta","Ocurí","U.E. COLLPA",-65.82913,-18.99837,10,13,158,168,25,7,113,138
"Bolivia","Potosí","Chayanta","Pocoata","ESC. ACHACANA",-66.15985,-18.5925,100,2,465,565,12,18,433,445
"Bolivia","Potosí","Chayanta","Pocoata","ESC. CACHUYO",-66.04868,-18.71111,39,17,260,299,39,14,190,229
"Bolivia","Potosí","Chayanta","Pocoata","ESC. CAMPAYA",-66.30963,-18.75883,68,12,1019,1087,84,12,911,995
"Bolivia","Potosí","Chayanta","Pocoata","ESC. CENTRAL JACHATAJO",-66.07078,-18.51748,67,17,231,298,11,8,195,206
"Bolivia","Potosí","Chayanta","Pocoata","ESC. CENTRAL VILLA ALCARAPI",-66.28011,-18.8248,19,0,329,348,16,12,301,317
"Bolivia","Potosí","Chayanta","Pocoata","ESC. CHAYALA",-66.04488,-18.53314,164,6,291,455,22,5,258,280
"Bolivia","Potosí","Chayanta","Pocoata","ESC. COLLANA TUICA",-66.20734,-18.60429,29,12,373,402,17,7,337,354
"Bolivia","Potosí","Chayanta","Pocoata","ESC. COLLPA CKASA",-66.118,-18.49396,36,4,235,271,40,7,184,224
"Bolivia","Potosí","Chayanta","Pocoata","ESC. HUANCARANI",-66.13522,-18.73722,146,56,638,784,133,34,415,548
"Bolivia","Potosí","Chayanta","Pocoata","ESC. JARANA",-66.12551,-18.6998,65,27,342,407,54,20,241,295
"Bolivia","Potosí","Chayanta","Pocoata","ESC. KAPARANCHO",-66.06309,-18.63861,19,7,126,145,19,7,93,112
"Bolivia","Potosí","Chayanta","Pocoata","ESC.PACOTANCA",-66.25257,-18.74593,33,2,97,130,6,0,89,95
"Bolivia","Potosí","Chayanta","Pocoata","ESC. PEDRO GUTIERREZ",-66.1626,-18.69938,484,118,1818,2302,559,146,995,1554
"Bolivia","Potosí","Chayanta","Pocoata","ESC. SAN MIGUEL DE KARI",-66.26031,-18.59378,3,3,385,388,42,14,326,368
"Bolivia","Potosí","Chayanta","Pocoata","ESC. SAYI",-66.22854,-18.75826,4,0,174,178,5,12,157,162
"Bolivia","Potosí","Chayanta","Pocoata","ESC. SECCIONAL SENAJO",-66.14663,-18.49398,16,5,77,93,30,4,38,68
"Bolivia","Potosí","Chayanta","Pocoata","ESC. SECCIONAL TURBERIA",-66.07927,-18.6298,118,18,531,649,47,59,407,454
"Bolivia","Potosí","Chayanta","Pocoata","ESC SECCIONAL YAHUACO",-66.02201,-18.5216,14,5,83,97,13,10,55,68
"Bolivia","Potosí","Chayanta","Pocoata","ESC. TOMOYO",-66.134,-18.463,41,1,187,228,34,5,147,181
"Bolivia","Potosí","Chayanta","Pocoata","ESC. VILA VILA",-66.27483,-18.82087,10,3,323,333,26,6,288,314
"Bolivia","Potosí","Chayanta","Pocoata","NUCLEO ESCOLAR JUAN DE ARROZ PATA",-66.17729,-18.4751,8,5,104,112,25,7,67,92
"Bolivia","Potosí","Chayanta","Pocoata","NUCLEO ESCOLAR KESIMPUCU",-66.05427,-18.56416,13,27,399,412,73,33,266,339
"Bolivia","Potosí","Chayanta","Ravelo","COL. JOSE ALONSO DE IBAÑEZ",-65.60184,-18.87419,28,27,252,280,21,9,195,216
"Bolivia","Potosí","Chayanta","Ravelo","ESC. ANTORA",-65.64693,-18.75318,72,21,278,350,52,30,175,227
"Bolivia","Potosí","Chayanta","Ravelo","ESC. CENTRAL 1º DE MAYO",-65.67611,-18.87961,78,9,235,313,36,19,171,207
"Bolivia","Potosí","Chayanta","Ravelo","ESC. CENTRAL RODEO HUAYLLAS",-65.59853,-18.7994,107,36,358,465,67,14,241,308
"Bolivia","Potosí","Chayanta","Ravelo","ESC. CENTRAL SAUCY MAYU",-65.55036,-18.78822,65,20,359,424,59,17,263,322
"Bolivia","Potosí","Chayanta","Ravelo","ESC. CHALLUMA",-65.54932,-18.85223,9,8,119,128,12,6,93,105
"Bolivia","Potosí","Chayanta","Ravelo","ESC. CHIPIRINA",-65.4499,-18.80882,23,1,101,124,19,10,71,90
"Bolivia","Potosí","Chayanta","Ravelo","ESC. HUAYCOMA",-65.48942,-18.58409,75,23,189,264,34,19,113,147
"Bolivia","Potosí","Chayanta","Ravelo","ESC. LACAYANI",-65.57085,-18.71785,52,30,271,323,37,14,190,227
"Bolivia","Potosí","Chayanta","Ravelo","ESC. LAMPHASUNI",-65.43322,-18.60605,18,1,116,134,7,9,99,106
"Bolivia","Potosí","Chayanta","Ravelo","ESC. M. ASCENCIO PADILLA",-65.50803,-18.80719,378,54,1383,1761,459,96,774,1233
"Bolivia","Potosí","Chayanta","Ravelo","ESC. MOROTO",-65.51731,-18.72289,13,9,77,90,2,4,62,64
"Bolivia","Potosí","Chayanta","Ravelo","ESC. PITANTORA",-65.6319,-18.70022,99,5,266,365,14,20,227,241
"Bolivia","Potosí","Chayanta","Ravelo","ESC. SASANTA",-65.48589,-18.85652,35,3,243,278,52,13,175,227
"Bolivia","Potosí","Chayanta","Ravelo","ESC. SECCIONAL MOKO KOTANI",-65.55286,-18.6043,65,14,132,197,7,5,106,113
"Bolivia","Potosí","Chayanta","Ravelo","ESC. SECCIONAL MOLLE MOLLE",-65.5581,-18.99458,68,52,444,512,55,19,318,373
"Bolivia","Potosí","Chayanta","Ravelo","ESC. SECC. LUQUI PAMPA",-65.71329,-18.71529,44,5,98,142,19,17,57,76
"Bolivia","Potosí","Chayanta","Ravelo","ESC. SECC TEJA MOLINO",-65.56034,-18.51546,71,1,151,222,21,11,118,139
"Bolivia","Potosí","Chayanta","Ravelo","ESC. S. YURUBAMBA",-65.45452,-18.86363,56,20,340,396,71,17,232,303
"Bolivia","Potosí","Chayanta","Ravelo","ESC. TOMOYO",-65.58306,-18.92324,76,38,316,392,50,27,201,251
"Bolivia","Potosí","Chayanta","Ravelo","TOROCA",-65.49248,-18.66342,22,2,146,168,6,7,131,137
"Bolivia","Potosí","Chayanta","Ravelo","U.E. JANINA",-65.67776,-18.77756,20,4,199,219,75,14,106,181
"Bolivia","Potosí","Cornelio Saavedra","Betanzos","CENTRAL ELIZARDO PEREZ",-66.42453,-18.54064,89,16,368,457,74,19,259,333
"Bolivia","Potosí","Cornelio Saavedra","Betanzos","COLEG. R. BOHORQUEZ",-65.44724,-19.55169,334,54,1686,2020,865,95,672,1537
"Bolivia","Potosí","Cornelio Saavedra","Betanzos","ESC. ALONZO DE IBAÑEZ",-65.45937,-19.3632,65,11,395,460,90,12,282,372
"Bolivia","Potosí","Cornelio Saavedra","Betanzos","ESC. ANCO MAYU",-65.26953,-19.413,16,0,70,86,3,1,66,69
"Bolivia","Potosí","Cornelio Saavedra","Betanzos","ESC. BLAS S. DE PEDRO",-65.27425,-19.36944,35,1,110,145,25,9,75,100
"Bolivia","Potosí","Cornelio Saavedra","Betanzos","ESC. BUEY TAMBO",-65.33926,-19.56878,74,7,312,386,93,22,190,283
"Bolivia","Potosí","Cornelio Saavedra","Betanzos","ESC. CAMALI",-65.00764,-19.49642,84,17,443,527,54,15,357,411
"Bolivia","Potosí","Cornelio Saavedra","Betanzos","ESC. CENTRAL OTUYO",-65.23023,-19.48659,82,13,295,377,49,8,225,274
"Bolivia","Potosí","Cornelio Saavedra","Betanzos","ESC. CENTRAL TECOYA",-65.4239,-19.50207,302,112,1167,1469,243,57,755,998
"Bolivia","Potosí","Cornelio Saavedra","Betanzos","ESC. CENTRAL VILA VILA",-65.33044,-19.34779,94,6,376,470,70,37,263,333
"Bolivia","Potosí","Cornelio Saavedra","Betanzos","ESC. DE HUANO HUANO",-64.985,-19.61366,48,10,125,173,27,8,80,107
"Bolivia","Potosí","Cornelio Saavedra","Betanzos","ESC. DE MAMAHOTA",-65.48484,-19.48434,36,12,238,274,27,6,193,220
"Bolivia","Potosí","Cornelio Saavedra","Betanzos","ESC. DE MARIACA",-65.35322,-19.41788,67,12,240,307,19,8,201,220
"Bolivia","Potosí","Cornelio Saavedra","Betanzos","ESC. ELIZARDO PEREZ",-65.3391,-19.44707,38,15,182,220,37,7,123,160
"Bolivia","Potosí","Cornelio Saavedra","Betanzos","ESC. GERMAN BUSH",-65.54766,-19.82024,47,8,340,387,151,26,155,306
"Bolivia","Potosí","Cornelio Saavedra","Betanzos","ESC. MEDIA LUNA",-64.77518,-19.76643,16,0,70,86,4,2,64,68
"Bolivia","Potosí","Cornelio Saavedra","Betanzos","ESC. MODESTO OMISTE",-65.44724,-19.55169,347,41,1391,1738,664,70,616,1280
"Bolivia","Potosí","Cornelio Saavedra","Betanzos","ESC. POCO POCO",-65.01298,-19.36994,139,8,527,666,109,20,390,499
"Bolivia","Potosí","Cornelio Saavedra","Betanzos","ESC. POTOBAMBA",-65.3583,-19.2998,58,0,241,299,21,2,218,239
"Bolivia","Potosí","Cornelio Saavedra","Betanzos","ESC. POTONGO ALTO",-65.24026,-19.39199,9,0,65,74,0,2,63,63
"Bolivia","Potosí","Cornelio Saavedra","Betanzos","ESC. SECCIONAL DE SAN PEDRO DE COLILA",-65.12701,-19.44642,21,1,132,153,8,2,121,129
"Bolivia","Potosí","Cornelio Saavedra","Betanzos","ESC. TARIJA CUCHU",-65.33474,-19.49068,66,17,317,383,67,21,212,279
"Bolivia","Potosí","Cornelio Saavedra","Betanzos","ESC. TAURI CANCHA",-65.31977,-19.59806,203,60,1079,1282,541,55,423,964
"Bolivia","Potosí","Cornelio Saavedra","Betanzos","ESC. TIRISPAYA",-65.40837,-19.27494,45,2,229,274,2,12,213,215
"Bolivia","Potosí","Cornelio Saavedra","Betanzos","ESC. TRAPICHE ALTA",-65.5425,-19.42349,20,1,144,164,66,3,74,140
"Bolivia","Potosí","Cornelio Saavedra","Betanzos","ESC. TROJA PAMPA",-64.96799,-19.44878,21,8,189,210,11,6,164,175
"Bolivia","Potosí","Cornelio Saavedra","Betanzos","ESC. UNZAGA DE LA VEGA",-65.18517,-19.4238,71,7,515,586,128,22,358,486
"Bolivia","Potosí","Cornelio Saavedra","Betanzos","ESC. URIFAYA",-64.92088,-19.48255,4,1,235,239,12,2,220,232
"Bolivia","Potosí","Cornelio Saavedra","Betanzos","ESC. VILLA IMPERIAL",-65.37331,-19.54539,84,49,314,398,56,13,196,252
"Bolivia","Potosí","Cornelio Saavedra","Betanzos","ESC. VIÑA QUEMADA",-64.85901,-19.42301,15,9,102,117,26,6,61,87
"Bolivia","Potosí","Cornelio Saavedra","Betanzos","KINDER VILLA IMPERIAL",-65.44724,-19.55169,162,42,949,1111,381,65,461,842
"Bolivia","Potosí","Cornelio Saavedra","Chaquí","COL. VILLA IMPERIAL",-65.57073,-19.62471,140,30,512,652,232,72,178,410
"Bolivia","Potosí","Cornelio Saavedra","Chaquí","ESC. ANDRES DE SANTA CRUZ",-65.56108,-19.58838,306,52,1152,1458,563,97,440,1003
"Bolivia","Potosí","Cornelio Saavedra","Chaquí","ESC. C. CHIUTALUYO",-65.51266,-19.63994,135,37,351,486,137,63,114,251
"Bolivia","Potosí","Cornelio Saavedra","Chaquí","ESC. CENTRAL EL PALOMAR",-65.41072,-19.65163,57,5,169,226,28,6,130,158
"Bolivia","Potosí","Cornelio Saavedra","Chaquí","ESC. CHARCA FLORIDA",-65.41967,-19.71643,34,1,103,137,26,4,72,98
"Bolivia","Potosí","Cornelio Saavedra","Chaquí","ESC. CHICO CHICO",-65.53385,-19.67762,130,41,320,450,72,23,184,256
"Bolivia","Potosí","Cornelio Saavedra","Chaquí","ESC. DON DIEGO",-65.60049,-19.50195,66,13,469,535,311,29,116,427
"Bolivia","Potosí","Cornelio Saavedra","Chaquí","ESC. RODERO",-65.51254,-19.56043,34,11,166,200,70,14,71,141
"Bolivia","Potosí","Cornelio Saavedra","Chaquí","ESC. SAN ANTONIO",-65.44303,-19.60513,90,13,228,318,95,16,104,199
"Bolivia","Potosí","Cornelio Saavedra","Tacobamba","COL. GUALBERTO VILLARROEL",-65.54424,-19.31846,46,8,213,259,133,17,55,188
"Bolivia","Potosí","Cornelio Saavedra","Tacobamba","ESC. ANCOMA",-65.63528,-19.13348,58,2,258,316,20,0,236,256
"Bolivia","Potosí","Cornelio Saavedra","Tacobamba","ESC. CAJAS ALTA",-65.63494,-19.29129,60,0,163,223,74,14,75,149
"Bolivia","Potosí","Cornelio Saavedra","Tacobamba","ESC. CENTRAL MACHACAMARCA",-65.54421,-19.37108,10,0,55,65,32,4,19,51
"Bolivia","Potosí","Cornelio Saavedra","Tacobamba","ESC. CHALLVIRI",-65.63294,-19.32677,47,5,210,257,116,14,75,191
"Bolivia","Potosí","Cornelio Saavedra","Tacobamba","ESC. C. MIGMA",-65.65115,-19.21268,95,13,197,292,84,16,84,168
"Bolivia","Potosí","Cornelio Saavedra","Tacobamba","ESC. GENOVEVA RIOS",-65.54977,-19.32013,57,16,221,278,90,5,110,200
"Bolivia","Potosí","Cornelio Saavedra","Tacobamba","ESC. HUAJCHI BAJO",-65.58374,-19.20394,38,1,67,105,17,3,46,63
"Bolivia","Potosí","Cornelio Saavedra","Tacobamba","ESC. JURUNA",-65.426,-19.219,50,5,284,334,21,10,248,269
"Bolivia","Potosí","Cornelio Saavedra","Tacobamba","ESC. RODEO",-65.58909,-19.07606,70,2,182,252,16,12,152,168
"Bolivia","Potosí","Cornelio Saavedra","Tacobamba","ESC. SECCIONAL TRAPICHE BAJO",-65.53699,-19.41847,12,1,69,81,26,4,38,64
"Bolivia","Potosí","Cornelio Saavedra","Tacobamba","ESC. SIMON BOLIVAR",-65.54227,-19.34671,22,2,44,66,21,3,18,39
"Bolivia","Potosí","Cornelio Saavedra","Tacobamba","ESC. TACOBAMBA",-65.55141,-19.20102,264,64,550,814,131,32,323,454
"Bolivia","Potosí","Cornelio Saavedra","Tacobamba","ESC. YAGUACARI",-65.60043,-19.04875,20,2,86,106,20,3,61,81
"Bolivia","Potosí","Cornelio Saavedra","Tacobamba","UNID. EDU. FRANZ TAMAYO",-65.44989,-19.16096,37,2,266,303,16,6,242,258
"Bolivia","Potosí","Daniel Campos","Llica","U.E. BERNABE LEDEZMA",-68.29847,-19.99556,13,0,66,79,8,1,57,65
"Bolivia","Potosí","Daniel Campos","Llica","U.E. CANQUELLA",-68.2532,-20.08167,14,0,65,79,19,0,46,65
"Bolivia","Potosí","Daniel Campos","Llica","U.E. ELIZARDO PEREZ",-68.10056,-19.62237,4,1,54,58,6,2,45,51
"Bolivia","Potosí","Daniel Campos","Llica","U.E. FRANZ TAMAYO",-68.2407,-19.86069,240,14,1053,1293,326,24,689,1015
"Bolivia","Potosí","Daniel Campos","Llica","U.E. HUANAQUE",-68.33338,-20.01662,24,4,89,113,13,0,72,85
"Bolivia","Potosí","Daniel Campos","Llica","U.E. MANUAL ANTONIO AGUIRRE",-68.30267,-20.11507,23,1,70,93,10,1,58,68
"Bolivia","Potosí","Daniel Campos","Llica","U.E. PALAYA",-68.13572,-19.80343,15,3,95,110,16,1,75,91
"Bolivia","Potosí","Daniel Campos","Llica","U.E. PEDRO GARCIA IGNACIO",-68.48859,-19.71477,16,3,62,78,19,0,40,59
"Bolivia","Potosí","Daniel Campos","Llica","U.E. VILLQUE",-68.10628,-19.66033,3,1,33,36,4,0,28,32
"Bolivia","Potosí","Daniel Campos","Tahua","ESC. JARUMA",-67.945,-19.77135,9,0,24,33,1,0,23,24
"Bolivia","Potosí","Daniel Campos","Tahua","ESC. TAMANCASA",-68.00201,-19.72284,5,0,27,32,5,2,20,25
"Bolivia","Potosí","Daniel Campos","Tahua","U.E. ANICETO ARCE",-67.9101,-19.7663,2,0,20,22,3,0,17,20
"Bolivia","Potosí","Daniel Campos","Tahua","U.E. BERNABE LEDEZMA",-67.80781,-19.82589,7,4,60,67,6,0,50,56
"Bolivia","Potosí","Daniel Campos","Tahua","U.E. CAQUENA",-67.76733,-19.84044,17,1,78,95,34,3,40,74
"Bolivia","Potosí","Daniel Campos","Tahua","U.E. FRANZ TAMAYO",-68.02673,-20.63319,1,2,120,121,37,1,80,117
"Bolivia","Potosí","Daniel Campos","Tahua","U.E. GERMAN BUSCH",-67.66147,-19.91329,4,0,35,39,10,1,24,34
"Bolivia","Potosí","Daniel Campos","Tahua","U.E. JOHN F. KENNEDY",-67.69619,-19.891,30,5,178,208,35,5,133,168
"Bolivia","Potosí","Enrique Baldivieso","San Agustín","ESC. SAN AGUSTIN",-67.6795,-21.1566,67,6,223,290,70,6,141,211
"Bolivia","Potosí","Enrique Baldivieso","San Agustín","ESC. VICTOR PAZ ESTENSORO",-67.35812,-21.51948,10,0,132,142,40,3,89,129
"Bolivia","Potosí","Enrique Baldivieso","San Agustín","U.E. 1RO DE MAYO",-67.23789,-21.70214,4,0,89,93,8,0,81,89
"Bolivia","Potosí","Enrique Baldivieso","San Agustín","U.E. ELIZARDO PEREZ",-67.18568,-21.72287,10,1,78,88,15,1,61,76
"Bolivia","Potosí","Enrique Baldivieso","San Agustín","U.E. LITORAL",-67.59641,-21.40281,36,4,223,259,109,5,105,214
"Bolivia","Potosí","General Bernardino B","Acacio","ESC. CHURITACA",-65.98965,-18.1063,78,7,417,495,12,9,389,401
"Bolivia","Potosí","General Bernardino B","Acacio","ESC. JOSE RIVERO",-66.05407,-18.02672,206,21,746,952,223,27,475,698
"Bolivia","Potosí","General Bernardino B","Acacio","ESC. PIRIQUINA",-66.01617,-18.0789,49,9,233,282,15,4,205,220
"Bolivia","Potosí","General Bernardino B","Acacio","ESC. TACONI DE CAINE",-66.00538,-17.94402,14,2,81,95,9,0,70,79
"Bolivia","Potosí","General Bernardino B","Acacio","ESC. TACONI YAMBATA",-65.94917,-18.04741,72,5,165,237,1,2,157,158
"Bolivia","Potosí","General Bernardino B","Acacio","ESC. TUQUIZA",-66.00704,-18.02213,41,11,208,249,15,5,177,192
"Bolivia","Potosí","General Bernardino B","Arampampa","ESC. ARAMPAMPA",-66.08163,-17.87692,50,14,225,275,54,27,130,184
"Bolivia","Potosí","General Bernardino B","Arampampa","ESC. CALACHUA",-66.12383,-17.98363,17,0,121,138,2,2,117,119
"Bolivia","Potosí","General Bernardino B","Arampampa","ESC. CATACORA",-66.15216,-17.94774,43,1,94,137,5,0,88,93
"Bolivia","Potosí","General Bernardino B","Arampampa","ESC. CHARCA MARCAVI",-66.04567,-17.92901,7,0,51,58,0,2,49,49
"Bolivia","Potosí","General Bernardino B","Arampampa","ESC. HUAYCURI",-66.10529,-17.85553,7,0,28,35,3,0,25,28
"Bolivia","Potosí","General Bernardino B","Arampampa","ESC. HUMAVIZA",-66.03617,-17.88659,4,1,16,20,4,2,9,13
"Bolivia","Potosí","General Bernardino B","Arampampa","ESC. MOLLEVILQUE",-66.10755,-17.84728,7,0,42,49,3,1,38,41
"Bolivia","Potosí","General Bernardino B","Arampampa","ESC. PARARANI",-66.105,-17.919,8,0,58,66,0,0,58,58
"Bolivia","Potosí","General Bernardino B","Arampampa","ESC. QOARACA",-66.17999,-18.0151,1,0,95,96,2,3,90,92
"Bolivia","Potosí","General Bernardino B","Arampampa","ESC. SANTIAGO",-66.19445,-17.99237,88,5,366,454,23,8,330,353
"Bolivia","Potosí","General Bernardino B","Arampampa","ESC. SARCURI",-66.08449,-17.94726,37,2,201,238,0,1,198,198
"Bolivia","Potosí","José María Linares","Caiza","COL. FRANZ TAMAYO",-65.69497,-19.88101,64,17,502,566,318,23,144,462
"Bolivia","Potosí","José María Linares","Caiza","ESC.DE KALTAPI",-65.55387,-20.01271,20,2,123,143,60,3,58,118
"Bolivia","Potosí","José María Linares","Caiza","ESC.DE PANOCOCHI",-65.6757,-20.1773,47,3,145,192,15,9,118,133
"Bolivia","Potosí","José María Linares","Caiza","ESC.HORNOS",-65.48529,-19.90132,92,5,253,345,67,14,167,234
"Bolivia","Potosí","José María Linares","Caiza","ESC. LA FRAGUA",-65.61447,-20.2052,29,4,154,183,18,9,123,141
"Bolivia","Potosí","José María Linares","Caiza","ESC.LA LAVA",-65.64637,-19.8947,79,15,372,451,134,21,202,336
"Bolivia","Potosí","José María Linares","Caiza","ESC. PALCA CANCHA",-65.56768,-19.94123,31,0,74,105,29,2,43,72
"Bolivia","Potosí","José María Linares","Caiza","ESC. SECCIONAL CHILLMA",-65.72665,-19.93593,58,15,309,367,156,23,115,271
"Bolivia","Potosí","José María Linares","Caiza","ESC. TRES CRUCES",-65.5471,-19.87114,253,40,801,1054,299,44,418,717
"Bolivia","Potosí","José María Linares","Caiza","ESC.TUCTAPARI",-65.53459,-20.04247,34,10,210,244,116,10,74,190
"Bolivia","Potosí","José María Linares","Caiza","NORMAL RURAL CAIZA D",-65.65247,-20.00772,212,28,953,1165,475,31,419,894
"Bolivia","Potosí","José María Linares","Ckochas","ESC. ALEJANDRO CORONADO",-65.14595,-19.67983,21,0,167,188,43,19,105,148
"Bolivia","Potosí","José María Linares","Ckochas","ESC. CENTRAL EUSEBIO B. FLORES",-64.83906,-19.61541,47,18,238,285,32,9,179,211
"Bolivia","Potosí","José María Linares","Ckochas","ESC.CKOCHAS",-65.2905,-19.63276,152,26,698,850,265,39,368,633
"Bolivia","Potosí","José María Linares","Ckochas","ESC.DE CALAPAYA",-65.206,-19.756,74,22,182,256,54,6,100,154
"Bolivia","Potosí","José María Linares","Ckochas","ESC.DE MELENA ALTA",-65.14054,-19.64427,37,4,221,258,55,7,155,210
"Bolivia","Potosí","José María Linares","Ckochas","ESC.DE MOJON CKASA",-64.9791,-19.75853,115,7,349,464,60,11,271,331
"Bolivia","Potosí","José María Linares","Ckochas","ESC.DE QUELUYO",-65.1904,-19.8398,128,8,297,425,61,24,204,265
"Bolivia","Potosí","José María Linares","Ckochas","ESC.DURAZNOS",-64.98342,-19.66648,56,4,240,296,54,12,170,224
"Bolivia","Potosí","José María Linares","Ckochas","ESC.ESQUIRI",-65.219,-19.64303,15,1,72,87,37,4,30,67
"Bolivia","Potosí","José María Linares","Ckochas","ESC.JOSE MA.LINARES",-64.94132,-19.81973,46,2,140,186,41,7,90,131
"Bolivia","Potosí","José María Linares","Ckochas","ESC. LAJAS",-64.91263,-19.58851,16,0,152,168,2,0,150,152
"Bolivia","Potosí","José María Linares","Ckochas","ESC. MEDIA LUNA",-64.77805,-19.76315,20,4,255,275,7,4,240,247
"Bolivia","Potosí","José María Linares","Ckochas","ESC. RODEO PAMPA",-64.81729,-19.81045,1,1,75,76,5,0,69,74
"Bolivia","Potosí","José María Linares","Ckochas","ESC. SAN PEDRO DE ESQUIRI",-65.19585,-19.5817,14,1,63,77,22,0,40,62
"Bolivia","Potosí","José María Linares","Ckochas","ESC.SECCIONAL",-64.83231,-19.83634,215,9,538,753,29,19,481,510
"Bolivia","Potosí","José María Linares","Ckochas","ESC. SECCIONAL CAPILLANI",-65.16954,-19.93791,35,3,104,139,33,7,61,94
"Bolivia","Potosí","José María Linares","Ckochas","ESC. SECCIONAL HUAYLLAJARA",-64.92155,-19.6202,35,3,141,176,21,3,114,135
"Bolivia","Potosí","José María Linares","Ckochas","ESC. SECCIONAL UYUNI",-65.12721,-19.85135,58,2,132,190,25,3,102,127
"Bolivia","Potosí","José María Linares","Ckochas","ESC. SEUCOCHI",-64.86348,-19.90878,111,13,339,450,32,14,280,312
"Bolivia","Potosí","José María Linares","Ckochas","ESC. SUCHINA",-65.24477,-19.72506,29,1,83,112,15,2,65,80
"Bolivia","Potosí","José María Linares","Ckochas","SECC. CARPA HUATA",-65.086,-19.586,19,1,59,78,12,2,44,56
"Bolivia","Potosí","José María Linares","Puna (Villa Talavera)","COLEG.LITORAL",-65.50571,-19.79494,223,50,819,1042,396,55,318,714
"Bolivia","Potosí","José María Linares","Puna (Villa Talavera)","ESC.BELEN",-65.54243,-19.86561,88,26,307,395,118,19,144,262
"Bolivia","Potosí","José María Linares","Puna (Villa Talavera)","ESC.CENTRAL",-65.52189,-19.49838,49,2,195,244,84,14,95,179
"Bolivia","Potosí","José María Linares","Puna (Villa Talavera)","ESC. CENTRAL JOSE MARIA LINARES",-65.30202,-19.6668,43,4,340,383,119,13,204,323
"Bolivia","Potosí","José María Linares","Puna (Villa Talavera)","ESC.DE ALCATUYO",-65.564,-19.86951,106,7,324,430,180,15,122,302
"Bolivia","Potosí","José María Linares","Puna (Villa Talavera)","ESC.DE HUAYCAYA",-65.61684,-19.8672,52,9,193,245,127,3,54,181
"Bolivia","Potosí","José María Linares","Puna (Villa Talavera)","ESC.DE KEPALLO",-65.31073,-19.90731,172,8,418,590,127,14,269,396
"Bolivia","Potosí","José María Linares","Puna (Villa Talavera)","ESC.DE LA ESMERALDA",-65.30669,-19.68868,77,30,307,384,125,13,139,264
"Bolivia","Potosí","José María Linares","Puna (Villa Talavera)","ESC.DE NUQUI",-65.30702,-19.97297,87,3,221,308,77,5,136,213
"Bolivia","Potosí","José María Linares","Puna (Villa Talavera)","ESC.DE SUQUICHA",-65.28864,-19.82753,117,7,266,383,111,16,132,243
"Bolivia","Potosí","José María Linares","Puna (Villa Talavera)","ESC. G.MALDINI CHACABUCO",-65.34591,-19.65162,49,6,301,350,124,16,155,279
"Bolivia","Potosí","José María Linares","Puna (Villa Talavera)","ESC.INCHASI",-65.47024,-19.7256,31,5,68,99,17,8,38,55
"Bolivia","Potosí","José María Linares","Puna (Villa Talavera)","ESC.JOSE MA. LINARES",-65.37317,-19.75613,123,4,315,438,89,16,206,295
"Bolivia","Potosí","José María Linares","Puna (Villa Talavera)","ESC.JOSE MARIA LINARES",-65.50571,-19.79494,195,53,871,1066,435,71,312,747
"Bolivia","Potosí","José María Linares","Puna (Villa Talavera)","ESC.MARAZA",-65.35992,-19.68579,43,22,174,217,60,7,85,145
"Bolivia","Potosí","José María Linares","Puna (Villa Talavera)","ESC. MOJONA",-65.33739,-20.07207,72,7,233,305,44,8,174,218
"Bolivia","Potosí","José María Linares","Puna (Villa Talavera)","ESC. SAN LORENZO",-65.32391,-19.80195,78,24,202,280,77,10,91,168
"Bolivia","Potosí","José María Linares","Puna (Villa Talavera)","ESC. SECCIONAL PAMPA TAMBO",-65.35207,-19.97996,54,4,125,179,43,5,73,116
"Bolivia","Potosí","José María Linares","Puna (Villa Talavera)","ESC.SEPULTURAS",-65.59354,-19.86297,82,25,300,382,118,18,139,257
"Bolivia","Potosí","José María Linares","Puna (Villa Talavera)","ESC.SIMON BOLIVAR",-65.33378,-20.05038,213,15,568,781,153,19,381,534
"Bolivia","Potosí","José María Linares","Puna (Villa Talavera)","ESC. TOMAS FRIAS",-65.51495,-19.7167,189,42,458,647,89,41,286,375
"Bolivia","Potosí","José María Linares","Puna (Villa Talavera)","ESC. TURQUIÑA",-65.26543,-19.7833,55,11,113,168,57,5,40,97
"Bolivia","Potosí","José María Linares","Puna (Villa Talavera)","ESC.VILACAYA",-65.48064,-19.99248,108,5,285,393,122,22,136,258
"Bolivia","Potosí","José María Linares","Puna (Villa Talavera)","ESC.YASPACI",-65.44774,-19.89478,66,2,174,240,59,6,107,166
"Bolivia","Potosí","José María Linares","Puna (Villa Talavera)","UNID. VILAMANI",-65.40481,-19.95643,38,4,142,180,40,6,92,132
"Bolivia","Potosí","Modesto Omiste","Villazón","COLEG. FRANZ TAMAYO",-65.81631,-21.80585,64,5,226,290,43,6,172,215
"Bolivia","Potosí","Modesto Omiste","Villazón","COLEGIO 9 DE ABRIL",-65.59546,-22.09029,712,61,2350,3062,1008,98,1183,2191
"Bolivia","Potosí","Modesto Omiste","Villazón","COL MARISCAL ANDRES DE SANTA CRUZ",-65.48156,-21.95128,17,5,130,147,28,5,92,120
"Bolivia","Potosí","Modesto Omiste","Villazón","COL.MODESTO OMISTE",-65.5955,-22.09031,587,24,1715,2302,859,63,769,1628
"Bolivia","Potosí","Modesto Omiste","Villazón","ESC. BERQUE",-65.78044,-21.94482,56,5,155,211,11,9,130,141
"Bolivia","Potosí","Modesto Omiste","Villazón","ESC. CORNELIO SAAVEDRA",-65.59546,-22.09029,818,44,2770,3588,1274,117,1335,2609
"Bolivia","Potosí","Modesto Omiste","Villazón","ESC. DANIEL CAMPOS",-65.59546,-22.09029,611,77,2640,3251,841,173,1549,2390
"Bolivia","Potosí","Modesto Omiste","Villazón","ESC. LIZARDO PEREZ",-65.51073,-21.91479,32,9,178,210,46,10,113,159
"Bolivia","Potosí","Modesto Omiste","Villazón","ESC. MAX FERNANDEZ",-65.59546,-22.09029,543,53,1897,2440,690,118,1036,1726
"Bolivia","Potosí","Modesto Omiste","Villazón","ESC. MORAYA",-65.54895,-21.74982,37,2,146,183,23,9,112,135
"Bolivia","Potosí","Modesto Omiste","Villazón","ESC. SALITRE",-65.34576,-22.02467,33,1,136,169,22,15,98,120
"Bolivia","Potosí","Modesto Omiste","Villazón","ESC. SAN PEDRO DE SOCOCHA",-65.45055,-21.93332,66,2,168,234,21,5,140,161
"Bolivia","Potosí","Modesto Omiste","Villazón","ESC. SARCARI",-66.02132,-21.91025,37,3,70,107,11,3,53,64
"Bolivia","Potosí","Modesto Omiste","Villazón","ESC. SARGENTO M. PAREDES",-65.87511,-21.95138,56,1,187,243,16,4,166,182
"Bolivia","Potosí","Modesto Omiste","Villazón","ESC. SECCIONAL CHAGUA",-65.80781,-21.88188,71,1,191,262,34,9,147,181
"Bolivia","Potosí","Modesto Omiste","Villazón","ESC. SECCIONAL SELOCHA",-65.48174,-21.80499,30,2,96,126,8,2,84,92
"Bolivia","Potosí","Modesto Omiste","Villazón","ESC. SECCIONAL SOCOCHA",-65.48177,-22.00244,93,14,166,259,19,10,123,142
"Bolivia","Potosí","Modesto Omiste","Villazón","ESC. YURUMA",-65.57485,-21.69375,38,2,209,247,62,10,135,197
"Bolivia","Potosí","Modesto Omiste","Villazón","NUCLEO DE MOJO",-65.55168,-21.83154,40,2,153,193,38,8,105,143
"Bolivia","Potosí","Modesto Omiste","Villazón","U.E. CALDERILLA",-65.58203,-21.71236,0,2,74,74,6,1,65,71
"Bolivia","Potosí","Modesto Omiste","Villazón","U.E.CUARTOS",-65.56418,-21.99242,1,0,27,28,6,1,20,26
"Bolivia","Potosí","Modesto Omiste","Villazón","U.E. MANTACILLAS",-65.59058,-22.06434,10,16,249,259,67,19,147,214
"Bolivia","Potosí","Modesto Omiste","Villazón","U.E. MONSEÑOR FELIX GAINZA",-65.56264,-21.73403,4,0,81,85,15,4,62,77
"Bolivia","Potosí","Modesto Omiste","Villazón","U.E. OJO DE AGUA",-65.61392,-22.08941,0,2,53,53,5,2,44,49
"Bolivia","Potosí","Modesto Omiste","Villazón","UN. ED. 1RO DE MAYO",-65.59546,-22.09029,999,107,4246,5245,1384,208,2547,3931
"Bolivia","Potosí","Modesto Omiste","Villazón","UN. ED. ALONSO DE IBAÑEZ",-65.59546,-22.09029,1085,73,2868,3953,950,184,1661,2611
"Bolivia","Potosí","Nor Chichas","Cotagaita","COLEG. CARLOS MEDINACELI",-65.66064,-20.8168,230,38,1159,1389,468,41,612,1080
"Bolivia","Potosí","Nor Chichas","Cotagaita","U.E. 2 DE ABRIL",-65.61977,-20.49149,31,4,145,176,50,2,89,139
"Bolivia","Potosí","Nor Chichas","Cotagaita","U.E. 6 DE JUNIO",-65.55482,-20.86805,27,2,236,263,30,5,199,229
"Bolivia","Potosí","Nor Chichas","Cotagaita","U.E. ASCANTY",-65.69196,-20.93444,24,11,234,258,19,4,200,219
"Bolivia","Potosí","Nor Chichas","Cotagaita","U.E. CARLOS MEDINACELI DE TASNA ROSARIO",-66.17947,-20.67462,182,16,841,1023,236,44,545,781
"Bolivia","Potosí","Nor Chichas","Cotagaita","U.E. CERRO COLORADO",-65.41893,-20.59675,9,0,49,58,2,0,47,49
"Bolivia","Potosí","Nor Chichas","Cotagaita","U.E. CHATI",-65.63601,-20.4317,39,1,123,162,27,10,85,112
"Bolivia","Potosí","Nor Chichas","Cotagaita","U.E. CHUI CHUI",-65.4746,-20.73512,29,0,59,88,3,2,54,57
"Bolivia","Potosí","Nor Chichas","Cotagaita","U.E. COLLPA UNO",-65.56855,-20.92512,22,3,231,253,65,1,162,227
"Bolivia","Potosí","Nor Chichas","Cotagaita","U.E. CORNACA",-65.57293,-21.06026,33,1,192,225,39,4,148,187
"Bolivia","Potosí","Nor Chichas","Cotagaita","U.E. COTAGAITILLA",-65.76016,-20.80183,49,7,252,301,34,15,196,230
"Bolivia","Potosí","Nor Chichas","Cotagaita","U.E. ELIZARDO PEREZ DE SAN JORGE",-65.72311,-20.26165,39,1,74,113,7,7,59,66
"Bolivia","Potosí","Nor Chichas","Cotagaita","U.E. EL MANZANAL",-65.5703,-21.10514,15,4,75,90,12,1,58,70
"Bolivia","Potosí","Nor Chichas","Cotagaita","U.E. EL PORVENIR A DE TOTORA I",-65.7318,-20.95282,194,22,614,808,148,18,426,574
"Bolivia","Potosí","Nor Chichas","Cotagaita","U.E. EL RANCHO",-65.43662,-20.66881,10,1,66,76,9,0,56,65
"Bolivia","Potosí","Nor Chichas","Cotagaita","U.E. JOSE ALONZO DE IBAÑEZ",-66.20502,-20.73754,63,6,354,417,117,19,212,329
"Bolivia","Potosí","Nor Chichas","Cotagaita","U.E. LAYTAPI",-65.61054,-20.99541,5,4,140,145,6,3,127,133
"Bolivia","Potosí","Nor Chichas","Cotagaita","U.E. MANUEL JOSE CORTEZ",-65.66064,-20.8168,220,21,1009,1229,404,45,539,943
"Bolivia","Potosí","Nor Chichas","Cotagaita","U.E. MARISCAL SUCRE",-65.69301,-20.41956,147,10,324,471,71,4,239,310
"Bolivia","Potosí","Nor Chichas","Cotagaita","U.E. MARTIN PRIMERO DE URUPALCA",-65.85529,-20.18545,47,0,84,131,27,1,56,83
"Bolivia","Potosí","Nor Chichas","Cotagaita","U.E. MOCKO PATA",-65.833,-20.729,15,0,169,184,10,5,154,164
"Bolivia","Potosí","Nor Chichas","Cotagaita","U.E. PAMPA GRANDE I",-65.39799,-20.70718,20,2,108,128,17,0,89,106
"Bolivia","Potosí","Nor Chichas","Cotagaita","U.E. PEDRO DOMINGO MURILLO DE SAGRARIO",-66.01643,-20.90559,53,8,326,379,65,14,239,304
"Bolivia","Potosí","Nor Chichas","Cotagaita","U.E. QUECHISLA",-66.11058,-20.87414,13,1,33,46,7,2,23,30
"Bolivia","Potosí","Nor Chichas","Cotagaita","U.E. RAMADAS",-65.63293,-21.08755,21,11,147,168,30,1,105,135
"Bolivia","Potosí","Nor Chichas","Cotagaita","U.E. SAN LORENZO",-65.40493,-20.75586,20,0,83,103,6,0,77,83
"Bolivia","Potosí","Nor Chichas","Cotagaita","U.E. SAN PEDRO DE CHECOCHI",-65.83663,-20.22395,43,1,102,145,31,4,66,97
"Bolivia","Potosí","Nor Chichas","Cotagaita","U.E. SANTIAGO WRIGHT",-65.70607,-20.62816,64,10,359,423,65,29,255,320
"Bolivia","Potosí","Nor Chichas","Cotagaita","U.E. SIMON BOLIVAR A DE TOROPALCA",-65.728,-20.329,228,28,555,783,119,16,392,511
"Bolivia","Potosí","Nor Chichas","Cotagaita","U.E. TAPCHIQUIRA",-65.79283,-20.41512,27,2,98,125,15,7,74,89
"Bolivia","Potosí","Nor Chichas","Cotagaita","U.E. TUPAC KATARI",-65.67236,-20.91708,87,6,194,281,20,3,165,185
"Bolivia","Potosí","Nor Chichas","Cotagaita","U.E. VILLA CONCEPCION",-65.567,-20.968,64,0,119,183,5,2,112,117
"Bolivia","Potosí","Nor Chichas","Cotagaita","U.E. VILLA IMPERIAL DE VICHACLA",-65.59898,-20.63377,40,9,208,248,34,15,150,184
"Bolivia","Potosí","Nor Chichas","Cotagaita","U.E. VILLA SAN LORENZO",-65.81915,-21.01485,46,1,195,241,8,2,184,192
"Bolivia","Potosí","Nor Chichas","Vitichi","U.E. ARA",-65.49908,-20.52345,84,10,223,307,70,10,133,203
"Bolivia","Potosí","Nor Chichas","Vitichi","U.E. AYOMA BAJA",-65.34461,-20.14421,65,7,180,245,17,4,152,169
"Bolivia","Potosí","Nor Chichas","Vitichi","U.E. CALCHA",-65.4649,-20.36904,180,45,415,595,119,25,226,345
"Bolivia","Potosí","Nor Chichas","Vitichi","U.E. ESTUMILLA",-65.40064,-20.5226,29,3,158,187,23,3,129,152
"Bolivia","Potosí","Nor Chichas","Vitichi","U.E. FRAY ANGELLO STELLINI DE CALVI",-65.35645,-20.34421,105,19,278,383,34,6,219,253
"Bolivia","Potosí","Nor Chichas","Vitichi","U.E. JUAN PELLEGRINI",-65.38126,-20.24069,177,38,508,685,86,7,377,463
"Bolivia","Potosí","Nor Chichas","Vitichi","U.E. MANUEL MORA DE PECKAJSI",-65.388,-20.354,85,0,256,341,20,11,225,245
"Bolivia","Potosí","Nor Chichas","Vitichi","U.E. PRIMO MARTINEZ",-65.49222,-20.55351,19,2,117,136,52,3,60,112
"Bolivia","Potosí","Nor Chichas","Vitichi","U.E. PULAXI",-65.51803,-20.55417,14,2,32,46,13,2,15,28
"Bolivia","Potosí","Nor Chichas","Vitichi","U.E. SAN MIGUEL DE TUSQUIÑA",-65.32579,-20.28519,72,9,483,555,95,7,372,467
"Bolivia","Potosí","Nor Chichas","Vitichi","U.E. TOMAS FRIAS",-65.49218,-20.20666,343,60,904,1247,348,34,462,810
"Bolivia","Potosí","Nor Lípez","Colcha K (Villa Martín)","ESC. ANTOFAGASTA",-67.76271,-20.89953,44,6,213,257,108,5,94,202
"Bolivia","Potosí","Nor Lípez","Colcha K (Villa Martín)","ESC. SANTIAGO",-67.1608,-21.64687,27,6,121,148,64,8,43,107
"Bolivia","Potosí","Nor Lípez","Colcha K (Villa Martín)","ESC. TOMAS FRIAS",-67.68085,-20.58681,3,0,93,96,40,0,53,93
"Bolivia","Potosí","Nor Lípez","Colcha K (Villa Martín)","U.E. 2 DE AGOSTO",-67.9187,-21.21596,27,6,195,222,84,7,98,182
"Bolivia","Potosí","Nor Lípez","Colcha K (Villa Martín)","U.E. ALFONZO IBAÑES",-67.70047,-20.62012,10,0,56,66,13,1,42,55
"Bolivia","Potosí","Nor Lípez","Colcha K (Villa Martín)","U.E. ANTOFAGASTA",-67.34248,-21.83394,35,2,241,276,107,5,127,234
"Bolivia","Potosí","Nor Lípez","Colcha K (Villa Martín)","U.E. BUENAS NUEVAS DE VINTO K",-67.02643,-20.68222,24,5,218,242,62,5,146,208
"Bolivia","Potosí","Nor Lípez","Colcha K (Villa Martín)","U.E. EDUARDO ABAROA",-67.66145,-20.73985,271,10,797,1068,329,25,433,762
"Bolivia","Potosí","Nor Lípez","Colcha K (Villa Martín)","U.E. EDUARDO ABAROA",-67.22194,-21.25105,271,10,797,1068,329,25,433,762
"Bolivia","Potosí","Nor Lípez","Colcha K (Villa Martín)","U.E. EDUARDO ABAROA DE VILLA MAR",-67.48146,-21.75496,42,12,182,224,64,4,102,166
"Bolivia","Potosí","Nor Lípez","Colcha K (Villa Martín)","U.E. HENRY LAREDO",-67.56828,-20.91416,11,0,38,49,17,0,21,38
"Bolivia","Potosí","Nor Lípez","Colcha K (Villa Martín)","U.E. JOSE BALLIVIAN",-66.3466,-18.14842,20,2,213,233,59,1,151,210
"Bolivia","Potosí","Nor Lípez","Colcha K (Villa Martín)","U.E. JUANA AZURDUY",-67.6095,-20.59178,2,3,33,35,15,1,14,29
"Bolivia","Potosí","Nor Lípez","Colcha K (Villa Martín)","U.E. LADISLAO CABRERA",-66.54451,-21.06077,30,2,122,152,25,8,87,112
"Bolivia","Potosí","Nor Lípez","Colcha K (Villa Martín)","U.E. LITORAL",-67.53351,-21.04118,38,0,96,134,33,2,61,94
"Bolivia","Potosí","Nor Lípez","Colcha K (Villa Martín)","U.E. LUIS ESPINAL",-67.63012,-20.57336,0,0,57,57,7,1,49,56
"Bolivia","Potosí","Nor Lípez","Colcha K (Villa Martín)","U.E. NUEVO AMANECER",-67.29654,-20.82078,88,6,354,442,141,6,201,342
"Bolivia","Potosí","Nor Lípez","Colcha K (Villa Martín)","U.E. RICARDO RODRIGUEZ",-67.17109,-21.16474,223,23,1485,1708,468,50,944,1412
"Bolivia","Potosí","Nor Lípez","Colcha K (Villa Martín)","U.E. SIMON BOLIVAR",-66.56165,-21.23029,50,4,208,258,58,13,133,191
"Bolivia","Potosí","Nor Lípez","Colcha K (Villa Martín)","U.E. TOMAS FRIAS",-66.79474,-21.20591,36,2,196,232,55,10,129,184
"Bolivia","Potosí","Nor Lípez","San Pedro de Quemes","U.E. CECILIO VELIZ",-68.04866,-20.74629,55,2,227,282,93,1,131,224
"Bolivia","Potosí","Nor Lípez","San Pedro de Quemes","U.E. CORNELIO SAAVEDRA",-68.03695,-20.94468,20,1,42,62,8,0,33,41
"Bolivia","Potosí","Nor Lípez","San Pedro de Quemes","U.E. EDUARDO ABAROA",-68.21673,-21.19829,1,0,12,13,3,0,9,12
"Bolivia","Potosí","Nor Lípez","San Pedro de Quemes","U.E.LADISLAO CABRERA",-68.34213,-21.01003,5,0,25,30,20,0,5,25
"Bolivia","Potosí","Rafael Bustillo","Chayanta","ESC. COCAFAYA",-66.37881,-18.50657,34,5,344,378,62,10,267,329
"Bolivia","Potosí","Rafael Bustillo","Chayanta","ESC. COPANA",-66.35302,-18.23664,16,27,352,368,34,13,278,312
"Bolivia","Potosí","Rafael Bustillo","Chayanta","ESC. MANCO CAPAC",-66.30493,-18.52878,23,22,329,352,40,9,258,298
"Bolivia","Potosí","Rafael Bustillo","Chayanta","ESC. MCAL. SANTA CRUZ",-66.44352,-18.46028,263,67,1688,1951,664,77,880,1544
"Bolivia","Potosí","Rafael Bustillo","Chayanta","ESC. OCTAVIO MURILLO",-66.38741,-18.48727,53,36,750,803,282,36,396,678
"Bolivia","Potosí","Rafael Bustillo","Chayanta","ESC. PHUSUTA PAMPA",-66.23933,-18.47786,13,7,120,133,13,11,89,102
"Bolivia","Potosí","Rafael Bustillo","Chayanta","ESC. PICHATA",-66.39987,-18.40766,30,0,284,314,24,7,253,277
"Bolivia","Potosí","Rafael Bustillo","Chayanta","ESC. QUINTA PAMPA",-66.32737,-18.23514,55,8,327,382,15,13,291,306
"Bolivia","Potosí","Rafael Bustillo","Chayanta","ESC. RAFAEL PABON",-66.46142,-18.44868,68,20,486,554,169,34,263,432
"Bolivia","Potosí","Rafael Bustillo","Chayanta","NUCLEO ESCOLAR",-66.28407,-18.42465,61,28,231,292,92,14,97,189
"Bolivia","Potosí","Rafael Bustillo","Chayanta","NUCLEO ESCOLAR IRUPATA",-66.37756,-18.29441,166,66,924,1090,117,43,698,815
"Bolivia","Potosí","Rafael Bustillo","Chayanta","NUCLEO ESCOLAR NUEVA COLCHA",-66.26283,-18.54489,43,0,277,320,13,12,252,265
"Bolivia","Potosí","Rafael Bustillo","Chayanta","NUCLEO ESCOLAR RIO VERDE (QUILA QUILA)",-66.30909,-18.37211,19,8,187,206,70,4,105,175
"Bolivia","Potosí","Rafael Bustillo","Chuquihuta","COL. PABLO ZARATE VILLCA",-66.36883,-18.59564,286,101,1568,1854,526,127,814,1340
"Bolivia","Potosí","Rafael Bustillo","Chuquihuta","ESC. LULUNI",-66.41494,-18.66807,41,59,284,325,40,17,168,208
"Bolivia","Potosí","Rafael Bustillo","Chuquihuta","ESC. TACOPALCA",-66.33701,-18.641,222,52,923,1145,240,103,528,768
"Bolivia","Potosí","Rafael Bustillo","Llallagua","COLEG. 1RO. DE MAYO",-66.58627,-18.42284,553,104,3722,4275,1973,182,1463,3436
"Bolivia","Potosí","Rafael Bustillo","Llallagua","COLEG. JUNIN",-66.58627,-18.42284,342,69,2250,2592,986,166,1029,2015
"Bolivia","Potosí","Rafael Bustillo","Llallagua","COLEG. SIGLO XX-AMERICA",-66.58627,-18.42284,562,67,3368,3930,1690,164,1447,3137
"Bolivia","Potosí","Rafael Bustillo","Llallagua","ESC. 6 DE JUNIO",-66.58627,-18.42284,227,47,1161,1388,537,83,494,1031
"Bolivia","Potosí","Rafael Bustillo","Llallagua","ESC. BARTOLINA SISA",-66.66508,-18.34604,50,34,503,553,130,37,302,432
"Bolivia","Potosí","Rafael Bustillo","Llallagua","ESC. CAPUNITA",-66.48626,-18.40959,47,6,279,326,67,16,190,257
"Bolivia","Potosí","Rafael Bustillo","Llallagua","ESC. CARLOS MEDINACELI",-66.58627,-18.42284,279,53,2121,2400,1133,106,829,1962
"Bolivia","Potosí","Rafael Bustillo","Llallagua","ESC. CHIRU CHIRU",-66.43234,-18.28475,14,3,207,221,21,9,174,195
"Bolivia","Potosí","Rafael Bustillo","Llallagua","ESC. JAIME MENDOZA",-66.58627,-18.42284,401,65,3191,3592,1809,148,1169,2978
"Bolivia","Potosí","Rafael Bustillo","Llallagua","ESC. UYUNI",-66.82401,-20.45792,24,0,318,342,16,37,265,281
"Bolivia","Potosí","Rafael Bustillo","Llallagua","HUMANISTICO LLALLAGUA",-66.58627,-18.42284,422,73,2559,2981,1343,152,991,2334
"Bolivia","Potosí","Rafael Bustillo","Llallagua","MARTIN CARDENAS",-66.58627,-18.42284,358,96,2566,2924,1036,215,1219,2255
"Bolivia","Potosí","Rafael Bustillo","Llallagua","NUCLEO JISK'ANQUI",-66.55359,-18.32512,20,21,253,273,106,11,115,221
"Bolivia","Potosí","Rafael Bustillo","Uncía","CÁRCEL SAN MIGUEL DE UNCÍA",-66.56538,-18.46565,7,1,29,36,15,0,13,28
"Bolivia","Potosí","Rafael Bustillo","Uncía","CHILCA PALCA",-66.48528,-18.62824,82,33,384,466,93,49,209,302
"Bolivia","Potosí","Rafael Bustillo","Uncía","COLEG. RAFAEL BUSTILLO",-66.56538,-18.46565,466,77,2251,2717,1085,97,992,2077
"Bolivia","Potosí","Rafael Bustillo","Uncía","COL. INTERMEDIO INDEPENDENCIA",-66.56538,-18.46565,276,72,1938,2214,1068,136,662,1730
"Bolivia","Potosí","Rafael Bustillo","Uncía","ESC. CHOCO CHICO",-66.56693,-18.66152,17,7,91,108,57,5,22,79
"Bolivia","Potosí","Rafael Bustillo","Uncía","ESC. HUACUTA A",-66.57107,-18.59737,20,10,123,143,62,5,46,108
"Bolivia","Potosí","Rafael Bustillo","Uncía","ESC. JUANA AZURDUY DE PADILLA",-66.56538,-18.46565,272,60,1759,2031,826,94,779,1605
"Bolivia","Potosí","Rafael Bustillo","Uncía","ESC. MODESTO OMISTE",-66.56538,-18.46565,162,35,1160,1322,707,45,373,1080
"Bolivia","Potosí","Rafael Bustillo","Uncía","ESC. MOROCOMARCA",-66.529,-18.674,116,29,334,450,80,28,197,277
"Bolivia","Potosí","Rafael Bustillo","Uncía","ESC. SUBCENTRAL LAGUNILLAS",-66.41483,-18.5441,46,18,337,383,57,19,243,300
"Bolivia","Potosí","Rafael Bustillo","Uncía","NUCLEO ESCOLAR CALA CALA",-66.48356,-18.52519,109,35,991,1100,173,48,735,908
"Bolivia","Potosí","Sur Chichas","Atocha","COL. CHOROLQUE",-66.0516,-20.92446,145,28,1092,1237,316,50,698,1014
"Bolivia","Potosí","Sur Chichas","Atocha","COLEG. GREGORIO PACHECO",-66.22056,-20.93593,181,20,751,932,293,33,405,698
"Bolivia","Potosí","Sur Chichas","Atocha","ESC. CHOCAYA",-66.3306,-20.97412,14,1,72,86,10,4,57,67
"Bolivia","Potosí","Sur Chichas","Atocha","ESC. CHOROLQUE VIEJO",-66.06475,-21.01707,4,0,12,16,2,0,10,12
"Bolivia","Potosí","Sur Chichas","Atocha","ESC. DE ANIMAS",-66.30733,-20.96173,83,20,677,760,312,15,330,642
"Bolivia","Potosí","Sur Chichas","Atocha","ESC. DE SIETE SUYOS",-66.29662,-20.9496,91,16,527,618,176,23,312,488
"Bolivia","Potosí","Sur Chichas","Atocha","ESC. DE TACMARI",-66.06282,-21.08223,0,0,21,21,3,1,17,20
"Bolivia","Potosí","Sur Chichas","Atocha","ESC. EDUARDO AVAROA",-66.22056,-20.93593,123,20,606,729,213,35,338,551
"Bolivia","Potosí","Sur Chichas","Atocha","ESC. GUADALUPE",-65.79517,-18.69062,17,0,46,63,9,3,34,43
"Bolivia","Potosí","Sur Chichas","Atocha","ESC. JULIO URQUIETA",-66.31551,-21.26756,94,12,473,567,137,26,298,435
"Bolivia","Potosí","Sur Chichas","Atocha","ESC. PORTUGALETE",-66.14603,-21.16817,50,8,310,360,74,13,215,289
"Bolivia","Potosí","Sur Chichas","Atocha","UNIDAD EDUCATIVA TELAMAYU",-66.22509,-20.94718,84,5,369,453,122,13,229,351
"Bolivia","Potosí","Sur Chichas","Tupiza","CÁRCEL TUPIZA",-65.72643,-21.4452,1,0,27,28,11,0,16,27
"Bolivia","Potosí","Sur Chichas","Tupiza","COLEGIO ANTOFAGASTA",-65.72643,-21.4452,364,38,1879,2243,788,83,970,1758
"Bolivia","Potosí","Sur Chichas","Tupiza","COL. NAL. MIXTO CHICHAS",-65.6029,-21.18405,22,6,107,129,9,5,87,96
"Bolivia","Potosí","Sur Chichas","Tupiza","EL MOLINO",-65.49464,-21.74079,13,0,58,71,11,1,46,57
"Bolivia","Potosí","Sur Chichas","Tupiza","ESC. CHACO PAMPA",-65.77544,-21.51714,69,7,283,352,46,10,220,266
"Bolivia","Potosí","Sur Chichas","Tupiza","ESC. CHIFLOCA",-65.79998,-21.48615,13,3,95,108,36,5,51,87
"Bolivia","Potosí","Sur Chichas","Tupiza","ESC. CHILLCO",-66.10437,-21.40515,28,4,104,132,29,8,63,92
"Bolivia","Potosí","Sur Chichas","Tupiza","ESC. CHUQUI",-66.17671,-21.72463,12,1,42,54,3,2,36,39
"Bolivia","Potosí","Sur Chichas","Tupiza","ESC. CHUQUIAGO",-65.64294,-21.56561,60,9,225,285,37,9,170,207
"Bolivia","Potosí","Sur Chichas","Tupiza","ESC. CONCEPCION",-66.12894,-21.69586,2,0,12,14,1,0,11,12
"Bolivia","Potosí","Sur Chichas","Tupiza","ESC. DE ALMONA",-65.78484,-21.17253,23,10,118,141,21,2,85,106
"Bolivia","Potosí","Sur Chichas","Tupiza","ESC. DE MOCHARA",-65.59682,-21.27156,25,5,218,243,14,5,194,208
"Bolivia","Potosí","Sur Chichas","Tupiza","ESC. DE OPLOCA",-65.80829,-21.33162,68,17,365,433,94,32,222,316
"Bolivia","Potosí","Sur Chichas","Tupiza","ESC. DE RIO BLANCO",-65.59937,-21.14781,33,0,125,158,10,6,109,119
"Bolivia","Potosí","Sur Chichas","Tupiza","ESC. DE SALO",-65.78109,-21.24509,32,7,183,215,28,4,144,172
"Bolivia","Potosí","Sur Chichas","Tupiza","ESC. DE SAN MIGUEL",-65.75484,-21.3053,28,1,121,149,21,7,92,113
"Bolivia","Potosí","Sur Chichas","Tupiza","ESC. ESMORACA",-66.22615,-21.6957,20,6,202,222,64,5,127,191
"Bolivia","Potosí","Sur Chichas","Tupiza","ESC. ESPICAYA",-65.79379,-21.58842,32,2,165,197,32,7,124,156
"Bolivia","Potosí","Sur Chichas","Tupiza","ESC. ESTARCA",-65.95553,-21.66106,22,0,138,160,21,1,116,137
"Bolivia","Potosí","Sur Chichas","Tupiza","ESC. HUARIRACA",-65.98829,-21.71672,5,1,33,38,5,0,27,32
"Bolivia","Potosí","Sur Chichas","Tupiza","ESC. KUCHU",-66.01013,-21.51916,11,1,54,65,11,1,41,52
"Bolivia","Potosí","Sur Chichas","Tupiza","ESC. MIXTA 7 DE NOVIEMBRE",-65.72643,-21.4452,415,23,2101,2516,1080,80,918,1998
"Bolivia","Potosí","Sur Chichas","Tupiza","ESC. NAZARENO",-65.58674,-21.60765,50,15,251,301,40,11,185,225
"Bolivia","Potosí","Sur Chichas","Tupiza","ESC. ORO INGENIO",-65.96437,-21.31153,13,1,44,57,7,5,31,38
"Bolivia","Potosí","Sur Chichas","Tupiza","ESC. REYNECILLA",-65.2538,-21.58071,45,0,113,158,19,4,90,109
"Bolivia","Potosí","Sur Chichas","Tupiza","ESC. SAN JOSE PAMPA GRANDE",-65.81684,-21.67879,52,15,178,230,14,7,142,156
"Bolivia","Potosí","Sur Chichas","Tupiza","ESC. SANTO DOMINCO",-66.10701,-21.56706,8,0,19,27,2,0,17,19
"Bolivia","Potosí","Sur Chichas","Tupiza","ESC. SECCIONAL",-65.30436,-21.69688,31,1,128,159,18,8,101,119
"Bolivia","Potosí","Sur Chichas","Tupiza","ESC. SUIPACHA",-65.60592,-21.57154,178,29,560,738,155,37,339,494
"Bolivia","Potosí","Sur Chichas","Tupiza","ESC. SUPIRA",-65.52016,-21.59575,31,6,148,179,40,15,87,127
"Bolivia","Potosí","Sur Chichas","Tupiza","ESC. TALINA",-65.82471,-21.74855,47,8,129,176,10,2,109,119
"Bolivia","Potosí","Sur Chichas","Tupiza","ESC. TAPAXA",-65.9848,-21.61774,15,4,96,111,13,5,74,87
"Bolivia","Potosí","Sur Chichas","Tupiza","ESC. TITIHOYO",-65.75745,-21.5398,8,1,78,86,10,6,61,71
"Bolivia","Potosí","Sur Chichas","Tupiza","ESC. TOCLOCA",-65.68027,-21.51474,74,11,285,359,57,10,207,264
"Bolivia","Potosí","Sur Chichas","Tupiza","ESC. VILLA FATIMA ANDRES DE SANTA CRUZ",-65.72643,-21.4452,330,63,1990,2320,775,115,1037,1812
"Bolivia","Potosí","Sur Chichas","Tupiza","ESC. ZAPATERA",-66.18834,-21.62791,5,0,33,38,9,0,24,33
"Bolivia","Potosí","Sur Chichas","Tupiza","INSTITUTO SAN JUAN",-65.72643,-21.4452,468,37,2402,2870,1277,102,986,2263
"Bolivia","Potosí","Sur Chichas","Tupiza","KINDER REMEDIOS",-65.72643,-21.4452,738,87,3803,4541,1206,200,2310,3516
"Bolivia","Potosí","Sur Chichas","Tupiza","NUCLEO ESCOLAR QUIRIZA",-65.79105,-21.61311,45,10,223,268,28,2,183,211
"Bolivia","Potosí","Sur Chichas","Tupiza","U.E. G. BERRIOS",-65.72643,-21.4452,22,5,137,159,39,5,88,127
"Bolivia","Potosí","Sur Chichas","Tupiza","U.E. NACIONAL 6 DE JUNIO",-65.58966,-21.57787,19,13,280,299,70,33,164,234
"Bolivia","Potosí","Sur Chichas","Tupiza","U.E. P. HARRIS",-65.72643,-21.4452,16,7,157,173,37,15,98,135
"Bolivia","Potosí","Sur Chichas","Tupiza","U.E. TOMATAS",-65.63572,-21.54967,11,4,115,126,20,13,78,98
"Bolivia","Potosí","Sur Chichas","Tupiza","UNIDAD EDUCATIVA RITA ROMANO",-65.72643,-21.4452,296,40,1575,1871,586,98,851,1437
"Bolivia","Potosí","Sur Chichas","Tupiza","UNIDAD EDUCATIVA TUPIZA B",-65.72643,-21.4452,337,30,1464,1801,493,78,863,1356
"Bolivia","Potosí","Sur Chichas","Tupiza","VETERINARIA SUB SEDE UATF",-65.72643,-21.4452,199,29,1070,1269,460,53,528,988
"Bolivia","Potosí","Sur Lípez","Mojinete","ESC. BONETE PALCA",-66.394,-21.788,0,0,13,13,1,0,12,13
"Bolivia","Potosí","Sur Lípez","Mojinete","ESC. CASA GRANDE",-66.27042,-21.93487,14,4,64,78,3,3,54,57
"Bolivia","Potosí","Sur Lípez","Mojinete","ESC. LA CIENEGA",-66.33878,-21.79782,7,0,24,31,2,1,21,23
"Bolivia","Potosí","Sur Lípez","Mojinete","ESC. PUEBLO VIEJO",-66.28301,-21.84269,2,0,20,22,1,0,19,20
"Bolivia","Potosí","Sur Lípez","Mojinete","H. ALCALDIA MUNICIPAL",-66.23934,-21.76464,24,2,97,121,12,2,81,93
"Bolivia","Potosí","Sur Lípez","San Antonio de Esmoruco","ESC. 10 DE NOVIEMBRE",-66.51337,-21.84954,20,0,73,93,12,0,61,73
"Bolivia","Potosí","Sur Lípez","San Antonio de Esmoruco","ESC. ANTOFAGASTA",-66.41882,-22.10488,34,6,112,146,31,3,72,103
"Bolivia","Potosí","Sur Lípez","San Antonio de Esmoruco","ESC. CENTRAL CALAMA",-66.51688,-21.9479,55,7,252,307,56,9,180,236
"Bolivia","Potosí","Sur Lípez","San Antonio de Esmoruco","ESC. DE RIO SECO",-66.33189,-21.99798,4,1,76,80,14,2,59,73
"Bolivia","Potosí","Sur Lípez","San Antonio de Esmoruco","ESC. OCKE ORCKO",-66.31582,-21.96951,7,2,48,55,6,0,40,46
"Bolivia","Potosí","Sur Lípez","San Antonio de Esmoruco","ESC. RANCHO CHILENO",-66.79728,-22.40032,9,0,29,38,8,0,21,29
"Bolivia","Potosí","Sur Lípez","San Pablo de Lípez","ESC. EDUARDO AVAROA",-67.35746,-22.22936,3,8,53,56,28,5,12,40
"Bolivia","Potosí","Sur Lípez","San Pablo de Lípez","ESC. KOLLPANI",-66.91783,-22.03759,6,0,51,57,7,3,41,48
"Bolivia","Potosí","Sur Lípez","San Pablo de Lípez","ESC. QUETENA CHICO",-67.34043,-22.1941,18,4,223,241,104,3,112,216
"Bolivia","Potosí","Sur Lípez","San Pablo de Lípez","ESC. RELAVE",-66.79867,-21.76142,15,1,45,60,16,4,24,40
"Bolivia","Potosí","Sur Lípez","San Pablo de Lípez","ESC. SANTA ISABEL",-66.45042,-21.64084,19,0,30,49,1,0,29,30
"Bolivia","Potosí","Sur Lípez","San Pablo de Lípez","ESC. SECCIONAL RIO SAN PABLO",-66.76449,-21.60779,12,3,89,101,23,2,61,84
"Bolivia","Potosí","Sur Lípez","San Pablo de Lípez","ESC. SECCIONAL VILUYO",-66.35195,-21.53281,16,0,83,99,5,3,75,80
"Bolivia","Potosí","Sur Lípez","San Pablo de Lípez","ESC. VILLA PORVENIR",-66.88214,-21.87592,23,3,111,134,37,9,62,99
"Bolivia","Potosí","Sur Lípez","San Pablo de Lípez","SALON DE COMUNIDAD",-66.48465,-21.41609,3,3,91,94,26,3,59,85
"Bolivia","Potosí","Sur Lípez","San Pablo de Lípez","SALON DE PLAZA",-66.67158,-21.50187,27,4,126,153,38,13,71,109
"Bolivia","Potosí","Sur Lípez","San Pablo de Lípez","U.E. COLORADOS DE BOLIVIA",-66.61893,-21.68718,12,0,70,82,23,7,40,63
"Bolivia","Potosí","Tomás Frías","Potosí","(CÁRCEL) PENAL DE CANTUMARCA",-65.78258,-19.59936,39,1,106,145,70,4,31,101
"Bolivia","Potosí","Tomás Frías","Potosí","CENTRO ED. FRAY VICENTE BERNEDO",-65.749,-19.58,551,40,4272,4823,3555,124,553,4108
"Bolivia","Potosí","Tomás Frías","Potosí","COL. 31 DE OCTUBRE",-65.7597,-19.58211,181,3,1186,1367,1006,30,147,1153
"Bolivia","Potosí","Tomás Frías","Potosí","COL. ANICETO ARCE",-65.75697,-19.58251,113,4,841,954,719,21,97,816
"Bolivia","Potosí","Tomás Frías","Potosí","COL. CARLOS MEDINACELI",-65.75753,-19.58196,96,3,731,827,641,9,78,719
"Bolivia","Potosí","Tomás Frías","Potosí","COL. DIVINO MAESTRO",-65.77073,-19.56213,348,7,2512,2860,2122,54,329,2451
"Bolivia","Potosí","Tomás Frías","Potosí","COLEG. ANTOFAGASTA",-65.74934,-19.59519,368,17,2803,3171,2396,54,336,2732
"Bolivia","Potosí","Tomás Frías","Potosí","COLEG. BANCARIO",-65.7532,-19.5843,131,3,1009,1140,910,9,87,997
"Bolivia","Potosí","Tomás Frías","Potosí","COLEG. CRISTO MAESTRO",-65.753,-19.583,63,1,548,611,497,4,46,543
"Bolivia","Potosí","Tomás Frías","Potosí","COLEG. DAVID BERRIOS",-65.76199,-19.58034,223,4,1576,1799,1323,42,207,1530
"Bolivia","Potosí","Tomás Frías","Potosí","COLEG. DON BOSCO",-65.75298,-19.58537,129,0,985,1114,887,10,88,975
"Bolivia","Potosí","Tomás Frías","Potosí","COLEGIO FRANCISCANO",-65.75263,-19.59103,94,2,927,1021,851,6,68,919
"Bolivia","Potosí","Tomás Frías","Potosí","COLEG. LUIS ESPINAL",-65.74538,-19.59578,525,34,3280,3805,2729,106,411,3140
"Bolivia","Potosí","Tomás Frías","Potosí","COLEG. SAN RAFAEL",-65.59398,-19.45205,99,17,822,921,503,89,213,716
"Bolivia","Potosí","Tomás Frías","Potosí","ESC. 12 DE ABRIL",-65.7491,-19.59479,119,5,898,1017,739,33,121,860
"Bolivia","Potosí","Tomás Frías","Potosí","ESC. 1RO DE ABRIL",-65.75495,-19.58885,61,2,526,587,456,9,59,515
"Bolivia","Potosí","Tomás Frías","Potosí","ESC. 6 DE JUNIO",-65.77945,-19.58491,182,25,1695,1877,1122,88,460,1582
"Bolivia","Potosí","Tomás Frías","Potosí","ESC. ANTONIO QUIJARRO",-65.75183,-19.59038,73,0,552,625,505,6,41,546
"Bolivia","Potosí","Tomás Frías","Potosí","ESC. BENICIO MONTERO MALLO",-65.74702,-19.59106,221,7,1868,2089,1631,42,188,1819
"Bolivia","Potosí","Tomás Frías","Potosí","ESC. BOLIVIANO ALEMÁN",-65.771,-19.583,155,20,1233,1388,1012,37,164,1176
"Bolivia","Potosí","Tomás Frías","Potosí","ESC. CLETO LOAYZA",-65.75833,-19.59216,352,27,2543,2895,2186,56,274,2460
"Bolivia","Potosí","Tomás Frías","Potosí","ESC. COBIJA",-65.75887,-19.57669,465,17,3334,3799,2826,73,418,3244
"Bolivia","Potosí","Tomás Frías","Potosí","ESC. COPACABANA",-65.75468,-19.59232,282,10,2160,2442,1905,52,193,2098
"Bolivia","Potosí","Tomás Frías","Potosí","ESC. DANIEL CAMPOS",-65.75119,-19.57934,792,30,4956,5748,4150,132,644,4794
"Bolivia","Potosí","Tomás Frías","Potosí","ESC. ENRIQUE VIANA",-65.75941,-19.57416,487,23,3819,4306,3238,81,477,3715
"Bolivia","Potosí","Tomás Frías","Potosí","ESC. GERMAN BUSCH",-65.76686,-19.59209,332,27,2128,2460,1676,100,325,2001
"Bolivia","Potosí","Tomás Frías","Potosí","ESC. GREGORIO BARRIGA",-65.75343,-19.58554,58,1,383,441,344,3,35,379
"Bolivia","Potosí","Tomás Frías","Potosí","ESC. GUALBERTO VILLARROEL",-65.75404,-19.59555,282,19,2176,2458,1756,77,324,2080
"Bolivia","Potosí","Tomás Frías","Potosí","ESC. JAIME MENDOZA",-65.744,-19.60323,201,21,1240,1441,981,41,197,1178
"Bolivia","Potosí","Tomás Frías","Potosí","ESC. JESUS DE NAZARET",-65.77232,-19.56954,321,28,2478,2799,1917,83,450,2367
"Bolivia","Potosí","Tomás Frías","Potosí","ESC. JOSE A.ZAMPA",-65.75164,-19.58199,175,9,725,900,613,18,85,698
"Bolivia","Potosí","Tomás Frías","Potosí","ESC. JOSE MARIA LINARES",-65.74564,-19.59069,225,10,1835,2060,1593,46,186,1779
"Bolivia","Potosí","Tomás Frías","Potosí","ESC. KARACHIPAMPA",-65.72121,-19.55614,98,6,576,674,402,46,122,524
"Bolivia","Potosí","Tomás Frías","Potosí","ESC. KENNY PRIETO MELGAREJO",-65.756,-19.561,443,43,3315,3758,2636,101,535,3171
"Bolivia","Potosí","Tomás Frías","Potosí","ESC. LITORAL",-65.75475,-19.58171,329,5,2262,2591,1948,37,272,2220
"Bolivia","Potosí","Tomás Frías","Potosí","ESC.L.SUBIETA SAGARNAGA",-65.74593,-19.59545,287,16,1934,2221,1405,81,432,1837
"Bolivia","Potosí","Tomás Frías","Potosí","ESC. MANQUIRI",-65.713,-19.422,42,6,191,233,126,21,38,164
"Bolivia","Potosí","Tomás Frías","Potosí","ESC. MARTIN CRUZ",-65.63708,-19.4641,47,18,411,458,227,13,153,380
"Bolivia","Potosí","Tomás Frías","Potosí","ESC. MODESTO OMISTE",-65.75407,-19.5905,80,1,498,578,428,9,60,488
"Bolivia","Potosí","Tomás Frías","Potosí","ESC. OCKORURO",-65.68793,-19.34093,39,14,148,187,84,12,38,122
"Bolivia","Potosí","Tomás Frías","Potosí","ESC. PARANTACA",-65.67346,-19.41582,14,2,126,140,91,2,31,122
"Bolivia","Potosí","Tomás Frías","Potosí","ESC. PARANTURI",-65.84405,-19.38804,8,5,86,94,55,8,18,73
"Bolivia","Potosí","Tomás Frías","Potosí","ESC. SALVADOR REVILLA",-65.75059,-19.58397,99,3,1074,1173,953,16,102,1055
"Bolivia","Potosí","Tomás Frías","Potosí","ESC. SAN JOSE",-65.75632,-19.58005,167,2,1693,1860,1478,35,178,1656
"Bolivia","Potosí","Tomás Frías","Potosí","ESC. SIMON RODRIGUEZ",-65.75714,-19.58396,172,5,1428,1600,1227,28,168,1395
"Bolivia","Potosí","Tomás Frías","Potosí","ESC. TARAPAYA",-65.79939,-19.47568,23,2,220,243,144,29,45,189
"Bolivia","Potosí","Tomás Frías","Potosí","ESC. TOMAS FRIAS",-65.78917,-19.42753,2,0,105,107,82,0,23,105
"Bolivia","Potosí","Tomás Frías","Potosí","ESC. TOPATER",-65.76611,-19.57706,524,19,3624,4148,3119,89,397,3516
"Bolivia","Potosí","Tomás Frías","Potosí","ESCUELA JOSÉ ALONSO DE IBÁÑEZ",-65.75143,-19.58758,191,4,1307,1498,1167,22,114,1281
"Bolivia","Potosí","Tomás Frías","Potosí","FE Y ALEGRIA Y SAN CLEMENTE",-65.76543,-19.57224,481,21,4159,4640,3662,81,395,4057
"Bolivia","Potosí","Tomás Frías","Potosí","INSTITUTO I.S.E.C.",-65.76514,-19.57146,109,3,1199,1308,1062,19,115,1177
"Bolivia","Potosí","Tomás Frías","Potosí","INSTITUTO SAN JUAN",-65.75861,-19.59069,116,7,1018,1134,866,30,115,981
"Bolivia","Potosí","Tomás Frías","Potosí","KINDER CONCEPCION",-65.747,-19.59719,207,14,1372,1579,1117,43,198,1315
"Bolivia","Potosí","Tomás Frías","Potosí","KINDER ISMAEL MONTES",-65.74657,-19.58614,448,37,3719,4167,3177,82,423,3600
"Bolivia","Potosí","Tomás Frías","Potosí","LIC. SUCRE",-65.7513,-19.58862,226,9,1737,1963,1560,19,149,1709
"Bolivia","Potosí","Tomás Frías","Potosí","MARISCAL SANTA CRUZ",-65.75602,-19.57199,599,43,4278,4877,3492,139,604,4096
"Bolivia","Potosí","Tomás Frías","Potosí","UE 31 DE OCTUBRE",-65.76176,-19.58175,458,27,3685,4143,3094,76,488,3582
"Bolivia","Potosí","Tomás Frías","Potosí","U.E. ANTONIO JOSE DE SUCRE",-65.75098,-19.57251,500,36,3678,4178,2914,151,577,3491
"Bolivia","Potosí","Tomás Frías","Potosí","U.E. CECILIO GUZMAN ROJAS",-65.75775,-19.56903,22,2,192,214,155,8,27,182
"Bolivia","Potosí","Tomás Frías","Potosí","U.E. DON BOSCO B",-65.76209,-19.59194,27,6,257,284,200,7,44,244
"Bolivia","Potosí","Tomás Frías","Potosí","U.E. DR. GONZALO CALDERON RIOS",-65.73939,-19.58194,21,8,312,333,219,17,68,287
"Bolivia","Potosí","Tomás Frías","Potosí","U.E. HUMBERTO IPORRE SALINAS",-65.748,-19.576,368,35,2350,2718,1653,127,535,2188
"Bolivia","Potosí","Tomás Frías","Potosí","UNIDAD EDUCATIVA JUAN PABLO II",-65.77334,-19.57676,490,50,4248,4738,3330,175,693,4023
"Bolivia","Potosí","Tomás Frías","Potosí","UNIDAD EDUCATIVA MEJILLONES",-65.74363,-19.58617,544,58,3993,4537,3174,181,580,3754
"Bolivia","Potosí","Tomás Frías","Potosí","UNIDAD EDUCATIVA SANTA ROSA",-65.75475,-19.58914,182,3,1341,1523,1180,35,123,1303
"Bolivia","Potosí","Tomás Frías","Potosí","UNIDAD EDUCATIVA VILLA COLON",-65.7385,-19.59098,531,60,3875,4406,2921,197,697,3618
"Bolivia","Potosí","Tomás Frías","Potosí","UNID. EDUCATIVA OSCAR ALFARO",-65.74941,-19.58645,130,4,1045,1175,928,18,95,1023
"Bolivia","Potosí","Tomás Frías","Tinguipaya","ESC. ACTARA",-65.95901,-19.07407,227,26,575,802,212,110,227,439
"Bolivia","Potosí","Tomás Frías","Tinguipaya","ESC. CALASAYA",-65.94428,-19.09865,88,1,192,280,3,10,178,181
"Bolivia","Potosí","Tomás Frías","Tinguipaya","ESC. CENTRAL ANTHURA",-65.96957,-19.12422,146,56,983,1129,145,112,670,815
"Bolivia","Potosí","Tomás Frías","Tinguipaya","ESC. CENTRAL JAHUACAYA",-65.88607,-19.19718,187,103,720,907,183,57,377,560
"Bolivia","Potosí","Tomás Frías","Tinguipaya","ESC. CENTRAL UTACALLA",-65.82983,-19.32134,111,18,327,438,124,20,165,289
"Bolivia","Potosí","Tomás Frías","Tinguipaya","ESC. EJE CAQUENA",-65.93787,-19.10439,75,30,320,395,122,15,153,275
"Bolivia","Potosí","Tomás Frías","Tinguipaya","ESC. FOROCTIRI",-65.71165,-19.14012,108,2,354,462,38,14,300,338
"Bolivia","Potosí","Tomás Frías","Tinguipaya","ESC. ISLA",-65.79921,-19.34833,15,2,69,84,47,5,15,62
"Bolivia","Potosí","Tomás Frías","Tinguipaya","ESC. ITHINOCA",-65.74291,-19.17638,53,4,370,423,50,18,298,348
"Bolivia","Potosí","Tomás Frías","Tinguipaya","ESC. LEÑAS",-66.08008,-19.24488,52,23,262,314,102,26,111,213
"Bolivia","Potosí","Tomás Frías","Tinguipaya","ESC. MARISCAL SUCRE",-65.86382,-19.09476,349,99,1428,1777,403,82,844,1247
"Bolivia","Potosí","Tomás Frías","Tinguipaya","ESC. MARISCAL SUCRE",-65.823,-19.22001,349,99,1428,1777,403,82,844,1247
"Bolivia","Potosí","Tomás Frías","Tinguipaya","ESC. MATANSUYO",-65.89815,-19.03701,83,20,208,291,83,15,90,173
"Bolivia","Potosí","Tomás Frías","Tinguipaya","ESC. MCAL. A. JOSE DE SUCRE",-65.72488,-19.24366,151,7,326,477,82,18,219,301
"Bolivia","Potosí","Tomás Frías","Tinguipaya","ESC. PUCA PUNTA",-65.68548,-19.11989,62,5,209,271,20,10,174,194
"Bolivia","Potosí","Tomás Frías","Tinguipaya","ESC. TACOHUARA",-65.7727,-19.13595,45,5,194,239,13,3,173,186
"Bolivia","Potosí","Tomás Frías","Tinguipaya","ESCUELA SAYACA",-66.0471,-19.11271,3,6,91,94,26,6,53,79
"Bolivia","Potosí","Tomás Frías","Tinguipaya","U.E. CIENEGOMA",-65.84728,-19.06967,0,1,256,256,52,19,184,236
"Bolivia","Potosí","Tomás Frías","Tinguipaya","U.E. MACHAC MARCA",-65.92706,-19.16479,12,24,195,207,131,10,30,161
"Bolivia","Potosí","Tomás Frías","Urmiri (Belén de Andamarca)","ESC. CAHUAYO",-66.17896,-19.27176,6,2,87,93,14,3,68,82
"Bolivia","Potosí","Tomás Frías","Urmiri (Belén de Andamarca)","ESC. JUAN JOSE PEREZ",-66.06399,-19.38641,27,2,267,294,85,12,168,253
"Bolivia","Potosí","Tomás Frías","Urmiri (Belén de Andamarca)","ESC. PUITUCO",-66.093,-19.315,19,3,112,131,47,2,60,107
"Bolivia","Potosí","Tomás Frías","Urmiri (Belén de Andamarca)","ESC. SECC. VACUYO",-66.10999,-19.45775,24,7,164,188,111,5,41,152
"Bolivia","Potosí","Tomás Frías","Yocalla","COLEG. ELIZARDO PEREZ",-65.97868,-19.41173,35,8,259,294,83,5,163,246
"Bolivia","Potosí","Tomás Frías","Yocalla","ESC. ALONSO DE IBANEZ",-65.81144,-19.51297,24,9,243,267,178,5,51,229
"Bolivia","Potosí","Tomás Frías","Yocalla","ESC. CAYARA",-65.88385,-19.55053,70,16,403,473,262,13,112,374
"Bolivia","Potosí","Tomás Frías","Yocalla","ESC. CHIRACORO",-65.9007,-19.60283,32,8,298,330,146,28,116,262
"Bolivia","Potosí","Tomás Frías","Yocalla","ESC. EDUARDO AVAROA",-65.90892,-19.38971,136,39,634,770,339,35,221,560
"Bolivia","Potosí","Tomás Frías","Yocalla","ESC. JOSE ANTONIO ZAMPA",-65.8355,-19.45168,63,29,503,566,281,26,167,448
"Bolivia","Potosí","Tomás Frías","Yocalla","ESC. JUAN XXIII",-66.019,-19.356,58,8,360,418,99,9,244,343
"Bolivia","Potosí","Tomás Frías","Yocalla","ESC. SAN ANTONIO",-65.79968,-19.58194,59,7,397,456,293,17,80,373
"Bolivia","Potosí","Tomás Frías","Yocalla","ESC. SANTA LUCIA",-65.84718,-19.55035,35,12,372,407,291,4,65,356
"Bolivia","Santa Cruz","Andrés Ibáñez","Cotoca","COLEGIO NAL. BENEMERITOS DE LA PATRIA",-62.99899,-17.75773,546,58,3675,4221,2367,95,1155,3522
"Bolivia","Santa Cruz","Andrés Ibáñez","Cotoca","ESC. GREMIAL CORTEZ",-63.01388,-17.82349,60,8,454,514,194,17,235,429
"Bolivia","Santa Cruz","Andrés Ibáñez","Cotoca","ESC. MARISCAL ANTONIO JOSE DE SUCRE",-63.05227,-17.74769,135,14,821,956,497,26,284,781
"Bolivia","Santa Cruz","Andrés Ibáñez","Cotoca","ESCUELA.COLEGIO LORENZO CORTEZ RIVERA",-62.9951,-17.75099,642,69,3952,4594,2513,117,1253,3766
"Bolivia","Santa Cruz","Andrés Ibáñez","Cotoca","ESCUELA.COLEGIO MANUEL ANGEL CORTEZ",-63.0035,-17.75491,443,33,2682,3125,1574,77,998,2572
"Bolivia","Santa Cruz","Andrés Ibáñez","Cotoca","ESCUELA.COL. SAN MARCOS",-62.98962,-17.75545,629,27,3675,4304,2039,131,1478,3517
"Bolivia","Santa Cruz","Andrés Ibáñez","Cotoca","ESCUELA DEMETRIO AÑEZ",-62.79085,-17.66665,462,16,2146,2608,1158,33,939,2097
"Bolivia","Santa Cruz","Andrés Ibáñez","Cotoca","ESCUELA GERMAN BUSCH",-62.93764,-17.73404,141,9,1072,1213,316,70,677,993
"Bolivia","Santa Cruz","Andrés Ibáñez","Cotoca","ESCUELA JESUS GOMEZ",-62.99224,-17.75945,187,14,991,1178,558,16,403,961
"Bolivia","Santa Cruz","Andrés Ibáñez","Cotoca","ESCUELA REP. DE MEXICO",-62.95778,-17.7372,279,27,1621,1900,356,137,1101,1457
"Bolivia","Santa Cruz","Andrés Ibáñez","Cotoca","ESCUELA.U.E. CALLEJAS",-62.9951,-17.75099,203,8,978,1181,666,14,290,956
"Bolivia","Santa Cruz","Andrés Ibáñez","Cotoca","ESCUELA U.E CLUB SOCIAL 24 DE SEPTIEMBRE",-63.0174,-17.69314,258,14,1674,1932,891,70,699,1590
"Bolivia","Santa Cruz","Andrés Ibáñez","Cotoca","ESCUELA UNIDADEDUCATIVA OSCAR ALFARO",-63.01909,-17.79542,202,26,1730,1932,356,66,1282,1638
"Bolivia","Santa Cruz","Andrés Ibáñez","Cotoca","U.E. PATUJU",-63.05326,-17.77304,12,4,236,248,146,8,78,224
"Bolivia","Santa Cruz","Andrés Ibáñez","Cotoca","U.E. SAN ANTONIO",-62.98827,-17.75096,7,1,62,69,39,1,21,60
"Bolivia","Santa Cruz","Andrés Ibáñez","Cotoca","UNIDAD EDUCATIVA FIDEL SAUCEDO",-62.99212,-17.69003,110,23,1116,1226,609,32,452,1061
"Bolivia","Santa Cruz","Andrés Ibáñez","El Torno","ESC.  29 DE JUNIO",-63.42663,-18.05655,314,62,2328,2642,1063,112,1091,2154
"Bolivia","Santa Cruz","Andrés Ibáñez","El Torno","ESC. ALBERTO RIBERA TAPIA",-63.50418,-18.15956,150,24,994,1144,371,105,494,865
"Bolivia","Santa Cruz","Andrés Ibáñez","El Torno","ESC. CAÑADA DOS",-63.32237,-18.06299,31,15,261,292,34,6,206,240
"Bolivia","Santa Cruz","Andrés Ibáñez","El Torno","ESC. CENTRAL MONTEVERDE",-63.50122,-17.92225,20,5,154,174,23,5,121,144
"Bolivia","Santa Cruz","Andrés Ibáñez","El Torno","ESC. ELENA VACA ANTELO",-63.3835,-17.99134,864,64,5819,6683,2753,271,2731,5484
"Bolivia","Santa Cruz","Andrés Ibáñez","El Torno","ESC. FE Y ALEGRIA",-63.45194,-17.981,42,6,369,411,114,11,238,352
"Bolivia","Santa Cruz","Andrés Ibáñez","El Torno","ESC. LA ELVIRA",-63.44523,-18.05682,0,2,24,24,13,0,9,22
"Bolivia","Santa Cruz","Andrés Ibáñez","El Torno","ESC. NACIONES UNIDAS",-63.38043,-17.9931,921,129,6202,7123,2304,309,3460,5764
"Bolivia","Santa Cruz","Andrés Ibáñez","El Torno","ESC, NUCLEO SAN LUIS",-63.48095,-18.1413,216,30,1305,1521,675,57,543,1218
"Bolivia","Santa Cruz","Andrés Ibáñez","El Torno","ESC. QUEBRADA LEON",-63.47776,-17.96212,17,3,140,157,39,4,94,133
"Bolivia","Santa Cruz","Andrés Ibáñez","El Torno","ESC. SECCIONAL SANTA RITA",-63.37109,-17.97818,207,32,1700,1907,740,72,856,1596
"Bolivia","Santa Cruz","Andrés Ibáñez","El Torno","ESCUELA 23 DE MARZO",-63.34325,-18.09747,61,3,374,435,57,16,298,355
"Bolivia","Santa Cruz","Andrés Ibáñez","El Torno","ESCUELA ANDRES IBAÑEZ",-63.40279,-18.02817,178,35,1785,1963,749,106,895,1644
"Bolivia","Santa Cruz","Andrés Ibáñez","El Torno","ESCUELA PUERTO RICO",-63.39142,-18.00683,357,48,2672,3029,1015,131,1478,2493
"Bolivia","Santa Cruz","Andrés Ibáñez","El Torno","ESCUELA SANTA MARTHA",-63.36341,-17.96476,157,13,1125,1282,334,110,668,1002
"Bolivia","Santa Cruz","Andrés Ibáñez","El Torno","ESCUELA TIQUIPAYA",-63.45114,-18.08387,134,43,1060,1194,224,42,751,975
"Bolivia","Santa Cruz","Andrés Ibáñez","El Torno","ESC. VILLA BARRIENTOS",-63.35257,-18.01478,14,3,90,104,16,3,68,84
"Bolivia","Santa Cruz","Andrés Ibáñez","El Torno","NUCLEO CENTRAL TARUMA",-63.46047,-18.11805,66,19,532,598,229,36,248,477
"Bolivia","Santa Cruz","Andrés Ibáñez","El Torno","SECCIONAL PARABANOCITO",-63.46001,-18.22056,14,6,135,149,53,3,73,126
"Bolivia","Santa Cruz","Andrés Ibáñez","El Torno","U.E. BICENTENARIO",-63.38105,-17.98782,21,4,178,199,71,2,101,172
"Bolivia","Santa Cruz","Andrés Ibáñez","El Torno","U.E. BICENTENARIO II",-63.38103,-17.98801,1,0,9,10,6,0,3,9
"Bolivia","Santa Cruz","Andrés Ibáñez","El Torno","U.E. LIC. ZACHARY MACY",-63.38482,-17.99942,25,2,199,224,72,4,121,193
"Bolivia","Santa Cruz","Andrés Ibáñez","El Torno","U.E. LIC. ZACHARY MACY",-63.38501,-17.9992,25,2,199,224,72,4,121,193
"Bolivia","Santa Cruz","Andrés Ibáñez","La Guardia","CAMBAO",-63.23442,-17.87344,79,6,822,901,397,22,397,794
"Bolivia","Santa Cruz","Andrés Ibáñez","La Guardia","ESC. CENTRAL ANGEL FOIANINI",-63.2851,-17.8802,572,78,4598,5170,2218,245,2057,4275
"Bolivia","Santa Cruz","Andrés Ibáñez","La Guardia","ESC. CENTRAL BASILIO",-63.19316,-18.12562,232,44,1398,1630,516,71,767,1283
"Bolivia","Santa Cruz","Andrés Ibáñez","La Guardia","ESC. JOSE MIGUEL DE VELASCO",-63.21535,-17.9662,35,5,282,317,172,5,100,272
"Bolivia","Santa Cruz","Andrés Ibáñez","La Guardia","ESC. JOSE VICENTE SOLIZ Y RAMOS",-63.32945,-17.89064,554,77,3290,3844,1744,169,1300,3044
"Bolivia","Santa Cruz","Andrés Ibáñez","La Guardia","ESC. JUANA AZURDUY DE PADILLA",-63.26641,-17.87674,350,17,2453,2803,1373,98,965,2338
"Bolivia","Santa Cruz","Andrés Ibáñez","La Guardia","ESC. LA PEÑA- BRECHA-3",-63.05506,-17.98781,67,17,470,537,213,13,227,440
"Bolivia","Santa Cruz","Andrés Ibáñez","La Guardia","ESC. NATANIEL VERDUGEZ",-63.25018,-17.85087,1438,62,9085,10523,4641,248,4134,8775
"Bolivia","Santa Cruz","Andrés Ibáñez","La Guardia","ESC. RUBEN DARIO SOLIZ",-63.35154,-17.93966,357,51,2252,2609,1051,76,1074,2125
"Bolivia","Santa Cruz","Andrés Ibáñez","La Guardia","ESC. TOMAS JOSE MORALES",-63.33047,-17.89173,650,39,4522,5172,2617,193,1673,4290
"Bolivia","Santa Cruz","Andrés Ibáñez","La Guardia","ESC. U. EDUC. ALFREDO IBAÑEZ FRANCO",-63.24312,-17.85056,637,105,4629,5266,2224,296,2004,4228
"Bolivia","Santa Cruz","Andrés Ibáñez","La Guardia","ESCUELA JOSE GIL SORUCO",-63.2532,-17.95629,141,15,850,991,457,61,317,774
"Bolivia","Santa Cruz","Andrés Ibáñez","La Guardia","ESCUELA MAESTRO PITAGORAS",-63.29059,-17.89535,625,47,4633,5258,1776,151,2659,4435
"Bolivia","Santa Cruz","Andrés Ibáñez","La Guardia","ESCUELA NUEVA ESPERANZA",-63.26702,-17.86146,440,17,2777,3217,1817,65,878,2695
"Bolivia","Santa Cruz","Andrés Ibáñez","La Guardia","MADRE TERESA DE CALCUTA",-63.23131,-17.87858,42,3,536,578,228,31,274,502
"Bolivia","Santa Cruz","Andrés Ibáñez","La Guardia","NUCLEO SAN CARLOS",-63.33423,-18.13221,22,4,142,164,78,4,56,134
"Bolivia","Santa Cruz","Andrés Ibáñez","La Guardia","U.E. ANGEL FOIANINI BANZER II",-63.2851,-17.8802,20,2,253,273,130,10,111,241
"Bolivia","Santa Cruz","Andrés Ibáñez","La Guardia","U.E. AYACUCHO",-63.21905,-17.86675,21,3,359,380,135,7,214,349
"Bolivia","Santa Cruz","Andrés Ibáñez","La Guardia","U.E. BARRIO LINDO",-63.26904,-17.89636,42,3,588,630,249,28,308,557
"Bolivia","Santa Cruz","Andrés Ibáñez","La Guardia","U.E. BICENTENARIO ARCO IRIS",-63.2214,-17.86212,22,1,180,202,112,5,62,174
"Bolivia","Santa Cruz","Andrés Ibáñez","La Guardia","U.E. CORDECRUZ",-63.24748,-17.84745,124,3,858,982,477,30,348,825
"Bolivia","Santa Cruz","Andrés Ibáñez","La Guardia","U.E. HERNANDO ZANABRIA",-63.28431,-17.89734,17,3,251,268,95,10,143,238
"Bolivia","Santa Cruz","Andrés Ibáñez","La Guardia","U.E. INTEGRACION DE LAS AMERICAS",-63.27132,-17.88183,42,6,608,650,88,10,504,592
"Bolivia","Santa Cruz","Andrés Ibáñez","La Guardia","U.E. JOSE MARIANO SERRANO",-63.25946,-17.83774,48,2,639,687,318,19,300,618
"Bolivia","Santa Cruz","Andrés Ibáñez","La Guardia","U.E. LUZ DE ESPERANZA",-63.27512,-17.85011,10,1,168,178,106,1,60,166
"Bolivia","Santa Cruz","Andrés Ibáñez","La Guardia","U.E. NACIONAL LA GUARDIA",-63.32025,-17.89236,31,6,451,482,215,18,212,427
"Bolivia","Santa Cruz","Andrés Ibáñez","La Guardia","U.E. NATANIEL GARCIA CHAVEZ",-63.23131,-17.87858,69,0,485,554,295,15,175,470
"Bolivia","Santa Cruz","Andrés Ibáñez","La Guardia","U.E. QUEBRADA SECA",-63.34096,-17.9067,0,1,41,41,26,1,13,39
"Bolivia","Santa Cruz","Andrés Ibáñez","La Guardia","U.E. TOMAS MORALES PADILLA",-63.22071,-17.89719,21,4,374,395,95,94,181,276
"Bolivia","Santa Cruz","Andrés Ibáñez","Porongo (Ayacucho)","ESC. FRAY SANTIAGO DE RIVERO",-63.30791,-17.85656,312,34,2277,2589,1348,50,845,2193
"Bolivia","Santa Cruz","Andrés Ibáñez","Porongo (Ayacucho)","ESC. JOSE PARADA LAGUINDEY",-63.38077,-17.72245,141,12,570,711,379,7,172,551
"Bolivia","Santa Cruz","Andrés Ibáñez","Porongo (Ayacucho)","ESC. NUCLEO CENTRAL SANTA FE",-63.45945,-17.70892,52,7,329,381,63,4,255,318
"Bolivia","Santa Cruz","Andrés Ibáñez","Porongo (Ayacucho)","ESCUELA 6 DE AGOSTO",-63.21883,-17.72828,26,4,694,720,568,75,47,615
"Bolivia","Santa Cruz","Andrés Ibáñez","Porongo (Ayacucho)","ESCUELA CENTRAL ANICETO PARADA ROCA",-63.44804,-17.6197,61,4,252,313,205,5,38,243
"Bolivia","Santa Cruz","Andrés Ibáñez","Porongo (Ayacucho)","ESCUELA CENTRAL SOMBRERITO",-63.36818,-17.88821,55,6,203,258,93,11,93,186
"Bolivia","Santa Cruz","Andrés Ibáñez","Porongo (Ayacucho)","ESCUELA IRENIA MONTERO",-63.4469,-17.87279,46,1,107,153,27,9,70,97
"Bolivia","Santa Cruz","Andrés Ibáñez","Porongo (Ayacucho)","ESCUELA PUERTO ICHILO",-63.23566,-17.74908,51,5,266,317,183,12,66,249
"Bolivia","Santa Cruz","Andrés Ibáñez","Porongo (Ayacucho)","ESCUELA SAN LORENZO",-63.24335,-17.76947,211,13,1196,1407,842,30,311,1153
"Bolivia","Santa Cruz","Andrés Ibáñez","Porongo (Ayacucho)","ESCUELA TARUMATU",-63.24299,-17.65729,71,2,360,431,263,12,83,346
"Bolivia","Santa Cruz","Andrés Ibáñez","Porongo (Ayacucho)","U.E. LAS CRUCES",-63.35539,-17.76963,8,0,72,80,48,4,20,68
"Bolivia","Santa Cruz","Andrés Ibáñez","Porongo (Ayacucho)","U.E. SAN PEDRO",-63.43151,-17.72083,0,0,50,50,23,0,27,50
"Bolivia","Santa Cruz","Andrés Ibáñez","Porongo (Ayacucho)","U.E. TACUAREMBO",-63.39894,-17.93078,1,0,6,7,0,0,6,6
"Bolivia","Santa Cruz","Andrés Ibáñez","Porongo (Ayacucho)","URUBO OPEN MALL",-63.21519,-17.7493,60,1,510,570,463,7,39,502
"Bolivia","Santa Cruz","Andrés Ibáñez","Santa Cruz de la Sierra","16 DE FEBRERO",-63.09864,-17.74821,0,1,139,139,82,14,42,124
"Bolivia","Santa Cruz","Andrés Ibáñez","Santa Cruz de la Sierra","16 DE JULIO",-63.11146,-17.75544,72,8,775,847,460,54,253,713
"Bolivia","Santa Cruz","Andrés Ibáñez","Santa Cruz de la Sierra","ANGELINA RIVERA",-63.17871,-17.85304,21,0,214,235,126,2,86,212
"Bolivia","Santa Cruz","Andrés Ibáñez","Santa Cruz de la Sierra","CAMPUS UNIVERSITARIO",-63.1925,-17.77396,566,6,2742,3308,2256,35,445,2701
"Bolivia","Santa Cruz","Andrés Ibáñez","Santa Cruz de la Sierra","COL. 12 DE DICIEMBRE",-63.13068,-17.821,1193,53,6567,7760,3871,178,2465,6336
"Bolivia","Santa Cruz","Andrés Ibáñez","Santa Cruz de la Sierra","COL. 18 DE MARZO",-63.12068,-17.78999,855,52,5021,5876,3225,153,1591,4816
"Bolivia","Santa Cruz","Andrés Ibáñez","Santa Cruz de la Sierra","COL. 27 DE MAYO",-63.1305,-17.80221,655,18,3291,3946,1750,112,1411,3161
"Bolivia","Santa Cruz","Andrés Ibáñez","Santa Cruz de la Sierra","COL. 30 DE MARZO",-63.14708,-17.80647,532,11,3569,4101,2721,91,746,3467
"Bolivia","Santa Cruz","Andrés Ibáñez","Santa Cruz de la Sierra","COL. 7 DE SEPTIEMBRE",-63.17094,-17.72965,552,10,3062,3614,2429,83,540,2969
"Bolivia","Santa Cruz","Andrés Ibáñez","Santa Cruz de la Sierra","COL.ADVENTISTA SANTA CRUZ",-63.16123,-17.73494,575,13,3616,4191,2831,147,625,3456
"Bolivia","Santa Cruz","Andrés Ibáñez","Santa Cruz de la Sierra","COL. ALAN FARAH",-63.0952,-17.79962,566,18,3107,3673,1992,150,947,2939
"Bolivia","Santa Cruz","Andrés Ibáñez","Santa Cruz de la Sierra","COL. ALFA Y OMEGA",-63.18944,-17.80245,212,7,1587,1799,1123,72,385,1508
"Bolivia","Santa Cruz","Andrés Ibáñez","Santa Cruz de la Sierra","COL. AMERICAN SCHOOL COOP.",-63.19998,-17.80871,315,4,1992,2307,1772,56,160,1932
"Bolivia","Santa Cruz","Andrés Ibáñez","Santa Cruz de la Sierra","COL. ANGELA PINCKERT",-63.12423,-17.80643,889,30,5378,6267,2843,179,2326,5169
"Bolivia","Santa Cruz","Andrés Ibáñez","Santa Cruz de la Sierra","COL. ANGLO AMERICANO",-63.17102,-17.75651,45,29,643,688,557,8,49,606
"Bolivia","Santa Cruz","Andrés Ibáñez","Santa Cruz de la Sierra","COL.  ANITA SUAREZ DE LEYGUE",-63.24062,-17.82561,262,17,2119,2381,1164,42,896,2060
"Bolivia","Santa Cruz","Andrés Ibáñez","Santa Cruz de la Sierra","COL.ANTONIO VICENTE SEOANE",-63.19352,-17.80136,281,9,2239,2520,1749,88,393,2142
"Bolivia","Santa Cruz","Andrés Ibáñez","Santa Cruz de la Sierra","COL. ARTURO MEDEIROS",-63.1909,-17.72338,192,8,1349,1541,855,41,445,1300
"Bolivia","Santa Cruz","Andrés Ibáñez","Santa Cruz de la Sierra","COL. ARZ. DANIEL RIVERO",-63.18145,-17.78975,25,0,137,162,108,1,28,136
"Bolivia","Santa Cruz","Andrés Ibáñez","Santa Cruz de la Sierra","COL. BAILON MERCADO ORTIZ",-63.16036,-17.75771,376,11,2633,3009,2098,62,462,2560
"Bolivia","Santa Cruz","Andrés Ibáñez","Santa Cruz de la Sierra","COL. BASILIO DE CUELLAR",-63.1786,-17.7843,145,1,778,923,709,15,53,762
"Bolivia","Santa Cruz","Andrés Ibáñez","Santa Cruz de la Sierra","COL. BATALLON TREN",-63.12371,-17.79344,243,9,1562,1805,1055,77,421,1476
"Bolivia","Santa Cruz","Andrés Ibáñez","Santa Cruz de la Sierra","COL. BERTHA CUELLAR",-63.13752,-17.78985,1101,25,5105,6206,3293,345,1442,4735
"Bolivia","Santa Cruz","Andrés Ibáñez","Santa Cruz de la Sierra","COL. BOSTON COLLEGE",-63.17429,-17.77369,188,3,1410,1598,1246,22,139,1385
"Bolivia","Santa Cruz","Andrés Ibáñez","Santa Cruz de la Sierra","COL. BRITANICO",-63.17352,-17.7643,381,4,2798,3179,2581,31,182,2763
"Bolivia","Santa Cruz","Andrés Ibáñez","Santa Cruz de la Sierra","COL. BUENAS NUEVAS",-63.13937,-17.8226,978,116,6445,7423,3805,205,2319,6124
"Bolivia","Santa Cruz","Andrés Ibáñez","Santa Cruz de la Sierra","COL. CAÑADA EL CARMEN",-63.15352,-17.81458,450,8,3510,3960,2813,87,602,3415
"Bolivia","Santa Cruz","Andrés Ibáñez","Santa Cruz de la Sierra","COL. CAÑADA PAILITAS",-63.14665,-17.81992,401,11,2507,2908,1766,63,667,2433
"Bolivia","Santa Cruz","Andrés Ibáñez","Santa Cruz de la Sierra","COL.CARCEL PUBLICA",-63.17891,-17.87441,400,3,530,930,265,9,253,518
"Bolivia","Santa Cruz","Andrés Ibáñez","Santa Cruz de la Sierra","COL.CARDENAL CUSHING JESUS MARIA",-63.18533,-17.79161,318,11,1929,2247,1566,41,311,1877
"Bolivia","Santa Cruz","Andrés Ibáñez","Santa Cruz de la Sierra","COL. CASTILLA LA MANCHA",-63.06415,-17.85068,1619,151,9549,11168,5034,419,3945,8979
"Bolivia","Santa Cruz","Andrés Ibáñez","Santa Cruz de la Sierra","COL. CENTRAL OBRERA DEPARTAMENTAL",-63.10396,-17.80835,771,69,4763,5534,2602,171,1921,4523
"Bolivia","Santa Cruz","Andrés Ibáñez","Santa Cruz de la Sierra","COL.CENTRO APRONDY",-63.15873,-17.77472,251,34,2255,2506,1823,114,284,2107
"Bolivia","Santa Cruz","Andrés Ibáñez","Santa Cruz de la Sierra","COL. CENTRO EDUCATIVO CARITAS",-63.18559,-17.83982,520,11,4777,5297,3648,162,956,4604
"Bolivia","Santa Cruz","Andrés Ibáñez","Santa Cruz de la Sierra","COL. CENTRO INTERNO BOL. ALEMAN",-63.11688,-17.82509,1431,53,6686,8117,3081,196,3356,6437
"Bolivia","Santa Cruz","Andrés Ibáñez","Santa Cruz de la Sierra","COL. CIUDAD NIÑO JESUS",-63.18233,-17.82738,643,18,4033,4676,2573,199,1243,3816
"Bolivia","Santa Cruz","Andrés Ibáñez","Santa Cruz de la Sierra","COL.CLUB DE LEONES",-63.17753,-17.7902,245,6,1758,2003,1297,32,423,1720
"Bolivia","Santa Cruz","Andrés Ibáñez","Santa Cruz de la Sierra","COL.CLUB DE LEONES #10",-63.17753,-17.7902,148,32,1130,1278,930,34,134,1064
"Bolivia","Santa Cruz","Andrés Ibáñez","Santa Cruz de la Sierra","COL. CLUB DE LEONES #6",-63.18416,-17.7943,118,3,670,788,450,45,172,622
"Bolivia","Santa Cruz","Andrés Ibáñez","Santa Cruz de la Sierra","COL. COMPLEJO EDUCATIVO JAPON",-63.18984,-17.80635,777,27,4684,5461,2821,182,1654,4475
"Bolivia","Santa Cruz","Andrés Ibáñez","Santa Cruz de la Sierra","COL. COVIPAL",-63.23657,-17.83965,151,14,933,1084,341,31,547,888
"Bolivia","Santa Cruz","Andrés Ibáñez","Santa Cruz de la Sierra","COL. CUPESI TERRADO",-63.09699,-17.81237,764,46,4206,4970,1806,173,2181,3987
"Bolivia","Santa Cruz","Andrés Ibáñez","Santa Cruz de la Sierra","COL. DIOS ES AMOR",-63.16571,-17.78535,174,8,1294,1468,1097,20,169,1266
"Bolivia","Santa Cruz","Andrés Ibáñez","Santa Cruz de la Sierra","COL.DOMINGO LEIGUE (BOLIVIANO CANADIENSE",-63.16274,-17.77073,265,5,1803,2068,1519,31,248,1767
"Bolivia","Santa Cruz","Andrés Ibáñez","Santa Cruz de la Sierra","COL. EDUCATIVO COTOCA",-63.11758,-17.74604,506,85,3026,3532,1654,128,1159,2813
"Bolivia","Santa Cruz","Andrés Ibáñez","Santa Cruz de la Sierra","COL. EDUCATIVO SAN ISIDRO",-63.13194,-17.80816,850,54,5300,6150,3113,144,1989,5102
"Bolivia","Santa Cruz","Andrés Ibáñez","Santa Cruz de la Sierra","COLEGIO  23 DE ABRIL",-63.14577,-17.74856,444,9,2730,3174,1761,123,837,2598
"Bolivia","Santa Cruz","Andrés Ibáñez","Santa Cruz de la Sierra","COLEGIO  6 DE JUNIO",-63.16083,-17.75763,600,7,2213,2813,1755,93,358,2113
"Bolivia","Santa Cruz","Andrés Ibáñez","Santa Cruz de la Sierra","COLEGIO ADELA ZAMUDIO",-63.17396,-17.8329,935,25,5934,6869,3515,228,2166,5681
"Bolivia","Santa Cruz","Andrés Ibáñez","Santa Cruz de la Sierra","COLEGIO BERTHA CUELLAR",-63.1344,-17.77751,187,5,856,1043,652,12,187,839
"Bolivia","Santa Cruz","Andrés Ibáñez","Santa Cruz de la Sierra","COLEGIO CASTULO CHAVEZ",-63.18775,-17.77663,395,14,2078,2473,1772,24,268,2040
"Bolivia","Santa Cruz","Andrés Ibáñez","Santa Cruz de la Sierra","COLEGIO CUPESO DE LOS REYES",-63.10786,-17.82436,609,21,3885,4494,1653,152,2059,3712
"Bolivia","Santa Cruz","Andrés Ibáñez","Santa Cruz de la Sierra","COLEGIO DOMINGO SAVIO - DON BOSCO",-63.19939,-17.83571,1167,39,7171,8338,4296,250,2586,6882
"Bolivia","Santa Cruz","Andrés Ibáñez","Santa Cruz de la Sierra","COLEGIO DON BOSCO",-63.17539,-17.79467,346,5,2023,2369,1752,37,229,1981
"Bolivia","Santa Cruz","Andrés Ibáñez","Santa Cruz de la Sierra","COLEGIO EL PROGRESO",-63.20576,-17.82713,926,33,5004,5930,2443,242,2286,4729
"Bolivia","Santa Cruz","Andrés Ibáñez","Santa Cruz de la Sierra","COLEGIO ELVIRA PARADA",-63.12992,-17.75476,646,16,3534,4180,2305,104,1109,3414
"Bolivia","Santa Cruz","Andrés Ibáñez","Santa Cruz de la Sierra","COLEGIO FUENTE DEL SABER",-63.16189,-17.87296,100,7,766,866,296,23,440,736
"Bolivia","Santa Cruz","Andrés Ibáñez","Santa Cruz de la Sierra","COLEGIO IGNACIO WARNES",-63.15627,-17.86588,614,20,3784,4398,1638,145,1981,3619
"Bolivia","Santa Cruz","Andrés Ibáñez","Santa Cruz de la Sierra","COLEGIO JOSEFINA BALSAMO( LOS TUSEQUIS)",-63.1523,-17.78086,539,50,3818,4357,2803,157,808,3611
"Bolivia","Santa Cruz","Andrés Ibáñez","Santa Cruz de la Sierra","COLEGIO JUSTO LEIGUE",-63.16701,-17.79873,132,4,1430,1562,1189,65,172,1361
"Bolivia","Santa Cruz","Andrés Ibáñez","Santa Cruz de la Sierra","COLEGIO LUZ Y VERDAD",-63.18724,-17.876,472,18,2520,2992,1136,76,1290,2426
"Bolivia","Santa Cruz","Andrés Ibáñez","Santa Cruz de la Sierra","COLEGIO MARCELINO CHAMPAGNAT",-63.18896,-17.85419,315,15,2690,3005,1976,107,592,2568
"Bolivia","Santa Cruz","Andrés Ibáñez","Santa Cruz de la Sierra","COLEGIO MARISTA",-63.17305,-17.78898,250,6,1698,1948,1523,21,148,1671
"Bolivia","Santa Cruz","Andrés Ibáñez","Santa Cruz de la Sierra","COLEGIO MARTIN SAPP",-63.17467,-17.82512,828,25,5678,6506,3614,179,1860,5474
"Bolivia","Santa Cruz","Andrés Ibáñez","Santa Cruz de la Sierra","COLEGIO NESTOR SUAREZ",-63.17374,-17.81688,548,12,3694,4242,2568,146,968,3536
"Bolivia","Santa Cruz","Andrés Ibáñez","Santa Cruz de la Sierra","COLEGIO PLAN 4000",-63.17594,-17.88471,685,37,4624,5309,1666,153,2768,4434
"Bolivia","Santa Cruz","Andrés Ibáñez","Santa Cruz de la Sierra","COLEGIO RAQUEL SOSSA",-63.19794,-17.77104,94,1,888,982,789,15,83,872
"Bolivia","Santa Cruz","Andrés Ibáñez","Santa Cruz de la Sierra","COLEGIO SAN FELIPE",-63.123,-17.76667,1279,166,7396,8675,3972,234,3024,6996
"Bolivia","Santa Cruz","Andrés Ibáñez","Santa Cruz de la Sierra","COLEGIO SAN FRANCISCO DE ASIS",-63.14429,-17.85693,46,5,434,480,220,6,203,423
"Bolivia","Santa Cruz","Andrés Ibáñez","Santa Cruz de la Sierra","COLEGIO SAN JORGE",-63.1956,-17.87261,466,49,2424,2890,1129,98,1148,2277
"Bolivia","Santa Cruz","Andrés Ibáñez","Santa Cruz de la Sierra","COLEGIO SIMON BOLIVAR",-63.1228,-17.82358,745,64,4324,5069,1870,135,2255,4125
"Bolivia","Santa Cruz","Andrés Ibáñez","Santa Cruz de la Sierra","COLEGIO TOKIO",-63.18006,-17.77509,273,2,1112,1385,708,25,377,1085
"Bolivia","Santa Cruz","Andrés Ibáñez","Santa Cruz de la Sierra","COLEGIO VILLA GLADYS THEVENETH",-63.11954,-17.82021,709,42,4643,5352,1923,222,2456,4379
"Bolivia","Santa Cruz","Andrés Ibáñez","Santa Cruz de la Sierra","COL. EL BUEN SAMARITANO",-63.08056,-17.81198,231,16,1724,1955,830,68,810,1640
"Bolivia","Santa Cruz","Andrés Ibáñez","Santa Cruz de la Sierra","COL. EL CARMEN 16 DE JULIO",-63.19295,-17.80798,301,12,2046,2347,1548,58,428,1976
"Bolivia","Santa Cruz","Andrés Ibáñez","Santa Cruz de la Sierra","COL.  ELFI RIVERA DE BARBERY",-63.15907,-17.73966,1594,50,8265,9859,4971,298,2946,7917
"Bolivia","Santa Cruz","Andrés Ibáñez","Santa Cruz de la Sierra","COL. EL PAJONAL",-63.16722,-17.81264,284,11,1633,1917,1353,29,240,1593
"Bolivia","Santa Cruz","Andrés Ibáñez","Santa Cruz de la Sierra","COL. ESC. 29 DE DICIEMBRE",-63.21157,-17.80971,337,8,1915,2252,1112,58,737,1849
"Bolivia","Santa Cruz","Andrés Ibáñez","Santa Cruz de la Sierra","COL.ESC.  AMSTERDAN",-63.14972,-17.85901,408,8,2357,2765,922,70,1357,2279
"Bolivia","Santa Cruz","Andrés Ibáñez","Santa Cruz de la Sierra","COL. ESC. CORONEL IGNACIO WARNES",-63.1825,-17.78679,150,2,585,735,466,21,96,562
"Bolivia","Santa Cruz","Andrés Ibáñez","Santa Cruz de la Sierra","COL.ESC. GRAL. ISMAEL MONTES GAMBOA",-63.10978,-17.74466,733,84,5227,5960,2676,238,2229,4905
"Bolivia","Santa Cruz","Andrés Ibáñez","Santa Cruz de la Sierra","COL. ESC. HILANDERIA",-63.21956,-17.80578,503,17,3062,3565,2090,98,857,2947
"Bolivia","Santa Cruz","Andrés Ibáñez","Santa Cruz de la Sierra","COL. ESC. HOLANDA",-63.19473,-17.88406,211,14,1625,1836,662,82,867,1529
"Bolivia","Santa Cruz","Andrés Ibáñez","Santa Cruz de la Sierra","COL. ESC. HONORATO MEJIA",-63.21367,-17.86145,335,52,2678,3013,1407,107,1112,2519
"Bolivia","Santa Cruz","Andrés Ibáñez","Santa Cruz de la Sierra","COL.ESC. INOCENCIO ROMAN",-63.06305,-17.85023,947,89,4783,5730,1783,171,2740,4523
"Bolivia","Santa Cruz","Andrés Ibáñez","Santa Cruz de la Sierra","COL. ESC.JUANA AZURDUY DE PADILLA",-63.10905,-17.84618,1216,186,7968,9184,3786,336,3660,7446
"Bolivia","Santa Cruz","Andrés Ibáñez","Santa Cruz de la Sierra","COL. ESC. LA BASE",-63.21367,-17.83001,351,14,2562,2913,1613,49,886,2499
"Bolivia","Santa Cruz","Andrés Ibáñez","Santa Cruz de la Sierra","COL. ESC. MAGISTERIO SUR",-63.18134,-17.86983,397,20,2581,2978,1301,103,1157,2458
"Bolivia","Santa Cruz","Andrés Ibáñez","Santa Cruz de la Sierra","COL. ESC. MANUEL IGNACIO SALVATIERRA",-63.17845,-17.78334,103,1,537,640,458,9,69,527
"Bolivia","Santa Cruz","Andrés Ibáñez","Santa Cruz de la Sierra","COL. ESC. MARIA ALICIA PAZ B.",-63.19432,-17.85304,810,32,5206,6016,3276,164,1734,5010
"Bolivia","Santa Cruz","Andrés Ibáñez","Santa Cruz de la Sierra","COL. ESC. MAX FERNANDEZ ROJAS B",-63.16543,-17.87381,524,28,3050,3574,1335,156,1531,2866
"Bolivia","Santa Cruz","Andrés Ibáñez","Santa Cruz de la Sierra","COL. ESC. NAUN FERNANDEZ",-63.17404,-17.83272,308,11,2526,2834,1607,101,807,2414
"Bolivia","Santa Cruz","Andrés Ibáñez","Santa Cruz de la Sierra","COL. ESC.PEREGRINA DAVALOS",-63.16763,-17.87231,589,17,3259,3848,1456,92,1694,3150
"Bolivia","Santa Cruz","Andrés Ibáñez","Santa Cruz de la Sierra","COL.ESC. ROCA CORONADO",-63.15992,-17.83748,872,36,5345,6217,2591,129,2589,5180
"Bolivia","Santa Cruz","Andrés Ibáñez","Santa Cruz de la Sierra","COL.ESC. TIERRAS NUEVAS EL CARMEN",-63.21467,-17.84509,1769,213,9544,11313,4380,453,4498,8878
"Bolivia","Santa Cruz","Andrés Ibáñez","Santa Cruz de la Sierra","COL. ESCUELA 2 DE AGOSTO",-63.15519,-17.75298,390,9,2532,2922,2063,32,428,2491
"Bolivia","Santa Cruz","Andrés Ibáñez","Santa Cruz de la Sierra","COL. ESCUELA AMBROCIO VILLARROEL",-63.2262,-17.79013,294,53,1659,1953,859,44,703,1562
"Bolivia","Santa Cruz","Andrés Ibáñez","Santa Cruz de la Sierra","COL.ESCUELA BOLIVIA HOLANDA",-63.14489,-17.86903,595,21,3656,4251,1247,190,2198,3445
"Bolivia","Santa Cruz","Andrés Ibáñez","Santa Cruz de la Sierra","COL.ESCUELA DELCY MARTINEZ SALINAS",-63.15478,-17.84095,300,8,1829,2129,890,186,745,1635
"Bolivia","Santa Cruz","Andrés Ibáñez","Santa Cruz de la Sierra","COL.ESCUELA EL FUERTE",-63.14807,-17.84582,999,75,5729,6728,2589,398,2667,5256
"Bolivia","Santa Cruz","Andrés Ibáñez","Santa Cruz de la Sierra","COL. ESCUELA JORGE URENDA TRIGO",-63.23063,-17.81518,505,17,3198,3703,2256,120,805,3061
"Bolivia","Santa Cruz","Andrés Ibáñez","Santa Cruz de la Sierra","COL. ESCUELA MAGISTERIO",-63.15523,-17.76229,390,43,3336,3726,2735,67,491,3226
"Bolivia","Santa Cruz","Andrés Ibáñez","Santa Cruz de la Sierra","COL.ESCUELA NUEVA ESPERANZA",-63.07431,-17.83275,291,18,1282,1573,511,36,717,1228
"Bolivia","Santa Cruz","Andrés Ibáñez","Santa Cruz de la Sierra","COL.ESCUELA POLY VILLARROEL",-63.1315,-17.8723,206,6,1541,1747,1034,81,420,1454
"Bolivia","Santa Cruz","Andrés Ibáñez","Santa Cruz de la Sierra","COL. ESCUELA SARA PORRAS DE PINTO",-63.22218,-17.79663,377,8,2465,2842,1720,127,610,2330
"Bolivia","Santa Cruz","Andrés Ibáñez","Santa Cruz de la Sierra","COL. ESC. UNZAGA DE LA VEGA",-63.22689,-17.82803,1549,91,9194,10743,5199,370,3534,8733
"Bolivia","Santa Cruz","Andrés Ibáñez","Santa Cruz de la Sierra","COL.ESC. VIRGEN DE URKUPINA",-63.10241,-17.74881,1331,65,7212,8543,2693,318,4136,6829
"Bolivia","Santa Cruz","Andrés Ibáñez","Santa Cruz de la Sierra","COL. FAUSTO MEDRANO",-63.12659,-17.78748,451,22,2839,3290,1664,130,1023,2687
"Bolivia","Santa Cruz","Andrés Ibáñez","Santa Cruz de la Sierra","COL. FELIX BASCOPE",-63.14538,-17.79648,433,11,3613,4046,2789,79,734,3523
"Bolivia","Santa Cruz","Andrés Ibáñez","Santa Cruz de la Sierra","COL. FELIX BASCOPE SANANDITA",-63.15129,-17.78336,309,8,2073,2382,1667,74,324,1991
"Bolivia","Santa Cruz","Andrés Ibáñez","Santa Cruz de la Sierra","COL. FE Y ALEGRIA",-63.13117,-17.79493,814,26,4302,5116,2823,74,1379,4202
"Bolivia","Santa Cruz","Andrés Ibáñez","Santa Cruz de la Sierra","COL. FE Y ALEGRIA - ANICETO ARZE",-63.15612,-17.7986,684,28,5033,5717,3934,218,853,4787
"Bolivia","Santa Cruz","Andrés Ibáñez","Santa Cruz de la Sierra","COL. FE Y ALEGRIA LA MERCED",-63.19189,-17.78853,575,20,4235,4810,3105,268,842,3947
"Bolivia","Santa Cruz","Andrés Ibáñez","Santa Cruz de la Sierra","COL. FE Y ALEGRIA NUEVA AMERICA",-63.13412,-17.82978,1332,62,7094,8426,3674,208,3150,6824
"Bolivia","Santa Cruz","Andrés Ibáñez","Santa Cruz de la Sierra","COL. GABRIEL RENE MORENO",-63.18595,-17.78357,230,2,1393,1623,1170,25,196,1366
"Bolivia","Santa Cruz","Andrés Ibáñez","Santa Cruz de la Sierra","COL.GASTON GUILLAUX",-63.17099,-17.77877,728,6,2912,3640,2454,57,395,2849
"Bolivia","Santa Cruz","Andrés Ibáñez","Santa Cruz de la Sierra","COL. GILBERTO MENACHO",-63.12507,-17.79899,871,62,5200,6071,3129,216,1793,4922
"Bolivia","Santa Cruz","Andrés Ibáñez","Santa Cruz de la Sierra","COL. GUALBERTO VILLARROEL",-63.16062,-17.77363,402,10,2624,3026,2179,45,390,2569
"Bolivia","Santa Cruz","Andrés Ibáñez","Santa Cruz de la Sierra","COL. GUAPILO JUNIN",-63.10236,-17.79171,769,31,4730,5499,3204,127,1368,4572
"Bolivia","Santa Cruz","Andrés Ibáñez","Santa Cruz de la Sierra","COL. HENRRY PRINCE",-63.20725,-17.81194,243,11,1409,1652,1048,27,323,1371
"Bolivia","Santa Cruz","Andrés Ibáñez","Santa Cruz de la Sierra","COL. HERMANOS CAVANIS",-63.22014,-17.81549,703,20,5427,6130,4031,164,1212,5243
"Bolivia","Santa Cruz","Andrés Ibáñez","Santa Cruz de la Sierra","COL. HERNANDO SILES",-63.17575,-17.86155,1926,71,10283,12209,5075,366,4771,9846
"Bolivia","Santa Cruz","Andrés Ibáñez","Santa Cruz de la Sierra","COL. HEROES DEL CHACO",-63.14454,-17.80119,730,21,4927,5657,3419,210,1277,4696
"Bolivia","Santa Cruz","Andrés Ibáñez","Santa Cruz de la Sierra","COL. HISPANO AMERICANO",-63.13283,-17.79934,319,12,1765,2084,1102,27,624,1726
"Bolivia","Santa Cruz","Andrés Ibáñez","Santa Cruz de la Sierra","COL. HNAS. ARREDONDO(COL.JESUS PEREDO)",-63.20106,-17.78474,533,39,3512,4045,2482,141,850,3332
"Bolivia","Santa Cruz","Andrés Ibáñez","Santa Cruz de la Sierra","COL. HUMBERTO EGUEZ",-63.11185,-17.79594,405,29,2887,3292,1660,168,1030,2690
"Bolivia","Santa Cruz","Andrés Ibáñez","Santa Cruz de la Sierra","COL.INST. DOMINGO SAVIO",-63.17353,-17.75908,178,1,870,1048,738,20,111,849
"Bolivia","Santa Cruz","Andrés Ibáñez","Santa Cruz de la Sierra","COL. INSTITUTO AMERICANO JUAN WESLEY",-63.16511,-17.78164,395,8,2843,3238,2379,93,363,2742
"Bolivia","Santa Cruz","Andrés Ibáñez","Santa Cruz de la Sierra","COL. INTERNACIONAL (BETHESDA)",-63.22035,-17.8294,344,14,2344,2688,1489,99,742,2231
"Bolivia","Santa Cruz","Andrés Ibáñez","Santa Cruz de la Sierra","COL. JHON KENNEDY",-63.19871,-17.78818,988,55,5951,6939,4339,182,1375,5714
"Bolivia","Santa Cruz","Andrés Ibáñez","Santa Cruz de la Sierra","COL. JOSEFINA GOYTIA",-63.17068,-17.79632,144,2,989,1133,860,20,107,967
"Bolivia","Santa Cruz","Andrés Ibáñez","Santa Cruz de la Sierra","COL. JOSE MALKY JESUS MARIA",-63.18144,-17.80808,895,13,4268,5163,3254,109,892,4146
"Bolivia","Santa Cruz","Andrés Ibáñez","Santa Cruz de la Sierra","COL. JUAN LA BORDE MOREL",-63.16035,-17.72277,282,3,2193,2475,1706,40,444,2150
"Bolivia","Santa Cruz","Andrés Ibáñez","Santa Cruz de la Sierra","COL. JUAN PABLO II",-63.17759,-17.7325,397,9,3247,3644,2813,126,299,3112
"Bolivia","Santa Cruz","Andrés Ibáñez","Santa Cruz de la Sierra","COL. JULIO A. GUTIERREZ",-63.18236,-17.79789,341,5,1524,1865,1214,30,275,1489
"Bolivia","Santa Cruz","Andrés Ibáñez","Santa Cruz de la Sierra","COL.KINDER FANNY ANTELO",-63.15987,-17.75532,107,3,704,811,537,13,151,688
"Bolivia","Santa Cruz","Andrés Ibáñez","Santa Cruz de la Sierra","COL. LA MADRE",-63.20914,-17.78125,598,17,3800,4398,2524,79,1180,3704
"Bolivia","Santa Cruz","Andrés Ibáñez","Santa Cruz de la Sierra","COL. LAS AMERICAS II",-63.19033,-17.86217,595,38,4929,5524,2664,348,1879,4543
"Bolivia","Santa Cruz","Andrés Ibáñez","Santa Cruz de la Sierra","COL.LA SANTA CRUZ",-63.17908,-17.76664,280,4,1998,2278,1757,54,183,1940
"Bolivia","Santa Cruz","Andrés Ibáñez","Santa Cruz de la Sierra","COL.LICEO MARIA VACADIEZ",-63.16927,-17.76587,164,1,1623,1787,1381,89,152,1533
"Bolivia","Santa Cruz","Andrés Ibáñez","Santa Cruz de la Sierra","COL. LUIS BARRANCO ALVAREZ",-63.12068,-17.84258,1072,48,5995,7067,2744,137,3066,5810
"Bolivia","Santa Cruz","Andrés Ibáñez","Santa Cruz de la Sierra","COL. LUIS ESPINAL CAMPOS",-63.16032,-17.86751,876,29,4883,5759,2253,222,2379,4632
"Bolivia","Santa Cruz","Andrés Ibáñez","Santa Cruz de la Sierra","COL. LUZ DEL ORIENTE",-63.13755,-17.79396,592,18,2849,3441,1917,78,836,2753
"Bolivia","Santa Cruz","Andrés Ibáñez","Santa Cruz de la Sierra","COL. LUZ Y SABER II",-63.14804,-17.73533,590,14,3343,3933,2463,113,753,3216
"Bolivia","Santa Cruz","Andrés Ibáñez","Santa Cruz de la Sierra","COL. MADRE CLARA RICCI (JESUS ROMAN VACA",-63.14016,-17.79584,208,2,1639,1847,1102,52,483,1585
"Bolivia","Santa Cruz","Andrés Ibáñez","Santa Cruz de la Sierra","COL. MAGDALENA POSTEL",-63.17854,-17.82687,569,19,3862,4431,2894,147,802,3696
"Bolivia","Santa Cruz","Andrés Ibáñez","Santa Cruz de la Sierra","COL. MARIA TERESA PULIDO",-63.1305,-17.8336,850,109,5129,5979,2601,250,2169,4770
"Bolivia","Santa Cruz","Andrés Ibáñez","Santa Cruz de la Sierra","COL. MARISCAL SUCRE",-63.15338,-17.77866,352,11,2646,2998,2240,45,350,2590
"Bolivia","Santa Cruz","Andrés Ibáñez","Santa Cruz de la Sierra","COL. MATEO KULJIS SECUNDARIO",-63.22539,-17.8377,463,43,4733,5196,2542,333,1815,4357
"Bolivia","Santa Cruz","Andrés Ibáñez","Santa Cruz de la Sierra","COL. MIRETTE SCIARONI",-63.18918,-17.76269,351,6,2162,2513,1833,48,275,2108
"Bolivia","Santa Cruz","Andrés Ibáñez","Santa Cruz de la Sierra","COL. M. NELLY VDA. DE BERTERO",-63.11536,-17.81427,271,13,1544,1815,770,44,717,1487
"Bolivia","Santa Cruz","Andrés Ibáñez","Santa Cruz de la Sierra","COL.MODULO # 5 ELVA ANTELO JORDAN",-63.16745,-17.86005,564,36,3171,3735,1558,63,1514,3072
"Bolivia","Santa Cruz","Andrés Ibáñez","Santa Cruz de la Sierra","COL. MODULO FLAMINGO",-63.21369,-17.82285,368,8,2480,2848,1922,45,505,2427
"Bolivia","Santa Cruz","Andrés Ibáñez","Santa Cruz de la Sierra","COL. MONSEÑOR LUIS RODRIGUEZ P.",-63.19559,-17.81594,916,24,5119,6035,3131,124,1840,4971
"Bolivia","Santa Cruz","Andrés Ibáñez","Santa Cruz de la Sierra","COL. NACIONAL 9 DE OCTUBRE",-63.15674,-17.84428,526,50,4490,5016,2931,218,1291,4222
"Bolivia","Santa Cruz","Andrés Ibáñez","Santa Cruz de la Sierra","COL. NACIONAL FLORIDA",-63.18027,-17.79039,150,4,1339,1489,1123,89,123,1246
"Bolivia","Santa Cruz","Andrés Ibáñez","Santa Cruz de la Sierra","COL. NACIONAL SALESIANO",-63.16814,-17.78925,276,6,1510,1786,1204,34,266,1470
"Bolivia","Santa Cruz","Andrés Ibáñez","Santa Cruz de la Sierra","COL. NIMIA CENTELLA",-63.11775,-17.78436,637,31,4115,4752,2457,170,1457,3914
"Bolivia","Santa Cruz","Andrés Ibáñez","Santa Cruz de la Sierra","COL. NORMANDIA JOSEFINA BALSAMO",-63.06764,-17.84974,559,35,3871,4430,1769,114,1953,3722
"Bolivia","Santa Cruz","Andrés Ibáñez","Santa Cruz de la Sierra","COL. NUCLEO ESCOLAR RAMAFA",-63.1834,-17.80372,238,7,1704,1942,1458,26,213,1671
"Bolivia","Santa Cruz","Andrés Ibáñez","Santa Cruz de la Sierra","COL. NUEVA AMERICA",-63.15847,-17.76582,330,8,1992,2322,1579,40,365,1944
"Bolivia","Santa Cruz","Andrés Ibáñez","Santa Cruz de la Sierra","COL. NUEVA ESPERANZA",-63.14962,-17.74375,384,10,1860,2244,1446,42,362,1808
"Bolivia","Santa Cruz","Andrés Ibáñez","Santa Cruz de la Sierra","COL. OBISPO SANTISTEVAN",-63.1792,-17.78578,113,2,731,844,653,16,60,713
"Bolivia","Santa Cruz","Andrés Ibáñez","Santa Cruz de la Sierra","COL. OSCAR ARNULFO",-63.23433,-17.82932,590,47,3909,4499,2207,272,1383,3590
"Bolivia","Santa Cruz","Andrés Ibáñez","Santa Cruz de la Sierra","COL. OVIDIO SANTISTEVAN",-63.19029,-17.74906,841,12,4602,5443,3526,130,934,4460
"Bolivia","Santa Cruz","Andrés Ibáñez","Santa Cruz de la Sierra","COL. PABLO SEXTO",-63.16424,-17.76425,256,3,1888,2144,1481,35,369,1850
"Bolivia","Santa Cruz","Andrés Ibáñez","Santa Cruz de la Sierra","COL. PAMPA DE LA CRUZ",-63.12878,-17.79276,436,15,2714,3150,1905,82,712,2617
"Bolivia","Santa Cruz","Andrés Ibáñez","Santa Cruz de la Sierra","COL. PAMPA DE LA ISLA",-63.12679,-17.77277,483,15,2007,2490,1340,39,613,1953
"Bolivia","Santa Cruz","Andrés Ibáñez","Santa Cruz de la Sierra","COL. PART. ALFRED B. NOBEL",-63.19432,-17.85304,275,8,1762,2037,1287,42,425,1712
"Bolivia","Santa Cruz","Andrés Ibáñez","Santa Cruz de la Sierra","COL.  PEDRO AÑEZ",-63.11894,-17.76698,815,27,4613,5428,2861,161,1564,4425
"Bolivia","Santa Cruz","Andrés Ibáñez","Santa Cruz de la Sierra","COL. PEDRO GUTIERREZ",-63.16812,-17.7553,264,7,2337,2601,2046,87,197,2243
"Bolivia","Santa Cruz","Andrés Ibáñez","Santa Cruz de la Sierra","COL  PLACIDO MOLILNA",-63.19062,-17.79406,506,21,2269,2775,1364,83,801,2165
"Bolivia","Santa Cruz","Andrés Ibáñez","Santa Cruz de la Sierra","COL.POLIFUNCIONAL CALAMA",-63.21886,-17.83718,533,26,3216,3749,1588,88,1514,3102
"Bolivia","Santa Cruz","Andrés Ibáñez","Santa Cruz de la Sierra","COL. PRIMAVERA",-63.1032,-17.81673,900,61,5207,6107,2346,200,2600,4946
"Bolivia","Santa Cruz","Andrés Ibáñez","Santa Cruz de la Sierra","COL. RAFAEL BUSTILLOS",-63.12329,-17.81418,625,21,3368,3993,1706,84,1557,3263
"Bolivia","Santa Cruz","Andrés Ibáñez","Santa Cruz de la Sierra","COL. RAMON DARIO GUTIERREZ",-63.164,-17.80529,196,0,1418,1614,1210,36,172,1382
"Bolivia","Santa Cruz","Andrés Ibáñez","Santa Cruz de la Sierra","COL.REPUBLICA DEL URUGUAY",-63.17242,-17.77493,459,9,2705,3164,2296,35,365,2661
"Bolivia","Santa Cruz","Andrés Ibáñez","Santa Cruz de la Sierra","COL. RODOLFO JOEM",-63.16545,-17.82204,1478,51,8097,9575,4736,285,3025,7761
"Bolivia","Santa Cruz","Andrés Ibáñez","Santa Cruz de la Sierra","COL.ROMULO HERRERA",-63.17609,-17.78023,217,5,1177,1394,840,29,303,1143
"Bolivia","Santa Cruz","Andrés Ibáñez","Santa Cruz de la Sierra","COL. SAGRADO CORAZON",-63.17153,-17.81605,139,5,937,1076,667,23,242,909
"Bolivia","Santa Cruz","Andrés Ibáñez","Santa Cruz de la Sierra","COL. SAN CARLOS",-63.15134,-17.79229,229,7,2142,2371,1689,94,352,2041
"Bolivia","Santa Cruz","Andrés Ibáñez","Santa Cruz de la Sierra","COL. SAN FRANCISCO DE SALES DON BOSCO",-63.0923,-17.76109,1196,51,7315,8511,5448,217,1599,7047
"Bolivia","Santa Cruz","Andrés Ibáñez","Santa Cruz de la Sierra","COL. SAN FRANCISCO SUR",-63.16087,-17.85275,562,26,3415,3977,1453,94,1842,3295
"Bolivia","Santa Cruz","Andrés Ibáñez","Santa Cruz de la Sierra","COL. SAN MARTIN DE PORRES",-63.2021,-17.77761,1088,30,7593,8681,4828,450,2285,7113
"Bolivia","Santa Cruz","Andrés Ibáñez","Santa Cruz de la Sierra","COL. SAN MARTIN NORTE",-63.14275,-17.7284,580,23,3799,4379,2529,217,1030,3559
"Bolivia","Santa Cruz","Andrés Ibáñez","Santa Cruz de la Sierra","COL. SAN PABLO",-63.18967,-17.83693,232,1,2029,2261,1671,29,328,1999
"Bolivia","Santa Cruz","Andrés Ibáñez","Santa Cruz de la Sierra","COL. SAN SILVESTRE",-63.11408,-17.81204,713,30,4262,4975,2053,119,2060,4113
"Bolivia","Santa Cruz","Andrés Ibáñez","Santa Cruz de la Sierra","COL. SANTA RAFAELA",-63.14124,-17.81471,378,44,2450,2828,1644,66,696,2340
"Bolivia","Santa Cruz","Andrés Ibáñez","Santa Cruz de la Sierra","COL. SECCIONAL MONSEÑOR SANTIESTEVAN",-63.18117,-17.77959,326,9,1516,1842,1195,25,287,1482
"Bolivia","Santa Cruz","Andrés Ibáñez","Santa Cruz de la Sierra","COL. SEFERINO NAMUCARA DON BOSCO",-63.17717,-17.77525,88,1,570,658,532,3,34,566
"Bolivia","Santa Cruz","Andrés Ibáñez","Santa Cruz de la Sierra","COL. SOCIEDAD DE INGENIEROS",-63.19918,-17.79882,427,8,3497,3924,2745,160,584,3329
"Bolivia","Santa Cruz","Andrés Ibáñez","Santa Cruz de la Sierra","COL. SOR MARIA CRISTINA PEREZ",-63.14532,-17.78059,1026,27,7718,8744,6347,174,1170,7517
"Bolivia","Santa Cruz","Andrés Ibáñez","Santa Cruz de la Sierra","COL.TECNOLOGICO SANTA CRUZ",-63.15675,-17.76927,192,8,1437,1629,1227,17,185,1412
"Bolivia","Santa Cruz","Andrés Ibáñez","Santa Cruz de la Sierra","COL. TRISTAN ROCA",-63.16394,-17.78412,376,11,2502,2878,1972,52,467,2439
"Bolivia","Santa Cruz","Andrés Ibáñez","Santa Cruz de la Sierra","COL.U.E.23 DE DICIEMBRE(J.  CARLOS TRUJI",-63.11529,-17.76983,847,40,4357,5204,3046,95,1176,4222
"Bolivia","Santa Cruz","Andrés Ibáñez","Santa Cruz de la Sierra","COL.U.E. 26 DE SEPTIEMBRE",-63.10361,-17.72374,994,45,5166,6160,2338,118,2665,5003
"Bolivia","Santa Cruz","Andrés Ibáñez","Santa Cruz de la Sierra","COL.U.E. ALFREDO BARBERY CHAVEZ",-63.11797,-17.75344,1039,47,6218,7257,3563,368,2240,5803
"Bolivia","Santa Cruz","Andrés Ibáñez","Santa Cruz de la Sierra","COL.U. E. CARLOS LA TORRE",-63.12363,-17.77396,515,47,3281,3796,2362,146,726,3088
"Bolivia","Santa Cruz","Andrés Ibáñez","Santa Cruz de la Sierra","COL.U.  E. EL DORADO NORTE",-63.09708,-17.73737,1662,45,8177,9839,4100,353,3679,7779
"Bolivia","Santa Cruz","Andrés Ibáñez","Santa Cruz de la Sierra","COL.U. E. EL RETOÑO",-63.07298,-17.73956,1068,34,5500,6568,3218,183,2065,5283
"Bolivia","Santa Cruz","Andrés Ibáñez","Santa Cruz de la Sierra","COL.U. E. ESCUELA ÑUFLO DE CHAVEZ",-63.15858,-17.74715,284,6,2043,2327,1766,43,228,1994
"Bolivia","Santa Cruz","Andrés Ibáñez","Santa Cruz de la Sierra","COL. U.E. LA RESURECCION -ESC.CONVIF",-63.17194,-17.7436,189,4,1609,1798,1478,10,117,1595
"Bolivia","Santa Cruz","Andrés Ibáñez","Santa Cruz de la Sierra","COL.U.E. NUEVO HORIZONTE",-63.10971,-17.73058,541,15,3152,3693,1403,265,1469,2872
"Bolivia","Santa Cruz","Andrés Ibáñez","Santa Cruz de la Sierra","COL.UNIDAD EDUCATIVA ESPAÑA",-63.11751,-17.77592,401,41,3081,3482,1827,141,1072,2899
"Bolivia","Santa Cruz","Andrés Ibáñez","Santa Cruz de la Sierra","COL. UNIDAD EDUCATIVA LA COLINA",-63.20247,-17.81842,705,25,4472,5177,2993,165,1289,4282
"Bolivia","Santa Cruz","Andrés Ibáñez","Santa Cruz de la Sierra","COL.UNIDAD EDUCATIVA LORENZO CABALLERO",-63.18774,-17.80008,241,8,1776,2017,1354,74,340,1694
"Bolivia","Santa Cruz","Andrés Ibáñez","Santa Cruz de la Sierra","COL.UNIDAD EDUCATIVA SAN JORGE",-63.10691,-17.83507,853,25,5194,6047,1655,299,3215,4870
"Bolivia","Santa Cruz","Andrés Ibáñez","Santa Cruz de la Sierra","COL. UV. LA MADRE",-63.21101,-17.78952,739,24,5166,5905,3851,183,1108,4959
"Bolivia","Santa Cruz","Andrés Ibáñez","Santa Cruz de la Sierra","COL.VENANCIO AQUINO VILLEGAS",-63.15873,-17.77472,176,1,1415,1591,1231,21,162,1393
"Bolivia","Santa Cruz","Andrés Ibáñez","Santa Cruz de la Sierra","COL. VICTOR PAZ ESTENSORO",-63.18661,-17.81709,729,26,4631,5360,2955,167,1483,4438
"Bolivia","Santa Cruz","Andrés Ibáñez","Santa Cruz de la Sierra","COL. VILLA ALEGRE",-63.17024,-17.87461,345,11,2083,2428,659,99,1314,1973
"Bolivia","Santa Cruz","Andrés Ibáñez","Santa Cruz de la Sierra","COL. VILLA BOLIVIA",-63.19029,-17.74906,746,17,3594,4340,2670,144,763,3433
"Bolivia","Santa Cruz","Andrés Ibáñez","Santa Cruz de la Sierra","COL. VILLA FATIMA",-63.20216,-17.81076,719,27,4231,4950,2904,118,1182,4086
"Bolivia","Santa Cruz","Andrés Ibáñez","Santa Cruz de la Sierra","COL. VILLA ROSARIO",-63.2086,-17.79646,787,24,3893,4680,2047,122,1700,3747
"Bolivia","Santa Cruz","Andrés Ibáñez","Santa Cruz de la Sierra","COL. VIRGEN DE COTOCA",-63.1789,-17.74445,463,14,3401,3864,2656,37,694,3350
"Bolivia","Santa Cruz","Andrés Ibáñez","Santa Cruz de la Sierra","COL.WENSESLAO MONTERO",-63.15583,-17.76315,370,12,2532,2902,2121,53,346,2467
"Bolivia","Santa Cruz","Andrés Ibáñez","Santa Cruz de la Sierra","ESC. APONTE TINEO(ESC.GREGORIO MORENO)",-63.18357,-17.76609,245,3,1632,1877,1412,54,163,1575
"Bolivia","Santa Cruz","Andrés Ibáñez","Santa Cruz de la Sierra","ESC.BERNARDO CADARIO(COL.KURT RICHTER)",-63.19029,-17.74906,537,11,2828,3365,2099,70,648,2747
"Bolivia","Santa Cruz","Andrés Ibáñez","Santa Cruz de la Sierra","ESC. CLARACUTA",-63.15587,-17.73351,342,10,2088,2430,1626,49,403,2029
"Bolivia","Santa Cruz","Andrés Ibáñez","Santa Cruz de la Sierra","ESC. GABRIEL JOSE MORENO",-62.94179,-17.88486,170,32,1584,1754,1141,42,369,1510
"Bolivia","Santa Cruz","Andrés Ibáñez","Santa Cruz de la Sierra","ESC. GERMAN BUSCH",-63.1716,-17.73681,401,6,2476,2877,1995,55,420,2415
"Bolivia","Santa Cruz","Andrés Ibáñez","Santa Cruz de la Sierra","ESC.HUGO BANZER SUAREZ",-63.1536,-17.88131,164,10,1245,1409,597,29,609,1206
"Bolivia","Santa Cruz","Andrés Ibáñez","Santa Cruz de la Sierra","ESC. JOSE MARIANO SERRANO",-63.16407,-17.72271,212,3,1279,1491,1103,12,161,1264
"Bolivia","Santa Cruz","Andrés Ibáñez","Santa Cruz de la Sierra","ESC. LA PEÑA",-62.96586,-17.96183,138,12,741,879,95,28,606,701
"Bolivia","Santa Cruz","Andrés Ibáñez","Santa Cruz de la Sierra","ESC LOS SAUCES I",-63.17955,-17.72833,408,10,2328,2736,1633,63,622,2255
"Bolivia","Santa Cruz","Andrés Ibáñez","Santa Cruz de la Sierra","ESC.MAMERTO CUELLAR COSTA",-63.16402,-17.69388,246,9,1758,2004,1254,46,449,1703
"Bolivia","Santa Cruz","Andrés Ibáñez","Santa Cruz de la Sierra","ESC. NORMAL ENRIQUET  FINOT",-63.19629,-17.76357,709,2,3948,4657,3621,20,305,3926
"Bolivia","Santa Cruz","Andrés Ibáñez","Santa Cruz de la Sierra","ESC. REAL AMERICA(ESC.F.FLORIDA)",-63.14962,-17.74375,237,4,1785,2022,1336,27,418,1754
"Bolivia","Santa Cruz","Andrés Ibáñez","Santa Cruz de la Sierra","ESC. RENE BARRIENTOS",-63.19794,-17.77104,590,10,3093,3683,2349,44,690,3039
"Bolivia","Santa Cruz","Andrés Ibáñez","Santa Cruz de la Sierra","ESC. SECCIONAL VILLA FLOR",-63.12761,-17.91508,92,11,643,735,324,20,288,612
"Bolivia","Santa Cruz","Andrés Ibáñez","Santa Cruz de la Sierra","ESC.SOLIDARIDAD 55",-63.09384,-17.88467,644,32,4023,4667,1800,199,1992,3792
"Bolivia","Santa Cruz","Andrés Ibáñez","Santa Cruz de la Sierra","ESCUELA 1RO DE MAYO",-63.12766,-17.79881,226,7,1399,1625,1031,62,299,1330
"Bolivia","Santa Cruz","Andrés Ibáñez","Santa Cruz de la Sierra","ESCUELA 23 DE MARZO",-63.14704,-17.71829,544,17,2990,3534,1885,104,984,2869
"Bolivia","Santa Cruz","Andrés Ibáñez","Santa Cruz de la Sierra","ESCUELA ADOLFO ROMAN HIJO",-62.82351,-17.6432,180,9,1323,1503,805,61,448,1253
"Bolivia","Santa Cruz","Andrés Ibáñez","Santa Cruz de la Sierra","ESCUELA CANOTO",-63.19444,-17.78442,162,3,1077,1239,867,14,193,1060
"Bolivia","Santa Cruz","Andrés Ibáñez","Santa Cruz de la Sierra","ESCUELA KM 9",-63.15509,-17.6916,574,11,3766,4340,2661,110,984,3645
"Bolivia","Santa Cruz","Andrés Ibáñez","Santa Cruz de la Sierra","ESCUELA NUEVA AURORA",-62.8249,-17.57719,40,0,63,103,48,3,12,60
"Bolivia","Santa Cruz","Andrés Ibáñez","Santa Cruz de la Sierra","ESCUELA PRIMAVERA",-63.1032,-17.81673,121,7,508,629,337,11,153,490
"Bolivia","Santa Cruz","Andrés Ibáñez","Santa Cruz de la Sierra","ESCUELA SAN CARLOS",-63.18186,-17.7572,467,7,2738,3205,2256,39,436,2692
"Bolivia","Santa Cruz","Andrés Ibáñez","Santa Cruz de la Sierra","ESCUELA SAN JOAQUIN",-63.13668,-17.72238,354,15,2179,2533,1317,129,718,2035
"Bolivia","Santa Cruz","Andrés Ibáñez","Santa Cruz de la Sierra","ESCUELA SECCIONAL GUAPILO",-63.08126,-17.74644,401,16,2227,2628,1374,81,756,2130
"Bolivia","Santa Cruz","Andrés Ibáñez","Santa Cruz de la Sierra","ESCUELA SECCIONAL ZAFRANILLA",-63.00508,-17.62794,43,2,314,357,199,9,104,303
"Bolivia","Santa Cruz","Andrés Ibáñez","Santa Cruz de la Sierra","ESC. USURI APONTE",-63.05743,-17.92564,60,2,218,278,132,7,77,209
"Bolivia","Santa Cruz","Andrés Ibáñez","Santa Cruz de la Sierra","ESC VILLA NORTE",-63.18038,-17.74704,265,5,1467,1732,1193,13,256,1449
"Bolivia","Santa Cruz","Andrés Ibáñez","Santa Cruz de la Sierra","ESC..ZENOVIA APONTE",-63.10257,-17.87117,277,11,1687,1964,782,39,855,1637
"Bolivia","Santa Cruz","Andrés Ibáñez","Santa Cruz de la Sierra","FACULTAD DE CIENCIAS AGRICOLAS UAGRM",-63.14874,-17.69814,22,2,303,325,207,8,86,293
"Bolivia","Santa Cruz","Andrés Ibáñez","Santa Cruz de la Sierra","FRED NUÑEZ GONZALES",-63.06961,-17.71776,88,9,1011,1099,453,26,523,976
"Bolivia","Santa Cruz","Andrés Ibáñez","Santa Cruz de la Sierra","GLADYS RIVERO DE JIMENEZ",-63.20806,-17.77348,469,14,3062,3531,2000,229,819,2819
"Bolivia","Santa Cruz","Andrés Ibáñez","Santa Cruz de la Sierra","KINDER CARIÑOSITO",-63.21444,-17.8494,1,0,3,4,2,0,1,3
"Bolivia","Santa Cruz","Andrés Ibáñez","Santa Cruz de la Sierra","KINDER FERROVIARIO",-63.145,-17.781,2,0,19,21,12,0,7,19
"Bolivia","Santa Cruz","Andrés Ibáñez","Santa Cruz de la Sierra","KINDER GUARDERIA EL CARMEN",-63.20383,-17.77054,1,1,48,49,39,2,6,45
"Bolivia","Santa Cruz","Andrés Ibáñez","Santa Cruz de la Sierra","KINDER LIBERTAD",-63.12066,-17.80011,0,0,9,9,7,1,1,8
"Bolivia","Santa Cruz","Andrés Ibáñez","Santa Cruz de la Sierra","KINDER LUISA SAUCEDO",-63.18323,-17.77909,103,0,758,861,677,5,76,753
"Bolivia","Santa Cruz","Andrés Ibáñez","Santa Cruz de la Sierra","KINDER NIMIA CENTELLA",-63.11775,-17.78436,0,0,45,45,31,10,4,35
"Bolivia","Santa Cruz","Andrés Ibáñez","Santa Cruz de la Sierra","LUZ DEL MUNDO C",-63.1118,-17.77199,10,0,142,152,98,0,44,142
"Bolivia","Santa Cruz","Andrés Ibáñez","Santa Cruz de la Sierra","MISIONES DE JESUS",-63.21696,-17.84764,0,1,285,285,130,53,101,231
"Bolivia","Santa Cruz","Andrés Ibáñez","Santa Cruz de la Sierra","MODULO EDUCATIVO 24 DE SEPTIEMBRE",-63.20504,-17.81955,28,1,110,138,73,4,32,105
"Bolivia","Santa Cruz","Andrés Ibáñez","Santa Cruz de la Sierra","MODULO EDUCATIVO 3 LAGUNAS",-63.1305,-17.80221,286,14,1915,2201,1082,40,779,1861
"Bolivia","Santa Cruz","Andrés Ibáñez","Santa Cruz de la Sierra","MODULO EDUCATIVO CENETROP",-63.17531,-17.86828,6,0,53,59,32,1,20,52
"Bolivia","Santa Cruz","Andrés Ibáñez","Santa Cruz de la Sierra","MODULO EDUCATIVO GERMAN BUSCH",-63.17423,-17.73516,13,2,151,164,126,2,21,147
"Bolivia","Santa Cruz","Andrés Ibáñez","Santa Cruz de la Sierra","MODULO EDUCATIVO JARDIN LATINO",-63.22685,-17.81104,0,0,65,65,52,3,10,62
"Bolivia","Santa Cruz","Andrés Ibáñez","Santa Cruz de la Sierra","MODULO EDUCATIVO JOSE MIGUEL DE VELASCO",-63.18459,-17.75368,703,54,4506,5209,3568,115,769,4337
"Bolivia","Santa Cruz","Andrés Ibáñez","Santa Cruz de la Sierra","MODULO EDUCATIVO MARIA DE MATTIAS",-63.19329,-17.84451,5,0,79,84,57,1,21,78
"Bolivia","Santa Cruz","Andrés Ibáñez","Santa Cruz de la Sierra","MODULO EDUCATIVO REPUBLICA DE COLOMBIA",-63.20602,-17.86002,18,4,196,214,84,0,108,192
"Bolivia","Santa Cruz","Andrés Ibáñez","Santa Cruz de la Sierra","MODULO RANCHO NUEVO",-63.12128,-17.74573,256,9,1188,1444,735,28,416,1151
"Bolivia","Santa Cruz","Andrés Ibáñez","Santa Cruz de la Sierra","MOTACUSAL",-63.10342,-17.68219,0,1,176,176,14,46,115,129
"Bolivia","Santa Cruz","Andrés Ibáñez","Santa Cruz de la Sierra","NACIONES UNIDAS",-63.17759,-17.7325,532,11,3355,3887,2418,150,776,3194
"Bolivia","Santa Cruz","Andrés Ibáñez","Santa Cruz de la Sierra","PEDRO DIEZ",-63.18398,-17.85394,31,0,133,164,83,2,48,131
"Bolivia","Santa Cruz","Andrés Ibáñez","Santa Cruz de la Sierra","PROGRESO",-63.13077,-17.72208,27,1,147,174,99,4,43,142
"Bolivia","Santa Cruz","Andrés Ibáñez","Santa Cruz de la Sierra","SAHARA GUARDIA",-63.20287,-17.85209,35,7,616,651,413,32,164,577
"Bolivia","Santa Cruz","Andrés Ibáñez","Santa Cruz de la Sierra","U.E. 18 DE JULIO",-63.0932,-17.7454,149,7,1028,1177,520,59,442,962
"Bolivia","Santa Cruz","Andrés Ibáñez","Santa Cruz de la Sierra","U.E 19 DE MARZO",-63.08685,-17.86819,16,1,294,310,91,1,201,292
"Bolivia","Santa Cruz","Andrés Ibáñez","Santa Cruz de la Sierra","U.E. 24 DE MARZO",-63.10131,-17.72942,16,1,153,169,51,6,95,146
"Bolivia","Santa Cruz","Andrés Ibáñez","Santa Cruz de la Sierra","U.E. 25 DE OCTUBRE",-63.0919,-17.81277,29,1,294,323,117,38,138,255
"Bolivia","Santa Cruz","Andrés Ibáñez","Santa Cruz de la Sierra","U.E. 26 DE JUNIO",-63.10215,-17.84533,37,2,245,282,100,9,134,234
"Bolivia","Santa Cruz","Andrés Ibáñez","Santa Cruz de la Sierra","U.E. 26 DE NOVIEMBRE",-63.13193,-17.73059,9,0,91,100,62,1,28,90
"Bolivia","Santa Cruz","Andrés Ibáñez","Santa Cruz de la Sierra","U.E. 2 DE ABRIL",-63.14366,-17.81759,17,1,111,128,86,3,21,107
"Bolivia","Santa Cruz","Andrés Ibáñez","Santa Cruz de la Sierra","UE 3 DE MAYO",-63.12704,-17.82614,95,7,635,730,284,19,325,609
"Bolivia","Santa Cruz","Andrés Ibáñez","Santa Cruz de la Sierra","U.E. APONTE DE JORORI",-63.02875,-17.88749,122,15,709,831,249,40,405,654
"Bolivia","Santa Cruz","Andrés Ibáñez","Santa Cruz de la Sierra","U.E. ARBOLEDA DE FATIMA",-63.09396,-17.77194,60,7,638,698,386,63,182,568
"Bolivia","Santa Cruz","Andrés Ibáñez","Santa Cruz de la Sierra","U.E. ARCA DE NOE",-63.0994,-17.74709,0,39,1073,1073,561,123,350,911
"Bolivia","Santa Cruz","Andrés Ibáñez","Santa Cruz de la Sierra","U.E. BIBOSI",-63.10976,-17.72477,16,1,109,125,53,2,53,106
"Bolivia","Santa Cruz","Andrés Ibáñez","Santa Cruz de la Sierra","U.E. CIELITO LINDO",-63.10667,-17.77039,97,39,1192,1289,746,61,346,1092
"Bolivia","Santa Cruz","Andrés Ibáñez","Santa Cruz de la Sierra","U.E. CLARA SERRANO",-63.06764,-17.69809,10,2,136,146,66,0,68,134
"Bolivia","Santa Cruz","Andrés Ibáñez","Santa Cruz de la Sierra","UE DOMINGO FAUSTINO",-63.1547,-17.78424,203,11,1367,1570,1142,21,193,1335
"Bolivia","Santa Cruz","Andrés Ibáñez","Santa Cruz de la Sierra","U.E. EL ARENAL C",-63.12381,-17.76286,0,3,29,29,10,0,16,26
"Bolivia","Santa Cruz","Andrés Ibáñez","Santa Cruz de la Sierra","U.E. HACIA LA CUMBRE",-63.13114,-17.79115,15,0,67,82,52,0,15,67
"Bolivia","Santa Cruz","Andrés Ibáñez","Santa Cruz de la Sierra","U.E. ISUTO",-63.19371,-17.74409,77,1,524,601,385,16,122,507
"Bolivia","Santa Cruz","Andrés Ibáñez","Santa Cruz de la Sierra","U.E. JOSEFINA BALSAMO CORDECRUZ",-63.13193,-17.73059,2,0,25,27,20,2,3,23
"Bolivia","Santa Cruz","Andrés Ibáñez","Santa Cruz de la Sierra","U.E. JOSEFINA BALSAMO LOS PINOS",-63.13827,-17.73302,10,3,107,117,67,0,37,104
"Bolivia","Santa Cruz","Andrés Ibáñez","Santa Cruz de la Sierra","U.E. LOS CUSIS",-63.07648,-17.73135,106,9,849,955,516,58,266,782
"Bolivia","Santa Cruz","Andrés Ibáñez","Santa Cruz de la Sierra","U.E. LUIS ANTONIO AÑEZ CAMPOS",-63.12105,-17.83816,18,0,117,135,49,4,64,113
"Bolivia","Santa Cruz","Andrés Ibáñez","Santa Cruz de la Sierra","U.E. MANANTIAL DE VIDA",-63.07259,-17.85223,64,8,804,868,307,17,472,779
"Bolivia","Santa Cruz","Andrés Ibáñez","Santa Cruz de la Sierra","U.E. MANOS UNIDAS",-63.12869,-17.83705,6,0,30,36,13,1,16,29
"Bolivia","Santa Cruz","Andrés Ibáñez","Santa Cruz de la Sierra","U.E. MARIA DE LAS CANDELARIAS",-63.11254,-17.78087,0,0,3,3,3,0,0,3
"Bolivia","Santa Cruz","Andrés Ibáñez","Santa Cruz de la Sierra","U.E. MATEO KULJIS LLIC II",-63.22541,-17.83761,19,2,65,84,35,3,25,60
"Bolivia","Santa Cruz","Andrés Ibáñez","Santa Cruz de la Sierra","U.E. MIGUEL APONTE",-63.02794,-17.93152,1,0,3,4,3,0,0,3
"Bolivia","Santa Cruz","Andrés Ibáñez","Santa Cruz de la Sierra","U.E. NESTOR PAZ ZAMORA",-63.16751,-17.82976,35,5,249,284,157,2,85,242
"Bolivia","Santa Cruz","Andrés Ibáñez","Santa Cruz de la Sierra","U.E. PALMAR DEL ORIENTE",-63.16326,-17.84556,0,0,38,38,23,4,11,34
"Bolivia","Santa Cruz","Andrés Ibáñez","Santa Cruz de la Sierra","U.E. PASTORCITO DE FÁTIMA (DON BOSCO)",-63.19865,-17.77891,5,0,32,37,27,0,5,32
"Bolivia","Santa Cruz","Andrés Ibáñez","Santa Cruz de la Sierra","U.E. REP. DEL PARAGUAY",-63.19029,-17.74906,9,0,74,83,38,6,30,68
"Bolivia","Santa Cruz","Andrés Ibáñez","Santa Cruz de la Sierra","U.E. SAN CAYETANO",-63.08637,-17.73178,122,9,946,1068,529,14,394,923
"Bolivia","Santa Cruz","Andrés Ibáñez","Santa Cruz de la Sierra","U.E. SAN DIEGO DE SAMARIA",-63.07624,-17.84651,39,0,237,276,99,3,135,234
"Bolivia","Santa Cruz","Andrés Ibáñez","Santa Cruz de la Sierra","U.E. SAN JUAN BAUTISTA",-63.084,-17.82422,27,2,323,350,143,9,169,312
"Bolivia","Santa Cruz","Andrés Ibáñez","Santa Cruz de la Sierra","U.E. SAN JUAN DEL ESTE",-63.05619,-17.85738,15,1,80,95,36,2,41,77
"Bolivia","Santa Cruz","Andrés Ibáñez","Santa Cruz de la Sierra","U.E. SAN MIGUEL APONTE",-63.02491,-17.91358,4,6,133,137,73,2,52,125
"Bolivia","Santa Cruz","Andrés Ibáñez","Santa Cruz de la Sierra","U.E. SANTA ANA C",-63.22587,-17.82052,19,0,118,137,66,2,50,116
"Bolivia","Santa Cruz","Andrés Ibáñez","Santa Cruz de la Sierra","U.E. SANTA CRUZ DE LA SIERRA",-63.15969,-17.70646,415,6,3367,3782,2847,58,456,3303
"Bolivia","Santa Cruz","Andrés Ibáñez","Santa Cruz de la Sierra","U.E. SEÑOR DE LOS MILAGROS",-63.11103,-17.73937,0,0,124,124,69,12,43,112
"Bolivia","Santa Cruz","Andrés Ibáñez","Santa Cruz de la Sierra","U.E. SIXTO SUAREZ NAVARRO",-63.08702,-17.83393,23,7,321,344,119,8,187,306
"Bolivia","Santa Cruz","Andrés Ibáñez","Santa Cruz de la Sierra","U.E. SIXTO SUAREZ NAVARRO",-63.08702,-17.83391,23,7,321,344,119,8,187,306
"Bolivia","Santa Cruz","Andrés Ibáñez","Santa Cruz de la Sierra","U.E. THEVENET DE VIANA",-63.05536,-17.87156,17,7,275,292,122,5,141,263
"Bolivia","Santa Cruz","Andrés Ibáñez","Santa Cruz de la Sierra","UE UNION Y PROGRESO",-63.20576,-17.82713,633,27,3331,3964,1659,127,1518,3177
"Bolivia","Santa Cruz","Andrés Ibáñez","Santa Cruz de la Sierra","U.E. VICTORIA",-63.10123,-17.8158,35,1,113,148,55,1,56,111
"Bolivia","Santa Cruz","Andrés Ibáñez","Santa Cruz de la Sierra","U.E. VICTORIA DIEZ",-63.19228,-17.87336,2,0,37,39,21,5,11,32
"Bolivia","Santa Cruz","Andrés Ibáñez","Santa Cruz de la Sierra","U.E. VILLA ALBA",-63.11149,-17.76056,4,1,12,16,7,0,4,11
"Bolivia","Santa Cruz","Andrés Ibáñez","Santa Cruz de la Sierra","U.E. VILLA MODERNA",-63.08892,-17.84801,59,10,444,503,158,7,269,427
"Bolivia","Santa Cruz","Andrés Ibáñez","Santa Cruz de la Sierra","U.E. ZARAGOZA",-63.0803,-17.73039,71,5,839,910,460,27,347,807
"Bolivia","Santa Cruz","Andrés Ibáñez","Santa Cruz de la Sierra","UNIDAD EDUCATIVA POMPEYA SANTISIMO REDENTOR",-63.13646,-17.73572,1180,25,6120,7300,3745,175,2175,5920
"Bolivia","Santa Cruz","Andrés Ibáñez","Santa Cruz de la Sierra","UNIDAD EDUCATIVA SAN JORGE NORTE",-63.18151,-17.74152,366,6,2032,2398,1567,47,412,1979
"Bolivia","Santa Cruz","Andrés Ibáñez","Santa Cruz de la Sierra","UNIDAD EDUCATIVA SAN JUAN",-63.15163,-17.71595,101,5,661,762,458,19,179,637
"Bolivia","Santa Cruz","Andrés Ibáñez","Santa Cruz de la Sierra","UNIVERSITARIO SUR",-63.20155,-17.84228,11,2,203,214,138,10,53,191
"Bolivia","Santa Cruz","Andrés Ibáñez","Santa Cruz de la Sierra","URKUPIÑA",-63.10837,-17.74188,39,51,579,618,278,20,230,508
"Bolivia","Santa Cruz","Andrés Ibáñez","Santa Cruz de la Sierra","VIRGEN DE GUADALUPE",-63.12177,-17.72815,178,21,1962,2140,1155,89,697,1852
"Bolivia","Santa Cruz","Ángel Sandoval","San Matías","ESC. BENJAMIN CATACORA",-59.44956,-16.31998,104,6,544,648,294,40,204,498
"Bolivia","Santa Cruz","Ángel Sandoval","San Matías","ESC. LAS PETAS",-58.39948,-16.36022,94,4,318,412,206,3,105,311
"Bolivia","Santa Cruz","Ángel Sandoval","San Matías","ESC. SAN FERNANDO",-58.50947,-17.16588,29,0,41,70,32,0,9,41
"Bolivia","Santa Cruz","Ángel Sandoval","San Matías","ESC. SANTA ISABEL",-58.64299,-16.41756,15,0,96,111,24,1,71,95
"Bolivia","Santa Cruz","Ángel Sandoval","San Matías","ESC. SANTO CORAZON",-58.80663,-17.97362,65,1,218,283,144,3,70,214
"Bolivia","Santa Cruz","Ángel Sandoval","San Matías","ESC. SECCIONAL CANDELARIA",-58.98688,-18.62612,92,1,259,351,132,5,121,253
"Bolivia","Santa Cruz","Ángel Sandoval","San Matías","ESC. U.E. EMILIA RODAT",-58.40152,-16.35967,635,77,2354,2989,1139,27,1111,2250
"Bolivia","Santa Cruz","Ángel Sandoval","San Matías","ESC. U.E.TECNICA VOCACIONAL",-58.40529,-16.36109,559,83,1882,2441,855,36,908,1763
"Bolivia","Santa Cruz","Chiquitos","Pailón","ESC. 25 DE MAYO (CHIQUITOS)",-62.72187,-17.665,7,2,97,104,18,4,73,91
"Bolivia","Santa Cruz","Chiquitos","Pailón","ESC. 3 DE MAYO",-62.71723,-17.65756,240,24,1005,1245,435,32,514,949
"Bolivia","Santa Cruz","Chiquitos","Pailón","ESC. EL TINTO",-61.51249,-17.66647,41,1,104,145,58,2,43,101
"Bolivia","Santa Cruz","Chiquitos","Pailón","ESC. EMILIO SUNCER SALINAS",-61.98844,-17.60188,99,4,358,457,159,6,189,348
"Bolivia","Santa Cruz","Chiquitos","Pailón","ESC. FE ALEGRIA",-62.72065,-17.65843,1615,81,7072,8687,4100,231,2660,6760
"Bolivia","Santa Cruz","Chiquitos","Pailón","ESC. MUNICIPAL ROSAL CENTRO",-62.68006,-17.93407,80,3,517,597,281,14,219,500
"Bolivia","Santa Cruz","Chiquitos","Pailón","ESC. POZA VERDE",-62.70517,-17.71927,18,0,93,111,17,3,73,90
"Bolivia","Santa Cruz","Chiquitos","Pailón","ESC. PUESTO PAZ",-62.44294,-17.48613,0,2,75,75,20,15,38,58
"Bolivia","Santa Cruz","Chiquitos","Pailón","ESC. SECCIONAL CAÑADA LARGA",-62.49146,-17.64193,57,2,278,335,167,2,107,274
"Bolivia","Santa Cruz","Chiquitos","Pailón","ESCUELA TUNAS NUEVO",-61.71287,-17.63908,195,9,605,800,105,8,483,588
"Bolivia","Santa Cruz","Chiquitos","Pailón","U.E. 12 DE OCTUBRE",-61.51058,-17.54329,0,1,39,39,26,0,12,38
"Bolivia","Santa Cruz","Chiquitos","Pailón","U.E. ING. JORGE MAURICIO ROJAS P.",-62.76874,-17.66311,9,3,129,138,85,4,37,122
"Bolivia","Santa Cruz","Chiquitos","Roboré","ESC. DON BOSCO",-59.75139,-18.33508,506,10,1459,1965,962,17,470,1432
"Bolivia","Santa Cruz","Chiquitos","Roboré","ESC. GUIDO OSWALDO SUANZO",-59.75161,-18.33875,343,17,1223,1566,824,15,367,1191
"Bolivia","Santa Cruz","Chiquitos","Roboré","ESC. LOS SOTOS",-59.8557,-18.24889,19,0,90,109,38,1,51,89
"Bolivia","Santa Cruz","Chiquitos","Roboré","ESC. MARISTA",-59.75665,-18.34039,455,11,1400,1855,909,18,462,1371
"Bolivia","Santa Cruz","Chiquitos","Roboré","ESC. NAPOLEON MONTERO MONTERO",-59.59888,-18.33945,176,7,616,792,463,5,141,604
"Bolivia","Santa Cruz","Chiquitos","Roboré","ESC. SAGRADA FAMILIA",-59.75781,-18.33087,484,17,1757,2241,1185,43,512,1697
"Bolivia","Santa Cruz","Chiquitos","Roboré","ESC. SAN ANTONIO DEL POTRERO",-59.74802,-18.342,8,1,45,53,13,1,30,43
"Bolivia","Santa Cruz","Chiquitos","Roboré","ESC. SECCIONAL AGUAS CALIENTES",-59.50294,-18.45304,55,5,346,401,108,12,221,329
"Bolivia","Santa Cruz","Chiquitos","Roboré","ESC.SECCIONAL CHOCHIS",-60.03102,-18.14897,94,3,453,547,350,8,92,442
"Bolivia","Santa Cruz","Chiquitos","San José de Chiquitos","ESC. EDUCACIONAL TAPERAS",-62.70883,-17.65825,113,6,445,558,267,8,164,431
"Bolivia","Santa Cruz","Chiquitos","San José de Chiquitos","ESC. GERMAN BUSCH",-60.74323,-17.84692,794,15,2574,3368,1633,53,873,2506
"Bolivia","Santa Cruz","Chiquitos","San José de Chiquitos","ESC. LEONOR RIVERA",-60.7432,-17.83881,673,19,2279,2952,1367,33,860,2227
"Bolivia","Santa Cruz","Chiquitos","San José de Chiquitos","ESC.MUNICIPAL",-61.17406,-17.70868,29,1,233,262,140,4,88,228
"Bolivia","Santa Cruz","Chiquitos","San José de Chiquitos","ESC. NUEVO HORIZONTE",-60.73072,-17.43794,0,15,75,75,40,0,20,60
"Bolivia","Santa Cruz","Chiquitos","San José de Chiquitos","ESC. SAN JUAN",-59.93511,-17.77805,129,6,304,433,169,1,128,297
"Bolivia","Santa Cruz","Chiquitos","San José de Chiquitos","ESC. SANTA TERESITA",-60.49098,-17.94919,0,0,13,13,0,0,13,13
"Bolivia","Santa Cruz","Chiquitos","San José de Chiquitos","ESC. UNZAGA DE LA VEGA",-60.73931,-17.84642,603,63,2603,3206,1663,52,825,2488
"Bolivia","Santa Cruz","Chiquitos","San José de Chiquitos","U.E. BUENA VISTA",-59.97245,-17.82214,12,2,166,178,98,3,63,161
"Bolivia","Santa Cruz","Chiquitos","San José de Chiquitos","U.E. RAMADA",-60.05825,-18.00214,2,1,41,43,22,1,17,39
"Bolivia","Santa Cruz","Cordillera","Boyuibe","ESC. CENTRAL RAFAEL PABON",-63.28176,-20.43133,615,20,1770,2385,806,55,889,1695
"Bolivia","Santa Cruz","Cordillera","Boyuibe","ESC. SECC. CHOROQUETAL LA ELE",-62.71613,-20.43031,11,0,13,24,8,0,5,13
"Bolivia","Santa Cruz","Cordillera","Boyuibe","ESC. SECC. POZO DE MONTE",-63.21899,-20.28442,0,1,85,85,25,13,46,71
"Bolivia","Santa Cruz","Cordillera","Cabezas","ESC. 12 DE ABRIL",-63.21368,-18.45699,296,37,1584,1880,796,61,690,1486
"Bolivia","Santa Cruz","Cordillera","Cabezas","ESC. COTOCA (CORDILLERA)",-63.19016,-18.28279,10,1,82,92,65,1,15,80
"Bolivia","Santa Cruz","Cordillera","Cabezas","ESC. EDUARDO ABAROA",-63.42406,-18.29929,20,2,178,198,77,25,74,151
"Bolivia","Santa Cruz","Cordillera","Cabezas","ESC. PAMPA DEL COSCAL",-63.31197,-18.78212,48,2,226,274,68,10,146,214
"Bolivia","Santa Cruz","Cordillera","Cabezas","ESC. PTO. CAMACHO",-63.39868,-18.90593,301,26,1630,1931,899,68,637,1536
"Bolivia","Santa Cruz","Cordillera","Cabezas","ESC. RIO SECO FLORIDA",-63.24144,-18.67221,93,3,413,506,207,28,175,382
"Bolivia","Santa Cruz","Cordillera","Cabezas","ESC. SANTA ROSA",-63.00379,-18.31618,30,3,145,175,74,1,67,141
"Bolivia","Santa Cruz","Cordillera","Cabezas","ESC. SECC. EL CURICHI",-63.18411,-18.36359,15,0,105,120,68,6,31,99
"Bolivia","Santa Cruz","Cordillera","Cabezas","ESC. SECCIONAL EL FILO",-63.31801,-18.78696,0,1,22,22,20,0,1,21
"Bolivia","Santa Cruz","Cordillera","Cabezas","ESC. SECCIONAL PUEBLO VIEJO",-63.32113,-18.79173,66,8,221,287,116,2,95,211
"Bolivia","Santa Cruz","Cordillera","Cabezas","ESC. SECC SAN FRANCISCO DE ASIS",-62.9499,-18.13124,75,8,297,372,97,11,181,278
"Bolivia","Santa Cruz","Cordillera","Cabezas","ESC. SERAFIN RODRIGUEZ",-63.31145,-18.78667,419,19,1402,1821,760,94,529,1289
"Bolivia","Santa Cruz","Cordillera","Cabezas","ESC. YATIRENDA",-63.22488,-18.60128,11,3,196,207,147,4,42,189
"Bolivia","Santa Cruz","Cordillera","Cabezas","ESC. ZANJA HONDA",-63.30159,-18.78745,219,23,1238,1457,611,41,563,1174
"Bolivia","Santa Cruz","Cordillera","Camiri","AULAS U.A.G.R.M.",-63.52124,-20.03783,635,37,2928,3563,1600,107,1184,2784
"Bolivia","Santa Cruz","Cordillera","Camiri","COL. HUGO ARTEAGA",-63.51498,-20.03587,214,14,968,1182,600,25,329,929
"Bolivia","Santa Cruz","Cordillera","Camiri","ESC. 12 DE JULIO",-63.53097,-20.04149,431,27,2244,2675,1228,122,867,2095
"Bolivia","Santa Cruz","Cordillera","Camiri","ESC. 16 DE MARZO",-63.52925,-20.04896,254,22,1233,1487,640,50,521,1161
"Bolivia","Santa Cruz","Cordillera","Camiri","ESC. 24 DE SEPTIEMBRE",-63.5203,-20.04004,370,17,1891,2261,1173,60,641,1814
"Bolivia","Santa Cruz","Cordillera","Camiri","ESC. ABEL ITURRALDE",-63.52305,-20.04487,309,11,1455,1764,906,35,503,1409
"Bolivia","Santa Cruz","Cordillera","Camiri","ESC. APONTE J. MANUEL O.H. DEL CHACO",-63.52154,-20.04499,240,15,1528,1768,949,36,528,1477
"Bolivia","Santa Cruz","Cordillera","Camiri","ESC. CENTRAL DE ITANAMBIKUA",-63.51152,-20.01815,70,15,484,554,109,26,334,443
"Bolivia","Santa Cruz","Cordillera","Camiri","ESC. CENTRAL URBANA",-63.53619,-20.01045,231,14,718,949,327,20,357,684
"Bolivia","Santa Cruz","Cordillera","Camiri","ESC. CRISTIANA EVANGELICA",-63.52061,-20.04179,153,7,889,1042,590,17,275,865
"Bolivia","Santa Cruz","Cordillera","Camiri","ESC. GABRIEL RENE MORENO",-63.52212,-20.03892,393,15,1646,2039,957,42,632,1589
"Bolivia","Santa Cruz","Cordillera","Camiri","ESC. JOSE CASTRILLO",-63.52077,-20.03724,301,18,1404,1705,708,42,636,1344
"Bolivia","Santa Cruz","Cordillera","Camiri","ESC. NIÑO JESUS",-63.51853,-20.04194,165,7,916,1081,635,21,253,888
"Bolivia","Santa Cruz","Cordillera","Camiri","ESC. SECC. CURUNDAITY",-63.52541,-19.96275,39,5,284,323,44,4,231,275
"Bolivia","Santa Cruz","Cordillera","Camiri","ESC. SECC. GUIRARAPO",-63.48684,-20.09914,18,2,120,138,41,5,72,113
"Bolivia","Santa Cruz","Cordillera","Camiri","ESC. SECC. IMBOCHI",-63.51324,-20.06726,19,9,114,133,36,3,66,102
"Bolivia","Santa Cruz","Cordillera","Camiri","ESC. SECCIONAL EL RODEO",-63.41266,-19.96312,31,9,205,236,31,13,152,183
"Bolivia","Santa Cruz","Cordillera","Camiri","ESC. SECCIONAL PIPI",-63.42315,-20.08308,37,2,147,184,22,2,121,143
"Bolivia","Santa Cruz","Cordillera","Camiri","ESC. SECC. PUENTE VIEJO",-63.54469,-20.01106,36,9,185,221,49,5,122,171
"Bolivia","Santa Cruz","Cordillera","Charagua","ESC. 25 DE MAYO",-62.11812,-18.4546,47,0,79,126,12,1,66,78
"Bolivia","Santa Cruz","Cordillera","Charagua","ESC. CENTRAL IYOBI",-63.14491,-19.7853,129,14,596,725,249,13,320,569
"Bolivia","Santa Cruz","Cordillera","Charagua","ESC. COOPERE BRECHA",-62.7429,-19.42522,146,6,419,565,105,14,294,399
"Bolivia","Santa Cruz","Cordillera","Charagua","ESC. ENRIQUE QUINTELA",-63.18414,-20.00909,116,10,549,665,228,14,297,525
"Bolivia","Santa Cruz","Cordillera","Charagua","ESC. ESTACION CHARAGUA",-63.1487,-19.78266,181,15,819,1000,392,22,390,782
"Bolivia","Santa Cruz","Cordillera","Charagua","ESC. NUCLEO ESCOLAR LA BRECHA",-62.7429,-19.42522,150,8,547,697,188,10,341,529
"Bolivia","Santa Cruz","Cordillera","Charagua","ESC. NUEVA ESPERANZA",-63.20002,-19.79183,53,0,84,137,19,1,64,83
"Bolivia","Santa Cruz","Cordillera","Charagua","ESC. OKITA",-63.2003,-19.79011,16,2,72,88,10,0,60,70
"Bolivia","Santa Cruz","Cordillera","Charagua","ESC. PUEBLO NUEVO PARAPETI",-63.13974,-19.98935,31,3,163,194,63,8,89,152
"Bolivia","Santa Cruz","Cordillera","Charagua","ESC. SECC. CENTRAL MASAVI",-63.19563,-19.79061,63,14,348,411,84,9,241,325
"Bolivia","Santa Cruz","Cordillera","Charagua","ESC. SECC. DE KAIPEPE",-63.19104,-19.79076,29,5,264,293,72,7,180,252
"Bolivia","Santa Cruz","Cordillera","Charagua","ESC. SECC. EL ESPINO",-63.32734,-19.21872,47,8,394,441,54,8,324,378
"Bolivia","Santa Cruz","Cordillera","Charagua","ESC. SECC. HUARIRENDA NUEVA",-63.19857,-19.78299,120,7,310,430,104,6,193,297
"Bolivia","Santa Cruz","Cordillera","Charagua","ESC. SECCIONAL ISIPORENDA",-62.5005,-19.24791,49,0,112,161,28,2,82,110
"Bolivia","Santa Cruz","Cordillera","Charagua","ESC. SECCIONAL ITATIQUE",-63.17703,-19.99888,11,0,82,93,8,1,73,81
"Bolivia","Santa Cruz","Cordillera","Charagua","ESC. SECCIONAL SAN F. DE PARAPETI",-63.17523,-19.99946,36,7,144,180,43,2,92,135
"Bolivia","Santa Cruz","Cordillera","Charagua","ESC. SECCIONAL SAN LORENZO",-63.12445,-19.649,19,0,87,106,36,4,47,83
"Bolivia","Santa Cruz","Cordillera","Charagua","ESC. SECC. RANCHO NUEVO",-63.1832,-20.01321,117,18,387,504,160,11,198,358
"Bolivia","Santa Cruz","Cordillera","Charagua","ESC. SECC. TACOBO",-63.19634,-19.78686,26,7,216,242,50,9,150,200
"Bolivia","Santa Cruz","Cordillera","Charagua","ESC. SECC. TAPUTA",-63.22105,-19.5902,0,33,272,272,13,9,217,230
"Bolivia","Santa Cruz","Cordillera","Charagua","ESCUELA CENTRAL FE Y ALEGRIA",-63.19686,-19.79076,461,28,2212,2673,1281,67,836,2117
"Bolivia","Santa Cruz","Cordillera","Charagua","ESCUELA SECCIONAL SAIPURU",-63.14339,-19.78258,0,2,132,132,56,27,47,103
"Bolivia","Santa Cruz","Cordillera","Charagua","U.E. 24 DE SEPTIEMBRE",-63.19831,-19.75614,1,4,65,66,16,5,40,56
"Bolivia","Santa Cruz","Cordillera","Charagua","U.E. JOSERAVI",-62.29416,-18.33184,19,0,62,81,36,1,25,61
"Bolivia","Santa Cruz","Cordillera","Charagua","U.E. JUAN LUIS OTIN",-63.08943,-19.97976,2,2,90,92,37,6,45,82
"Bolivia","Santa Cruz","Cordillera","Charagua","U.E. MACHIPO",-63.17883,-19.83895,6,8,100,106,36,4,52,88
"Bolivia","Santa Cruz","Cordillera","Charagua","U.E. PEDRO RAMOS",-63.21563,-19.63187,3,2,121,124,49,2,68,117
"Bolivia","Santa Cruz","Cordillera","Charagua","U.E. YAPIROA",-62.57546,-19.60771,5,1,185,190,112,5,67,179
"Bolivia","Santa Cruz","Cordillera","Cuevo","ESC. SECC. EL ARENAL",-63.51422,-20.40347,0,0,8,8,1,0,7,8
"Bolivia","Santa Cruz","Cordillera","Cuevo","ESC. SECC. ITAKUATIA",-63.51872,-20.45691,10,2,64,74,42,3,17,59
"Bolivia","Santa Cruz","Cordillera","Cuevo","ESC. UB. ANGEL SANDOVAL",-63.46928,-20.39243,502,20,1218,1720,706,26,466,1172
"Bolivia","Santa Cruz","Cordillera","Cuevo","ESC. UNIDAD EDUCATIVA IVICUATI",-63.41391,-20.37102,42,3,144,186,95,0,46,141
"Bolivia","Santa Cruz","Cordillera","Cuevo","ESC. UNIDAD SECCIONAL HUARACA",-63.51622,-20.4536,29,2,116,145,83,3,28,111
"Bolivia","Santa Cruz","Cordillera","Cuevo","U.E. EL ARENAL",-63.51412,-20.40366,9,2,98,107,5,3,88,93
"Bolivia","Santa Cruz","Cordillera","Cuevo","U.E. SALINAS",-63.46267,-20.226,16,1,93,109,19,2,71,90
"Bolivia","Santa Cruz","Cordillera","Gutiérrez","ESC. CENTRAL IPATIMIRI",-63.48169,-19.76727,85,7,515,600,167,30,311,478
"Bolivia","Santa Cruz","Cordillera","Gutiérrez","ESC. EMILIO FINOT",-63.52944,-19.42346,196,10,749,945,446,15,278,724
"Bolivia","Santa Cruz","Cordillera","Gutiérrez","ESC. IBAMIRAPINTA",-63.53056,-19.4212,90,18,552,642,185,17,332,517
"Bolivia","Santa Cruz","Cordillera","Gutiérrez","ESC. KURUGUAKUA",-63.52905,-19.42271,20,1,107,127,22,1,83,105
"Bolivia","Santa Cruz","Cordillera","Gutiérrez","ESC. MARCELINO REVOLLO",-63.39302,-19.72541,92,19,566,658,229,16,302,531
"Bolivia","Santa Cruz","Cordillera","Gutiérrez","ESC. MARISCAL SUCRE",-63.50597,-19.35422,67,15,298,365,181,4,98,279
"Bolivia","Santa Cruz","Cordillera","Gutiérrez","ESC. MIGUEL LANDIVAR",-63.50658,-19.34445,59,8,348,407,111,21,208,319
"Bolivia","Santa Cruz","Cordillera","Gutiérrez","ESC. PALMARITO",-63.46463,-19.50546,69,2,267,336,21,11,233,254
"Bolivia","Santa Cruz","Cordillera","Gutiérrez","ESC. SECC. GUASANTI",-63.42537,-19.78613,32,4,243,275,57,7,175,232
"Bolivia","Santa Cruz","Cordillera","Gutiérrez","ESC. SECCIONAL CAIPIPENDI",-63.3559,-19.78204,0,5,54,54,11,0,38,49
"Bolivia","Santa Cruz","Cordillera","Gutiérrez","ESC. SECCIONAL CAPIRENDA",-63.37655,-19.6701,36,5,225,261,45,10,165,210
"Bolivia","Santa Cruz","Cordillera","Gutiérrez","ESC. SECCIONAL ITEMBEGUAZU",-63.36713,-19.36706,33,7,181,214,80,4,90,170
"Bolivia","Santa Cruz","Cordillera","Gutiérrez","ESC. SECCIONAL S. MIGUEL POCITO",-63.45378,-19.68275,16,5,126,142,78,3,40,118
"Bolivia","Santa Cruz","Cordillera","Gutiérrez","ESC. TATARENDA VIEJA",-63.53038,-19.42489,62,8,339,401,94,18,219,313
"Bolivia","Santa Cruz","Cordillera","Lagunillas","ESC. LAGUNILLAS",-63.67723,-19.65222,334,18,1086,1420,478,26,564,1042
"Bolivia","Santa Cruz","Cordillera","Lagunillas","ESC. PROF. DELFIN ARTEAGA IPATI",-63.56137,-19.76491,99,17,666,765,316,21,312,628
"Bolivia","Santa Cruz","Cordillera","Lagunillas","ESC. SECCIONAL AGUADA GRANDE",-63.67469,-19.64971,40,5,191,231,76,7,103,179
"Bolivia","Santa Cruz","Cordillera","Lagunillas","ESC. SECCIONAL ALTO PARAPETI",-63.67161,-19.65821,15,2,67,82,11,5,49,60
"Bolivia","Santa Cruz","Cordillera","Lagunillas","ESC. TASETE",-63.65621,-19.65524,3,0,40,43,7,3,30,37
"Bolivia","Santa Cruz","Cordillera","Lagunillas","ESCUELA SECCIONAL AQUIO",-63.68824,-19.70833,6,1,69,75,49,2,17,66
"Bolivia","Santa Cruz","Cordillera","Lagunillas","U.E. CARPARICITO",-63.66229,-19.80228,41,5,145,186,44,10,86,130
"Bolivia","Santa Cruz","Cordillera","Lagunillas","U.E. PAMPA REDONDA",-63.66234,-19.60102,5,4,73,78,26,4,39,65
"Bolivia","Santa Cruz","Cordillera","Lagunillas","U. E. TENTA PIAU",-63.66815,-19.55789,12,0,73,85,32,5,36,68
"Bolivia","Santa Cruz","Cordillera","Lagunillas","U.E. YAITY",-63.63815,-20.06437,9,2,80,89,15,3,60,75
"Bolivia","Santa Cruz","Florida","Mairana","ESC. ANANIAS MELENDRES",-64.03188,-17.97899,99,18,599,698,203,31,347,550
"Bolivia","Santa Cruz","Florida","Mairana","ESC. ANGEL SAAVEDRA CHAVEZ",-63.96286,-18.12236,19,5,139,158,74,8,52,126
"Bolivia","Santa Cruz","Florida","Mairana","ESC. RENE BARRIENTOS ORTUÑO",-63.95997,-18.11939,690,134,4900,5590,2049,323,2394,4443
"Bolivia","Santa Cruz","Florida","Pampa Grande","ESC. NUCLEO SANTA ROSA",-64.24594,-17.86679,18,2,172,190,68,4,98,166
"Bolivia","Santa Cruz","Florida","Pampa Grande","ESC. PALMASOLA (EL CARMEN)",-64.2088,-17.89188,23,6,156,179,47,4,99,146
"Bolivia","Santa Cruz","Florida","Pampa Grande","ESC. PEDRO ARISTIDES",-64.11092,-18.08937,98,21,602,700,372,15,194,566
"Bolivia","Santa Cruz","Florida","Pampa Grande","ESC. SAN IGNACIO DE LOYOLA",-64.11346,-18.0916,83,12,457,540,294,18,133,427
"Bolivia","Santa Cruz","Florida","Pampa Grande","ESC. U.E. EDUARDO AVAROA",-64.12405,-18.05703,457,72,2948,3405,980,151,1745,2725
"Bolivia","Santa Cruz","Florida","Quirusillas","ESC. NESTOR PAZ ZAMORA",-63.96211,-18.37715,208,27,865,1073,465,56,317,782
"Bolivia","Santa Cruz","Florida","Samaipata","ESC. CENTRAL BELLA VICTORIA",-63.94548,-18.23438,74,23,893,967,436,49,385,821
"Bolivia","Santa Cruz","Florida","Samaipata","ESC. GRAL. AGUSTIN SAAVEDRA",-63.87621,-18.1794,270,15,1483,1753,850,94,524,1374
"Bolivia","Santa Cruz","Florida","Samaipata","ESC. NAPOLEON GOMEZ",-63.87625,-18.17913,229,45,1779,2008,1079,74,581,1660
"Bolivia","Santa Cruz","Florida","Samaipata","ESC. NUCLEO SAN JUAN DEL ROSARIO",-63.8751,-18.17855,63,2,193,256,108,6,77,185
"Bolivia","Santa Cruz","Florida","Samaipata","ESC. SANTIAGO DEL VALLE",-63.91644,-18.22129,62,7,327,389,224,7,89,313
"Bolivia","Santa Cruz","Florida","Samaipata","ESC. TIMOTEO RONDALES",-63.63435,-18.13063,64,12,341,405,206,23,100,306
"Bolivia","Santa Cruz","Florida","Samaipata","ESC. UNIDAD EDUCATIVA 27 DE MAYO",-63.79241,-18.17142,18,3,110,128,39,2,66,105
"Bolivia","Santa Cruz","Germán Busch","El Carmen Rivero Tórrez","ESC. CANDELARIA (CHIQUITOS)",-58.98688,-18.62612,11,1,59,70,26,2,30,56
"Bolivia","Santa Cruz","Germán Busch","El Carmen Rivero Tórrez","ESC. DANIEL ZAMBRANA",-58.62548,-18.82769,546,24,1737,2283,910,29,774,1684
"Bolivia","Santa Cruz","Germán Busch","El Carmen Rivero Tórrez","ESC. EVANGELICA RINCON DEL TIGRE",-58.16805,-18.21079,90,4,199,289,104,8,83,187
"Bolivia","Santa Cruz","Germán Busch","El Carmen Rivero Tórrez","ESC. PALMERAS",-58.20692,-18.22021,39,2,87,126,41,4,40,81
"Bolivia","Santa Cruz","Germán Busch","El Carmen Rivero Tórrez","ESC. SANTA ANA",-58.78492,-18.70716,59,0,181,240,87,4,90,177
"Bolivia","Santa Cruz","Germán Busch","El Carmen Rivero Tórrez","U.E. PALMITO",-58.40663,-18.91338,19,0,34,53,21,0,13,34
"Bolivia","Santa Cruz","Germán Busch","Puerto Quijarro","ESC. GISELA BRUN SCIARONI",-57.7165,-19.00469,238,24,2908,3146,1610,453,821,2431
"Bolivia","Santa Cruz","Germán Busch","Puerto Quijarro","ESC. MIXTA LA FRONTERA",-57.70963,-19.02897,1229,24,2836,4065,1399,111,1302,2701
"Bolivia","Santa Cruz","Germán Busch","Puerto Quijarro","ESC. SAMUEL LOPEZ MENDOZA",-57.7174,-19.00237,971,14,2691,3662,1543,66,1068,2611
"Bolivia","Santa Cruz","Germán Busch","Puerto Quijarro","U.E. SAN SALVADOR",-57.74367,-18.91407,0,0,13,13,1,0,12,13
"Bolivia","Santa Cruz","Germán Busch","Puerto Suárez","ESC. ANGELICA RIVERO",-57.79461,-18.96881,171,7,812,983,542,10,253,795
"Bolivia","Santa Cruz","Germán Busch","Puerto Suárez","ESC. COLONIA WARNES",-57.94844,-19.21188,0,0,62,62,12,9,41,53
"Bolivia","Santa Cruz","Germán Busch","Puerto Suárez","ESC. COOP EDUCACIONAL PUERTO SUAREZ",-57.80175,-18.96629,674,24,2287,2961,1408,33,822,2230
"Bolivia","Santa Cruz","Germán Busch","Puerto Suárez","ESC. ELIODORO PAZ",-57.79655,-18.96109,357,6,946,1303,644,18,278,922
"Bolivia","Santa Cruz","Germán Busch","Puerto Suárez","ESC. GERMAN BUSCH YACUSES",-58.23871,-18.97605,80,10,382,462,167,11,194,361
"Bolivia","Santa Cruz","Germán Busch","Puerto Suárez","ESC. JOSEFINA GOYTIA",-57.80096,-18.96123,351,10,1330,1681,944,20,356,1300
"Bolivia","Santa Cruz","Germán Busch","Puerto Suárez","ESC. MIGUEL SUAREZ ARANA",-57.79474,-18.96855,533,19,2294,2827,1447,108,720,2167
"Bolivia","Santa Cruz","Germán Busch","Puerto Suárez","U.E. EL SALAO",-57.80831,-18.97087,3,0,4,7,3,0,1,4
"Bolivia","Santa Cruz","Germán Busch","Puerto Suárez","U.E. MOTACUCITO",-57.86888,-18.9975,2,1,19,21,6,0,12,18
"Bolivia","Santa Cruz","Guarayos","Ascención de Guarayos","COL. JOSE BARRERA",-63.19069,-15.89573,67,4,371,438,230,7,130,360
"Bolivia","Santa Cruz","Guarayos","Ascención de Guarayos","ESC. 17 DE FEBRERO",-63.46325,-15.73225,45,0,218,263,29,4,185,214
"Bolivia","Santa Cruz","Guarayos","Ascención de Guarayos","ESC. 6 DE ABRIL",-63.45643,-15.72873,16,0,86,102,29,2,55,84
"Bolivia","Santa Cruz","Guarayos","Ascención de Guarayos","ESC. ASCENCION CENTRAL",-63.18915,-15.89754,1057,37,3873,4930,2022,94,1720,3742
"Bolivia","Santa Cruz","Guarayos","Ascención de Guarayos","ESC. COLONIA 5 DE MARZO",-63.79241,-15.32275,39,3,163,202,65,4,91,156
"Bolivia","Santa Cruz","Guarayos","Ascención de Guarayos","ESC. ESTEBAN GEBARD",-63.187,-15.90327,1040,40,4564,5604,2575,136,1813,4388
"Bolivia","Santa Cruz","Guarayos","Ascención de Guarayos","ESC. SAN PABLO",-63.30412,-15.89327,82,14,476,558,174,17,271,445
"Bolivia","Santa Cruz","Guarayos","Ascención de Guarayos","ESC. SANTA MARIA",-63.45824,-15.73023,48,11,345,393,103,9,222,325
"Bolivia","Santa Cruz","Guarayos","Ascención de Guarayos","KINDER MI DULCE HOGAR",-63.19152,-15.89707,68,1,480,548,214,13,252,466
"Bolivia","Santa Cruz","Guarayos","El Puente","ESC. 10 DE NOVIEMBRE",-63.10825,-16.43058,95,13,493,588,137,13,330,467
"Bolivia","Santa Cruz","Guarayos","El Puente","ESC. ALFREDO SMITH",-62.90907,-16.32987,442,29,1732,2174,1003,42,658,1661
"Bolivia","Santa Cruz","Guarayos","El Puente","ESC. CACHUELA",-63.11323,-16.20543,10,1,65,75,11,2,51,62
"Bolivia","Santa Cruz","Guarayos","El Puente","ESC. CORRALON",-63.21976,-16.36582,83,0,220,303,32,2,186,218
"Bolivia","Santa Cruz","Guarayos","El Puente","ESC. EL COMBATE",-64.34967,-15.96244,5,0,34,39,10,0,24,34
"Bolivia","Santa Cruz","Guarayos","El Puente","ESC. LOS CHACOS",-63.53627,-15.93622,19,0,51,70,46,1,4,50
"Bolivia","Santa Cruz","Guarayos","El Puente","ESC. PUEBLOS UNIDOS",-64.45015,-15.95046,154,1,222,376,30,8,183,213
"Bolivia","Santa Cruz","Guarayos","El Puente","ESC. SAN JOSE DE YOTAU",-63.02123,-16.17607,257,20,1041,1298,322,29,670,992
"Bolivia","Santa Cruz","Guarayos","El Puente","ESC. SECCIONAL EL CARMEN",-63.38649,-16.17395,75,5,346,421,128,15,198,326
"Bolivia","Santa Cruz","Guarayos","El Puente","ESC. SECCIONAL LIMONCITO",-63.38322,-15.91767,15,0,33,48,21,1,11,32
"Bolivia","Santa Cruz","Guarayos","El Puente","ESC. U.E. BOLIVAR",-63.2851,-16.27928,35,13,255,290,70,13,159,229
"Bolivia","Santa Cruz","Guarayos","El Puente","MONTE SINAI",-63.28524,-16.28186,32,2,224,256,32,7,183,215
"Bolivia","Santa Cruz","Guarayos","El Puente","U.E EL CORRALON",-63.44645,-16.40989,0,4,104,104,12,9,79,91
"Bolivia","Santa Cruz","Guarayos","Urubichá","ESC, MARIA DE LOS ANGELES",-63.08243,-15.62326,404,27,1715,2119,720,44,924,1644
"Bolivia","Santa Cruz","Guarayos","Urubichá","ESC. NUCLEO ESCOLAR YAGUARU",-63.22532,-15.60033,180,14,860,1040,538,28,280,818
"Bolivia","Santa Cruz","Guarayos","Urubichá","ESC. SANTA TERESITA (CURURU)",-63.19052,-15.89766,15,2,57,72,45,0,10,55
"Bolivia","Santa Cruz","Guarayos","Urubichá","ESC. SECC.MON.SALVATIERRA",-63.01738,-15.50296,29,1,78,107,32,0,45,77
"Bolivia","Santa Cruz","Ichilo","Buena Vista","ESC. ADHEMAR ORTIZ",-63.5253,-17.61063,31,1,213,244,81,1,130,211
"Bolivia","Santa Cruz","Ichilo","Buena Vista","ESC. EDUARDO ABAROA",-63.6379,-17.55737,109,14,762,871,218,30,500,718
"Bolivia","Santa Cruz","Ichilo","Buena Vista","ESC. MARIANO SAUCEDO SEVILLA",-63.66378,-17.45934,380,13,1750,2130,1047,43,647,1694
"Bolivia","Santa Cruz","Ichilo","Buena Vista","ESC. OVIDIO SUAREZ",-63.66139,-17.45913,473,25,1661,2134,850,75,711,1561
"Bolivia","Santa Cruz","Ichilo","Buena Vista","ESC. U.E. CARANDA",-63.53439,-17.52241,117,15,643,760,262,21,345,607
"Bolivia","Santa Cruz","Ichilo","Buena Vista","ESC. U.E. LUCIO  PEREZ",-63.5322,-17.4093,34,3,182,216,140,5,34,174
"Bolivia","Santa Cruz","Ichilo","Buena Vista","ESC. U.E. PEDRO DOMINGO MURILLO",-63.57303,-17.63503,75,8,459,534,57,10,384,441
"Bolivia","Santa Cruz","Ichilo","Buena Vista","ESC. U.E. SAN ISIDRO",-63.53614,-17.44589,44,1,199,243,175,0,23,198
"Bolivia","Santa Cruz","Ichilo","Buena Vista","ESC. U.E. SAN JAVIER",-63.56753,-17.36419,0,0,48,48,36,3,9,45
"Bolivia","Santa Cruz","Ichilo","Buena Vista","ESC. U.E. SANTO ESPOSORIO",-63.60875,-17.35815,40,0,158,198,130,2,26,156
"Bolivia","Santa Cruz","Ichilo","Buena Vista","U.E. 5 DE SEPTIEMBRE",-63.69266,-17.53192,3,2,89,92,5,0,82,87
"Bolivia","Santa Cruz","Ichilo","Buena Vista","U.E. 6 DE AGOSTO",-63.60951,-17.40799,6,6,265,271,214,5,40,254
"Bolivia","Santa Cruz","Ichilo","San Carlos","ESC. CENTRAL SAN CARLOS",-63.72837,-17.40302,456,40,2762,3218,1740,104,878,2618
"Bolivia","Santa Cruz","Ichilo","San Carlos","ESC. FISCAL DE NINOS SANTA FE",-63.82872,-17.39861,865,58,4764,5629,1936,215,2555,4491
"Bolivia","Santa Cruz","Ichilo","San Carlos","ESC. NUCLEO CENTRAL",-63.76135,-17.16378,95,14,740,835,148,14,564,712
"Bolivia","Santa Cruz","Ichilo","San Carlos","ESC. U.E. POPULAR DON BOSCO",-63.76614,-17.09247,66,11,934,1000,533,123,267,800
"Bolivia","Santa Cruz","Ichilo","San Juan","ESC. POPULAR DON BOSCO",-63.85132,-17.29254,435,75,2475,2910,1395,47,958,2353
"Bolivia","Santa Cruz","Ichilo","San Juan","NUCLEO CENTRAL LA ENCONADA",-63.89576,-17.05627,105,17,652,757,203,21,411,614
"Bolivia","Santa Cruz","Ichilo","San Juan","UN. ED. AYACUCHO",-63.90579,-17.00542,54,6,288,342,90,2,190,280
"Bolivia","Santa Cruz","Ichilo","San Juan","UN. ED.  NUCLEO CENTRAL",-63.99822,-16.91391,34,1,126,160,31,2,92,123
"Bolivia","Santa Cruz","Ichilo","San Juan","UN. ED. RAUL MENACHO",-64.04461,-16.70449,44,1,225,269,61,7,156,217
"Bolivia","Santa Cruz","Ichilo","Yapacaní","ESC. CESAR BANZER ALIAGA",-63.88105,-17.40066,1311,94,7132,8443,2413,387,4238,6651
"Bolivia","Santa Cruz","Ichilo","Yapacaní","ESC. DON BOSCO FE Y ALEGRIA",-64.09068,-17.35061,419,24,2019,2438,432,50,1513,1945
"Bolivia","Santa Cruz","Ichilo","Yapacaní","ESC. EL PALLAR",-64.81531,-16.76252,77,6,197,274,57,4,130,187
"Bolivia","Santa Cruz","Ichilo","Yapacaní","ESC. GERMAN BUSCH",-63.88563,-17.40492,683,66,4440,5123,1652,151,2571,4223
"Bolivia","Santa Cruz","Ichilo","Yapacaní","ESC. MARISCAL SUCRE",-63.96143,-17.38778,129,16,997,1126,226,24,731,957
"Bolivia","Santa Cruz","Ichilo","Yapacaní","ESC. NACIONAL BOLIVIA",-63.88673,-17.40517,69,3,372,441,99,37,233,332
"Bolivia","Santa Cruz","Ichilo","Yapacaní","ESC. NOEL KENP MERCADO",-64.29475,-17.08242,217,16,1115,1332,156,22,921,1077
"Bolivia","Santa Cruz","Ichilo","Yapacaní","ESC. NUEVO SIMON BOLLIVAR",-63.88425,-17.4061,847,37,4136,4983,1514,94,2491,4005
"Bolivia","Santa Cruz","Ichilo","Yapacaní","ESC. U.E. CASCABEL",-64.25111,-17.05944,124,8,494,618,84,11,391,475
"Bolivia","Santa Cruz","Ichilo","Yapacaní","ESC. U.E. GERMAN BUSCH (P. GRETHER)",-64.3512,-17.18946,68,7,299,367,99,14,179,278
"Bolivia","Santa Cruz","Ichilo","Yapacaní","ESCUELA CORTE HONDO",-64.77988,-16.74353,0,0,69,69,7,1,61,68
"Bolivia","Santa Cruz","Ichilo","Yapacaní","ESC. U.E. NUCLEO CENTRAL",-64.03771,-17.36884,85,5,625,710,145,15,460,605
"Bolivia","Santa Cruz","Ichilo","Yapacaní","ESC. U.E. NUCLEO CENTRAL EL CONDOR",-64.12843,-17.42864,44,6,251,295,49,5,191,240
"Bolivia","Santa Cruz","Ichilo","Yapacaní","ESC. U.E. NUCLEO CENTRAL LOS POZOS",-64.07143,-17.0136,31,5,228,259,64,9,150,214
"Bolivia","Santa Cruz","Ichilo","Yapacaní","ESC. U.E. PUERTO AVAROA",-64.22526,-17.25569,58,6,402,460,113,8,275,388
"Bolivia","Santa Cruz","Ichilo","Yapacaní","U.E. JUANA AZURDUY",-63.90387,-17.41217,7,0,58,65,21,5,32,53
"Bolivia","Santa Cruz","Ichilo","Yapacaní","U.E. NUEVO HORIZONTE",-64.1521,-17.31313,25,12,394,419,57,13,312,369
"Bolivia","Santa Cruz","Ichilo","Yapacaní","U.E. SAN RAFAEL",-63.92513,-17.45016,5,0,121,126,14,3,104,118
"Bolivia","Santa Cruz","Manuel M. Caballero","Comarapa","ESC.  EL JAGUE",-64.32232,-18.02102,10,0,48,58,26,0,22,48
"Bolivia","Santa Cruz","Manuel M. Caballero","Comarapa","ESC. ESCUELA SAN MATEO",-64.66756,-17.75924,19,4,205,224,24,4,173,197
"Bolivia","Santa Cruz","Manuel M. Caballero","Comarapa","ESC. GABRIEL RENE MORENO",-64.52667,-17.91351,532,73,3949,4481,1439,227,2210,3649
"Bolivia","Santa Cruz","Manuel M. Caballero","Comarapa","ESC. HABRA DE CAPILLA",-64.73131,-17.87328,9,2,116,125,17,6,91,108
"Bolivia","Santa Cruz","Manuel M. Caballero","Comarapa","ESC. MANZANAL",-64.77901,-17.84591,12,0,98,110,8,3,87,95
"Bolivia","Santa Cruz","Manuel M. Caballero","Comarapa","ESC. MARCELINO CHAIPANA",-64.43036,-18.10087,48,4,372,420,158,19,191,349
"Bolivia","Santa Cruz","Manuel M. Caballero","Comarapa","ESC. SAN ISIDRO",-64.43211,-18.04461,162,14,909,1071,427,43,425,852
"Bolivia","Santa Cruz","Manuel M. Caballero","Comarapa","ESC. SAN JOSE DE LA CAPILLA",-64.4388,-18.0994,56,8,365,421,160,23,174,334
"Bolivia","Santa Cruz","Manuel M. Caballero","Comarapa","ESC. SAN JUAN DEL POTRERO",-64.29284,-17.96157,53,13,331,384,164,12,142,306
"Bolivia","Santa Cruz","Manuel M. Caballero","Comarapa","ESC. SIBERIA",-64.75382,-17.82761,10,0,120,130,30,3,87,117
"Bolivia","Santa Cruz","Manuel M. Caballero","Comarapa","ESC. TORRECILLAS",-64.61208,-17.86851,67,28,740,807,112,60,540,652
"Bolivia","Santa Cruz","Manuel M. Caballero","Comarapa","ESC. U.E. LA PALIZADA",-64.43266,-18.06145,45,13,328,373,126,12,177,303
"Bolivia","Santa Cruz","Manuel M. Caballero","Saipina","ESC. EMILIA CABALLERO",-64.63905,-17.96113,1,0,33,34,6,1,26,32
"Bolivia","Santa Cruz","Manuel M. Caballero","Saipina","ESC. HUMBERTO VILLARROEL",-64.58239,-18.09421,322,35,2105,2427,718,73,1279,1997
"Bolivia","Santa Cruz","Manuel M. Caballero","Saipina","ESC. OCONI",-64.68318,-17.98282,21,3,103,124,6,2,92,98
"Bolivia","Santa Cruz","Manuel M. Caballero","Saipina","ESC. SAN RAFAEL",-64.56412,-18.1077,16,1,207,223,54,6,146,200
"Bolivia","Santa Cruz","Manuel M. Caballero","Saipina","ESC. U.E. SANTA CATALINA CHILON",-64.63826,-18.00198,65,8,397,462,99,15,275,374
"Bolivia","Santa Cruz","Ñuflo De Chávez","Concepción","ESC. CENT. JULIO FLORES FRANCO",-62.01875,-16.44536,26,7,207,233,112,3,85,197
"Bolivia","Santa Cruz","Ñuflo De Chávez","Concepción","ESC. CENTRAL SAN PEDRO",-62.2496,-16.67241,28,0,143,171,94,3,46,140
"Bolivia","Santa Cruz","Ñuflo De Chávez","Concepción","ESC. EDUCATIVA MAKANATE",-62.29666,-15.48511,15,2,109,124,4,3,100,104
"Bolivia","Santa Cruz","Ñuflo De Chávez","Concepción","ESC. GUADALUPE FE Y ALEGRIA",-62.02316,-16.13626,1293,115,7052,8345,3589,185,3163,6752
"Bolivia","Santa Cruz","Ñuflo De Chávez","Concepción","ESC. PALESTINA",-62.25437,-15.5535,0,0,73,73,3,12,58,61
"Bolivia","Santa Cruz","Ñuflo De Chávez","Concepción","ESC. SECCIONAL CALENDARIA",-62.12077,-16.2456,13,5,188,201,64,7,112,176
"Bolivia","Santa Cruz","Ñuflo De Chávez","Concepción","ESC. SECCIONAL PALMARITO",-61.58675,-15.68015,29,2,211,240,155,3,51,206
"Bolivia","Santa Cruz","Ñuflo De Chávez","Concepción","ESC. TIERRA HERMOZA",-61.96533,-16.47223,116,6,486,602,42,11,427,469
"Bolivia","Santa Cruz","Ñuflo De Chávez","Concepción","ESC. U.E. ALTAMIRA",-62.02086,-16.13548,74,10,374,448,166,18,180,346
"Bolivia","Santa Cruz","Ñuflo De Chávez","Concepción","ESC. U.E. GUAYABA",-62.00958,-16.11202,9,4,130,139,16,2,108,124
"Bolivia","Santa Cruz","Ñuflo De Chávez","Concepción","ESC. U.E. LAS MERCEDES",-62.15521,-16.63746,13,1,38,51,18,0,19,37
"Bolivia","Santa Cruz","Ñuflo De Chávez","Concepción","ESC. U.E. SAN SILVESTRE",-61.8651,-15.87338,14,1,123,137,45,8,69,114
"Bolivia","Santa Cruz","Ñuflo De Chávez","Concepción","ESC. U.E. SANTA MONICA",-62.19145,-15.97295,13,1,91,104,6,0,84,90
"Bolivia","Santa Cruz","Ñuflo De Chávez","Concepción","ESC. U.E. ZAPOCO",-61.64749,-16.49761,7,0,14,21,9,0,5,14
"Bolivia","Santa Cruz","Ñuflo De Chávez","Concepción","MEDIO MONTE",-62.07742,-16.52462,6,0,108,114,10,1,97,107
"Bolivia","Santa Cruz","Ñuflo De Chávez","Concepción","U.E. JOSE ORTIZ SENAR",-61.9508,-16.22951,9,0,63,72,6,0,57,63
"Bolivia","Santa Cruz","Ñuflo De Chávez","Concepción","U.E. NUBIASIX",-62.1369,-16.33951,4,2,59,63,16,2,39,55
"Bolivia","Santa Cruz","Ñuflo De Chávez","Concepción","U.E. SAN FRANCISCO DE ASIS",-62.06047,-16.13365,3,2,80,83,13,4,61,74
"Bolivia","Santa Cruz","Ñuflo De Chávez","Cuatro Cañadas","COL. NACIONAL CUATRO CAÑANDAS",-62.55971,-17.27547,21,5,147,168,40,4,98,138
"Bolivia","Santa Cruz","Ñuflo De Chávez","Cuatro Cañadas","ESC. 26 DE AGOSTO",-62.60896,-17.44349,89,14,703,792,226,29,434,660
"Bolivia","Santa Cruz","Ñuflo De Chávez","Cuatro Cañadas","ESC. JOSE LUIS CASTRO",-62.55427,-17.34488,180,17,1297,1477,418,39,823,1241
"Bolivia","Santa Cruz","Ñuflo De Chávez","Cuatro Cañadas","ESC. JUAN PABLO SEGUNDO",-62.55701,-17.26752,996,72,5934,6930,2113,310,3439,5552
"Bolivia","Santa Cruz","Ñuflo De Chávez","Cuatro Cañadas","ESC. LOS TRONCOS",-62.63882,-17.06814,25,3,182,207,96,3,80,176
"Bolivia","Santa Cruz","Ñuflo De Chávez","Cuatro Cañadas","ESC. MONTE RICO",-62.48614,-17.37492,34,2,206,240,24,1,179,203
"Bolivia","Santa Cruz","Ñuflo De Chávez","Cuatro Cañadas","U.E. HAZIEL",-62.152,-17.22365,13,2,235,248,181,7,45,226
"Bolivia","Santa Cruz","Ñuflo De Chávez","San Antonio de Lomerio","ESC. CENTRAL EL PUQUIO",-61.9117,-16.73251,54,3,400,454,4,3,390,394
"Bolivia","Santa Cruz","Ñuflo De Chávez","San Antonio de Lomerio","ESC. HOLANDA",-61.79376,-16.88703,0,0,7,7,0,2,5,5
"Bolivia","Santa Cruz","Ñuflo De Chávez","San Antonio de Lomerio","ESC. PADRE MATIAS LENS",-61.81025,-16.76787,209,11,1149,1358,496,36,606,1102
"Bolivia","Santa Cruz","Ñuflo De Chávez","San Antonio de Lomerio","ESC.SAN LORENZO",-61.87291,-16.70838,31,7,265,296,5,1,252,257
"Bolivia","Santa Cruz","Ñuflo De Chávez","San Antonio de Lomerio","ESC. SECCIONAL SALINAS",-61.85703,-16.98182,43,8,188,231,72,5,103,175
"Bolivia","Santa Cruz","Ñuflo De Chávez","San Antonio de Lomerio","ESC. U.E. LAS TRANCAS",-61.86698,-16.5975,9,0,109,118,6,2,101,107
"Bolivia","Santa Cruz","Ñuflo De Chávez","San Antonio de Lomerio","ESC. U.E. MONTERITO",-61.96834,-16.70661,8,1,173,181,0,0,172,172
"Bolivia","Santa Cruz","Ñuflo De Chávez","San Antonio de Lomerio","ESC. U.E. PADRE PIO",-61.8397,-16.68229,16,1,147,163,10,2,134,144
"Bolivia","Santa Cruz","Ñuflo De Chávez","San Antonio de Lomerio","PEDRO PABLO PEÑA GARCIA",-61.93461,-16.75292,2,0,60,62,0,0,60,60
"Bolivia","Santa Cruz","Ñuflo De Chávez","San Javier","ESC. SECCIONAL CORONACION",-62.63953,-16.50191,59,6,424,483,132,9,277,409
"Bolivia","Santa Cruz","Ñuflo De Chávez","San Javier","ESCUELA ADOLFO BURTON",-62.50405,-16.27246,877,109,4625,5502,2881,73,1562,4443
"Bolivia","Santa Cruz","Ñuflo De Chávez","San Javier","ESC. U.E. LAS ABRAS",-62.62867,-16.31566,37,2,195,232,16,2,175,191
"Bolivia","Santa Cruz","Ñuflo De Chávez","San Javier","ESC. U.E. SAN PABLO",-62.59928,-16.16368,12,0,104,116,4,0,100,104
"Bolivia","Santa Cruz","Ñuflo De Chávez","San Javier","ESC. U.E. SANTA RITA",-62.41707,-16.19858,10,0,59,69,21,0,38,59
"Bolivia","Santa Cruz","Ñuflo De Chávez","San Javier","ESC. U.E. TURUX NAPEZ",-62.54155,-16.06091,13,2,86,99,1,1,82,83
"Bolivia","Santa Cruz","Ñuflo De Chávez","San Julián","ESC. 26 DE OCT. FE Y ALEGRIA",-62.75789,-16.80131,48,4,501,549,43,6,448,491
"Bolivia","Santa Cruz","Ñuflo De Chávez","San Julián","ESC. CENTRAL FRANZ TAMAYO",-62.84544,-16.9986,153,26,865,1018,190,43,606,796
"Bolivia","Santa Cruz","Ñuflo De Chávez","San Julián","ESC. COL  CIRO MEALLA",-62.61414,-16.90736,1235,165,9306,10541,2619,651,5871,8490
"Bolivia","Santa Cruz","Ñuflo De Chávez","San Julián","ESC. EL PROGRESO",-62.62124,-16.91284,74,4,498,572,116,38,340,456
"Bolivia","Santa Cruz","Ñuflo De Chávez","San Julián","ESC. FE Y ALEGRIA",-62.68461,-17.09639,153,16,786,939,385,26,359,744
"Bolivia","Santa Cruz","Ñuflo De Chávez","San Julián","ESC. GRAL SAN MARTIN",-62.85691,-16.70174,81,9,499,580,90,17,383,473
"Bolivia","Santa Cruz","Ñuflo De Chávez","San Julián","ESC. LA ASUNTA SAN BERNARDO",-62.57837,-16.76817,171,17,1201,1372,445,34,705,1150
"Bolivia","Santa Cruz","Ñuflo De Chávez","San Julián","ESC.LIMONCITO",-63.06672,-16.76165,51,6,223,274,60,6,151,211
"Bolivia","Santa Cruz","Ñuflo De Chávez","San Julián","ESC. MAX FERNANDEZ ROJAS",-62.54577,-16.97607,44,11,477,521,101,13,352,453
"Bolivia","Santa Cruz","Ñuflo De Chávez","San Julián","ESC. NUCLEO 66 2 DE AGOSTO",-62.78839,-16.6398,55,8,417,472,128,9,272,400
"Bolivia","Santa Cruz","Ñuflo De Chávez","San Julián","ESC. PATUJU",-62.61599,-16.9081,65,2,497,562,133,19,343,476
"Bolivia","Santa Cruz","Ñuflo De Chávez","San Julián","ESC. SAN ANTONIO",-62.72305,-16.83416,7,1,125,132,24,1,99,123
"Bolivia","Santa Cruz","Ñuflo De Chávez","San Julián","ESC. SAN SALVADOR NUCLEO 38",-63.01813,-16.53014,94,7,480,574,50,23,400,450
"Bolivia","Santa Cruz","Ñuflo De Chávez","San Julián","ESC. SEBASTIAN PAGADOR",-62.62574,-16.91129,9,0,104,113,6,0,98,104
"Bolivia","Santa Cruz","Ñuflo De Chávez","San Julián","ESC. U.E. 16 DE MARZO",-62.46996,-16.93457,42,5,276,318,23,25,223,246
"Bolivia","Santa Cruz","Ñuflo De Chávez","San Julián","ESC. U.E. EL LIMONAL",-62.94872,-16.60476,41,5,263,304,34,8,216,250
"Bolivia","Santa Cruz","Ñuflo De Chávez","San Julián","ESCUELA EDUARDO AVAROA",-62.93443,-17.02607,143,17,1026,1169,287,40,682,969
"Bolivia","Santa Cruz","Ñuflo De Chávez","San Julián","ESCUELA LUZ Y VERDAD",-62.91896,-16.63566,35,10,282,317,75,11,186,261
"Bolivia","Santa Cruz","Ñuflo De Chávez","San Julián","ESC. U.E. SEGUNDA MILLA",-62.91419,-16.50614,12,1,123,135,89,6,27,116
"Bolivia","Santa Cruz","Ñuflo De Chávez","San Julián","U.E. 27 DE ABRIL",-62.61187,-16.86376,3,0,28,31,10,2,16,26
"Bolivia","Santa Cruz","Ñuflo De Chávez","San Julián","U.E. GUILLERMO JORDAN",-62.62149,-16.91677,350,19,2052,2402,535,122,1376,1911
"Bolivia","Santa Cruz","Ñuflo De Chávez","San Julián","U.E. JOSE DAVID BERRIOS",-62.63219,-16.90126,0,0,20,20,6,2,12,18
"Bolivia","Santa Cruz","Ñuflo De Chávez","San Julián","U.E. SAN JULIAN DE BERLIN",-62.63087,-17.0567,3,1,31,34,6,3,21,27
"Bolivia","Santa Cruz","Ñuflo De Chávez","San Julián","U.E. SANTA ANA",-63.06822,-16.33947,3,2,98,101,8,2,86,94
"Bolivia","Santa Cruz","Ñuflo De Chávez","San Ramón","ESC. CENTRAL SAN RAMON",-62.49786,-16.61663,737,58,3465,4202,1874,146,1387,3261
"Bolivia","Santa Cruz","Ñuflo De Chávez","San Ramón","ESC. SANTA ROSA DE LA MINA",-62.46406,-16.54375,19,1,156,175,89,9,57,146
"Bolivia","Santa Cruz","Obispo Santisteban","Fernández Alonso","ESC. AGUAICES",-63.31085,-16.89686,33,3,274,307,88,14,169,257
"Bolivia","Santa Cruz","Obispo Santisteban","Fernández Alonso","ESC. EDUARDO AVAROA",-63.23214,-16.96287,63,12,499,562,156,15,316,472
"Bolivia","Santa Cruz","Obispo Santisteban","Fernández Alonso","ESC. NUCLEO MARISCAL SUCRE",-63.2194,-16.96726,276,20,1815,2091,575,67,1153,1728
"Bolivia","Santa Cruz","Obispo Santisteban","Fernández Alonso","ESC. SECCIONAL",-63.31478,-17.03029,4,0,20,24,2,1,17,19
"Bolivia","Santa Cruz","Obispo Santisteban","Fernández Alonso","ESC. SECCIONAL FAJA BOLIVAR",-63.22898,-16.97343,0,1,10,10,0,0,9,9
"Bolivia","Santa Cruz","Obispo Santisteban","Fernández Alonso","ESC. U.E. BETANIA",-63.20389,-16.86883,5,3,106,111,30,2,71,101
"Bolivia","Santa Cruz","Obispo Santisteban","Fernández Alonso","ESC. U.E. VICTOR HUGO OTALORA",-63.22835,-17.00979,494,52,3096,3590,1080,138,1826,2906
"Bolivia","Santa Cruz","Obispo Santisteban","General Agustín Saavedra","COL. PRINCIPE DE PAZ",-63.21263,-17.22497,523,39,3217,3740,1900,134,1144,3044
"Bolivia","Santa Cruz","Obispo Santisteban","General Agustín Saavedra","ESC. 1 DE SEPTIEMBRE",-63.08397,-17.09076,78,7,379,457,140,7,225,365
"Bolivia","Santa Cruz","Obispo Santisteban","General Agustín Saavedra","ESC. NUCLEO CENTRAL NUEVA ESPERANZA",-63.21746,-17.16079,129,9,823,952,363,22,429,792
"Bolivia","Santa Cruz","Obispo Santisteban","General Agustín Saavedra","ESC. NUCLEO  MARISCAL SUCRE",-63.12855,-17.10982,149,17,857,1006,283,34,523,806
"Bolivia","Santa Cruz","Obispo Santisteban","General Agustín Saavedra","ESC. U.E. CHANE BEDOYA",-63.07076,-17.02967,68,3,313,381,109,8,193,302
"Bolivia","Santa Cruz","Obispo Santisteban","General Agustín Saavedra","ESC. U.E. GUALBERTO VILLARROEL",-63.13241,-17.22034,96,12,458,554,129,25,292,421
"Bolivia","Santa Cruz","Obispo Santisteban","General Agustín Saavedra","ESC. U.E. SANTIAGO CORNEN",-63.07765,-17.07392,53,1,352,405,171,13,167,338
"Bolivia","Santa Cruz","Obispo Santisteban","General Agustín Saavedra","U.E. ARMINDA MERCADO P.",-63.27879,-17.22003,4,4,81,85,57,2,18,75
"Bolivia","Santa Cruz","Obispo Santisteban","General Agustín Saavedra","U.E. MARCELO QUIROGA SANTA CRUZ",-63.23772,-17.25334,1,6,81,82,17,1,57,74
"Bolivia","Santa Cruz","Obispo Santisteban","General Agustín Saavedra","U.E. SAN FELIX",-63.16826,-17.22752,6,3,45,51,15,2,25,40
"Bolivia","Santa Cruz","Obispo Santisteban","Mineros","ESC. LA PATRIA",-63.33168,-17.13894,48,6,220,268,99,10,105,204
"Bolivia","Santa Cruz","Obispo Santisteban","Mineros","ESC. LAS PALMAS",-63.27835,-17.07745,46,5,326,372,115,11,195,310
"Bolivia","Santa Cruz","Obispo Santisteban","Mineros","ESC. NUCLEO CENTRAL MINERO",-63.23399,-17.11312,1568,165,9457,11025,5140,371,3781,8921
"Bolivia","Santa Cruz","Obispo Santisteban","Mineros","ESC. SUB. CENTRAL LA PORFIA",-63.15114,-17.05671,98,5,388,486,144,6,233,377
"Bolivia","Santa Cruz","Obispo Santisteban","Mineros","ESC. U.E. SAN JUAN DEL CARMEN",-63.18584,-17.07821,6,1,58,64,21,3,33,54
"Bolivia","Santa Cruz","Obispo Santisteban","Mineros","U.E. 24 DE JUNIO",-63.37979,-17.01744,0,0,88,88,14,7,67,81
"Bolivia","Santa Cruz","Obispo Santisteban","Mineros","U.E. ALIANZA EL PROGRESO",-63.2196,-17.05495,0,19,183,183,42,5,117,159
"Bolivia","Santa Cruz","Obispo Santisteban","Mineros","U.E. ALICE ALVAREZ DE AREDONDO I",-63.23064,-17.11864,81,9,560,641,305,11,235,540
"Bolivia","Santa Cruz","Obispo Santisteban","Mineros","U.E. BENJAMIN BANEGAS VACA",-63.22878,-17.1259,37,5,252,289,131,4,112,243
"Bolivia","Santa Cruz","Obispo Santisteban","Montero","CARCEL PUBLICA DE MONTERO",-63.20849,-17.31119,84,0,26,110,15,4,7,22
"Bolivia","Santa Cruz","Obispo Santisteban","Montero","COL. ANGEL LIMPIAS",-63.23486,-17.34456,384,28,2254,2638,929,72,1225,2154
"Bolivia","Santa Cruz","Obispo Santisteban","Montero","COL. DANIEL RIVERO",-63.24461,-17.34128,1029,58,5460,6489,2066,169,3167,5233
"Bolivia","Santa Cruz","Obispo Santisteban","Montero","COL. EDUARDO ABAROA",-63.23902,-17.32316,331,15,2193,2524,1362,54,762,2124
"Bolivia","Santa Cruz","Obispo Santisteban","Montero","COL. FE Y ALEGRIA",-63.22857,-17.34315,222,13,1807,2029,1483,28,283,1766
"Bolivia","Santa Cruz","Obispo Santisteban","Montero","COL. FRANZ TAMAYO",-63.23262,-17.34123,343,21,2293,2636,1066,76,1130,2196
"Bolivia","Santa Cruz","Obispo Santisteban","Montero","COL. GUILLERMO KRUEGLER",-63.26248,-17.34654,475,19,2960,3435,2154,119,668,2822
"Bolivia","Santa Cruz","Obispo Santisteban","Montero","COL. JOSE CRONEMBOL",-63.25688,-17.35259,404,15,2141,2545,1565,78,483,2048
"Bolivia","Santa Cruz","Obispo Santisteban","Montero","COL. JUAN ZABALA",-63.27181,-17.31366,770,35,4491,5261,2796,132,1528,4324
"Bolivia","Santa Cruz","Obispo Santisteban","Montero","COL. MARCELIANO MONTERO",-63.25363,-17.34717,325,42,2464,2789,1844,86,492,2336
"Bolivia","Santa Cruz","Obispo Santisteban","Montero","COL. MARCOS CHAVEZ",-63.24632,-17.35353,348,23,2349,2697,1490,51,785,2275
"Bolivia","Santa Cruz","Obispo Santisteban","Montero","COL. NACIONAL GUABIRA",-63.26613,-17.30766,346,11,2427,2773,1400,126,890,2290
"Bolivia","Santa Cruz","Obispo Santisteban","Montero","COL. OBISPO SANTISTEBAN",-63.25393,-17.34288,253,4,1683,1936,1226,41,412,1638
"Bolivia","Santa Cruz","Obispo Santisteban","Montero","COL. RAFAEL TERRAZAS",-63.25919,-17.3407,325,8,1954,2279,1572,46,328,1900
"Bolivia","Santa Cruz","Obispo Santisteban","Montero","COL. RENE MORENO",-63.25811,-17.33856,199,9,2754,2953,2172,155,418,2590
"Bolivia","Santa Cruz","Obispo Santisteban","Montero","COL. SAN JOSE OBRERO",-63.24022,-17.34599,621,38,3672,4293,1383,137,2114,3497
"Bolivia","Santa Cruz","Obispo Santisteban","Montero","COL. SIMON BOLIVAR",-63.25801,-17.34814,173,8,1404,1577,983,110,303,1286
"Bolivia","Santa Cruz","Obispo Santisteban","Montero","COL. U.E. ELVIRA FRIAS",-63.25016,-17.33013,929,77,5774,6703,1833,287,3577,5410
"Bolivia","Santa Cruz","Obispo Santisteban","Montero","COL. U.E. MONTECRISTO",-63.26806,-17.34976,359,13,1873,2232,738,310,812,1550
"Bolivia","Santa Cruz","Obispo Santisteban","Montero","COL. UNIDAD EDUCATIVA LA ESPERANZA",-63.23973,-17.35262,304,10,2210,2514,1188,81,931,2119
"Bolivia","Santa Cruz","Obispo Santisteban","Montero","COL. UNIDAD EDUCATIVA VILLA VIRGINIA",-63.23734,-17.33811,358,24,1977,2335,563,86,1304,1867
"Bolivia","Santa Cruz","Obispo Santisteban","Montero","COL. VICTOR SALVATIERRA",-63.25366,-17.34156,266,8,1851,2117,1398,42,403,1801
"Bolivia","Santa Cruz","Obispo Santisteban","Montero","ESC. U.E. MARILUZ ESTREMADOIRO",-63.22701,-17.32729,27,4,158,185,74,8,72,146
"Bolivia","Santa Cruz","Obispo Santisteban","Montero","U.E. 12 DE ABRIL",-63.25831,-17.33828,23,3,331,354,148,19,161,309
"Bolivia","Santa Cruz","Obispo Santisteban","Montero","U.E. JUANCITO PINTO",-63.14261,-17.58141,44,15,922,966,189,31,687,876
"Bolivia","Santa Cruz","Obispo Santisteban","Montero","U.E. MARCELIANO MONTERO",-63.25181,-17.34623,251,14,1663,1914,1287,33,329,1616
"Bolivia","Santa Cruz","Obispo Santisteban","Montero","UE MAXIMILIANO KOLBE",-63.26643,-17.3404,613,29,4199,4812,2592,165,1413,4005
"Bolivia","Santa Cruz","Obispo Santisteban","Montero","U.E. NUEVO MILENIO",-63.24696,-17.32077,31,2,170,201,62,5,101,163
"Bolivia","Santa Cruz","Obispo Santisteban","Montero","U.E. SAN RAMON DE LA VIBORA",-63.26657,-17.33263,15,0,154,169,41,4,109,150
"Bolivia","Santa Cruz","Obispo Santisteban","Montero","U.E. SAN SILVESTRE",-63.26012,-17.3525,33,3,234,267,96,9,126,222
"Bolivia","Santa Cruz","Obispo Santisteban","Montero","U.E. SANTA ROSITA",-63.2749,-17.30831,0,0,4,4,3,0,1,4
"Bolivia","Santa Cruz","Obispo Santisteban","San Pedro","ESC. 9 DE ABRIL",-63.66607,-16.60111,106,9,588,694,180,12,387,567
"Bolivia","Santa Cruz","Obispo Santisteban","San Pedro","ESC. CANANDOA",-63.71227,-16.52267,80,6,343,423,68,13,256,324
"Bolivia","Santa Cruz","Obispo Santisteban","San Pedro","ESC. FE Y ALEGRIA",-63.48004,-16.82541,301,38,1758,2059,789,34,897,1686
"Bolivia","Santa Cruz","Obispo Santisteban","San Pedro","ESC. FE Y ALEGRIA TITO BOLTAN",-63.42871,-16.84723,113,7,864,977,420,12,425,845
"Bolivia","Santa Cruz","Obispo Santisteban","San Pedro","ESC. NUCLEO CENTRAL MURILLO",-63.55027,-16.75557,15,4,178,193,62,4,108,170
"Bolivia","Santa Cruz","Obispo Santisteban","San Pedro","ESC. OBISPO SANTISTEBAN",-63.38285,-16.84942,77,6,601,678,162,34,399,561
"Bolivia","Santa Cruz","Obispo Santisteban","San Pedro","ESC. PADRE REMO PRANDINI VIOTTI",-63.6132,-16.67545,195,29,1059,1254,380,22,628,1008
"Bolivia","Santa Cruz","Obispo Santisteban","San Pedro","ESC. SAN SILVESTRE",-63.3363,-16.87776,16,0,113,129,34,1,78,112
"Bolivia","Santa Cruz","Obispo Santisteban","San Pedro","ESC. SECCIONAL LITORAL",-63.57311,-16.72976,28,2,270,298,75,1,192,267
"Bolivia","Santa Cruz","Obispo Santisteban","San Pedro","ESC. U.E. PETA GRANDE",-63.68477,-16.44438,25,1,112,137,24,8,79,103
"Bolivia","Santa Cruz","Obispo Santisteban","San Pedro","ESC. VILLA ROSARIO",-63.42629,-16.93978,74,5,291,365,47,8,231,278
"Bolivia","Santa Cruz","Sara","Colpa Bélgica","ESC. LOLA TERRAZAS DE GASSER",-63.23116,-17.5691,440,15,2358,2798,1357,39,947,2304
"Bolivia","Santa Cruz","Sara","Colpa Bélgica","ESC, REPUBLICA DEL BRASIL",-63.2303,-17.56968,109,8,689,798,478,20,183,661
"Bolivia","Santa Cruz","Sara","Portachuelo","ESC. ANGEL MARIA LIMPIAS",-63.39923,-17.35743,236,11,1770,2006,1310,24,425,1735
"Bolivia","Santa Cruz","Sara","Portachuelo","ESC. JULIO LANDIVAR",-63.39304,-17.35695,176,6,1373,1549,1085,23,259,1344
"Bolivia","Santa Cruz","Sara","Portachuelo","ESC. LA APLICACION",-63.39476,-17.35477,368,54,3185,3553,2389,107,635,3024
"Bolivia","Santa Cruz","Sara","Portachuelo","ESC. MARTINA DORADO",-63.39271,-17.35174,365,60,2771,3136,1964,71,676,2640
"Bolivia","Santa Cruz","Sara","Portachuelo","ESC. NUCLEO CENTRAL",-63.51644,-17.58445,88,9,595,683,403,4,179,582
"Bolivia","Santa Cruz","Sara","Portachuelo","ESC. PEROTO",-63.41801,-17.47633,0,0,53,53,38,2,13,51
"Bolivia","Santa Cruz","Sara","Portachuelo","ESC. SAN IGNACIO",-63.57069,-17.2788,59,3,363,422,225,7,128,353
"Bolivia","Santa Cruz","Sara","Santa Rosa del Sara","ESC. 4 DE MARZO",-63.89693,-16.93718,35,5,293,328,31,10,247,278
"Bolivia","Santa Cruz","Sara","Santa Rosa del Sara","ESC.  ALFREDO VACA FLOR",-63.86467,-16.67098,100,8,454,554,58,13,375,433
"Bolivia","Santa Cruz","Sara","Santa Rosa del Sara","ESC  ALFREDO VASQUEZ",-63.18314,-17.78275,65,7,575,640,438,33,97,535
"Bolivia","Santa Cruz","Sara","Santa Rosa del Sara","ESC. EL COLORADO",-63.42475,-17.17983,18,2,97,115,40,3,52,92
"Bolivia","Santa Cruz","Sara","Santa Rosa del Sara","ESC.GALILEA",-63.67821,-16.95352,63,2,404,467,71,4,327,398
"Bolivia","Santa Cruz","Sara","Santa Rosa del Sara","ESC. LA CONQUISTA",-63.95355,-16.73366,72,6,363,435,53,17,287,340
"Bolivia","Santa Cruz","Sara","Santa Rosa del Sara","ESC.  MIXTO LOS ANDES",-63.83144,-16.88512,206,20,1067,1273,175,44,828,1003
"Bolivia","Santa Cruz","Sara","Santa Rosa del Sara","ESC. PALOMETAS",-63.52637,-17.03255,16,0,83,99,46,0,37,83
"Bolivia","Santa Cruz","Sara","Santa Rosa del Sara","ESC. PASTO MERCADO QUIROGA",-63.43382,-17.12932,64,6,318,382,145,12,155,300
"Bolivia","Santa Cruz","Sara","Santa Rosa del Sara","ESC. RINCON DE PALOMETA",-63.18314,-17.78275,67,7,405,472,263,2,133,396
"Bolivia","Santa Cruz","Sara","Santa Rosa del Sara","ESC. SAN LUIS",-63.78288,-16.94883,63,4,295,358,39,11,241,280
"Bolivia","Santa Cruz","Sara","Santa Rosa del Sara","ESC. SANTA ROSA",-63.59691,-17.11006,565,37,2833,3398,1803,52,941,2744
"Bolivia","Santa Cruz","Valle Grande","Moro Moro","ESC. ASTILLERO",-64.3554,-18.40132,4,9,119,123,26,5,79,105
"Bolivia","Santa Cruz","Valle Grande","Moro Moro","ESC.LA LAJA",-64.29583,-18.25416,14,8,175,189,96,9,62,158
"Bolivia","Santa Cruz","Valle Grande","Moro Moro","ESC. MOROMORO",-64.3226,-18.36664,94,11,646,740,393,30,212,605
"Bolivia","Santa Cruz","Valle Grande","Moro Moro","ESC.NUCLEO AÑAPACO",-64.28843,-18.44178,0,0,25,25,15,1,9,24
"Bolivia","Santa Cruz","Valle Grande","Moro Moro","ESC. NUCLEO ARIRUMA",-64.32661,-18.43659,23,1,155,178,65,8,81,146
"Bolivia","Santa Cruz","Valle Grande","Moro Moro","ESC. NUCLEO CENTRAL",-64.29378,-18.52514,6,0,61,67,17,2,42,59
"Bolivia","Santa Cruz","Valle Grande","Moro Moro","ESC. U.E. EL VELADERO",-64.26523,-18.35126,39,8,245,284,114,14,109,223
"Bolivia","Santa Cruz","Valle Grande","Postrer Valle","ESC. NUCLEO POSTERVALLE",-63.83601,-18.49309,143,19,603,746,398,23,163,561
"Bolivia","Santa Cruz","Valle Grande","Postrer Valle","ESC.SAN PABLO DE LA LADERA",-63.92479,-18.43073,7,0,36,43,18,1,17,35
"Bolivia","Santa Cruz","Valle Grande","Postrer Valle","ESC.TIERRAS NUEVAS",-63.90362,-18.48421,16,0,105,121,87,3,15,102
"Bolivia","Santa Cruz","Valle Grande","Postrer Valle","ESC. UNIDAD EDUCATIVA MOSQUERA",-63.75977,-18.62887,31,5,92,123,68,3,16,84
"Bolivia","Santa Cruz","Valle Grande","Pucará","ESC. EDEY CORBAN SEHALLER",-64.18601,-18.71765,99,9,593,692,262,18,304,566
"Bolivia","Santa Cruz","Valle Grande","Pucará","ESC. LA HIGUERA",-64.18205,-18.71724,54,8,322,376,195,10,109,304
"Bolivia","Santa Cruz","Valle Grande","Trigal","ESC. LA AGUADA",-64.05747,-18.29873,0,1,53,53,29,7,16,45
"Bolivia","Santa Cruz","Valle Grande","Trigal","ESC.LAGUNILLAS",-64.15909,-18.26369,39,4,276,315,113,60,99,212
"Bolivia","Santa Cruz","Valle Grande","Trigal","ESC.SAN JOSE AGUIRRE ACHA",-64.15065,-18.30182,136,10,533,669,266,15,242,508
"Bolivia","Santa Cruz","Valle Grande","Trigal","ESC.TTE.ROMAN ALDERETTE",-64.15926,-18.35822,29,2,156,185,88,7,59,147
"Bolivia","Santa Cruz","Valle Grande","Vallegrande","ESC. ALTO SECO",-64.07446,-18.87057,53,5,285,338,151,12,117,268
"Bolivia","Santa Cruz","Valle Grande","Vallegrande","ESC. CASAMONTES",-64.02926,-18.70448,44,4,138,182,90,3,41,131
"Bolivia","Santa Cruz","Valle Grande","Vallegrande","ESC. CENTRAL GUADALUPE",-64.08943,-18.55554,39,12,378,417,196,9,161,357
"Bolivia","Santa Cruz","Valle Grande","Vallegrande","ESC. DE CHACOPATA",-64.22842,-18.35763,11,8,153,164,77,21,47,124
"Bolivia","Santa Cruz","Valle Grande","Vallegrande","ESC.DE MANKAILLPA",-64.21599,-18.39356,0,0,61,61,44,7,10,54
"Bolivia","Santa Cruz","Valle Grande","Vallegrande","ESC. IGNACIO TERAN",-64.10592,-18.48932,362,42,2095,2457,1261,109,683,1944
"Bolivia","Santa Cruz","Valle Grande","Vallegrande","ESC. JUANA CARMEN ROMAN",-64.10367,-18.4858,300,25,1457,1757,857,71,504,1361
"Bolivia","Santa Cruz","Valle Grande","Vallegrande","ESC.LOMA LARGA",-63.90175,-18.76361,13,1,88,101,67,1,19,86
"Bolivia","Santa Cruz","Valle Grande","Vallegrande","ESC. LOS SITANOS",-63.95913,-18.86104,31,4,151,182,116,3,28,144
"Bolivia","Santa Cruz","Valle Grande","Vallegrande","ESC.MASICURI",-63.7827,-18.83035,30,3,166,196,109,7,47,156
"Bolivia","Santa Cruz","Valle Grande","Vallegrande","ESC.NARANJO",-64.25002,-18.42377,9,1,69,78,55,0,13,68
"Bolivia","Santa Cruz","Valle Grande","Vallegrande","ESC. NUCLEO EL BELLO",-64.1921,-18.4416,8,4,90,98,76,0,10,86
"Bolivia","Santa Cruz","Valle Grande","Vallegrande","ESC. NUCLEO SAN JUAN",-64.20347,-18.3373,15,5,158,173,101,3,49,150
"Bolivia","Santa Cruz","Valle Grande","Vallegrande","ESC. NUCLEO TUCUMANCILLO",-64.14893,-18.37689,4,1,54,58,37,0,16,53
"Bolivia","Santa Cruz","Valle Grande","Vallegrande","ESC. OBISPO MANUEL JOSE PEÑA",-64.10788,-18.48844,343,26,1917,2260,1149,100,642,1791
"Bolivia","Santa Cruz","Valle Grande","Vallegrande","ESC. PIRAIMIRI",-63.96607,-18.63742,13,5,83,96,46,7,25,71
"Bolivia","Santa Cruz","Valle Grande","Vallegrande","ESC.SANTA ANA",-64.14568,-18.59265,11,1,108,119,52,5,50,102
"Bolivia","Santa Cruz","Valle Grande","Vallegrande","ESC. SANTA ROSITA",-64.08921,-18.52326,22,3,132,154,85,3,41,126
"Bolivia","Santa Cruz","Valle Grande","Vallegrande","ESC. TEMPORAL",-64.07647,-18.63612,6,0,29,35,21,1,7,28
"Bolivia","Santa Cruz","Valle Grande","Vallegrande","ESC. UNIDAD EDUCATIVA ARENALES",-63.72049,-18.95825,28,0,113,141,87,4,22,109
"Bolivia","Santa Cruz","Valle Grande","Vallegrande","KINDER SANTA MARIA",-64.1016,-18.48618,239,26,1628,1867,968,80,554,1522
"Bolivia","Santa Cruz","Velasco","San Ignacio (San Ignacio de Velasco)","15 DE AGOSTO",-61.22021,-16.04663,28,5,192,220,13,6,168,181
"Bolivia","Santa Cruz","Velasco","San Ignacio (San Ignacio de Velasco)","ESC.ALBERTO NATUSCH BUSCH",-61.19359,-14.61075,6,0,36,42,11,0,25,36
"Bolivia","Santa Cruz","Velasco","San Ignacio (San Ignacio de Velasco)","ESC. CAMPAMENTO",-61.01795,-15.1786,121,10,391,512,206,16,159,365
"Bolivia","Santa Cruz","Velasco","San Ignacio (San Ignacio de Velasco)","ESC. CARLOS MAYSER",-60.96424,-16.37827,751,52,3206,3957,2263,74,817,3080
"Bolivia","Santa Cruz","Velasco","San Ignacio (San Ignacio de Velasco)","ESC.CENTRAL EL PORVENIR",-59.49656,-16.28357,89,2,119,208,46,1,70,116
"Bolivia","Santa Cruz","Velasco","San Ignacio (San Ignacio de Velasco)","ESC.CENTRAL PISO FIRME",-61.73743,-13.63076,32,4,143,175,49,6,84,133
"Bolivia","Santa Cruz","Velasco","San Ignacio (San Ignacio de Velasco)","ESC. DON BOSCO",-60.9684,-16.38181,500,65,2505,3005,1494,60,886,2380
"Bolivia","Santa Cruz","Velasco","San Ignacio (San Ignacio de Velasco)","ESC.EL CARMEN DE RUIZ",-61.09895,-16.04755,92,6,488,580,359,13,110,469
"Bolivia","Santa Cruz","Velasco","San Ignacio (San Ignacio de Velasco)","ESC. LIC. SENORITAS MONSENOR DANIEL RIVE",-60.95947,-16.38194,1047,45,4525,5572,3400,116,964,4364
"Bolivia","Santa Cruz","Velasco","San Ignacio (San Ignacio de Velasco)","ESC. MARISCAL SUCRE",-60.97673,-16.37599,890,47,3456,4346,2594,78,737,3331
"Bolivia","Santa Cruz","Velasco","San Ignacio (San Ignacio de Velasco)","ESC.MIRAFLORES",-60.39898,-15.7093,9,0,31,40,25,0,6,31
"Bolivia","Santa Cruz","Velasco","San Ignacio (San Ignacio de Velasco)","ESC.NUCLEO CENTRAL ESPIRITU",-60.52824,-16.18724,116,5,244,360,164,3,72,236
"Bolivia","Santa Cruz","Velasco","San Ignacio (San Ignacio de Velasco)","ESC. PAILITA",-60.71217,-16.55711,12,1,54,66,22,0,31,53
"Bolivia","Santa Cruz","Velasco","San Ignacio (San Ignacio de Velasco)","ESC. RECREO",-61.05543,-16.42583,17,1,108,125,38,1,68,106
"Bolivia","Santa Cruz","Velasco","San Ignacio (San Ignacio de Velasco)","ESC. SAN JOSEMA",-61.0378,-16.26388,6,5,97,103,27,4,61,88
"Bolivia","Santa Cruz","Velasco","San Ignacio (San Ignacio de Velasco)","ESC. SAN JUAN DEL MACOÑO",-60.1824,-16.04592,8,0,56,64,37,3,16,53
"Bolivia","Santa Cruz","Velasco","San Ignacio (San Ignacio de Velasco)","ESC. SAN MARTIN",-61.48943,-15.39137,193,14,705,898,97,29,565,662
"Bolivia","Santa Cruz","Velasco","San Ignacio (San Ignacio de Velasco)","ESC.SANTA ANA",-60.68709,-16.58516,107,2,363,470,274,4,83,357
"Bolivia","Santa Cruz","Velasco","San Ignacio (San Ignacio de Velasco)","ESC.SANTA ROSA ROCA",-61.43752,-15.9136,394,22,1053,1447,549,45,437,986
"Bolivia","Santa Cruz","Velasco","San Ignacio (San Ignacio de Velasco)","ESC.SAN VICENTE",-60.07525,-16.27286,61,5,229,290,122,10,92,214
"Bolivia","Santa Cruz","Velasco","San Ignacio (San Ignacio de Velasco)","ESC. U.E. 25 DE JULIO",-60.34592,-15.55293,18,1,67,85,41,5,20,61
"Bolivia","Santa Cruz","Velasco","San Ignacio (San Ignacio de Velasco)","ESC. U.E. LA ESTRELLA",-61.51268,-15.57549,44,5,337,381,106,13,213,319
"Bolivia","Santa Cruz","Velasco","San Ignacio (San Ignacio de Velasco)","ESC. U.E. SIMON BOLIVAR",-60.42154,-15.33675,14,0,118,132,55,6,57,112
"Bolivia","Santa Cruz","Velasco","San Ignacio (San Ignacio de Velasco)","U.E. 15 DE AGOSTO",-61.221,-16.0462,5,0,105,110,16,2,87,103
"Bolivia","Santa Cruz","Velasco","San Ignacio (San Ignacio de Velasco)","U.E. 19 DE MARZO",-61.04763,-16.33254,8,0,0,8,0,0,0,0
"Bolivia","Santa Cruz","Velasco","San Ignacio (San Ignacio de Velasco)","U.E. BERNARDO MONTEAGUDO",-61.43381,-15.22893,11,1,94,105,6,2,85,91
"Bolivia","Santa Cruz","Velasco","San Ignacio (San Ignacio de Velasco)","U.E. CELEDONIO CORTEZON",-61.15897,-16.03947,4,0,0,4,0,0,0,0
"Bolivia","Santa Cruz","Velasco","San Ignacio (San Ignacio de Velasco)","U.E. JOSE CHAVEZ",-61.42244,-15.99493,1,0,75,76,41,1,33,74
"Bolivia","Santa Cruz","Velasco","San Ignacio (San Ignacio de Velasco)","U.E. JOSE FERREIRA",-60.96625,-15.38916,3,0,41,44,25,0,16,41
"Bolivia","Santa Cruz","Velasco","San Ignacio (San Ignacio de Velasco)","U.E. JOSE PESSOA",-60.89307,-15.46235,0,2,42,42,23,2,15,38
"Bolivia","Santa Cruz","Velasco","San Ignacio (San Ignacio de Velasco)","U.E. MERCEDES DE LAS MINAS",-60.87927,-16.38784,3,2,50,53,27,0,21,48
"Bolivia","Santa Cruz","Velasco","San Ignacio (San Ignacio de Velasco)","U.E. SAN BARTOLO DE LA FRONTERA",-59.89635,-16.29955,22,1,109,131,57,5,46,103
"Bolivia","Santa Cruz","Velasco","San Ignacio (San Ignacio de Velasco)","U.E. SAN JAVIERITO",-61.00164,-16.16473,12,3,247,259,155,21,68,223
"Bolivia","Santa Cruz","Velasco","San Ignacio (San Ignacio de Velasco)","U.E. SAN LORENCITO DE LA FRONTERA",-60.32001,-15.62855,12,1,107,119,68,2,36,104
"Bolivia","Santa Cruz","Velasco","San Ignacio (San Ignacio de Velasco)","U.E. SAN RAFAELITO DE SUPONEMA",-60.73782,-16.51591,4,1,107,111,86,1,19,105
"Bolivia","Santa Cruz","Velasco","San Ignacio (San Ignacio de Velasco)","U.E. SANTA ANITA DE LA FRONTERA",-60.46891,-16.16416,5,1,64,69,9,1,53,62
"Bolivia","Santa Cruz","Velasco","San Ignacio (San Ignacio de Velasco)","U.E. TARCILA JUSTINIANO",-61.3272,-15.92669,4,1,68,72,30,3,34,64
"Bolivia","Santa Cruz","Velasco","San Ignacio (San Ignacio de Velasco)","U.E. TIERRA FIRME",-61.38297,-15.43932,13,1,123,136,7,4,111,118
"Bolivia","Santa Cruz","Velasco","San Miguel (San Miguel de Velasco)","ESC. BELISARIO SANTISTEBAN",-60.96719,-16.70072,369,14,1819,2188,784,34,987,1771
"Bolivia","Santa Cruz","Velasco","San Miguel (San Miguel de Velasco)","ESC. JOSE J.DORADO",-60.96856,-16.69866,431,61,2409,2840,1178,44,1126,2304
"Bolivia","Santa Cruz","Velasco","San Miguel (San Miguel de Velasco)","ESC. MONSEÑOR BONIFACIO",-61.49168,-17.07628,59,9,378,437,203,7,159,362
"Bolivia","Santa Cruz","Velasco","San Miguel (San Miguel de Velasco)","ESC. U.E. CRUZ DEL TOCOIGO",-61.14905,-16.62491,14,3,112,126,27,1,81,108
"Bolivia","Santa Cruz","Velasco","San Miguel (San Miguel de Velasco)","ESC. U.E. SAN LUISITO DE LIMA",-61.22618,-16.79143,2,0,20,22,1,2,17,18
"Bolivia","Santa Cruz","Velasco","San Miguel (San Miguel de Velasco)","ESC. U.E. SAN PEDRO DEL CERRITO",-61.1039,-16.61456,6,0,49,55,17,2,30,47
"Bolivia","Santa Cruz","Velasco","San Miguel (San Miguel de Velasco)","U.E. ALTAMIRA",-61.0463,-16.71514,6,2,49,55,6,1,40,46
"Bolivia","Santa Cruz","Velasco","San Miguel (San Miguel de Velasco)","U.E. SAPOCO",-60.99136,-16.61194,0,3,85,85,11,1,70,81
"Bolivia","Santa Cruz","Velasco","San Rafael","ESC. EL TUNA",-59.6983,-16.62828,32,0,138,170,106,3,29,135
"Bolivia","Santa Cruz","Velasco","San Rafael","ESC. GODOFREDO TRENKER",-60.67352,-16.78576,458,24,1673,2131,1119,39,491,1610
"Bolivia","Santa Cruz","Velasco","San Rafael","ESC. MIRAFLORES II",-60.58031,-17.12125,64,0,228,292,56,5,167,223
"Bolivia","Santa Cruz","Velasco","San Rafael","ESC. VILLA FATIMA",-60.60354,-16.9649,17,1,52,69,34,3,14,48
"Bolivia","Santa Cruz","Warnes","Okinawa Uno","ESC. NUEVA AURORA",-62.80148,-17.49827,7,0,48,55,39,0,9,48
"Bolivia","Santa Cruz","Warnes","Okinawa Uno","ESCUELA. COLEGIO EVANGELICO METODISTA",-62.88918,-17.21915,486,66,3233,3719,2007,172,988,2995
"Bolivia","Santa Cruz","Warnes","Okinawa Uno","ESCUELA UNID. EDU.NUEVO HORIZONTE",-62.80159,-17.32424,135,14,934,1069,639,9,272,911
"Bolivia","Santa Cruz","Warnes","Okinawa Uno","ESC. UNIDAD EDUCATIVA NUEVA ESPERANZA",-62.7861,-17.24826,30,5,201,231,107,6,83,190
"Bolivia","Santa Cruz","Warnes","Okinawa Uno","ESC. UNID. EDU. SAN MIGUEL",-62.90409,-17.43998,60,3,373,433,217,8,145,362
"Bolivia","Santa Cruz","Warnes","Okinawa Uno","ESC. UNID.EDU. SECCIONAL PUERTO NUEVO",-62.79018,-17.17909,52,5,338,390,251,5,77,328
"Bolivia","Santa Cruz","Warnes","Okinawa Uno","ESC.UNID EDU.  VILLA REYES",-62.82537,-17.39157,19,0,129,148,54,5,70,124
"Bolivia","Santa Cruz","Warnes","Warnes","26 DE MARZO",-63.13284,-17.58807,25,2,152,177,57,28,65,122
"Bolivia","Santa Cruz","Warnes","Warnes","ESC. ADRIAN JUSTINIANO ROCA",-63.01891,-17.59505,73,12,474,547,287,10,165,452
"Bolivia","Santa Cruz","Warnes","Warnes","ESC. CIUDAD SATELITE NORTE",-63.14571,-17.60657,1688,57,8634,10322,3703,302,4572,8275
"Bolivia","Santa Cruz","Warnes","Warnes","ESC. COL. CONSTANTINO CUELLAR",-63.16426,-17.50641,477,89,3386,3863,2007,85,1205,3212
"Bolivia","Santa Cruz","Warnes","Warnes","ESC. COLEGIO JULIA SAID",-63.16407,-17.51213,1125,51,6745,7870,3208,253,3233,6441
"Bolivia","Santa Cruz","Warnes","Warnes","ESC. EL JIPA",-63.14586,-17.50428,34,5,450,484,197,17,231,428
"Bolivia","Santa Cruz","Warnes","Warnes","ESC. FISCAL POTRERO LARGO",-63.11728,-17.56155,448,24,2508,2956,1064,103,1317,2381
"Bolivia","Santa Cruz","Warnes","Warnes","ESC. JUANA AZURDUY DE PADILLA",-63.0628,-17.51302,633,32,4061,4694,1485,187,2357,3842
"Bolivia","Santa Cruz","Warnes","Warnes","ESC. TERRACOR",-63.18655,-17.65559,324,24,2002,2326,1188,49,741,1929
"Bolivia","Santa Cruz","Warnes","Warnes","ESC. UE ANGELMIRA MONTE. DE DALENCE",-62.96617,-17.45183,46,6,429,475,269,9,145,414
"Bolivia","Santa Cruz","Warnes","Warnes","ESC. UE LAS BARRERAS",-63.18001,-17.44845,189,29,1575,1764,761,101,684,1445
"Bolivia","Santa Cruz","Warnes","Warnes","ESC. UE MARIANO VACA MONTERO",-63.05692,-17.42761,163,10,849,1012,458,49,332,790
"Bolivia","Santa Cruz","Warnes","Warnes","ESC. UE. NUCLEO CENTRAL CLARA CHUCHIO",-63.10474,-17.6164,84,8,615,699,397,14,196,593
"Bolivia","Santa Cruz","Warnes","Warnes","ESC. UE SECCIONAL AZUZAQUI",-63.15946,-17.43235,33,3,340,373,149,13,175,324
"Bolivia","Santa Cruz","Warnes","Warnes","ESC. UE SECCIONAL LA MARINA",-63.00195,-17.4187,62,9,345,407,123,8,205,328
"Bolivia","Santa Cruz","Warnes","Warnes","ESC. UE TUROBITO",-63.14501,-17.36471,26,5,314,340,193,16,100,293
"Bolivia","Santa Cruz","Warnes","Warnes","ESC. UNID. EDU. 21 DE OCTUBRE",-62.99185,-17.40991,30,5,171,201,27,5,134,161
"Bolivia","Santa Cruz","Warnes","Warnes","ESC. UNID. EDU. DON BOSCO",-63.20383,-17.40809,91,4,566,657,333,17,212,545
"Bolivia","Santa Cruz","Warnes","Warnes","ESC. UNID. EDU. EL TAJIBO",-62.99646,-17.24698,146,14,736,882,434,18,270,704
"Bolivia","Santa Cruz","Warnes","Warnes","ESC.  UNID. EDU. FELIX PAZ VIEIRA",-63.04347,-17.29358,26,17,287,313,127,9,134,261
"Bolivia","Santa Cruz","Warnes","Warnes","ESC. UNID. EDU.  JUAN LATINO",-63.22111,-17.4443,59,5,392,451,188,17,182,370
"Bolivia","Santa Cruz","Warnes","Warnes","ESC. UNID. EDU.  LA REFORMA",-63.07001,-17.26757,87,13,627,714,301,7,306,607
"Bolivia","Santa Cruz","Warnes","Warnes","ESC. UNID. EDU.  LOS CHACOS",-63.01535,-17.29066,54,5,360,414,251,2,102,353
"Bolivia","Santa Cruz","Warnes","Warnes","ESC.UNID.EDU.    MOTACU",-63.11813,-17.55554,30,2,206,236,140,3,61,201
"Bolivia","Santa Cruz","Warnes","Warnes","ESC. UNID. EDU. SECCIONAL EL FUTURO",-63.0559,-17.36139,6,3,73,79,27,2,41,68
"Bolivia","Santa Cruz","Warnes","Warnes","ESC. VALLE SANCHEZ",-63.16564,-17.65603,523,14,2806,3329,1988,78,726,2714
"Bolivia","Santa Cruz","Warnes","Warnes","POLITECNICO PENTAGUAZU",-63.13067,-17.59501,8,0,53,61,23,0,30,53
"Bolivia","Santa Cruz","Warnes","Warnes","U.E. AKUALAND",-63.17204,-17.64403,23,1,330,353,217,5,107,324
"Bolivia","Santa Cruz","Warnes","Warnes","U.E. ANTONIO ANZUATI",-63.17149,-17.53695,12,2,163,175,52,8,101,153
"Bolivia","Santa Cruz","Warnes","Warnes","U.E. BUENA FE",-63.0742,-17.5464,52,5,673,725,181,55,432,613
"Bolivia","Santa Cruz","Warnes","Warnes","U.E. CAMPO ROSSO 4 DE ABRIL",-63.13654,-17.59862,157,9,1048,1205,489,28,522,1011
"Bolivia","Santa Cruz","Warnes","Warnes","U.E. EL MANANTIAL",-63.12106,-17.60827,94,2,738,832,407,14,315,722
"Bolivia","Santa Cruz","Warnes","Warnes","U.E. IGNACIO WARNES",-63.16686,-17.50828,1162,44,7429,8591,4224,228,2933,7157
"Bolivia","Santa Cruz","Warnes","Warnes","U.E. JOSE MANUEL VACA",-63.16396,-17.50945,34,5,235,269,134,4,92,226
"Bolivia","Santa Cruz","Warnes","Warnes","U.E. JUANCITO PINTO",-63.27866,-17.35187,19,1,252,271,78,6,167,245
"Bolivia","Santa Cruz","Warnes","Warnes","U.E. MAXIMO NOVILLO",-63.12106,-17.60827,0,10,975,975,320,107,538,858
"Bolivia","Santa Cruz","Warnes","Warnes","U.E. MONTE CARMELO",-63.11643,-17.59848,26,2,251,277,104,37,108,212
"Bolivia","Santa Cruz","Warnes","Warnes","U.E. NUEVA JERUSALEN-PENTAGUAZU",-63.12896,-17.60241,30,1,377,407,155,8,213,368
"Bolivia","Santa Cruz","Warnes","Warnes","U.E. PAITITI",-63.17518,-17.5598,18,3,232,250,68,5,156,224
"Bolivia","Santa Cruz","Warnes","Warnes","U.E . SAN JUAN",-63.10375,-17.60646,122,3,865,987,414,31,417,831
"Bolivia","Santa Cruz","Warnes","Warnes","U.E. SATELITE NORTE",-63.14511,-17.60841,91,3,565,656,251,25,286,537
"Bolivia","Santa Cruz","Warnes","Warnes","U.E. WAJOJO",-63.18615,-17.54112,12,5,225,237,89,15,116,205
"Bolivia","Tarija","Arce","Bermejo","(CÁRCEL) CARCELETA BERMEJO",-64.34433,-22.73379,1,0,14,15,6,0,8,14
"Bolivia","Tarija","Arce","Bermejo","U.E. 25 DE MAYO",-64.33881,-22.73283,751,34,2989,3740,1773,60,1122,2895
"Bolivia","Tarija","Arce","Bermejo","U.E. 8 DE SEPTIEMBRE",-64.3345,-22.74253,499,33,1867,2366,936,54,844,1780
"Bolivia","Tarija","Arce","Bermejo","U.E. ANTONIO JOSE DE SUCRE",-64.33714,-22.72646,197,5,812,1009,408,22,377,785
"Bolivia","Tarija","Arce","Bermejo","U.E. ARROZALES",-64.28224,-22.71737,45,2,187,232,72,6,107,179
"Bolivia","Tarija","Arce","Bermejo","U.E. AULIO ARAOZ",-64.34415,-22.72519,444,32,1518,1962,708,62,716,1424
"Bolivia","Tarija","Arce","Bermejo","U.E. BARREDERO",-64.25467,-22.60689,59,6,258,317,42,5,205,247
"Bolivia","Tarija","Arce","Bermejo","U.E. CAMPO GRANDE (ARCE)",-64.31056,-22.8059,111,12,300,411,84,30,174,258
"Bolivia","Tarija","Arce","Bermejo","U.E. COLONIA LINARES",-64.27553,-22.67242,127,18,486,613,124,20,324,448
"Bolivia","Tarija","Arce","Bermejo","U.E. EDUARDO AVAROA",-64.34496,-22.72868,920,44,3542,4462,1931,103,1464,3395
"Bolivia","Tarija","Arce","Bermejo","U.E. FLOR DE ORO",-64.42138,-22.64809,47,3,141,188,56,4,78,134
"Bolivia","Tarija","Arce","Bermejo","U.E. GUIDO VILLAGOMEZ",-64.333,-22.73719,648,45,2524,3172,1332,71,1076,2408
"Bolivia","Tarija","Arce","Bermejo","U.E. LA ESPERANZA",-64.31773,-22.72795,16,6,289,305,77,5,201,278
"Bolivia","Tarija","Arce","Bermejo","U.E. MOTO MENDEZ",-64.40874,-22.67791,78,11,209,287,71,8,119,190
"Bolivia","Tarija","Arce","Bermejo","U.E. MSCAL. ANDRES DE SANTA CRUZ",-64.33983,-22.73268,620,20,1911,2531,1155,37,699,1854
"Bolivia","Tarija","Arce","Bermejo","U.E. OCTAVIO CAMPERO ECHAZU (BERMEJO)",-64.33255,-22.73421,795,42,3075,3870,1617,101,1315,2932
"Bolivia","Tarija","Arce","Bermejo","U.E. PORCELANA",-64.2924,-22.77003,40,6,97,137,28,3,60,88
"Bolivia","Tarija","Arce","Padcaya","ESC. SECCIONAL QUEÑAHUAYCO",-64.95709,-21.92935,31,2,259,290,37,9,211,248
"Bolivia","Tarija","Arce","Padcaya","ESC. TACUARA SIMON BOLIVAR",-64.85365,-21.8613,38,2,154,192,30,2,120,150
"Bolivia","Tarija","Arce","Padcaya","NUCLEO 9 DE OCTUBRE",-64.16064,-22.4478,73,5,169,242,30,7,127,157
"Bolivia","Tarija","Arce","Padcaya","NUCLEO  SAN TELMO/PRIMERO DE MAYO",-64.41067,-22.53317,50,8,278,328,124,16,130,254
"Bolivia","Tarija","Arce","Padcaya","U.E. 2 DE AGOSTO",-64.24153,-22.49751,66,3,248,314,30,8,207,237
"Bolivia","Tarija","Arce","Padcaya","U.E. ABRA DE SAN MIGUEL",-64.80976,-21.90239,12,1,213,225,80,1,131,211
"Bolivia","Tarija","Arce","Padcaya","U.E. ANICETO ARCE",-64.71397,-21.88711,317,26,1759,2076,975,41,717,1692
"Bolivia","Tarija","Arce","Padcaya","U.E. ANZELMO ONTIVEROS",-64.53857,-22.26854,73,4,365,438,71,8,282,353
"Bolivia","Tarija","Arce","Padcaya","U.E. BLANCA NAVAJAS",-64.84832,-21.89751,89,6,384,473,105,31,242,347
"Bolivia","Tarija","Arce","Padcaya","U.E. CAMACHO",-64.91243,-21.89222,64,5,367,431,84,9,269,353
"Bolivia","Tarija","Arce","Padcaya","U.E. CANCHAS MAYU",-64.89188,-21.89764,28,2,209,237,42,2,163,205
"Bolivia","Tarija","Arce","Padcaya","U.E. EL CARMEN",-64.84747,-22.04908,25,1,135,160,32,1,101,133
"Bolivia","Tarija","Arce","Padcaya","U.E. ELOY APARICIO",-64.67204,-21.83963,116,8,518,634,188,12,310,498
"Bolivia","Tarija","Arce","Padcaya","U.E. JUAN PABLO II",-64.47629,-22.45985,54,1,127,181,50,3,73,123
"Bolivia","Tarija","Arce","Padcaya","U.E. LA HUERTA",-64.93794,-21.91131,43,7,209,252,27,6,169,196
"Bolivia","Tarija","Arce","Padcaya","U.E. LA MERCED",-64.67546,-22.02656,64,4,338,402,171,11,152,323
"Bolivia","Tarija","Arce","Padcaya","U.E. LIMAL",-64.49821,-22.32937,21,0,107,128,35,3,69,104
"Bolivia","Tarija","Arce","Padcaya","U.E. NARANJO AGRIO",-64.49283,-22.30481,23,1,100,123,17,1,81,98
"Bolivia","Tarija","Arce","Padcaya","U.E. OROZAS ARRIBA",-64.64409,-21.91746,90,15,505,595,137,23,330,467
"Bolivia","Tarija","Arce","Padcaya","U.E. OSCAR HIZA BASTIAS",-64.66535,-22.17904,117,9,466,583,149,19,289,438
"Bolivia","Tarija","Arce","Padcaya","U.E. PAMPA GRANDE",-64.43581,-22.04747,181,23,464,645,110,17,314,424
"Bolivia","Tarija","Arce","Padcaya","U.E. QUEBRADA DE CAÑAS",-64.88522,-21.96515,25,3,135,160,19,6,107,126
"Bolivia","Tarija","Arce","Padcaya","U.E. RIO NEGRO",-64.67294,-22.10281,53,11,305,358,103,11,180,283
"Bolivia","Tarija","Arce","Padcaya","U.E. ROSILLAS II",-64.78128,-21.93346,110,10,525,635,211,11,293,504
"Bolivia","Tarija","Arce","Padcaya","U.E. RUMY CANCHA",-64.67708,-21.94845,45,6,146,191,57,6,77,134
"Bolivia","Tarija","Arce","Padcaya","U.E. SALADO CONCHAS",-64.41152,-22.36673,15,0,122,137,27,2,93,120
"Bolivia","Tarija","Arce","Padcaya","U.E. SAN ANTONIO DE MACOYA",-64.89361,-22.10435,92,6,233,325,164,12,51,215
"Bolivia","Tarija","Arce","Padcaya","U.E. SAN FRANCISCO (ARCE)",-64.81699,-21.99598,22,1,151,173,34,5,111,145
"Bolivia","Tarija","Arce","Padcaya","U.E. SAN JOSE DE MARAÑUELO",-64.8847,-21.02283,20,3,175,195,18,2,152,170
"Bolivia","Tarija","Arce","Padcaya","U.E. SIMON BOLIVAR DE REJARA",-64.98435,-22.00053,49,2,271,320,21,4,244,265
"Bolivia","Tarija","Arce","Padcaya","U.E. VIRGEN DE CHAGUAYA",-64.82275,-21.86792,70,4,296,366,108,11,173,281
"Bolivia","Tarija","Avilés","Uriondo (Concepción)","COL. DELFIN PINO ICHAZU",-64.65437,-21.69452,359,20,1833,2192,1080,75,658,1738
"Bolivia","Tarija","Avilés","Uriondo (Concepción)","ESC. FELIPE ARAOZ",-64.79521,-21.81298,72,8,255,327,107,10,130,237
"Bolivia","Tarija","Avilés","Uriondo (Concepción)","ESC. MULLI CANCHA 27 DE MAYO",-64.75569,-21.66716,15,2,67,82,23,7,35,58
"Bolivia","Tarija","Avilés","Uriondo (Concepción)","ESC. NICOLAS GARECA",-64.73965,-21.68574,18,8,125,143,36,8,73,109
"Bolivia","Tarija","Avilés","Uriondo (Concepción)","ESC. WALTER MADALLENO",-64.87085,-21.83233,79,4,223,302,48,8,163,211
"Bolivia","Tarija","Avilés","Uriondo (Concepción)","U.E. 15 DE OCTUBRE",-64.87048,-21.78415,121,9,347,468,82,12,244,326
"Bolivia","Tarija","Avilés","Uriondo (Concepción)","U.E. 19 DE MARZO",-64.76694,-21.79675,44,4,203,247,73,7,119,192
"Bolivia","Tarija","Avilés","Uriondo (Concepción)","U.E. ANCON CHICO",-64.65513,-21.67163,37,5,295,332,106,4,180,286
"Bolivia","Tarija","Avilés","Uriondo (Concepción)","U.E. ANCON GRANDE",-64.65231,-21.62995,9,0,129,138,82,8,39,121
"Bolivia","Tarija","Avilés","Uriondo (Concepción)","U.E. ANICETO ARCE",-64.73565,-21.75162,181,22,870,1051,431,28,389,820
"Bolivia","Tarija","Avilés","Uriondo (Concepción)","U.E. LA CHOZA",-64.61714,-21.67806,85,13,590,675,323,32,222,545
"Bolivia","Tarija","Avilés","Uriondo (Concepción)","U.E. LA COMPAÑIA",-64.68107,-21.70434,37,7,329,366,106,14,202,308
"Bolivia","Tarija","Avilés","Uriondo (Concepción)","U.E. NUEVO AMANECER",-64.65608,-21.7632,178,17,888,1066,450,19,402,852
"Bolivia","Tarija","Avilés","Uriondo (Concepción)","U.E. ROSARIO JARAMILLO",-64.62204,-21.69797,261,40,1842,2103,823,84,895,1718
"Bolivia","Tarija","Avilés","Uriondo (Concepción)","U.E. VIRGEN DE LADERAS",-64.55874,-21.6606,27,4,166,193,45,9,108,153
"Bolivia","Tarija","Avilés","Yunchará","COL. 6 DE ABRIL",-65.22864,-21.82303,67,1,260,327,61,12,186,247
"Bolivia","Tarija","Avilés","Yunchará","U.E. 13 DE ABRIL",-65.09945,-21.99084,28,1,162,190,10,8,143,153
"Bolivia","Tarija","Avilés","Yunchará","U.E. 15 DE ABRIL",-65.32096,-21.76059,13,3,67,80,8,2,54,62
"Bolivia","Tarija","Avilés","Yunchará","U.E.  25 DE MAYO",-65.13538,-21.55874,39,2,194,233,26,7,159,185
"Bolivia","Tarija","Avilés","Yunchará","U.E. CHORCOYA AVILES",-65.05279,-21.65858,24,4,123,147,43,5,71,114
"Bolivia","Tarija","Avilés","Yunchará","U.E. FELIX RAMOS",-65.28792,-21.84653,23,0,54,77,7,2,45,52
"Bolivia","Tarija","Avilés","Yunchará","U.E. HUGO AMABLE HOYOS",-65.25793,-21.60342,8,1,45,53,3,0,41,44
"Bolivia","Tarija","Avilés","Yunchará","U.E. JOSE BALLIVIAN",-65.09161,-21.8291,90,10,208,298,44,6,148,192
"Bolivia","Tarija","Avilés","Yunchará","U.E. JOSE MARIA AVILES",-65.24372,-21.56001,18,1,99,117,15,7,76,91
"Bolivia","Tarija","Avilés","Yunchará","U.E. NARCISO CAMPERO",-65.32111,-21.81886,36,6,124,160,23,6,89,112
"Bolivia","Tarija","Avilés","Yunchará","U.E. ÑOQUERA",-65.13422,-21.62397,35,5,151,186,53,3,90,143
"Bolivia","Tarija","Avilés","Yunchará","U.E. PASAJES",-65.08871,-21.74598,48,5,272,320,50,10,207,257
"Bolivia","Tarija","Avilés","Yunchará","U.E. QUEBRADA HONDA",-65.15102,-21.95652,36,0,125,161,19,5,101,120
"Bolivia","Tarija","Avilés","Yunchará","U.E. SAN JOSE DE CHURQUIS",-65.23459,-21.72629,22,3,68,90,8,6,51,59
"Bolivia","Tarija","Avilés","Yunchará","U.E. SATURNINO URZAGASTE",-65.30037,-21.69103,18,0,123,141,15,0,108,123
"Bolivia","Tarija","Avilés","Yunchará","U.E. YUTICANCHA",-65.06479,-21.91516,4,2,91,95,13,5,71,84
"Bolivia","Tarija","Burnet O'Connor","Entre Ríos (La Moreta)","CENTRO P.A.N TENTAGUAZU",-63.96276,-21.11408,35,0,116,151,75,4,37,112
"Bolivia","Tarija","Burnet O'Connor","Entre Ríos (La Moreta)","U.E. 12 DE ABRIL",-63.78238,-21.41462,69,5,350,419,235,5,105,340
"Bolivia","Tarija","Burnet O'Connor","Entre Ríos (La Moreta)","U.E. CANALETAS CENTRO",-64.35432,-21.45255,32,2,134,166,33,7,92,125
"Bolivia","Tarija","Burnet O'Connor","Entre Ríos (La Moreta)","U.E. CHIQUIACA CENTRO",-64.12215,-21.86438,64,14,431,495,153,11,253,406
"Bolivia","Tarija","Burnet O'Connor","Entre Ríos (La Moreta)","U.E. CNL. EUSTAQUIO MENDEZ",-64.27944,-21.40812,43,6,346,389,94,14,232,326
"Bolivia","Tarija","Burnet O'Connor","Entre Ríos (La Moreta)","U.E. FRANZ TAMAYO",-64.17131,-21.52566,870,75,4070,4940,2194,116,1685,3879
"Bolivia","Tarija","Burnet O'Connor","Entre Ríos (La Moreta)","U.E. HUAICO ACERRADERO",-64.25552,-21.33019,53,4,244,297,90,12,138,228
"Bolivia","Tarija","Burnet O'Connor","Entre Ríos (La Moreta)","U.E. JUAN SAAVEDRA MEALLA",-64.23573,-21.79252,62,5,262,324,119,11,127,246
"Bolivia","Tarija","Burnet O'Connor","Entre Ríos (La Moreta)","U.E. LAGUNITAS",-63.89547,-21.41483,42,2,101,143,61,5,33,94
"Bolivia","Tarija","Burnet O'Connor","Entre Ríos (La Moreta)","U.E. LUIS VACA GALLARDO",-64.1218,-21.31882,47,5,176,223,98,7,66,164
"Bolivia","Tarija","Burnet O'Connor","Entre Ríos (La Moreta)","U.E. MISTOLAR",-63.78576,-21.17984,80,1,146,226,86,4,55,141
"Bolivia","Tarija","Burnet O'Connor","Entre Ríos (La Moreta)","U.E. ÑAURENDA",-64.05932,-21.1314,58,4,265,323,100,9,152,252
"Bolivia","Tarija","Burnet O'Connor","Entre Ríos (La Moreta)","U.E. PAJONAL",-64.16981,-21.48504,34,4,161,195,74,3,80,154
"Bolivia","Tarija","Burnet O'Connor","Entre Ríos (La Moreta)","U.E. PAMPA REDONDA",-64.17494,-21.997,16,0,118,134,23,3,92,115
"Bolivia","Tarija","Burnet O'Connor","Entre Ríos (La Moreta)","U.E. POTRERILLOS (O CONNOR)",-64.10823,-21.2234,45,13,250,295,105,3,129,234
"Bolivia","Tarija","Burnet O'Connor","Entre Ríos (La Moreta)","U.E. PROF. EMILIANO VILLARRUBIA",-63.98725,-21.52296,44,2,226,270,114,6,104,218
"Bolivia","Tarija","Burnet O'Connor","Entre Ríos (La Moreta)","U.E. PROFESOR RENE AVILA BAYON",-64.23028,-21.20329,141,13,504,645,179,21,291,470
"Bolivia","Tarija","Burnet O'Connor","Entre Ríos (La Moreta)","U.E. PUESTO MARGARITA",-63.79027,-21.1828,27,3,108,135,65,4,36,101
"Bolivia","Tarija","Burnet O'Connor","Entre Ríos (La Moreta)","U.E. REMIGIO VACA",-64.14987,-21.6035,31,2,118,149,60,23,33,93
"Bolivia","Tarija","Burnet O'Connor","Entre Ríos (La Moreta)","U.E. SAN DIEGO CENTRO",-64.18287,-21.42213,69,6,263,332,70,4,183,253
"Bolivia","Tarija","Burnet O'Connor","Entre Ríos (La Moreta)","U.E. SAN SIMON",-64.12061,-21.44145,20,7,123,143,56,1,59,115
"Bolivia","Tarija","Burnet O'Connor","Entre Ríos (La Moreta)","U.E. SECCIONAL BERETY",-64.03776,-21.44295,24,1,127,151,60,3,63,123
"Bolivia","Tarija","Burnet O'Connor","Entre Ríos (La Moreta)","U.E. SECCIONAL CAÑADAS",-63.97494,-21.41901,11,1,25,36,15,0,9,24
"Bolivia","Tarija","Burnet O'Connor","Entre Ríos (La Moreta)","U.E. SIVINGAL",-64.20417,-21.33499,30,3,188,218,23,8,154,177
"Bolivia","Tarija","Burnet O'Connor","Entre Ríos (La Moreta)","U.E. TAQUILLOS",-64.11756,-21.39566,15,3,75,90,18,2,52,70
"Bolivia","Tarija","Burnet O'Connor","Entre Ríos (La Moreta)","U.E. TARUPAYO",-63.95544,-21.32335,52,0,129,181,63,5,61,124
"Bolivia","Tarija","Burnet O'Connor","Entre Ríos (La Moreta)","U.E. TENTAPIAO",-63.91972,-21.15654,27,1,72,99,53,2,16,69
"Bolivia","Tarija","Burnet O'Connor","Entre Ríos (La Moreta)","U.E. TIMBOY",-64.06391,-21.16788,106,7,357,463,203,16,131,334
"Bolivia","Tarija","Burnet O'Connor","Entre Ríos (La Moreta)","U.E. TTE. GUALBERTO VILLARROEL",-64.20447,-21.69906,54,3,223,277,80,10,130,210
"Bolivia","Tarija","Burnet O'Connor","Entre Ríos (La Moreta)","U.E. VALLECITO DE LOS LAPACHOS",-64.05889,-21.7324,25,8,157,182,91,6,52,143
"Bolivia","Tarija","Burnet O'Connor","Entre Ríos (La Moreta)","U.E. YUKIMBIA",-63.97997,-21.04885,21,0,128,149,17,3,108,125
"Bolivia","Tarija","Cercado","Tarija","ALDEAS S.O.S ALTO SENAC",-64.76811,-21.53532,133,11,842,975,603,19,209,812
"Bolivia","Tarija","Cercado","Tarija","(CÁRCEL) PENAL DE MORROS BLANCOS",-64.70137,-21.54816,38,3,153,191,66,5,79,145
"Bolivia","Tarija","Cercado","Tarija","C.E.B.A.",-64.74647,-21.51721,571,37,2861,3432,1716,96,1012,2728
"Bolivia","Tarija","Cercado","Tarija","LOCAL PALO SANTO",-64.74363,-21.53167,342,12,1738,2080,1148,35,543,1691
"Bolivia","Tarija","Cercado","Tarija","SALON CAPACITACION BARRIO CATEDRAL",-64.76089,-21.54589,107,8,696,803,472,9,207,679
"Bolivia","Tarija","Cercado","Tarija","U.A.J.M.S CAMPUS",-64.72205,-21.54214,396,6,2039,2435,1603,47,383,1986
"Bolivia","Tarija","Cercado","Tarija","U.E. 15 DE ABRIL",-64.70269,-21.39775,49,7,209,258,155,5,42,197
"Bolivia","Tarija","Cercado","Tarija","U.E. 6 DE JUNIO",-64.73151,-21.56649,168,11,904,1072,604,25,264,868
"Bolivia","Tarija","Cercado","Tarija","U.E. ALTO DE ESPAÑA NORTE",-64.44588,-21.33693,58,9,212,270,63,34,106,169
"Bolivia","Tarija","Cercado","Tarija","U.E. AUDELIO QUIFRE",-64.53367,-21.61713,53,4,178,231,57,7,110,167
"Bolivia","Tarija","Cercado","Tarija","U.E. AVELINA RAÑA",-64.73672,-21.52712,614,26,3520,4134,2628,50,816,3444
"Bolivia","Tarija","Cercado","Tarija","U.E. BANCARIO",-64.73233,-21.54881,86,4,639,725,518,7,110,628
"Bolivia","Tarija","Cercado","Tarija","U.E. BELGRANO",-64.72131,-21.53838,965,25,5409,6374,4355,105,924,5279
"Bolivia","Tarija","Cercado","Tarija","U.E. BELLA VISTA",-64.84763,-21.65682,124,17,444,568,153,27,247,400
"Bolivia","Tarija","Cercado","Tarija","U.E. BOLIVIA",-64.7492,-21.54095,581,18,4290,4871,3316,114,842,4158
"Bolivia","Tarija","Cercado","Tarija","U.E. CARLAZO CENTRO",-64.48372,-21.48354,34,4,140,174,67,6,63,130
"Bolivia","Tarija","Cercado","Tarija","U.E. CARMEN ECHAZU",-64.72836,-21.53263,223,7,1348,1571,1121,17,203,1324
"Bolivia","Tarija","Cercado","Tarija","U.E. CASTELFORT CASTELLANOS",-64.70528,-21.54581,639,22,4069,4708,3124,110,813,3937
"Bolivia","Tarija","Cercado","Tarija","U.E. CHURQUIS",-64.78795,-21.66093,82,13,263,345,95,19,136,231
"Bolivia","Tarija","Cercado","Tarija","U.E. EL PORTILLO",-64.65661,-21.56547,204,13,1138,1342,681,39,405,1086
"Bolivia","Tarija","Cercado","Tarija","U.E. ESTEBAN MIGLIACI",-64.71228,-21.53156,800,38,5623,6423,4074,138,1373,5447
"Bolivia","Tarija","Cercado","Tarija","U.E. EULOGIO RUIZ",-64.7403,-21.51833,764,39,3787,4551,2177,103,1468,3645
"Bolivia","Tarija","Cercado","Tarija","U.E. FE Y ALEGRIA",-64.73994,-21.52347,933,40,4992,5925,3342,135,1475,4817
"Bolivia","Tarija","Cercado","Tarija","U.E. GAMONEDA",-64.62419,-21.49576,24,5,176,200,69,10,92,161
"Bolivia","Tarija","Cercado","Tarija","U.E. HERMANN GMEINER",-64.73551,-21.50994,1019,72,5020,6039,2440,227,2281,4721
"Bolivia","Tarija","Cercado","Tarija","U.E. IGNACIA NAZARIA MARCH",-64.75533,-21.50238,406,37,3082,3488,1585,128,1332,2917
"Bolivia","Tarija","Cercado","Tarija","U.E. J. NAVAL MONZON",-64.76114,-21.53481,406,33,2559,2965,1560,71,895,2455
"Bolivia","Tarija","Cercado","Tarija","U.E. JOSE MANUEL AVILA",-64.72959,-21.52524,1334,41,7435,8769,5604,189,1601,7205
"Bolivia","Tarija","Cercado","Tarija","U.E. JUANA AZURDUY DE PADILLA",-64.7084,-21.54054,372,5,2667,3039,2048,73,541,2589
"Bolivia","Tarija","Cercado","Tarija","U.E. JUAN PABLO II",-64.7523,-21.53608,542,40,3599,4141,2092,185,1282,3374
"Bolivia","Tarija","Cercado","Tarija","U.E. JUAN XXIII",-64.71565,-21.53829,604,19,3610,4214,2932,81,578,3510
"Bolivia","Tarija","Cercado","Tarija","U.E. JULIO CALVO",-64.72686,-21.51741,1247,70,7131,8378,3926,272,2863,6789
"Bolivia","Tarija","Cercado","Tarija","U.E. JUNACAS SUD",-64.46302,-21.43147,40,9,223,263,71,16,127,198
"Bolivia","Tarija","Cercado","Tarija","U.E. LA PAZ",-64.71841,-21.52833,663,36,3836,4499,2671,143,986,3657
"Bolivia","Tarija","Cercado","Tarija","U.E. LA PINTADA",-64.64189,-21.60837,106,19,823,929,502,18,284,786
"Bolivia","Tarija","Cercado","Tarija","U.E. LICEO CAMPERO",-64.73161,-21.53495,213,4,1162,1375,981,11,166,1147
"Bolivia","Tarija","Cercado","Tarija","U.E. LOS CALLEJONES",-64.73492,-21.54672,151,13,922,1073,666,27,216,882
"Bolivia","Tarija","Cercado","Tarija","U.E. LUIS DE FUENTES",-64.82387,-21.70473,178,6,323,501,173,6,138,311
"Bolivia","Tarija","Cercado","Tarija","U.E. MARIA LAURA JUSTINIANO",-64.72923,-21.53517,334,7,2046,2380,1770,27,242,2012
"Bolivia","Tarija","Cercado","Tarija","U.E. MONS ABEL COSTAS",-64.71011,-21.52861,304,28,2615,2919,1621,107,859,2480
"Bolivia","Tarija","Cercado","Tarija","U.E. MONTE CERCADO",-64.6991,-21.43521,25,3,145,170,109,8,25,134
"Bolivia","Tarija","Cercado","Tarija","U.E. NACIONAL SAN LUIS",-64.73555,-21.53229,326,7,1721,2047,1459,27,228,1687
"Bolivia","Tarija","Cercado","Tarija","U.E. NARCISO CAMPERO",-64.73502,-21.53197,210,4,1059,1269,898,14,143,1041
"Bolivia","Tarija","Cercado","Tarija","U.E. NUESTRA SEÑORA DEL ROSARIO",-64.73557,-21.52024,401,16,1990,2391,1276,72,626,1902
"Bolivia","Tarija","Cercado","Tarija","U.E. OCTAVIO CAMPERO ECHAZU",-64.72095,-21.52139,969,50,5770,6739,3400,197,2123,5523
"Bolivia","Tarija","Cercado","Tarija","U.E. OSCAR ZAMORA",-64.77103,-21.62803,184,12,596,780,237,49,298,535
"Bolivia","Tarija","Cercado","Tarija","U.E. PAPACHACRA",-64.40735,-21.48955,46,7,152,198,39,12,94,133
"Bolivia","Tarija","Cercado","Tarija","U.E. PINOS SUD",-64.87549,-21.73471,110,10,328,438,73,19,226,299
"Bolivia","Tarija","Cercado","Tarija","U.E.ROSA ARCE",-64.73045,-21.53088,344,12,2149,2493,1788,41,308,2096
"Bolivia","Tarija","Cercado","Tarija","U.E. SAN AGUSTIN SUD",-64.5279,-21.55583,56,1,136,192,70,6,59,129
"Bolivia","Tarija","Cercado","Tarija","U.E. SAN ANDRES",-64.81682,-21.62062,273,22,1369,1642,580,61,706,1286
"Bolivia","Tarija","Cercado","Tarija","U.E. SAN BLAS",-64.71835,-21.56428,84,8,466,550,313,8,137,450
"Bolivia","Tarija","Cercado","Tarija","U.E. SAN FRANCISCO DE ASIS",-64.7686,-21.51214,37,7,307,344,190,9,101,291
"Bolivia","Tarija","Cercado","Tarija","U.E. SAN GERONIMO",-64.71439,-21.54964,1257,22,3256,4513,2473,73,688,3161
"Bolivia","Tarija","Cercado","Tarija","U.E. SAN JACINTO SUD",-64.72188,-21.61152,63,8,325,388,138,16,163,301
"Bolivia","Tarija","Cercado","Tarija","U.E. SAN JORGE",-64.69663,-21.55364,693,30,3914,4607,2790,120,974,3764
"Bolivia","Tarija","Cercado","Tarija","U.E. SAN LAZARO DE GUERRA HUAYCO",-64.81322,-21.59201,385,34,1176,1561,414,45,683,1097
"Bolivia","Tarija","Cercado","Tarija","U.E. SAN LUIS",-64.69969,-21.56867,265,18,1518,1783,1013,55,432,1445
"Bolivia","Tarija","Cercado","Tarija","U.E. SAN MATEO",-64.75101,-21.48644,207,20,1239,1446,713,42,464,1177
"Bolivia","Tarija","Cercado","Tarija","U.E. SAN ROQUE",-64.73508,-21.52923,465,6,2503,2968,2108,32,357,2465
"Bolivia","Tarija","Cercado","Tarija","U.E. SANTA ANA LA NUEVA",-64.57794,-21.5435,80,12,467,547,250,5,200,450
"Bolivia","Tarija","Cercado","Tarija","U.E. SELLA QUEBRADA",-64.66478,-21.38699,86,21,257,343,112,18,106,218
"Bolivia","Tarija","Cercado","Tarija","U.E. TARIJA",-64.74217,-21.51051,455,25,2446,2901,1404,85,932,2336
"Bolivia","Tarija","Cercado","Tarija","U.E. TERESA DE CALCUTA",-64.74924,-21.53217,284,25,2053,2337,1317,79,632,1949
"Bolivia","Tarija","Cercado","Tarija","U.E. TOLOMOSITA",-64.75163,-21.6041,41,15,259,300,101,18,125,226
"Bolivia","Tarija","Cercado","Tarija","U.E. TORRECILLAS",-64.67634,-21.55232,205,19,1434,1639,862,61,492,1354
"Bolivia","Tarija","Cercado","Tarija","U.E. YESERA CENTRO",-64.5505,-21.41345,36,6,220,256,102,6,106,208
"Bolivia","Tarija","Cercado","Tarija","U.E. YESERA NORTE",-64.54983,-21.37354,59,11,251,310,111,17,112,223
"Bolivia","Tarija","Cercado","Tarija","U.E. YESERA SUD",-64.56313,-21.46948,55,5,255,310,165,15,70,235
"Bolivia","Tarija","Gran Chaco","Caraparí","POSTA SANITARIA KEREIMBA RENDA (INDIGENA)",-64.10361,-22.10099,0,0,23,23,0,0,23,23
"Bolivia","Tarija","Gran Chaco","Caraparí","U.E. 15 DE ABRIL",-63.76043,-21.74331,25,5,180,205,77,2,96,173
"Bolivia","Tarija","Gran Chaco","Caraparí","U.E. 17 DE AGOSTO",-63.92107,-21.94912,20,1,72,92,16,2,53,69
"Bolivia","Tarija","Gran Chaco","Caraparí","U.E. 2 DE AGOSTO",-63.99053,-22.09679,60,4,224,284,32,5,183,215
"Bolivia","Tarija","Gran Chaco","Caraparí","U.E. 3 DE MAYO",-63.73976,-21.82526,723,46,3404,4127,1593,70,1695,3288
"Bolivia","Tarija","Gran Chaco","Caraparí","U.E. 6 DE AGOSTO",-63.72484,-21.77807,29,8,236,265,80,9,139,219
"Bolivia","Tarija","Gran Chaco","Caraparí","U.E. BERETY CHACO",-63.69269,-21.58313,43,3,221,264,65,5,148,213
"Bolivia","Tarija","Gran Chaco","Caraparí","U.E. BOLIVIA",-63.93956,-21.80327,10,0,168,178,82,2,84,166
"Bolivia","Tarija","Gran Chaco","Caraparí","U.E. BOLIVIA DE CARAPARI",-63.77484,-21.93113,0,8,103,103,46,3,46,92
"Bolivia","Tarija","Gran Chaco","Caraparí","U.E. CAMPO LARGO HITO 22",-63.95479,-22.02285,30,2,132,162,33,2,95,128
"Bolivia","Tarija","Gran Chaco","Caraparí","U.E. CAÑITAS",-63.90673,-21.88649,3,1,74,77,21,1,51,72
"Bolivia","Tarija","Gran Chaco","Caraparí","U.E. CELSO RAFFAELLI",-63.77841,-21.8849,136,6,508,644,246,11,245,491
"Bolivia","Tarija","Gran Chaco","Caraparí","U.E. EUSTAQUIO MENDEZ/FRAY QUEBRACHO",-63.88299,-21.70185,84,8,516,600,240,10,258,498
"Bolivia","Tarija","Gran Chaco","Caraparí","U.E. FRAY QUEBRACHO",-63.72994,-21.69252,109,7,413,522,185,13,208,393
"Bolivia","Tarija","Gran Chaco","Caraparí","U.E. JULIO RAMOS VALDEZ",-63.87885,-21.81146,79,5,361,440,142,10,204,346
"Bolivia","Tarija","Gran Chaco","Caraparí","U.E. LIDIA GALARZA",-63.72426,-21.68103,141,12,631,772,234,25,360,594
"Bolivia","Tarija","Gran Chaco","Caraparí","U.E. SAN ALBERTO",-63.80844,-21.91013,108,13,522,630,210,20,279,489
"Bolivia","Tarija","Gran Chaco","Caraparí","U.E. SAN JUAN",-63.84999,-21.98089,0,0,31,31,11,1,19,30
"Bolivia","Tarija","Gran Chaco","Caraparí","U.E. SAN NICOLAS",-64.10381,-22.10169,2,3,52,54,13,2,34,47
"Bolivia","Tarija","Gran Chaco","Caraparí","U.E. ZAPATERA NORTE",-63.82479,-21.55252,61,5,285,346,111,5,164,275
"Bolivia","Tarija","Gran Chaco","Villamontes","CASA DEL NOTARIO",-62.86723,-21.80463,14,0,30,44,10,0,20,30
"Bolivia","Tarija","Gran Chaco","Villamontes","CENTRO COMUNAL",-63.45503,-21.54227,84,7,297,381,88,10,192,280
"Bolivia","Tarija","Gran Chaco","Villamontes","KINDER COLORADOS DE BOLIVIA",-63.44756,-21.25988,136,7,521,657,246,10,258,504
"Bolivia","Tarija","Gran Chaco","Villamontes","SEDE SOCIAL DE LA COMUNIDAD",-63.15966,-21.41535,15,0,41,56,25,0,16,41
"Bolivia","Tarija","Gran Chaco","Villamontes","U.E. 27 DE MAYO",-63.39827,-21.13041,48,9,345,393,130,3,203,333
"Bolivia","Tarija","Gran Chaco","Villamontes","U.E. 27 DE MAYO",-63.36565,-21.1518,48,9,345,393,130,3,203,333
"Bolivia","Tarija","Gran Chaco","Villamontes","U.E. ADELA HOYOS",-63.46374,-21.26653,568,12,2111,2679,1303,35,761,2064
"Bolivia","Tarija","Gran Chaco","Villamontes","U.E. AGUARAGÜE",-63.57405,-21.22751,44,2,147,191,81,7,57,138
"Bolivia","Tarija","Gran Chaco","Villamontes","U.E. ALGARROBAL",-63.30728,-21.38963,27,1,123,150,14,3,105,119
"Bolivia","Tarija","Gran Chaco","Villamontes","U.E.ANTONIO JOSE DE SUCRE",-63.41752,-21.06529,31,3,170,201,67,10,90,157
"Bolivia","Tarija","Gran Chaco","Villamontes","U.E. ASAMBLEA DE DIOS",-63.46189,-21.27044,742,53,3006,3748,1552,71,1330,2882
"Bolivia","Tarija","Gran Chaco","Villamontes","U.E. CABO JUAN",-63.42142,-21.16265,95,12,497,592,222,10,253,475
"Bolivia","Tarija","Gran Chaco","Villamontes","U.E. CAPIRENDA",-63.00224,-21.09902,14,0,30,44,25,0,5,30
"Bolivia","Tarija","Gran Chaco","Villamontes","U.E. CAPIRENDITA",-63.43694,-21.29784,337,12,589,926,81,72,424,505
"Bolivia","Tarija","Gran Chaco","Villamontes","U.E. CENTRAL CUTAIQUI",-62.83306,-21.892,11,0,49,60,18,0,31,49
"Bolivia","Tarija","Gran Chaco","Villamontes","U.E. CHACO BOREAL",-62.62968,-21.56227,2,1,13,15,3,0,9,12
"Bolivia","Tarija","Gran Chaco","Villamontes","U.E. CHIMEO",-63.44035,-21.18806,19,4,249,268,68,5,172,240
"Bolivia","Tarija","Gran Chaco","Villamontes","U.E. COLORADOS DE BOLIVIA",-63.44739,-21.26013,825,44,3487,4312,1600,147,1696,3296
"Bolivia","Tarija","Gran Chaco","Villamontes","U.E. IBIBOBO",-62.99517,-21.5432,198,2,133,331,62,1,68,130
"Bolivia","Tarija","Gran Chaco","Villamontes","U.E. IBOPEITI",-63.3834,-21.29926,34,2,197,231,43,2,150,193
"Bolivia","Tarija","Gran Chaco","Villamontes","U.E. ISMAEL MONTES",-63.47746,-21.25815,512,24,2204,2716,1419,47,714,2133
"Bolivia","Tarija","Gran Chaco","Villamontes","U.E. JUANA AZURDUY DE PADILLA (V.M.)",-63.46507,-21.25878,558,31,2820,3378,1845,58,886,2731
"Bolivia","Tarija","Gran Chaco","Villamontes","U.E.  JULIO CREVAUX",-63.47588,-21.26414,764,16,2612,3376,1752,60,784,2536
"Bolivia","Tarija","Gran Chaco","Villamontes","U.E. LA ESMERALDA",-62.65346,-22.22636,12,0,25,37,11,0,14,25
"Bolivia","Tarija","Gran Chaco","Villamontes","U.E. NUEVA ESPERANZA",-62.73864,-21.84503,13,0,48,61,16,3,29,45
"Bolivia","Tarija","Gran Chaco","Villamontes","U.E. REBECA AGUIRRE",-63.33084,-21.00389,173,12,610,783,301,16,281,582
"Bolivia","Tarija","Gran Chaco","Villamontes","U.E. RESISTENCIA",-63.113,-21.5044,0,32,154,154,20,4,98,118
"Bolivia","Tarija","Gran Chaco","Villamontes","U.E. SAN ANTONIO (VILLA MONTES)",-63.47097,-21.27801,150,9,776,926,419,15,333,752
"Bolivia","Tarija","Gran Chaco","Villamontes","U.E. SAN ISIDRO LA VICTORIA",-62.75867,-22.14704,23,1,45,68,35,0,9,44
"Bolivia","Tarija","Gran Chaco","Villamontes","U.E. TENIENTE VICTOR ZEBALLOS CLAROS",-63.42403,-21.09695,57,11,345,402,129,11,194,323
"Bolivia","Tarija","Gran Chaco","Yacuiba","(CÁRCEL) CARCELETA PUBLICA",-63.61958,-21.87883,26,0,76,102,29,2,45,74
"Bolivia","Tarija","Gran Chaco","Yacuiba","ESC. 2 DE AGOSTO",-63.6631,-21.98295,291,32,1763,2054,834,72,825,1659
"Bolivia","Tarija","Gran Chaco","Yacuiba","ESCUELA 27 DE MAYO",-63.63179,-21.86089,25,4,217,242,90,9,114,204
"Bolivia","Tarija","Gran Chaco","Yacuiba","U.E. 12 DE AGOSTO",-63.62997,-21.90739,175,13,808,983,318,45,432,750
"Bolivia","Tarija","Gran Chaco","Yacuiba","U.E. 21 DE SEPTIEMBRE",-63.38381,-21.8469,37,3,131,168,76,6,46,122
"Bolivia","Tarija","Gran Chaco","Yacuiba","U.E. 27 DE MAYO",-63.63601,-21.93299,313,13,1107,1420,402,30,662,1064
"Bolivia","Tarija","Gran Chaco","Yacuiba","U.E. 4 DE MAYO",-63.55672,-21.71432,144,28,822,966,246,27,521,767
"Bolivia","Tarija","Gran Chaco","Yacuiba","U.E. ALCIDES D`ORBIGNI",-62.8343,-21.99477,184,11,334,518,45,15,263,308
"Bolivia","Tarija","Gran Chaco","Yacuiba","U.E. CAMPO GRANDE (GRAN CHACO)",-63.6561,-21.95966,324,33,1779,2103,805,57,884,1689
"Bolivia","Tarija","Gran Chaco","Yacuiba","U.E. CAÑON OCULTO",-63.61351,-21.97809,38,7,220,258,71,6,136,207
"Bolivia","Tarija","Gran Chaco","Yacuiba","U.E. CLUB DE LEONES (BÁSICO Y MEDIO)",-63.6776,-22.00842,967,29,4201,5168,2720,104,1348,4068
"Bolivia","Tarija","Gran Chaco","Yacuiba","U.E. CREVAUX SUD",-62.93186,-21.81382,227,7,600,827,116,23,454,570
"Bolivia","Tarija","Gran Chaco","Yacuiba","U.E. FERROVIARIA",-63.6751,-22.01609,451,15,1736,2187,1017,39,665,1682
"Bolivia","Tarija","Gran Chaco","Yacuiba","U.E. GERMAN BUSCH",-63.68483,-22.02006,369,14,1322,1691,789,29,490,1279
"Bolivia","Tarija","Gran Chaco","Yacuiba","U.E. HEROES DE BOQUERON",-63.60726,-21.6859,292,6,502,794,242,25,229,471
"Bolivia","Tarija","Gran Chaco","Yacuiba","U.E. HEROES DEL CHACO",-63.68172,-22.05065,1086,37,2919,4005,1380,60,1442,2822
"Bolivia","Tarija","Gran Chaco","Yacuiba","U.E. JOSE MANUEL BELGRANO (YACUIBA)",-63.6762,-22.01613,713,18,3055,3768,1888,64,1085,2973
"Bolivia","Tarija","Gran Chaco","Yacuiba","U.E. JUANA AZURDUY DE PADILLA (YACUIBA)",-63.67266,-22.00477,864,40,3561,4425,2125,120,1276,3401
"Bolivia","Tarija","Gran Chaco","Yacuiba","U.E. LA PURISIMA",-62.99116,-21.62585,35,0,90,125,17,0,73,90
"Bolivia","Tarija","Gran Chaco","Yacuiba","U.E. LICEO GRAN CHACO",-63.67698,-22.01581,538,19,2359,2897,1600,47,693,2293
"Bolivia","Tarija","Gran Chaco","Yacuiba","U.E. MARISCAL SUCRE",-63.66786,-21.99878,193,9,806,999,434,17,346,780
"Bolivia","Tarija","Gran Chaco","Yacuiba","U.E. MIGUEL ESTENSORO",-63.68021,-22.01661,1277,31,4464,5741,2800,94,1539,4339
"Bolivia","Tarija","Gran Chaco","Yacuiba","U.E. NACIONAL MIXTO EL PALMAR",-63.61583,-21.88011,371,23,1426,1797,756,47,600,1356
"Bolivia","Tarija","Gran Chaco","Yacuiba","U.E. NESTOR PAZ GALARZA",-63.67497,-21.99887,587,19,2316,2903,1276,96,925,2201
"Bolivia","Tarija","Gran Chaco","Yacuiba","U.E. OLIVERIO PELICHELLI",-63.67335,-22.02432,251,15,1090,1341,568,26,481,1049
"Bolivia","Tarija","Gran Chaco","Yacuiba","U.E. PROF. BAUTISTA JURADO",-63.55737,-21.8007,183,23,797,980,323,17,434,757
"Bolivia","Tarija","Gran Chaco","Yacuiba","U.E. SACHAPERA",-63.55339,-21.66175,55,14,607,662,150,24,419,569
"Bolivia","Tarija","Gran Chaco","Yacuiba","U.E. SAN FRANCISCO DE INTI",-63.58647,-21.81835,55,10,394,449,133,12,239,372
"Bolivia","Tarija","Gran Chaco","Yacuiba","U.E. SIMON BOLIVAR",-63.6829,-22.0522,1095,94,3863,4958,1415,130,2224,3639
"Bolivia","Tarija","Gran Chaco","Yacuiba","U.E. SUNCHAL",-63.49324,-21.68086,35,2,95,130,44,1,48,92
"Bolivia","Tarija","Gran Chaco","Yacuiba","U.E. TIERRAS NUEVAS",-63.56289,-21.74935,124,15,653,777,131,35,472,603
"Bolivia","Tarija","Gran Chaco","Yacuiba","U.E. TIMBOY TIGUAZU",-63.57601,-21.55468,32,4,170,202,34,6,126,160
"Bolivia","Tarija","Gran Chaco","Yacuiba","U.E. VILLA EL CARMEN",-63.57232,-21.78605,185,28,1001,1186,310,45,618,928
"Bolivia","Tarija","Gran Chaco","Yacuiba","U.E. YACUIBA",-63.67945,-21.99672,784,52,3662,4446,1964,126,1520,3484
"Bolivia","Tarija","Méndez","Tomayapo (El Puente)","CENTRO COMUNAL",-65.21614,-21.31723,24,3,170,194,83,3,81,164
"Bolivia","Tarija","Méndez","Tomayapo (El Puente)","NUCLEO ANDRES ZAMORA",-65.23907,-21.43847,18,3,120,138,51,2,64,115
"Bolivia","Tarija","Méndez","Tomayapo (El Puente)","SEDE CLUB DE MADRES",-65.24256,-21.46749,15,0,53,68,19,6,28,47
"Bolivia","Tarija","Méndez","Tomayapo (El Puente)","SEDE COMUNAL",-64.96433,-21.23611,58,8,254,312,134,7,105,239
"Bolivia","Tarija","Méndez","Tomayapo (El Puente)","U.E. 1O. DE JULIO",-65.20398,-21.23499,166,13,751,917,347,21,370,717
"Bolivia","Tarija","Méndez","Tomayapo (El Puente)","U.E. CHINCHILLA",-65.14574,-21.19778,10,0,60,70,18,1,41,59
"Bolivia","Tarija","Méndez","Tomayapo (El Puente)","U.E. CHORCOYA MENDEZ",-65.01444,-21.56835,78,10,175,253,30,5,130,160
"Bolivia","Tarija","Méndez","Tomayapo (El Puente)","U.E. CUMBRE DE SAMA",-64.95296,-21.48289,57,12,236,293,62,10,152,214
"Bolivia","Tarija","Méndez","Tomayapo (El Puente)","U.E. EDUARDO ABAROA",-65.11504,-21.35772,3,1,70,73,17,2,50,67
"Bolivia","Tarija","Méndez","Tomayapo (El Puente)","U.E. EL MOLINO",-64.95007,-21.39787,80,8,282,362,70,18,186,256
"Bolivia","Tarija","Méndez","Tomayapo (El Puente)","U.E. FRANZ TAMAYO",-64.96854,-21.48615,285,44,1112,1397,392,78,598,990
"Bolivia","Tarija","Méndez","Tomayapo (El Puente)","U.E. GERALDINO GUERRERO",-64.95905,-21.14464,94,3,280,374,145,11,121,266
"Bolivia","Tarija","Méndez","Tomayapo (El Puente)","U.E. HUARMACHI",-65.06249,-21.44367,22,0,131,153,74,5,52,126
"Bolivia","Tarija","Méndez","Tomayapo (El Puente)","U.E. HUERTA HUAYCO",-64.94923,-21.11442,35,2,87,122,27,6,52,79
"Bolivia","Tarija","Méndez","Tomayapo (El Puente)","U.E. IRCALAYA",-65.20068,-21.19576,14,1,48,62,15,1,31,46
"Bolivia","Tarija","Méndez","Tomayapo (El Puente)","U.E. JESUS ZAMORA",-65.22533,-21.37169,33,4,145,178,83,2,56,139
"Bolivia","Tarija","Méndez","Tomayapo (El Puente)","U.E. LIC. SEGUNDINO UGARTE DURAN",-65.04431,-21.27013,39,2,153,192,98,5,48,146
"Bolivia","Tarija","Méndez","Tomayapo (El Puente)","U.E. MONTE GRANDE",-65.08482,-21.24768,33,2,113,146,76,3,32,108
"Bolivia","Tarija","Méndez","Tomayapo (El Puente)","U.E. OBISPO EL CARMEN",-65.03886,-21.30891,38,2,81,119,48,4,27,75
"Bolivia","Tarija","Méndez","Tomayapo (El Puente)","U.E. PUEBLO NUEVO",-64.98272,-21.53179,115,15,236,351,36,14,171,207
"Bolivia","Tarija","Méndez","Tomayapo (El Puente)","U.E. SAN ANTONIO DE CURQUI",-65.07034,-21.49188,36,4,196,232,99,5,88,187
"Bolivia","Tarija","Méndez","Tomayapo (El Puente)","U.E. SAN ANTONIO (MENDEZ)",-64.965,-21.44068,67,8,235,302,60,29,138,198
"Bolivia","Tarija","Méndez","Tomayapo (El Puente)","U.E. SANTA ROSA",-65.05383,-21.13585,40,1,58,98,1,1,55,56
"Bolivia","Tarija","Méndez","Tomayapo (El Puente)","U.E. VILLA NUEVA",-64.9509,-21.35972,39,1,122,161,43,10,68,111
"Bolivia","Tarija","Méndez","Villa San Lorenzo","PUESTO DE SALUD JARCAS",-64.50289,-21.28495,4,0,66,70,19,3,44,63
"Bolivia","Tarija","Méndez","Villa San Lorenzo","U.E. 15 DE ABRIL ERQUIS",-64.79546,-21.46687,110,15,734,844,409,48,262,671
"Bolivia","Tarija","Méndez","Villa San Lorenzo","U.E. 1O. DE MAYO",-64.57595,-21.03652,59,8,134,193,24,7,95,119
"Bolivia","Tarija","Méndez","Villa San Lorenzo","U.E. ALTO DE CAJAS",-64.47047,-21.30705,29,2,70,99,40,4,24,64
"Bolivia","Tarija","Méndez","Villa San Lorenzo","U.E. ANGEL CALABI PASOLINNI",-64.76366,-21.49823,258,18,1513,1771,907,47,541,1448
"Bolivia","Tarija","Méndez","Villa San Lorenzo","U.E. BORDO EL MOLLAR",-64.76112,-21.42673,66,9,403,469,226,23,145,371
"Bolivia","Tarija","Méndez","Villa San Lorenzo","U.E. CARACHIMAYO CENTRO",-64.72285,-21.35113,153,23,433,586,207,34,169,376
"Bolivia","Tarija","Méndez","Villa San Lorenzo","U.E. CHAUPICANCHA",-64.66171,-21.34586,33,6,56,89,18,3,29,47
"Bolivia","Tarija","Méndez","Villa San Lorenzo","U.E. COCHAS",-64.8509,-21.37324,10,4,71,81,17,3,47,64
"Bolivia","Tarija","Méndez","Villa San Lorenzo","U.E. COLORADO NORTE",-64.78835,-21.17892,62,0,124,186,7,8,109,116
"Bolivia","Tarija","Méndez","Villa San Lorenzo","U.E. EL PAJONAL",-64.52412,-21.20756,23,0,61,84,28,4,29,57
"Bolivia","Tarija","Méndez","Villa San Lorenzo","U.E. EL PUESTO",-64.52888,-21.28559,30,1,57,87,10,6,40,50
"Bolivia","Tarija","Méndez","Villa San Lorenzo","U.E. EUSTAQUIO MENDEZ",-64.75005,-21.41892,943,72,3042,3985,1845,129,996,2841
"Bolivia","Tarija","Méndez","Villa San Lorenzo","U.E. EUSTAQUIO MENDEZ",-64.67755,-21.04951,943,72,3042,3985,1845,129,996,2841
"Bolivia","Tarija","Méndez","Villa San Lorenzo","U.E. EUSTAQUIO MENDEZ",-64.76018,-21.34489,943,72,3042,3985,1845,129,996,2841
"Bolivia","Tarija","Méndez","Villa San Lorenzo","U.E. HUANCOIRO",-64.85504,-21.19721,13,1,68,81,31,4,32,63
"Bolivia","Tarija","Méndez","Villa San Lorenzo","U.E. JUAN MISAEL SARACHO",-64.7941,-21.49765,47,7,407,454,257,17,126,383
"Bolivia","Tarija","Méndez","Villa San Lorenzo","U.E. JULIO SUCRE SELLA MENDEZ",-64.69686,-21.38795,95,9,360,455,248,12,91,339
"Bolivia","Tarija","Méndez","Villa San Lorenzo","U.E. LEON CANCHA",-64.71355,-21.17894,128,13,219,347,62,12,132,194
"Bolivia","Tarija","Méndez","Villa San Lorenzo","U.E. MANDOR GRANDE",-64.74651,-21.06744,29,1,25,54,13,1,10,23
"Bolivia","Tarija","Méndez","Villa San Lorenzo","U.E. NESTOR PAZ ZAMORA",-64.75089,-21.38968,114,24,499,613,269,22,184,453
"Bolivia","Tarija","Méndez","Villa San Lorenzo","U.E. OSVALDO GALVEZ",-64.80488,-21.4087,136,24,514,650,241,15,234,475
"Bolivia","Tarija","Méndez","Villa San Lorenzo","U.E. PEÑADERIA",-64.49856,-21.2275,3,3,67,70,25,7,32,57
"Bolivia","Tarija","Méndez","Villa San Lorenzo","U.E. RANCHO SUD",-64.7542,-21.4619,69,4,455,524,331,9,111,442
"Bolivia","Tarija","Méndez","Villa San Lorenzo","U.E. SAN LORENCITO",-64.47129,-21.25033,14,1,71,85,6,7,57,63
"Bolivia","Tarija","Méndez","Villa San Lorenzo","U.E. SAN PEDRO DE LAS PEÑAS",-64.65049,-21.14055,37,2,49,86,17,1,29,46
"Bolivia","Tarija","Méndez","Villa San Lorenzo","U.E. SERAPIO MARTINEZ",-64.74917,-21.44493,121,11,876,997,602,23,240,842
"Bolivia","Tarija","Méndez","Villa San Lorenzo","U.E. SIMON BOLIVAR",-64.7877,-21.50771,97,14,791,888,565,31,181,746
"Bolivia","Tarija","Méndez","Villa San Lorenzo","U.E. TARIJA CANCHA SUD",-64.76456,-21.41479,88,9,532,620,331,16,176,507
"Bolivia","Tarija","Méndez","Villa San Lorenzo","U.E. TOMATAS GRANDE",-64.78188,-21.3224,101,10,429,530,235,21,163,398
"Bolivia","Tarija","Méndez","Villa San Lorenzo","U.E. TRANCAS",-64.8347,-21.30479,44,3,127,171,65,12,47,112
"Bolivia","Tarija","Méndez","Villa San Lorenzo","U.E. TUCUMILLAS",-64.83385,-21.45885,18,2,104,122,16,3,83,99
"Bolivia","Beni","Cercado","San Javier","ESCUELA ESPIRITU SANTO",-64.80295,-14.63469,7,0,34,41,13,0,21,34
"Bolivia","Beni","Cercado","San Javier","ESCUELA LAGUNA COLORADA",-64.63057,-14.63861,15,0,33,48,14,0,19,33
"Bolivia","Beni","Cercado","San Javier","ESCUELA NUEVA ISRAEL",-64.3355,-14.67209,110,7,420,530,195,36,182,377
"Bolivia","Beni","Cercado","San Javier","ESCUELA PEDRO IGNACIO MUIBA",-64.08376,-14.49183,23,1,161,184,74,0,86,160
"Bolivia","Beni","Cercado","San Javier","ESCUELA SAN JAVIER",-64.88087,-14.59987,63,4,287,350,141,2,140,281
"Bolivia","Beni","Cercado","San Javier","ESCUELA SAN PEDRO",-64.90086,-14.33668,79,2,319,398,157,10,150,307
"Bolivia","Beni","Cercado","San Javier","U.E. LA CURVA",-64.20807,-14.58863,41,2,100,141,37,3,58,95
"Bolivia","Beni","Cercado","Trinidad","CARCEL DE MUJERES",-64.90281,-14.84692,9,1,36,45,19,0,16,35
"Bolivia","Beni","Cercado","Trinidad","CARCEL MOCOBI",-64.90376,-14.77958,0,0,178,178,62,50,66,128
"Bolivia","Beni","Cercado","Trinidad","CENTRO INTEGRADO SAN FRANCISCO DE ASIS",-64.88588,-14.82278,85,4,686,771,488,11,183,671
"Bolivia","Beni","Cercado","Trinidad","COL. JOAQUIN HURTADO CHAVEZ",-64.90425,-14.81511,383,17,1922,2305,1225,38,642,1867
"Bolivia","Beni","Cercado","Trinidad","COL. LA SALLE",-64.89569,-14.82676,329,5,1457,1786,1045,38,369,1414
"Bolivia","Beni","Cercado","Trinidad","COL. SAN VICENTE (EX UAB)",-64.91093,-14.8346,631,20,3141,3772,2072,80,969,3041
"Bolivia","Beni","Cercado","Trinidad","ESC.4 DE  FEBRERO",-64.90131,-14.84447,801,36,3606,4407,2139,91,1340,3479
"Bolivia","Beni","Cercado","Trinidad","ESC.CORINA HURTADO DE",-64.89422,-14.84378,458,15,2434,2892,1438,50,931,2369
"Bolivia","Beni","Cercado","Trinidad","ESC.J.AZURDUY DE PADILLA",-64.8893,-14.82634,271,8,1612,1883,1128,36,440,1568
"Bolivia","Beni","Cercado","Trinidad","ESC.J. CHAVEZ SUAREZ",-64.90463,-14.8414,1158,36,5202,6360,3120,112,1934,5054
"Bolivia","Beni","Cercado","Trinidad","ESC.J. LORENZO CAMPERO",-64.89998,-14.8257,226,7,1423,1649,982,23,411,1393
"Bolivia","Beni","Cercado","Trinidad","ESC. LOMA SUAREZ",-64.96272,-14.76063,202,7,444,646,182,19,236,418
"Bolivia","Beni","Cercado","Trinidad","ESC. MANGALITO",-64.91572,-14.84847,371,11,1608,1979,872,32,693,1565
"Bolivia","Beni","Cercado","Trinidad","ESC.MARY RIBERA G.",-64.88783,-14.81399,613,20,3832,4445,2571,95,1146,3717
"Bolivia","Beni","Cercado","Trinidad","ESC.MAYOR PEDRO VACA DIEZ",-64.96582,-14.86952,100,3,236,336,109,1,123,232
"Bolivia","Beni","Cercado","Trinidad","ESC.NICOLAS SUAREZ",-64.90492,-14.83268,444,10,2080,2524,1516,37,517,2033
"Bolivia","Beni","Cercado","Trinidad","ESC. NUESTRA SEÑORA DE FATIMA",-64.89811,-14.83099,758,18,3338,4096,2229,82,1009,3238
"Bolivia","Beni","Cercado","Trinidad","ESC. PEDRO IGNACIO MUIBA",-64.91414,-14.84481,472,25,2346,2818,1413,96,812,2225
"Bolivia","Beni","Cercado","Trinidad","ESC.PUERTO BALLIVIAN",-64.97205,-14.79312,20,2,119,139,55,0,62,117
"Bolivia","Beni","Cercado","Trinidad","ESC. PUERTO VARADOR",-64.99762,-14.87702,128,13,453,581,242,21,177,419
"Bolivia","Beni","Cercado","Trinidad","ESC. RAUL MONJE ROCA",-64.8938,-14.83707,439,7,2240,2679,1414,74,745,2159
"Bolivia","Beni","Cercado","Trinidad","ESC.SAN ANTONIO",-64.91032,-14.83844,573,47,3077,3650,2005,42,983,2988
"Bolivia","Beni","Cercado","Trinidad","ESC.SAN JOSE",-64.90439,-14.82626,209,9,1272,1481,931,21,311,1242
"Bolivia","Beni","Cercado","Trinidad","ESC.SAN JUAN DE AGUAS DULCES",-64.57809,-14.80817,12,0,89,101,67,0,22,89
"Bolivia","Beni","Cercado","Trinidad","ESCUELA 13 DE ABRIL",-64.8902,-14.83764,333,22,2304,2637,1262,129,891,2153
"Bolivia","Beni","Cercado","Trinidad","ESCUELA CASARABE",-64.47997,-14.87161,112,3,415,527,228,9,175,403
"Bolivia","Beni","Cercado","Trinidad","ESCUELA EMILIO CAMPOS PEDRIEL",-64.8847,-14.81962,388,12,1994,2382,1324,39,619,1943
"Bolivia","Beni","Cercado","Trinidad","ESCUELA IVIATO",-64.44854,-14.83285,40,1,172,212,94,0,77,171
"Bolivia","Beni","Cercado","Trinidad","ESCUELA NUEVA TRINIDAD",-64.8754,-14.82357,857,28,3145,4002,1882,72,1163,3045
"Bolivia","Beni","Cercado","Trinidad","ESC. URBANIZ.MANA",-64.9059,-14.77769,100,2,512,612,306,5,199,505
"Bolivia","Beni","Cercado","Trinidad","ESC. VILLA VECINAL",-64.87392,-14.81023,400,26,2609,3009,1791,40,752,2543
"Bolivia","Beni","Cercado","Trinidad","INFOCAL",-64.90236,-14.82328,231,7,1082,1313,736,19,320,1056
"Bolivia","Beni","Cercado","Trinidad","LICEO MARIO SAIELLY",-64.90276,-14.83593,321,6,1655,1976,1150,17,482,1632
"Bolivia","Beni","Cercado","Trinidad","U.A.B. (CARRERA DE DERECHO)",-64.91308,-14.83274,454,46,2151,2605,1438,31,636,2074
"Bolivia","Beni","Cercado","Trinidad","U.E 15 DE AGOSTO",-64.92943,-14.83425,115,11,811,926,454,19,327,781
"Bolivia","Beni","Cercado","Trinidad","U.E GONZALO SUAREZ D.",-64.90136,-14.85325,80,5,337,417,214,4,114,328
"Bolivia","Beni","Cercado","Trinidad","U.E LUIS ESPINAL CAMS",-64.92085,-14.84365,160,16,1065,1225,577,22,450,1027
"Bolivia","Beni","Cercado","Trinidad","U.E. ORLANDO MONASTERIO CLAURE",-64.93098,-14.8181,22,7,259,281,151,4,97,248
"Bolivia","Beni","General Jose Ballivián Segurola","Puerto Rurrenabaque","ESC. ASUNCION DEL QUIQUIBEY",-67.51161,-14.64125,29,2,73,102,36,2,33,69
"Bolivia","Beni","General Jose Ballivián Segurola","Puerto Rurrenabaque","ESC.CENTRAL NUEVOS HORIZONTES",-67.27888,-14.59985,115,9,374,489,122,29,214,336
"Bolivia","Beni","General Jose Ballivián Segurola","Puerto Rurrenabaque","ESC.CENTRAL PIEDRAS BLANCAS",-67.15208,-14.78934,100,16,586,686,79,15,476,555
"Bolivia","Beni","General Jose Ballivián Segurola","Puerto Rurrenabaque","ESC.GUALBERTO VILLARRUEL",-67.5281,-14.44452,861,31,2868,3729,1703,52,1082,2785
"Bolivia","Beni","General Jose Ballivián Segurola","Puerto Rurrenabaque","ESC. PLAYA ANCHA",-67.26197,-14.62954,27,5,164,191,12,9,138,150
"Bolivia","Beni","General Jose Ballivián Segurola","Puerto Rurrenabaque","ESCUELA VILLA LOURDES",-67.5043,-14.42944,45,5,152,197,71,3,73,144
"Bolivia","Beni","General Jose Ballivián Segurola","Puerto Rurrenabaque","UNIDAD EDUCATIVA LUCIO LENS",-67.52292,-14.44037,953,50,3672,4625,2055,165,1402,3457
"Bolivia","Beni","General Jose Ballivián Segurola","Reyes","COL. NACIONAL REYES",-67.33482,-14.29558,370,16,1409,1779,779,27,587,1366
"Bolivia","Beni","General Jose Ballivián Segurola","Reyes","ESC. BUEN DESTINO",-66.76987,-11.76321,21,4,102,123,17,2,79,96
"Bolivia","Beni","General Jose Ballivián Segurola","Reyes","ESC. CENTRAL BAQUETY",-66.79783,-12.53514,65,0,48,113,4,1,43,47
"Bolivia","Beni","General Jose Ballivián Segurola","Reyes","ESC.CENTRAL PUERTO CAVINAS",-66.91502,-12.53129,85,5,133,218,46,1,81,127
"Bolivia","Beni","General Jose Ballivián Segurola","Reyes","ESC. CONSTANZA VARGAS",-66.73828,-11.73581,11,0,24,35,13,2,9,22
"Bolivia","Beni","General Jose Ballivián Segurola","Reyes","ESC.JESUS ALVAREZ",-67.3343,-14.29483,471,23,1650,2121,912,74,641,1553
"Bolivia","Beni","General Jose Ballivián Segurola","Reyes","ESC.PEÑA AMARILLA",-66.67179,-11.5471,61,2,95,156,77,2,14,91
"Bolivia","Beni","General Jose Ballivián Segurola","Reyes","ESC. RENE BARRIENTOS ORTUÑO",-67.33835,-14.29512,113,1,310,423,174,9,126,300
"Bolivia","Beni","General Jose Ballivián Segurola","Reyes","ESC. SAN JOSE",-67.37435,-14.30772,12,1,89,101,41,5,42,83
"Bolivia","Beni","General Jose Ballivián Segurola","Reyes","ESC. SAN MARCOS",-67.50578,-13.81978,3,0,22,25,18,1,3,21
"Bolivia","Beni","General Jose Ballivián Segurola","Reyes","ESC. SORAIDA",-67.50439,-14.05581,17,0,24,41,14,0,10,24
"Bolivia","Beni","General Jose Ballivián Segurola","Reyes","ESCUELA DE CALIFORNIA",-66.90263,-11.95482,16,0,54,70,22,1,31,53
"Bolivia","Beni","General Jose Ballivián Segurola","Reyes","U.E. CARMEN ALTO",-66.36278,-11.71022,6,4,88,94,39,1,44,83
"Bolivia","Beni","General Jose Ballivián Segurola","San Borja","COL. ARNULFO MARTINEZ",-66.74274,-14.86135,1010,35,3361,4371,1946,68,1312,3258
"Bolivia","Beni","General Jose Ballivián Segurola","San Borja","COL.INDUSTRIAL INGAVI",-67.03596,-15.14148,666,37,2392,3058,828,69,1458,2286
"Bolivia","Beni","General Jose Ballivián Segurola","San Borja","COL.SAN FRANCISCO DE BORJA",-66.75023,-14.85829,760,29,2731,3491,1804,62,836,2640
"Bolivia","Beni","General Jose Ballivián Segurola","San Borja","ESC.DE PUERTO YUCUMO",-66.93755,-15.19761,36,3,276,312,16,6,251,267
"Bolivia","Beni","General Jose Ballivián Segurola","San Borja","ESC.EL CHACAL",-66.62759,-14.75295,62,6,300,362,3,3,288,291
"Bolivia","Beni","General Jose Ballivián Segurola","San Borja","ESC.EL PALMAR",-67.08794,-14.97903,131,20,688,819,150,19,499,649
"Bolivia","Beni","General Jose Ballivián Segurola","San Borja","ESC.GERMAN BUSCH",-66.74983,-14.85664,707,19,2407,3114,1615,47,726,2341
"Bolivia","Beni","General Jose Ballivián Segurola","San Borja","ESC. INDIGENA ARENALES",-66.9127,-15.10867,41,8,455,496,13,12,422,435
"Bolivia","Beni","General Jose Ballivián Segurola","San Borja","ESC.JUNRRENO",-66.93327,-14.37257,11,1,32,43,15,0,16,31
"Bolivia","Beni","General Jose Ballivián Segurola","San Borja","ESC. LA CRUZ",-66.73125,-14.97601,78,14,584,662,38,9,523,561
"Bolivia","Beni","General Jose Ballivián Segurola","San Borja","ESC.LA EMBOCADA",-66.73125,-14.97601,85,1,254,339,96,7,150,246
"Bolivia","Beni","General Jose Ballivián Segurola","San Borja","ESC.LAS ABRAS",-66.93307,-14.4615,12,4,77,89,6,0,67,73
"Bolivia","Beni","General Jose Ballivián Segurola","San Borja","ESC. MISION FATIMA",-66.746,-15.45636,43,7,352,395,23,3,319,342
"Bolivia","Beni","General Jose Ballivián Segurola","San Borja","ESC.SANTA ELENA DEL CARIPO",-66.82342,-14.5799,19,1,102,121,39,0,62,101
"Bolivia","Beni","General Jose Ballivián Segurola","San Borja","ESC.S.JUAN DEL REMANZO",-66.5321,-14.67902,8,0,39,47,7,0,32,39
"Bolivia","Beni","General Jose Ballivián Segurola","San Borja","ESC. TACUARAL DE MATTOS",-66.53598,-14.99362,39,46,471,510,17,8,400,417
"Bolivia","Beni","General Jose Ballivián Segurola","San Borja","ESCUELA EL ORIENTE DEL YACUMA",-66.99512,-14.35404,26,1,79,105,34,0,44,78
"Bolivia","Beni","General Jose Ballivián Segurola","San Borja","U.E. MANGUITO",-66.63986,-14.89842,39,10,458,497,56,3,389,445
"Bolivia","Beni","General Jose Ballivián Segurola","San Borja","U.E MARCA COROICO",-67.08862,-14.78361,10,4,109,119,14,7,84,98
"Bolivia","Beni","General Jose Ballivián Segurola","San Borja","U.E. QUIQUIBEY",-67.0975,-15.36358,27,1,174,201,22,1,150,172
"Bolivia","Beni","General Jose Ballivián Segurola","San Borja","U.E SAN IGNACIO DEL MANIQUI",-66.72903,-14.85899,101,7,365,466,195,8,155,350
"Bolivia","Beni","General Jose Ballivián Segurola","San Borja","U.E VILLA SAN ANTONIO",-66.74652,-14.87003,108,6,463,571,252,13,192,444
"Bolivia","Beni","General Jose Ballivián Segurola","Santa Rosa","COLEGIO NACIONAL SANTA ROSA",-66.78864,-14.07823,263,4,654,917,407,23,220,627
"Bolivia","Beni","General Jose Ballivián Segurola","Santa Rosa","ESC.CENTRAL PALMA FLOR",-66.6287,-12.96253,45,1,71,116,40,9,21,61
"Bolivia","Beni","General Jose Ballivián Segurola","Santa Rosa","ESC.EL CANDADO",-66.84259,-13.50823,30,2,80,110,25,1,52,77
"Bolivia","Beni","General Jose Ballivián Segurola","Santa Rosa","ESC. EL CERRITO",-66.7103,-13.09042,22,1,82,104,53,1,27,80
"Bolivia","Beni","General Jose Ballivián Segurola","Santa Rosa","ESC.EL TRIUNFO",-66.76116,-13.86169,58,0,223,281,118,1,104,222
"Bolivia","Beni","General Jose Ballivián Segurola","Santa Rosa","ESC.GERARDO REYES",-66.79248,-14.07916,509,30,2303,2812,1545,43,685,2230
"Bolivia","Beni","General Jose Ballivián Segurola","Santa Rosa","ESC. PUERTO TERESA",-66.60133,-13.44813,18,0,67,85,49,1,17,66
"Bolivia","Beni","General Jose Ballivián Segurola","Santa Rosa","ESC.PUERTO YATA",-66.63308,-13.45108,66,5,119,185,81,1,32,113
"Bolivia","Beni","General Jose Ballivián Segurola","Santa Rosa","ESCUELA AUSTRALIA",-66.52208,-12.78946,79,2,155,234,75,3,75,150
"Bolivia","Beni","General Jose Ballivián Segurola","Santa Rosa","ESCUELA EL ROSARIO",-66.71803,-13.82903,14,8,130,144,61,4,57,118
"Bolivia","Beni","Iténez","Baures","ESC. ALTA GRACIA",-63.66943,-13.63675,8,0,51,59,32,0,19,51
"Bolivia","Beni","Iténez","Baures","ESC. CAIRO II",-63.52425,-14.20468,7,0,22,29,0,0,22,22
"Bolivia","Beni","Iténez","Baures","ESC.CARMELO LOPEZ",-63.69662,-13.65491,305,11,1213,1518,674,7,521,1195
"Bolivia","Beni","Iténez","Baures","ESC.EL CAIRO",-63.72225,-13.72575,10,1,95,105,42,3,49,91
"Bolivia","Beni","Iténez","Baures","ESC.EL REMANZO",-61.8741,-13.52387,114,4,291,405,126,5,156,282
"Bolivia","Beni","Iténez","Baures","ESC. MONTE CRISTO DEL TIQUIN",-61.97526,-13.62647,100,3,121,221,21,3,94,115
"Bolivia","Beni","Iténez","Baures","ESC. RURAL JASIAQUIRI",-63.7384,-13.72094,12,0,150,162,70,1,79,149
"Bolivia","Beni","Iténez","Baures","ESC.SAN SIMON",-62.02819,-13.61491,54,4,138,192,40,2,92,132
"Bolivia","Beni","Iténez","Baures","ESC.SECCIONAL CAFETAL",-61.88521,-13.49341,98,1,122,220,40,0,81,121
"Bolivia","Beni","Iténez","Huacaraje","ESC.EL CARMEN",-63.80146,-14.23021,129,2,461,590,275,5,179,454
"Bolivia","Beni","Iténez","Huacaraje","ESC.JUAN ALBERTO ORELLANA",-63.87964,-13.59328,313,15,1104,1417,627,17,445,1072
"Bolivia","Beni","Iténez","Huacaraje","NUCLEO ESCOLAR LA EMBROLLA",-63.82495,-13.6832,3,0,58,61,10,6,42,52
"Bolivia","Beni","Iténez","Magdalena","COL.CNEL.CARMELO CUELLAR J.",-63.79037,-13.23383,30,1,219,249,109,2,107,216
"Bolivia","Beni","Iténez","Magdalena","ESC.ANGEL CHAVEZ ARZA",-64.24437,-12.89689,10,1,112,122,30,0,81,111
"Bolivia","Beni","Iténez","Magdalena","ESC.BUENA VISTA",-64.23037,-12.45551,133,7,236,369,109,4,116,225
"Bolivia","Beni","Iténez","Magdalena","ESC.CENTRAL 1O. DE MAYO",-63.37995,-12.65748,2,0,36,38,3,0,33,36
"Bolivia","Beni","Iténez","Magdalena","ESC.GIL COIMBRA",-64.05195,-13.25954,419,19,1839,2258,1018,22,780,1798
"Bolivia","Beni","Iténez","Magdalena","ESC.JOSE BALLIVIAN",-64.05527,-13.26313,184,9,1079,1263,584,30,456,1040
"Bolivia","Beni","Iténez","Magdalena","ESC.LA CAYOBA",-64.08502,-13.09004,9,0,69,78,45,2,22,67
"Bolivia","Beni","Iténez","Magdalena","ESC. SAN BORJA RIO BLANCO",-64.10181,-12.62778,25,4,146,171,77,1,64,141
"Bolivia","Beni","Iténez","Magdalena","ESC.SANTA MARIA",-63.825,-13.11831,8,0,84,92,55,0,29,84
"Bolivia","Beni","Iténez","Magdalena","U.E. MACEDONIO PAZ PINO",-63.70535,-13.27234,226,8,927,1153,454,23,442,896
"Bolivia","Beni","Mamoré","Puerto Siles","ESC.ALEJANDRIA",-65.06511,-12.08011,3,2,47,50,12,1,32,44
"Bolivia","Beni","Mamoré","Puerto Siles","ESC.ANTOFAGASTA",-65.00496,-12.80045,57,1,159,216,43,3,112,155
"Bolivia","Beni","Mamoré","Puerto Siles","ESC.SANTA ROSA",-65.11021,-12.29405,48,3,121,169,90,0,28,118
"Bolivia","Beni","Mamoré","San Joaquín","ESC.CAP.ARTURO CUELLAR REA",-64.66712,-13.04515,431,9,1044,1475,506,80,449,955
"Bolivia","Beni","Mamoré","San Joaquín","ESC.CHACO LEJOS",-64.9071,-12.83958,3,1,29,32,9,0,19,28
"Bolivia","Beni","Mamoré","San Joaquín","ESC.LAS PEÑITAS",-64.4332,-12.65806,0,0,5,5,0,1,4,4
"Bolivia","Beni","Mamoré","San Joaquín","ESC. MORE-MONTE AZUL",-64.91856,-12.09472,12,0,50,62,0,0,50,50
"Bolivia","Beni","Mamoré","San Joaquín","ESC. PUERTO USTAREZ",-64.45786,-12.40728,10,1,44,54,14,1,28,42
"Bolivia","Beni","Mamoré","San Joaquín","UNIDAD EDUCATIVA 21 DE AGOSTO",-64.6656,-13.04053,381,11,1044,1425,583,20,430,1013
"Bolivia","Beni","Mamoré","San Ramón","ESC. EL CARMEN DE GUACAYANE",-64.37999,-13.12766,5,0,38,43,0,0,38,38
"Bolivia","Beni","Mamoré","San Ramón","ESC.EL POYORI",-64.42094,-13.00931,2,1,38,40,6,0,31,37
"Bolivia","Beni","Mamoré","San Ramón","ESC.NAPOLEON AÑEZ ORTIZ",-64.61865,-13.26702,463,16,1835,2298,999,24,796,1795
"Bolivia","Beni","Mamoré","San Ramón","U.E. LAS PEÑAS",-64.39467,-12.63922,7,0,4,11,2,0,2,4
"Bolivia","Beni","Marbán","Loreto","ESC.CAMIACO",-64.86686,-15.33278,57,0,246,303,155,7,84,239
"Bolivia","Beni","Marbán","Loreto","ESC.GUNDONOVIA",-65.11512,-15.51444,62,4,135,197,79,1,51,130
"Bolivia","Beni","Marbán","Loreto","ESC.PERFECTA VDA. DE BEJARANO",-64.76012,-15.19398,155,3,335,490,130,10,192,322
"Bolivia","Beni","Marbán","Loreto","ESC.SACHOJERE",-64.75289,-14.98731,60,1,183,243,79,2,101,180
"Bolivia","Beni","Marbán","Loreto","ESC.SAN ANTONIO",-64.99944,-15.1992,23,0,55,78,26,1,28,54
"Bolivia","Beni","Marbán","Loreto","ESC.SAN PABLO-ISIBORO",-65.14317,-15.70741,33,1,138,171,31,5,101,132
"Bolivia","Beni","Marbán","Loreto","ESCUELA SANTA ROSA DEL CHAPARE",-64.75703,-15.93923,22,0,27,49,21,0,6,27
"Bolivia","Beni","Marbán","Loreto","SANTA ROSA DEL ISIBORO",-65.20737,-16.26001,23,2,71,94,16,0,53,69
"Bolivia","Beni","Marbán","Loreto","U.E. PALERMO",-64.65648,-15.88381,3,0,21,24,8,0,13,21
"Bolivia","Beni","Marbán","Loreto","U.E. VILLA EL CARMEN DEL REMANZO",-65.00182,-15.25932,18,0,63,81,21,1,41,62
"Bolivia","Beni","Marbán","San Andrés","ESC.BUEN JESUS",-64.37089,-14.98918,45,5,248,293,153,4,86,239
"Bolivia","Beni","Marbán","San Andrés","ESC.CAIMANES",-64.05082,-15.16342,32,7,163,195,87,2,67,154
"Bolivia","Beni","Marbán","San Andrés","ESC.CENTRAL 2 DE AGOSTO",-63.86697,-15.24271,419,28,1546,1965,595,33,890,1485
"Bolivia","Beni","Marbán","San Andrés","ESC.HUMBERTO VELARDE",-64.66631,-15.02232,61,2,225,286,110,5,108,218
"Bolivia","Beni","Marbán","San Andrés","ESC.LA ISIGA-PERSEVERA",-64.32283,-15.39423,38,1,38,76,22,0,15,37
"Bolivia","Beni","Marbán","San Andrés","ESC. MONTE CRISTO",-64.37347,-15.61208,29,1,46,75,21,0,24,45
"Bolivia","Beni","Marbán","San Andrés","ESC.PEROTO",-64.63706,-14.97516,41,3,145,186,82,1,59,141
"Bolivia","Beni","Marbán","San Andrés","ESC.SAN LORENZO",-64.7207,-15.03478,32,2,73,105,34,1,36,70
"Bolivia","Beni","Marbán","San Andrés","ESC.SANTA ROSA",-64.244,-15.10586,97,8,407,504,181,6,212,393
"Bolivia","Beni","Marbán","San Andrés","ESC.SOMOPAE",-64.65401,-14.94441,41,1,194,235,99,2,92,191
"Bolivia","Beni","Marbán","San Andrés","ESCUELA 4 DE JULIO",-63.46377,-15.73327,59,6,243,302,35,7,195,230
"Bolivia","Beni","Marbán","San Andrés","ESCUELA DE NUEVA BETANIA",-64.34632,-15.02995,55,3,219,274,90,3,123,213
"Bolivia","Beni","Marbán","San Andrés","ESCUELA ELVIRA",-64.60383,-14.92893,43,2,181,224,102,2,75,177
"Bolivia","Beni","Marbán","San Andrés","ESCUELA LIMONCITO",-63.46377,-15.73327,0,0,30,30,15,1,14,29
"Bolivia","Beni","Marbán","San Andrés","ESCUELA NUEVA MAGDALENA",-63.69929,-15.48585,51,0,117,168,31,0,86,117
"Bolivia","Beni","Marbán","San Andrés","ESCUELA TAJIBOTE",-64.08765,-15.63134,5,0,9,14,3,0,6,9
"Bolivia","Beni","Marbán","San Andrés","ESC. VILLA ALBA",-64.68153,-15.06132,30,0,135,165,65,2,68,133
"Bolivia","Beni","Marbán","San Andrés","ESC.VILLA BANZER",-64.41677,-14.94876,17,0,64,81,25,0,39,64
"Bolivia","Beni","Moxos","San Ignacio","COL.SOCRATES PARADA EGUEZ",-65.64265,-14.9983,661,55,2892,3553,1138,64,1635,2773
"Bolivia","Beni","Moxos","San Ignacio","ESC.CENTRAL SAN IGNACITO",-65.64748,-15.4581,8,0,21,29,6,0,15,21
"Bolivia","Beni","Moxos","San Ignacio","ESC.CENTRAL SANTA ROSA",-65.85181,-15.22264,5,2,91,96,10,0,79,89
"Bolivia","Beni","Moxos","San Ignacio","ESC. EL DESENGAÑO",-65.44534,-14.27502,45,2,121,166,59,2,58,117
"Bolivia","Beni","Moxos","San Ignacio","ESC.FATIMA",-65.34778,-14.91402,20,0,78,98,44,0,34,78
"Bolivia","Beni","Moxos","San Ignacio","ESC.LA ARGENTINA",-65.32679,-14.82843,9,0,68,77,24,1,43,67
"Bolivia","Beni","Moxos","San Ignacio","ESC.LITORAL",-65.57434,-14.97235,10,3,107,117,10,0,94,104
"Bolivia","Beni","Moxos","San Ignacio","ESC.MERCEDES DE LOJOJOTA",-65.57259,-16.5034,22,4,74,96,8,4,58,66
"Bolivia","Beni","Moxos","San Ignacio","ESC.MONTE GRANDE",-65.82966,-15.63879,23,1,90,113,16,8,65,81
"Bolivia","Beni","Moxos","San Ignacio","ESC.MONTE MAE",-65.72498,-15.53512,36,0,49,85,28,0,21,49
"Bolivia","Beni","Moxos","San Ignacio","ESC. OROMOMO",-66.18743,-16.04399,46,28,279,325,37,6,208,245
"Bolivia","Beni","Moxos","San Ignacio","ESC.OVIDIO ROCA C.",-65.55151,-15.55553,123,1,430,553,225,7,197,422
"Bolivia","Beni","Moxos","San Ignacio","ESC.PTO.SAN LORENZO",-65.4773,-15.77166,29,6,98,127,41,5,46,87
"Bolivia","Beni","Moxos","San Ignacio","ESC. PUERTO SAN BORJA",-65.79875,-14.98267,28,0,83,111,12,2,69,81
"Bolivia","Beni","Moxos","San Ignacio","ESC.RETIRO",-65.80604,-15.34924,15,1,106,121,2,2,101,103
"Bolivia","Beni","Moxos","San Ignacio","ESC.SAN ANTONIO DE IMOSE",-65.35487,-15.95693,45,2,94,139,48,9,35,83
"Bolivia","Beni","Moxos","San Ignacio","ESC.SAN FRANCISCO",-65.35629,-15.41029,63,8,231,294,68,7,148,216
"Bolivia","Beni","Moxos","San Ignacio","ESC.SAN JOSE DEL CABITU",-65.9744,-15.26368,60,1,163,223,35,6,121,156
"Bolivia","Beni","Moxos","San Ignacio","ESC.SAN JOSE DE PATROCINIO",-65.29938,-15.7724,16,0,22,38,20,0,2,22
"Bolivia","Beni","Moxos","San Ignacio","ESC.SAN MIGUELITO ISIBORO",-65.44078,-16.52943,15,1,68,83,6,4,57,63
"Bolivia","Beni","Moxos","San Ignacio","ESC.SUB-CENTRAL PUEBLO NUEVO",-65.88788,-15.24535,13,0,32,45,5,0,27,32
"Bolivia","Beni","Moxos","San Ignacio","ESC.TRINIDACITO",-65.30994,-15.76319,19,0,31,50,27,0,4,31
"Bolivia","Beni","Moxos","San Ignacio","ESCUELA DE BERMEO",-65.3772,-14.89496,28,1,82,110,30,0,51,81
"Bolivia","Beni","Moxos","San Ignacio","ESCUELA SANTÍSIMA TRINIDAD",-65.76534,-16.61358,21,3,160,181,42,2,113,155
"Bolivia","Beni","Moxos","San Ignacio","L.GILFREDO CORTEZ CANDIA",-65.64448,-14.99516,671,44,2561,3232,964,47,1506,2470
"Bolivia","Beni","Moxos","San Ignacio","U.E. SAN BERNARDO",-65.2933,-15.65132,43,2,92,135,73,3,14,87
"Bolivia","Beni","Vaca Diéz","Puerto Guayaramerín","(CÁRCEL) PENAL GUAYARAMERIN",-65.35279,-10.81292,11,0,22,33,11,1,10,21
"Bolivia","Beni","Vaca Diéz","Puerto Guayaramerín","CENTRO EDUCATIVO SIMON BOLIVAR",-65.36375,-10.83101,75,4,283,358,175,3,101,276
"Bolivia","Beni","Vaca Diéz","Puerto Guayaramerín","COL. 6 DE JUNIO",-65.34737,-10.82762,365,9,1476,1841,976,27,464,1440
"Bolivia","Beni","Vaca Diéz","Puerto Guayaramerín","COL. ALTO DE LA ALIANZA",-65.36181,-10.82369,485,15,1787,2272,1098,40,634,1732
"Bolivia","Beni","Vaca Diéz","Puerto Guayaramerín","COLEGIO ANTONIO VACA DIEZ",-65.35497,-10.81294,92,3,342,434,224,2,113,337
"Bolivia","Beni","Vaca Diéz","Puerto Guayaramerín","COLEGIO MANUEL VICENTE BALLIVIAN",-65.35051,-10.81116,182,1,302,484,218,5,78,296
"Bolivia","Beni","Vaca Diéz","Puerto Guayaramerín","COL. EVANGELICO NACIONAL",-65.35439,-10.81791,541,9,1442,1983,905,25,503,1408
"Bolivia","Beni","Vaca Diéz","Puerto Guayaramerín","COL.MANUEL ANTONIO OJOPI",-65.35567,-10.81322,732,14,2585,3317,1703,32,836,2539
"Bolivia","Beni","Vaca Diéz","Puerto Guayaramerín","DR.ELMER BOTSFORD",-65.35297,-10.8088,225,6,701,926,471,17,207,678
"Bolivia","Beni","Vaca Diéz","Puerto Guayaramerín","ESC.ANTOFAGASTA",-65.39104,-10.39382,15,0,51,66,28,0,23,51
"Bolivia","Beni","Vaca Diéz","Puerto Guayaramerín","ESC.CENTRAL SAN LORENZO",-65.23228,-11.73968,22,0,85,107,34,1,50,84
"Bolivia","Beni","Vaca Diéz","Puerto Guayaramerín","ESC.JUDDI DE SUAREZ",-65.58167,-10.53687,80,5,257,337,179,3,70,249
"Bolivia","Beni","Vaca Diéz","Puerto Guayaramerín","ESC. MEJILLONES",-65.35355,-10.82544,908,42,3354,4262,2205,58,1049,3254
"Bolivia","Beni","Vaca Diéz","Puerto Guayaramerín","ESC.ROSARIO DEL YATA",-65.57995,-10.99195,72,3,200,272,84,6,107,191
"Bolivia","Beni","Vaca Diéz","Puerto Guayaramerín","ESC. SAN FRANCISCO DEL YATA",-65.51111,-10.61194,15,1,46,61,29,0,16,45
"Bolivia","Beni","Vaca Diéz","Puerto Guayaramerín","ESC. SAN JOSE",-65.34554,-10.81522,402,12,1405,1807,904,25,464,1368
"Bolivia","Beni","Vaca Diéz","Puerto Guayaramerín","ESCUELA BRASIL",-65.3572,-10.8307,153,1,472,625,316,8,147,463
"Bolivia","Beni","Vaca Diéz","Puerto Guayaramerín","ESCUELA LOS ALMENDROS",-65.3472,-10.83402,425,10,1488,1913,890,44,544,1434
"Bolivia","Beni","Vaca Diéz","Puerto Guayaramerín","LIC.MIXTO GUAYAMERIN",-65.35883,-10.82098,541,8,1386,1927,891,24,463,1354
"Bolivia","Beni","Vaca Diéz","Puerto Guayaramerín","U.E. 9 DE ABRIL",-65.36181,-10.84011,25,2,266,291,154,5,105,259
"Bolivia","Beni","Vaca Diéz","Puerto Guayaramerín","U.E. BELEN",-65.35558,-10.83641,96,1,433,529,258,10,164,422
"Bolivia","Beni","Vaca Diéz","Puerto Guayaramerín","U.E MIGUEL ANTELO",-65.34438,-10.82256,49,0,186,235,111,8,67,178
"Bolivia","Beni","Vaca Diéz","Riberalta","(CÁRCEL) PENAL RIBERALTA",-66.0738,-10.99669,29,1,17,46,9,1,6,15
"Bolivia","Beni","Vaca Diéz","Riberalta","COL. 6 DE JUNIO",-66.077,-11.00458,534,11,1371,1905,1014,18,328,1342
"Bolivia","Beni","Vaca Diéz","Riberalta","COLEGIO EDUARDO ABAROA",-66.06204,-11.00703,637,23,2435,3072,1638,47,727,2365
"Bolivia","Beni","Vaca Diéz","Riberalta","COLEGIO ISMAEL CARRASCO TELLERIA",-66.05402,-11.01021,122,8,387,509,215,12,152,367
"Bolivia","Beni","Vaca Diéz","Riberalta","COLEGIO SAN FRANCISCO",-66.07206,-11.00753,81,3,359,440,244,7,105,349
"Bolivia","Beni","Vaca Diéz","Riberalta","COLEGIO SAN JUAN",-66.04671,-11.03188,542,57,1894,2436,967,57,813,1780
"Bolivia","Beni","Vaca Diéz","Riberalta","COLEGIO WALTER ALPIRE DURAN",-66.05729,-11.01164,157,6,638,795,429,8,195,624
"Bolivia","Beni","Vaca Diéz","Riberalta","COL. PEDRO KRAMER",-66.06915,-10.99869,391,8,1297,1688,929,37,323,1252
"Bolivia","Beni","Vaca Diéz","Riberalta","COL. SAN JOSE OBRERO",-66.06607,-10.99754,484,12,1271,1755,894,21,344,1238
"Bolivia","Beni","Vaca Diéz","Riberalta","COMITE CIVICO TUMICHUCUA",-66.16624,-11.14738,73,11,254,327,145,20,78,223
"Bolivia","Beni","Vaca Diéz","Riberalta","ESC.BRITANICA",-66.05006,-11.01523,915,39,2819,3734,1780,89,911,2691
"Bolivia","Beni","Vaca Diéz","Riberalta","ESC.FELIX SATTORY ROMAN",-66.06739,-11.00182,858,22,3384,4242,2517,66,779,3296
"Bolivia","Beni","Vaca Diéz","Riberalta","ESC. JUANA AZURDUY DE PADILLA",-66.07388,-10.99538,257,4,847,1104,649,23,171,820
"Bolivia","Beni","Vaca Diéz","Riberalta","ESCUELA 12 DE OCTUBRE",-65.69309,-11.0167,65,6,206,271,93,2,105,198
"Bolivia","Beni","Vaca Diéz","Riberalta","ESCUELA 1RO DE DICIEMBRE",-66.07318,-11.01311,454,12,1301,1755,933,18,338,1271
"Bolivia","Beni","Vaca Diéz","Riberalta","ESCUELA ALTO IVON",-66.03656,-11.87361,21,4,244,265,4,3,233,237
"Bolivia","Beni","Vaca Diéz","Riberalta","ESCUELA BOLIVAR",-65.9,-11.00223,93,5,268,361,124,6,133,257
"Bolivia","Beni","Vaca Diéz","Riberalta","ESCUELA LOS TAJIBOS",-66.04456,-11.02086,1118,41,3198,4316,1929,76,1152,3081
"Bolivia","Beni","Vaca Diéz","Riberalta","ESCUELA MARIPOSA",-66.1415,-12.27631,20,1,87,107,51,5,30,81
"Bolivia","Beni","Vaca Diéz","Riberalta","ESCUELA NAZARETH",-66.3375,-11.38739,22,2,92,114,60,3,27,87
"Bolivia","Beni","Vaca Diéz","Riberalta","ESCUELA PETROLERA",-66.05014,-11.00229,1526,58,4261,5787,2792,100,1311,4103
"Bolivia","Beni","Vaca Diéz","Riberalta","ESCUELA SANTA MARIA",-65.93813,-11.1185,68,9,280,348,112,6,153,265
"Bolivia","Beni","Vaca Diéz","Riberalta","ESCUELA SANTUARIO",-66.4724,-11.5389,6,2,53,59,23,6,22,45
"Bolivia","Beni","Vaca Diéz","Riberalta","ESCUELA WARNES",-65.96947,-10.92752,166,10,185,351,105,4,66,171
"Bolivia","Beni","Vaca Diéz","Riberalta","KINDER JHON F. KENNEDY",-66.06571,-10.99814,298,18,1487,1785,1094,20,355,1449
"Bolivia","Beni","Vaca Diéz","Riberalta","POLITECNICO BENJAMIN BOWLES",-66.05167,-11.00485,866,24,2961,3827,1945,58,934,2879
"Bolivia","Beni","Vaca Diéz","Riberalta","U.E. BELLA FLOR",-66.21178,-11.33017,4,0,71,75,31,2,38,69
"Bolivia","Beni","Vaca Diéz","Riberalta","U.E FEDERICO DEMMER",-66.04344,-10.99968,429,20,1389,1818,904,42,423,1327
"Bolivia","Beni","Vaca Diéz","Riberalta","U.E. LA ESPERANZA",-66.0544,-11.06529,16,3,147,163,85,14,45,130
"Bolivia","Beni","Vaca Diéz","Riberalta","U.E. NUESTRA SEÑORA DEL CARMEN",-66.07724,-10.99875,465,15,1549,2014,1070,31,433,1503
"Bolivia","Beni","Vaca Diéz","Riberalta","U.E. POPECHI",-66.07248,-11.13074,26,11,186,212,78,7,90,168
"Bolivia","Beni","Vaca Diéz","Riberalta","UNIDAD EDUCATIVA NATANIEL GARCÍA CHAVEZ",-66.07935,-11.00858,687,35,2572,3259,1803,101,633,2436
"Bolivia","Beni","Yacuma","Exaltación","ESC. CAMPO ANA MARIA",-65.57471,-12.94433,4,0,23,27,6,0,17,23
"Bolivia","Beni","Yacuma","Exaltación","ESC.COOPERATIVA",-65.04883,-12.6354,15,0,46,61,19,1,26,45
"Bolivia","Beni","Yacuma","Exaltación","ESC.COQUINAL",-65.85875,-12.97027,26,2,165,191,35,2,126,161
"Bolivia","Beni","Yacuma","Exaltación","ESC.EL MOTACUSAL",-65.4307,-12.91581,10,1,71,81,34,0,36,70
"Bolivia","Beni","Yacuma","Exaltación","ESC.EL TROMPILLO",-65.11865,-13.11602,7,0,10,17,6,0,4,10
"Bolivia","Beni","Yacuma","Exaltación","ESC.JOSE MAX PAREDES",-65.25107,-13.32101,133,1,411,544,149,3,258,407
"Bolivia","Beni","Yacuma","Exaltación","ESC. NUEVA ESPERANZA",-66.00737,-12.97329,9,0,17,26,9,0,8,17
"Bolivia","Beni","Yacuma","Exaltación","ESC.SAN CARLOS",-65.70103,-13.23234,15,0,44,59,11,0,33,44
"Bolivia","Beni","Yacuma","Exaltación","ESC.SANTA ROSA",-66.16964,-13.51003,1,0,9,10,4,0,5,9
"Bolivia","Beni","Yacuma","Exaltación","ESCUELA PUERTO SANTIAGO",-65.20205,-13.10789,2,0,16,18,11,0,5,16
"Bolivia","Beni","Yacuma","Exaltación","ESCUELA SAN JUAN DEL JORDAN",-66.42942,-12.88492,12,0,22,34,12,0,10,22
"Bolivia","Beni","Yacuma","Santa Ana (de Yacuma)","COL.ANDRES ALBERDI SALEGUI",-65.4307,-13.7505,621,21,2129,2750,1406,29,673,2079
"Bolivia","Beni","Yacuma","Santa Ana (de Yacuma)","COLEGIO GUILLERMO SEARLE",-65.42456,-13.74432,225,7,663,888,403,10,243,646
"Bolivia","Beni","Yacuma","Santa Ana (de Yacuma)","COL.MONS.DANIEL RIVERO",-65.42525,-13.74378,971,44,3247,4218,1945,65,1193,3138
"Bolivia","Beni","Yacuma","Santa Ana (de Yacuma)","ESC.CEC EL TOTAISAL",-66.32708,-14.87791,58,1,158,216,58,5,94,152
"Bolivia","Beni","Yacuma","Santa Ana (de Yacuma)","ESC.LOS MONTES DE ORO",-65.8585,-14.33763,11,1,13,24,6,0,6,12
"Bolivia","Beni","Yacuma","Santa Ana (de Yacuma)","ESC.WENCESLAO AÑEZ",-65.63189,-14.60486,123,3,350,473,185,8,154,339
"Bolivia","Chuquisaca","Azurduy","Tarvita (Villa Orías)","ESCUELA 12 DE OCTUBRE",-64.46204,-19.78101,146,18,552,698,176,21,337,513
"Bolivia","Chuquisaca","Azurduy","Tarvita (Villa Orías)","ESCUELA CHUNCA CANCHA",-64.68405,-19.58565,6,2,73,79,4,10,57,61
"Bolivia","Chuquisaca","Azurduy","Tarvita (Villa Orías)","ESCUELA CRUZ CKASA",-64.57745,-19.87214,132,9,572,704,123,21,419,542
"Bolivia","Chuquisaca","Azurduy","Tarvita (Villa Orías)","ESCUELA LUIS EVENCIO ORÍAS",-64.44648,-19.61855,173,9,567,740,272,16,270,542
"Bolivia","Chuquisaca","Azurduy","Tarvita (Villa Orías)","ESCUELA MARISCAL BRAUN",-64.56983,-19.97382,66,13,388,454,143,15,217,360
"Bolivia","Chuquisaca","Azurduy","Tarvita (Villa Orías)","ESCUELA MOLLE CANCHA",-64.61646,-19.74335,6,0,75,81,4,1,70,74
"Bolivia","Chuquisaca","Azurduy","Tarvita (Villa Orías)","ESCUELA SAN JOSE DE ALISOS",-64.63702,-19.69949,45,6,207,252,44,5,152,196
"Bolivia","Chuquisaca","Azurduy","Tarvita (Villa Orías)","U.E. VILLA PAMPA",-64.51918,-19.65606,37,6,172,209,62,3,101,163
"Bolivia","Chuquisaca","Azurduy","Tarvita (Villa Orías)","UNIDAD EDUCATIVA ANTONIO TOVAR",-64.48597,-19.92718,198,31,807,1005,294,34,448,742
"Bolivia","Chuquisaca","Azurduy","Tarvita (Villa Orías)","UNIDAD EDUCATIVA JESÚS MAESTRO",-64.68082,-19.674,157,17,786,943,56,31,682,738
"Bolivia","Chuquisaca","Azurduy","Tarvita (Villa Orías)","UNIDAD EDUCATIVA PAMPAS DE LEQUE",-64.57776,-19.72431,27,5,288,315,22,3,258,280
"Bolivia","Chuquisaca","Azurduy","Villa Azurduy","ESCUELA DURAZNAL",-64.42482,-20.41302,37,2,193,230,18,5,168,186
"Bolivia","Chuquisaca","Azurduy","Villa Azurduy","ESCUELA HUANCARANI",-64.48476,-20.23491,29,1,131,160,3,7,120,123
"Bolivia","Chuquisaca","Azurduy","Villa Azurduy","ESCUELA PINOS",-64.45695,-20.32877,52,0,177,229,5,1,171,176
"Bolivia","Chuquisaca","Azurduy","Villa Azurduy","ESCUELA  RODEO CHICO",-64.53408,-20.24856,63,5,380,443,12,10,353,365
"Bolivia","Chuquisaca","Azurduy","Villa Azurduy","ESCUELA TABLANI",-64.56451,-20.06003,82,2,315,397,27,24,262,289
"Bolivia","Chuquisaca","Azurduy","Villa Azurduy","ESCUELA TORRECILLAS",-64.3971,-19.9672,56,3,133,189,36,9,85,121
"Bolivia","Chuquisaca","Azurduy","Villa Azurduy","U.E. COLLPAMAYU",-64.51823,-20.08899,51,9,282,333,14,8,251,265
"Bolivia","Chuquisaca","Azurduy","Villa Azurduy","U.E. QUEHUEÑAL",-64.4158,-19.92459,12,3,73,85,23,3,44,67
"Bolivia","Chuquisaca","Azurduy","Villa Azurduy","UNIDAD EDUCATIVA NICANOR LOPEZ",-64.41391,-20.10486,400,54,1556,1956,633,68,801,1434
"Bolivia","Chuquisaca","Azurduy","Villa Azurduy","UNIDAD EDUCATIVA SAN ROQUE",-64.51511,-20.13545,45,1,162,207,6,9,146,152
"Bolivia","Chuquisaca","Azurduy","Villa Azurduy","UNIDAD EDUCATIVA SANTA ROSA",-64.3904,-19.88058,76,2,138,214,33,5,98,131
"Bolivia","Chuquisaca","Belisario Boeto","Villa Serrano","COLEGIO DANIEL SANCHEZ BUSTAMANTE",-64.42113,-19.01643,85,9,476,561,67,25,375,442
"Bolivia","Chuquisaca","Belisario Boeto","Villa Serrano","ESCUELA DARIO OVANDO CUELLAR",-64.3476,-18.8886,38,2,134,172,4,8,120,124
"Bolivia","Chuquisaca","Belisario Boeto","Villa Serrano","ESCUELA ELISARDO PEREZ",-64.19292,-19.11728,61,5,240,301,67,9,159,226
"Bolivia","Chuquisaca","Belisario Boeto","Villa Serrano","ESCUELA HEROES DEL CHACO",-64.13771,-19.06195,54,3,199,253,15,3,178,193
"Bolivia","Chuquisaca","Belisario Boeto","Villa Serrano","ESCUELA JORGE ANIBARRO ZAPATA",-64.29203,-18.99208,127,13,442,569,87,20,322,409
"Bolivia","Chuquisaca","Belisario Boeto","Villa Serrano","ESCUELA LUIS SANTOS PRADO",-64.2653,-19.1737,20,0,95,115,4,3,88,92
"Bolivia","Chuquisaca","Belisario Boeto","Villa Serrano","ESCUELA MARISCAL SUCRE",-64.32195,-19.12737,494,67,2485,2979,948,112,1358,2306
"Bolivia","Chuquisaca","Belisario Boeto","Villa Serrano","ESCUELA RENÉ ANIBARRO GÓMEZ",-64.396,-18.8268,99,4,201,300,16,11,170,186
"Bolivia","Chuquisaca","Belisario Boeto","Villa Serrano","U.E. LAMPAZOS",-64.39145,-18.76599,3,0,72,75,15,2,55,70
"Bolivia","Chuquisaca","Belisario Boeto","Villa Serrano","U.E. LOTHAR BRUCKER",-64.36176,-18.82008,3,0,97,100,1,3,93,94
"Bolivia","Chuquisaca","Belisario Boeto","Villa Serrano","UNIDAD EDUCATIVA MAMERTO NAVA DURAN",-64.37803,-18.94884,47,3,150,197,15,10,122,137
"Bolivia","Chuquisaca","Belisario Boeto","Villa Serrano","UNID. EDUC. SAN MIGUEL DE LA QUEBRADA",-64.24857,-19.1079,29,2,91,120,6,5,78,84
"Bolivia","Chuquisaca","Hernando Siles","Monteagudo","ESCUELA 6 DE JUNIO",-64.11983,-20.33284,125,2,368,493,159,16,191,350
"Bolivia","Chuquisaca","Hernando Siles","Monteagudo","ESCUELA BERNARDO MONTEAGUDO",-63.95635,-19.78872,594,59,3297,3891,1692,101,1445,3137
"Bolivia","Chuquisaca","Hernando Siles","Monteagudo","ESCUELA CHAPIMAYU",-64.14899,-19.87584,70,2,268,338,62,8,196,258
"Bolivia","Chuquisaca","Hernando Siles","Monteagudo","ESCUELA DESPENSAS",-64.1007,-20.04283,61,2,173,234,71,10,90,161
"Bolivia","Chuquisaca","Hernando Siles","Monteagudo","ESCUELA EL ZAPALLAR",-63.93938,-19.80897,32,7,194,226,60,8,119,179
"Bolivia","Chuquisaca","Hernando Siles","Monteagudo","ESCUELA FERNANDEZ",-64.23994,-20.16429,46,3,168,214,72,4,89,161
"Bolivia","Chuquisaca","Hernando Siles","Monteagudo","ESCUELA MARÍA VDA. DE VALDA",-63.95535,-19.80042,630,50,3353,3983,1657,124,1522,3179
"Bolivia","Chuquisaca","Hernando Siles","Monteagudo","ESCUELA PAMPA HEREDIA",-64.0597,-19.80225,37,2,118,155,40,5,71,111
"Bolivia","Chuquisaca","Hernando Siles","Monteagudo","ESCUELA PEDERNAL",-64.11466,-19.77911,52,8,246,298,45,7,186,231
"Bolivia","Chuquisaca","Hernando Siles","Monteagudo","ESCUELA SAN LORENZO",-64.20084,-19.92886,24,2,139,163,31,5,101,132
"Bolivia","Chuquisaca","Hernando Siles","Monteagudo","ESCUELA YANA YANA",-64.13422,-20.19204,24,0,34,58,19,2,13,32
"Bolivia","Chuquisaca","Hernando Siles","Monteagudo","NUCLEO ESCOLAR BARTOLO",-64.03931,-19.66221,13,1,94,107,11,1,81,92
"Bolivia","Chuquisaca","Hernando Siles","Monteagudo","U. EDU. JUANA AZURDUY DE PADILLA",-63.9845,-20.0189,99,16,495,594,164,45,270,434
"Bolivia","Chuquisaca","Hernando Siles","Monteagudo","U. EDU. SAN MIGUEL DEL BAÑADO",-63.88668,-20.0789,87,22,503,590,198,23,260,458
"Bolivia","Chuquisaca","Hernando Siles","Monteagudo","U. EDU. SAN PEDRO DEL PARAPETI",-63.88159,-20.16382,15,0,59,74,35,1,23,58
"Bolivia","Chuquisaca","Hernando Siles","Monteagudo","UNIDAD EDUCATIVA AZERO NORTE",-63.99007,-19.56839,4,0,42,46,13,2,27,40
"Bolivia","Chuquisaca","Hernando Siles","Monteagudo","UNIDAD EDUCATIVA INGAVI",-64.0831,-20.21808,8,2,92,100,45,0,45,90
"Bolivia","Chuquisaca","Hernando Siles","Monteagudo","UNIDAD EDUCATIVA LOS ARCOS",-64.22605,-20.3155,25,0,92,117,21,4,67,88
"Bolivia","Chuquisaca","Hernando Siles","Monteagudo","UNIDAD EDUCATIVA REBECA DE LA VEGA",-63.97173,-19.81358,269,37,1608,1877,630,82,859,1489
"Bolivia","Chuquisaca","Hernando Siles","Monteagudo","UNIDAD EDUCATIVA ROLDANA",-64.12152,-19.80378,13,4,101,114,23,1,73,96
"Bolivia","Chuquisaca","Hernando Siles","Monteagudo","UNIDAD EDUCATIVA VALLE NUEVO",-63.98814,-19.9332,29,6,181,210,43,10,122,165
"Bolivia","Chuquisaca","Hernando Siles","San Pablo de Huacareta","COLEGIO AMISTAD A",-64.00413,-20.36557,328,14,1206,1534,748,26,418,1166
"Bolivia","Chuquisaca","Hernando Siles","San Pablo de Huacareta","ESCUELA MIGUEL JHASTER",-64.02778,-20.71865,46,5,189,235,120,1,63,183
"Bolivia","Chuquisaca","Hernando Siles","San Pablo de Huacareta","ESCUELA RAFAEL PABON",-64.14964,-20.57222,94,8,366,460,176,16,166,342
"Bolivia","Chuquisaca","Hernando Siles","San Pablo de Huacareta","ESCUELA SALVIO LANUZA",-63.89535,-20.5817,106,11,312,418,189,20,92,281
"Bolivia","Chuquisaca","Hernando Siles","San Pablo de Huacareta","UNIDAD BALDOMERO LOPEZ",-63.96331,-20.16225,65,8,254,319,109,8,129,238
"Bolivia","Chuquisaca","Hernando Siles","San Pablo de Huacareta","UNIDAD EDUCATIVA ATIRIMBIA",-63.93389,-20.8244,24,8,92,116,37,3,44,81
"Bolivia","Chuquisaca","Hernando Siles","San Pablo de Huacareta","UNIDAD EDUCATIVA ERNESTO THEOBALD",-64.15099,-20.51959,146,6,433,579,159,14,254,413
"Bolivia","Chuquisaca","Hernando Siles","San Pablo de Huacareta","UNIDAD EDUCATIVA HUIRASAI",-63.992,-20.61985,23,0,123,146,17,3,103,120
"Bolivia","Chuquisaca","Hernando Siles","San Pablo de Huacareta","UNIDAD EDUCATIVA SAN JORGE DE IPATY",-63.8552,-20.42435,51,9,298,349,18,10,261,279
"Bolivia","Chuquisaca","Luis Calvo","Macharetí","COLEGIO 27 DE MARZO",-63.28704,-20.70558,54,0,221,275,61,36,124,185
"Bolivia","Chuquisaca","Luis Calvo","Macharetí","COLEGIO FRAY QUEBRACHO",-63.32757,-20.99875,13,2,118,131,50,4,62,112
"Bolivia","Chuquisaca","Luis Calvo","Macharetí","ESCUELA 25 DE MAYO",-63.42398,-20.45202,75,10,410,485,110,7,283,393
"Bolivia","Chuquisaca","Luis Calvo","Macharetí","ESCUELA EDUARDO AVAROA",-63.3611,-20.81543,284,22,938,1222,464,37,415,879
"Bolivia","Chuquisaca","Luis Calvo","Macharetí","ESCUELA EL SIMBOLAR",-62.9492,-20.5253,16,2,55,71,25,4,24,49
"Bolivia","Chuquisaca","Luis Calvo","Macharetí","ESCUELA EL VINAL",-63.10925,-20.70269,18,3,53,71,23,3,24,47
"Bolivia","Chuquisaca","Luis Calvo","Macharetí","ESCUELA IPATI",-63.40212,-20.54343,25,7,139,164,73,2,57,130
"Bolivia","Chuquisaca","Luis Calvo","Macharetí","ESCUELA PEDRO DOMINGO MURILLO",-63.3061,-20.86273,10,1,62,72,4,0,57,61
"Bolivia","Chuquisaca","Luis Calvo","Macharetí","ESCUELA SAN JUAN DE CAMATINDI",-63.39542,-20.99425,37,5,147,184,44,6,92,136
"Bolivia","Chuquisaca","Luis Calvo","Macharetí","ESCUELA TIGUIPA PUEBLO",-63.38359,-20.91519,24,4,147,171,76,5,62,138
"Bolivia","Chuquisaca","Luis Calvo","Macharetí","U. EDU. HEROES DEL CHACO HERNADO SILES",-63.07143,-20.75865,106,8,259,365,151,6,94,245
"Bolivia","Chuquisaca","Luis Calvo","Macharetí","U.E. ISIPOTINDI",-63.31057,-20.61732,13,0,118,131,21,16,81,102
"Bolivia","Chuquisaca","Luis Calvo","Macharetí","U.E. TENTAMI",-63.3348,-20.937,13,1,75,88,7,2,65,72
"Bolivia","Chuquisaca","Luis Calvo","Macharetí","U.E. TIMBOYCITO",-63.311,-20.7379,5,1,46,51,13,0,32,45
"Bolivia","Chuquisaca","Luis Calvo","Macharetí","UNIDAD EDUCATIVA CUATRO VIENTOS",-62.68652,-20.86266,6,1,24,30,20,0,3,23
"Bolivia","Chuquisaca","Luis Calvo","Macharetí","UNIDAD EDUCATIVA MANUEL MARIANO GÓMEZ",-63.06475,-20.53849,2,2,34,36,16,3,13,29
"Bolivia","Chuquisaca","Luis Calvo","Villa de Huacaya","ESCUELA BOYCOBO",-63.65736,-20.69879,17,2,102,119,24,2,74,98
"Bolivia","Chuquisaca","Luis Calvo","Villa de Huacaya","ESCUELA CHIMBE",-63.55851,-20.64951,10,0,34,44,4,1,29,33
"Bolivia","Chuquisaca","Luis Calvo","Villa de Huacaya","ESCUELA FRAY MARCOS OZETI",-63.52636,-20.48822,118,7,450,568,118,11,314,432
"Bolivia","Chuquisaca","Luis Calvo","Villa de Huacaya","ESCUELA SAN ANTONIO",-63.66537,-20.74458,57,0,177,234,78,3,96,174
"Bolivia","Chuquisaca","Luis Calvo","Villa de Huacaya","UNIDAD EDUCATIVA ANKAGUAZU",-63.67434,-20.88688,2,0,33,35,7,0,26,33
"Bolivia","Chuquisaca","Luis Calvo","Villa de Huacaya","UNIDAD EDUCATIVA BORORIGUA",-63.63357,-20.56405,22,0,140,162,26,2,112,138
"Bolivia","Chuquisaca","Luis Calvo","Villa Vaca Guzmán (Muyupampa)","CASA COMUNAL AGUAIRENDA",-63.76873,-19.46924,66,4,205,271,34,1,166,200
"Bolivia","Chuquisaca","Luis Calvo","Villa Vaca Guzmán (Muyupampa)","CASA COMUNAL TENTAYAPI",-63.85,-20.86667,21,1,190,211,2,0,187,189
"Bolivia","Chuquisaca","Luis Calvo","Villa Vaca Guzmán (Muyupampa)","ESCUELA HERNANDO SILES",-63.75016,-19.8965,490,42,2498,2988,1405,108,943,2348
"Bolivia","Chuquisaca","Luis Calvo","Villa Vaca Guzmán (Muyupampa)","ESCUELA RUFINO SALAZAR",-63.8163,-19.67933,67,7,200,267,70,6,117,187
"Bolivia","Chuquisaca","Luis Calvo","Villa Vaca Guzmán (Muyupampa)","ESCUELA SAPIRANGUIMIRI",-63.76806,-20.09122,16,2,78,94,26,6,44,70
"Bolivia","Chuquisaca","Luis Calvo","Villa Vaca Guzmán (Muyupampa)","ESCUELA TICUCHA",-63.82461,-19.62364,18,2,97,115,38,6,51,89
"Bolivia","Chuquisaca","Luis Calvo","Villa Vaca Guzmán (Muyupampa)","NUCLEO ESCOLAR CUMANDAITI",-63.84387,-19.45372,53,4,193,246,64,2,123,187
"Bolivia","Chuquisaca","Luis Calvo","Villa Vaca Guzmán (Muyupampa)","U.E. LEO SCHWARZ",-63.88537,-19.26629,5,1,58,63,17,2,38,55
"Bolivia","Chuquisaca","Luis Calvo","Villa Vaca Guzmán (Muyupampa)","UNIDAD EDUCATIVA IGUEMBE",-63.7504,-20.55215,86,6,326,412,115,26,179,294
"Bolivia","Chuquisaca","Luis Calvo","Villa Vaca Guzmán (Muyupampa)","UNIDAD EDUCATIVA ITAU",-63.76336,-20.27766,19,0,57,76,17,2,38,55
"Bolivia","Chuquisaca","Luis Calvo","Villa Vaca Guzmán (Muyupampa)","UNIDAD EDUCATIVA ITY",-63.7644,-19.6085,11,2,181,192,48,2,129,177
"Bolivia","Chuquisaca","Nor Cinti","Camargo","(CÁRCEL) CARCELETA PÚBLICA DE CAMARGO",-65.20866,-20.64096,6,0,15,21,6,0,9,15
"Bolivia","Chuquisaca","Nor Cinti","Camargo","COLEGIO BOLIVIA",-65.20852,-20.6396,414,32,1894,2308,1048,64,750,1798
"Bolivia","Chuquisaca","Nor Cinti","Camargo","COLEGIO NACIONAL MIXTO 3 DE ABRIL",-65.21046,-20.64259,475,27,2154,2629,1169,82,876,2045
"Bolivia","Chuquisaca","Nor Cinti","Camargo","ESCUELA EL CHURO",-65.13138,-20.63216,21,0,57,78,2,1,54,56
"Bolivia","Chuquisaca","Nor Cinti","Camargo","ESCUELA LA QUEMADA",-65.29808,-20.75148,13,2,98,111,33,10,53,86
"Bolivia","Chuquisaca","Nor Cinti","Camargo","ESCUELA RIO CHICO",-65.22565,-20.69902,23,1,127,150,42,4,80,122
"Bolivia","Chuquisaca","Nor Cinti","Camargo","ESCUELA YURAC CABALLO",-65.13165,-20.74312,41,3,144,185,27,7,107,134
"Bolivia","Chuquisaca","Nor Cinti","Camargo","UNIDAD EDUCATIVA CARPACHACRA",-65.34814,-20.64821,18,1,99,117,21,6,71,92
"Bolivia","Chuquisaca","Nor Cinti","Camargo","UNIDAD EDUCATIVA CUEVA PAMPA",-65.04705,-20.45579,45,4,167,212,14,3,146,160
"Bolivia","Chuquisaca","Nor Cinti","Camargo","UNIDAD EDUCATIVA HIGUERA HUAYCO",-65.22394,-20.79629,47,5,174,221,48,3,118,166
"Bolivia","Chuquisaca","Nor Cinti","Camargo","UNIDAD EDUCATIVA HUACA CANCHA",-64.95026,-20.47788,57,4,118,175,6,8,100,106
"Bolivia","Chuquisaca","Nor Cinti","Camargo","UNIDAD EDUCATIVA JATUN QUINRAY",-64.9914,-20.5823,16,1,86,102,7,0,78,85
"Bolivia","Chuquisaca","Nor Cinti","Camargo","UNIDAD EDUCATIVA LINTACA",-65.34542,-20.73311,15,0,24,39,7,0,17,24
"Bolivia","Chuquisaca","Nor Cinti","Camargo","UNIDAD EDUCATIVA MUYUQUIRI",-65.14874,-20.49716,106,11,471,577,57,14,389,446
"Bolivia","Chuquisaca","Nor Cinti","Camargo","UNIDAD EDUCATIVA PALCA GRANDE",-65.23849,-20.7456,48,3,151,199,90,9,49,139
"Bolivia","Chuquisaca","Nor Cinti","Camargo","UNIDAD EDUCATIVA QUIRUCILLANI",-64.88852,-20.49862,0,0,28,28,0,0,28,28
"Bolivia","Chuquisaca","Nor Cinti","Camargo","UNIDAD EDUCATIVA SUQUISTACA",-65.09431,-20.38414,45,5,208,253,21,5,177,198
"Bolivia","Chuquisaca","Nor Cinti","Camargo","UNIDAD EDUCATIVA TACAQUIRA",-65.14967,-20.54018,107,0,260,367,69,12,179,248
"Bolivia","Chuquisaca","Nor Cinti","Incahuasi","ESCUELA 2 DE AGOSTO",-64.70975,-20.70182,52,6,334,386,14,7,307,321
"Bolivia","Chuquisaca","Nor Cinti","Incahuasi","ESCUELA EL VERANO",-64.6666,-20.56279,21,0,181,202,4,1,176,180
"Bolivia","Chuquisaca","Nor Cinti","Incahuasi","ESCUELA HUAJLAYA",-64.5423,-20.59936,109,15,256,365,28,4,209,237
"Bolivia","Chuquisaca","Nor Cinti","Incahuasi","ESCUELA JOLENCIA",-64.86333,-20.71497,72,11,316,388,60,24,221,281
"Bolivia","Chuquisaca","Nor Cinti","Incahuasi","ESCUELA LAMPAZAR",-64.4935,-20.5347,46,0,115,161,3,0,112,115
"Bolivia","Chuquisaca","Nor Cinti","Incahuasi","ESCUELA SAN LORENCITO",-64.87055,-20.79387,7,2,32,39,4,6,20,24
"Bolivia","Chuquisaca","Nor Cinti","Incahuasi","U.E. YATINA",-64.73019,-20.61985,90,10,285,375,19,8,248,267
"Bolivia","Chuquisaca","Nor Cinti","Incahuasi","UNIDAD EDUCATIVA EDUARDO AVAROA",-64.86781,-20.78048,398,24,1297,1695,493,57,723,1216
"Bolivia","Chuquisaca","Nor Cinti","Incahuasi","UNIDAD EDUCATIVA EL QUEMADO",-64.5985,-20.57037,5,2,257,262,3,2,250,253
"Bolivia","Chuquisaca","Nor Cinti","San Lucas","ESCUELA HUAYLLANI",-64.93605,-20.36235,66,6,194,260,6,4,178,184
"Bolivia","Chuquisaca","Nor Cinti","San Lucas","ESCUELA MOLLE PATA",-64.64008,-20.41311,81,7,264,345,36,17,204,240
"Bolivia","Chuquisaca","Nor Cinti","San Lucas","ESCUELA PAYACOTA DEL CARMEN",-65.25732,-20.21278,104,8,367,471,75,14,270,345
"Bolivia","Chuquisaca","Nor Cinti","San Lucas","U.E. CINTEÑO TAMBO",-65.01966,-20.22208,61,3,296,357,71,8,214,285
"Bolivia","Chuquisaca","Nor Cinti","San Lucas","U.E. CRUZ MAYU",-64.87011,-20.03394,2,2,90,92,1,0,87,88
"Bolivia","Chuquisaca","Nor Cinti","San Lucas","U. EDU. EDUARDO AVAROA",-65.13464,-20.1035,537,55,2040,2577,664,101,1220,1884
"Bolivia","Chuquisaca","Nor Cinti","San Lucas","U.E. EL TERRADO",-64.98693,-20.39509,15,2,133,148,5,1,125,130
"Bolivia","Chuquisaca","Nor Cinti","San Lucas","U.E. TORRE DE LINARES",-64.7693,-19.901,55,8,171,226,8,0,155,163
"Bolivia","Chuquisaca","Nor Cinti","San Lucas","UNIDAD EDUCATIVA 12 DE ABRIL",-65.02613,-20.27677,159,12,691,850,96,13,570,666
"Bolivia","Chuquisaca","Nor Cinti","San Lucas","UNIDAD EDUCATIVA ACCHILLA",-64.80387,-20.32539,141,13,250,391,16,11,210,226
"Bolivia","Chuquisaca","Nor Cinti","San Lucas","UNIDAD EDUCATIVA BUENA VISTA",-64.93593,-19.9318,52,1,175,227,5,3,166,171
"Bolivia","Chuquisaca","Nor Cinti","San Lucas","UNIDAD EDUCATIVA CANCHAS BLANCAS",-64.79684,-20.03145,104,8,256,360,16,6,226,242
"Bolivia","Chuquisaca","Nor Cinti","San Lucas","UNIDAD EDUCATIVA CHILLAGUA",-64.96616,-20.26884,62,1,265,327,14,3,247,261
"Bolivia","Chuquisaca","Nor Cinti","San Lucas","UNIDAD EDUCATIVA CIVITA",-64.90813,-20.00292,8,0,110,118,0,3,107,107
"Bolivia","Chuquisaca","Nor Cinti","San Lucas","UNIDAD EDUCATIVA HUAÑUMILLA",-64.74733,-19.94859,81,1,267,348,18,6,242,260
"Bolivia","Chuquisaca","Nor Cinti","San Lucas","UNIDAD EDUCATIVA JAPO",-64.77112,-20.09636,34,2,113,147,9,2,100,109
"Bolivia","Chuquisaca","Nor Cinti","San Lucas","UNIDAD EDUCATIVA KOLLPA",-64.65379,-20.03951,66,0,257,323,2,6,249,251
"Bolivia","Chuquisaca","Nor Cinti","San Lucas","UNIDAD EDUCATIVA LAJA CKASA",-64.94637,-20.19596,87,5,190,277,24,8,153,177
"Bolivia","Chuquisaca","Nor Cinti","San Lucas","UNIDAD EDUCATIVA MURIFAYA",-65.00114,-20.13484,13,3,94,107,9,4,78,87
"Bolivia","Chuquisaca","Nor Cinti","San Lucas","UNIDAD EDUCATIVA OCURI",-65.05057,-20.21683,74,21,392,466,30,7,334,364
"Bolivia","Chuquisaca","Nor Cinti","San Lucas","UNIDAD EDUCATIVA PADCOYO",-65.15222,-20.23535,186,23,665,851,96,17,529,625
"Bolivia","Chuquisaca","Nor Cinti","San Lucas","UNIDAD EDUCATIVA PALACIO TAMBO",-64.9901,-20.21117,278,36,822,1100,181,38,567,748
"Bolivia","Chuquisaca","Nor Cinti","San Lucas","UNIDAD EDUCATIVA PASLA",-64.78234,-19.94768,27,4,151,178,1,0,146,147
"Bolivia","Chuquisaca","Nor Cinti","San Lucas","UNIDAD EDUCATIVA PIRHUANI",-64.6492,-20.16914,111,4,290,401,2,4,280,282
"Bolivia","Chuquisaca","Nor Cinti","San Lucas","UNIDAD EDUCATIVA ROSENDO LA FUENTE",-65.01423,-20.3716,149,17,529,678,92,15,405,497
"Bolivia","Chuquisaca","Nor Cinti","San Lucas","UNIDAD EDUCATIVA SACAVILLQUE CHICO",-64.6198,-20.30524,112,8,204,316,13,11,172,185
"Bolivia","Chuquisaca","Nor Cinti","San Lucas","UNIDAD EDUCATIVA SAN PEDRO DE HUANAYA",-64.69353,-20.28096,16,3,91,107,1,0,87,88
"Bolivia","Chuquisaca","Nor Cinti","San Lucas","UNIDAD EDUCATIVA TAMBILLOS",-65.27066,-20.04161,102,33,284,386,18,4,229,247
"Bolivia","Chuquisaca","Nor Cinti","San Lucas","UNIDAD EDUCATIVA TAMBO CKASA",-64.7476,-20.33026,120,1,223,343,0,1,221,221
"Bolivia","Chuquisaca","Nor Cinti","San Lucas","UNIDAD EDUCATIVA TOROJCHI",-64.9986,-19.99369,32,1,122,154,13,4,104,117
"Bolivia","Chuquisaca","Nor Cinti","San Lucas","UNIDAD EDUCATIVA URUCHINI",-64.98957,-19.87956,53,3,129,182,27,7,92,119
"Bolivia","Chuquisaca","Nor Cinti","Villa Charcas","COLEGIO PADRE LANDINI SIMON BOLIVAR",-64.88494,-20.72522,756,80,2586,3342,773,151,1582,2355
"Bolivia","Chuquisaca","Nor Cinti","Villa Charcas","ESCUELA BOMBOMA",-64.69144,-20.44497,8,1,75,83,7,0,67,74
"Bolivia","Chuquisaca","Nor Cinti","Villa Charcas","ESCUELA CAIZA K",-64.74667,-20.52791,76,8,232,308,8,5,211,219
"Bolivia","Chuquisaca","Nor Cinti","Villa Charcas","ESCUELA LLUJLLAYA",-64.73945,-20.54849,45,20,255,300,12,6,217,229
"Bolivia","Chuquisaca","Nor Cinti","Villa Charcas","ESCUELA SANTA ELENA",-64.77654,-20.58304,86,5,359,445,15,9,330,345
"Bolivia","Chuquisaca","Nor Cinti","Villa Charcas","ESCUELA SUPAS",-64.77631,-20.43394,57,17,314,371,11,4,282,293
"Bolivia","Chuquisaca","Nor Cinti","Villa Charcas","U.E. MOLLINI",-64.71598,-20.45341,17,1,57,74,3,1,52,55
"Bolivia","Chuquisaca","Nor Cinti","Villa Charcas","UNIDAD EDUCATIVA JOSE ANTONIO ZAMPA",-64.85761,-20.66362,78,10,682,760,84,13,575,659
"Bolivia","Chuquisaca","Oropeza","Poroma","COLEGIOMANUEL OVANDO SAN JUAN DE ORCAS",-65.31216,-18.73248,86,10,251,337,37,16,188,225
"Bolivia","Chuquisaca","Oropeza","Poroma","COLEGIO RAFAEL CAMPOS DE LUJE",-65.21857,-18.78213,49,3,186,235,35,5,143,178
"Bolivia","Chuquisaca","Oropeza","Poroma","ESCUELA CENTRAL CHALLCHA",-65.54505,-18.44033,64,2,296,360,89,13,192,281
"Bolivia","Chuquisaca","Oropeza","Poroma","ESCUELA KAYNACAS",-65.404,-18.86573,32,4,171,203,26,3,138,164
"Bolivia","Chuquisaca","Oropeza","Poroma","ESCUELA SAN SALVADOR DE POJPO",-65.32699,-18.79455,75,14,259,334,61,10,174,235
"Bolivia","Chuquisaca","Oropeza","Poroma","POSTA SANITARIA",-65.28516,-18.49988,15,0,23,38,4,1,18,22
"Bolivia","Chuquisaca","Oropeza","Poroma","PUESTO DE SALUD VIRU VIRU",-65.651,-18.38448,21,9,124,145,26,8,81,107
"Bolivia","Chuquisaca","Oropeza","Poroma","SUB ALCALDÍA DE SAPSE",-65.27885,-18.72523,36,7,152,188,43,3,99,142
"Bolivia","Chuquisaca","Oropeza","Poroma","U. EDU. SAN ANDRES DE POROMA",-65.42594,-18.53917,368,25,941,1309,278,51,587,865
"Bolivia","Chuquisaca","Oropeza","Poroma","UNIDAD EDUCATIVA CALIZAYA",-65.33015,-18.48993,11,1,104,115,20,3,80,100
"Bolivia","Chuquisaca","Oropeza","Poroma","UNIDAD EDUCATIVA CHIJMURI",-65.39856,-18.81042,38,8,146,184,34,3,101,135
"Bolivia","Chuquisaca","Oropeza","Poroma","UNIDAD EDUCATIVA COPAVILLQUE",-65.2855,-18.62391,90,3,292,382,48,16,225,273
"Bolivia","Chuquisaca","Oropeza","Poroma","UNIDAD EDUCATIVA CUCURI",-65.30397,-18.84813,34,8,212,246,43,9,152,195
"Bolivia","Chuquisaca","Oropeza","Poroma","UNIDAD EDUCATIVA HUAÑOMA",-65.59436,-18.45855,171,4,351,522,70,38,239,309
"Bolivia","Chuquisaca","Oropeza","Poroma","UNIDAD EDUCATIVA IRU KKOTA",-65.36794,-18.6862,53,11,192,245,42,7,132,174
"Bolivia","Chuquisaca","Oropeza","Poroma","UNIDAD EDUCATIVA LOS ALAMOS",-65.34219,-18.87337,29,12,225,254,53,5,155,208
"Bolivia","Chuquisaca","Oropeza","Poroma","UNIDAD EDUCATIVA PALAJLA",-65.46515,-18.45122,43,3,178,221,19,9,147,166
"Bolivia","Chuquisaca","Oropeza","Poroma","UNIDAD EDUCATIVA  PANGORASI",-65.39965,-18.60243,23,4,105,128,11,2,88,99
"Bolivia","Chuquisaca","Oropeza","Poroma","UNIDAD EDUCATIVA PIOCERA",-65.40269,-18.74838,21,3,111,132,20,2,86,106
"Bolivia","Chuquisaca","Oropeza","Poroma","UNIDAD EDUCATIVA SANABRIA",-65.33897,-18.93845,21,3,185,206,60,3,119,179
"Bolivia","Chuquisaca","Oropeza","Poroma","UNIDAD EDUCATIVA SIJCHA ALTA",-65.30686,-18.92584,13,3,128,141,17,1,107,124
"Bolivia","Chuquisaca","Oropeza","Poroma","UNIDAD EDUCATIVA URUGUAYO",-65.35072,-18.61396,13,2,104,117,10,4,88,98
"Bolivia","Chuquisaca","Oropeza","Poroma","UNIDAD EDUCATIVA YANANI",-65.43656,-18.59779,23,2,191,214,12,2,175,187
"Bolivia","Chuquisaca","Oropeza","Sucre","AASANA",-65.29323,-19.01331,650,58,5298,5948,3156,242,1842,4998
"Bolivia","Chuquisaca","Oropeza","Sucre","CAMPO DEPORTIVO 20 DE OCTUBRE",-65.28734,-19.02233,101,19,955,1056,600,27,309,909
"Bolivia","Chuquisaca","Oropeza","Sucre","CARCEL PUBLICA",-65.26225,-19.05368,52,0,172,224,97,4,71,168
"Bolivia","Chuquisaca","Oropeza","Sucre","COL. BERNARDO MONTEAGUDO",-65.25573,-19.04699,168,8,1134,1302,897,65,164,1061
"Bolivia","Chuquisaca","Oropeza","Sucre","COL. CARDENAL MAURER",-65.26183,-19.05324,275,10,1884,2159,1529,36,309,1838
"Bolivia","Chuquisaca","Oropeza","Sucre","COL. DON BOSCO",-65.26269,-19.04767,232,6,1365,1597,1121,24,214,1335
"Bolivia","Chuquisaca","Oropeza","Sucre","COLEGIO 23 DE MARZO",-65.2681,-19.04329,236,6,1573,1809,1198,48,321,1519
"Bolivia","Chuquisaca","Oropeza","Sucre","COLEGIO 24 DE SEPTIEMBRE - MARAGUA",-65.4332,-19.05204,78,15,275,353,50,20,190,240
"Bolivia","Chuquisaca","Oropeza","Sucre","COLEGIO DOMINGO SABIO",-65.27417,-19.04843,271,24,1829,2100,1228,74,503,1731
"Bolivia","Chuquisaca","Oropeza","Sucre","COLEGIO FE Y ALEGRIA",-65.26789,-19.03673,534,25,3944,4478,2832,132,955,3787
"Bolivia","Chuquisaca","Oropeza","Sucre","COLEGIO JUEZ BALTAZAR GARZÓN",-65.21569,-19.0804,34,11,492,526,218,26,237,455
"Bolivia","Chuquisaca","Oropeza","Sucre","COLEGIO JUNIN",-65.25817,-19.04907,226,6,1139,1365,943,22,168,1111
"Bolivia","Chuquisaca","Oropeza","Sucre","COLEGIO SIMÓN RODRÍGUEZ",-65.25462,-19.05121,332,4,1292,1624,1051,47,190,1241
"Bolivia","Chuquisaca","Oropeza","Sucre","COL. EMILIO HOSCHMAN",-65.26781,-19.01751,606,76,4854,5460,2608,289,1881,4489
"Bolivia","Chuquisaca","Oropeza","Sucre","COLISEO JORGE REVILLA ALDANA",-65.25701,-19.03738,189,9,1172,1361,921,26,216,1137
"Bolivia","Chuquisaca","Oropeza","Sucre","COL.JORGE REVILLA",-65.25858,-19.02505,714,44,5101,5815,3476,197,1384,4860
"Bolivia","Chuquisaca","Oropeza","Sucre","COL.MARIANO SERRANO",-65.25015,-19.04412,480,17,3392,3872,2667,67,641,3308
"Bolivia","Chuquisaca","Oropeza","Sucre","COL. SAGRADO CORAZON",-65.26104,-19.04679,218,4,1015,1233,849,19,143,992
"Bolivia","Chuquisaca","Oropeza","Sucre","COL. VICTORINO VEGA",-65.23779,-19.04786,623,40,4119,4742,2706,153,1220,3926
"Bolivia","Chuquisaca","Oropeza","Sucre","ESC. ANGEL BASPINEIRO",-65.31149,-19.00419,100,34,985,1085,397,68,486,883
"Bolivia","Chuquisaca","Oropeza","Sucre","ESC. ANICETO ARCE",-65.27341,-19.06394,778,39,4055,4833,2485,209,1322,3807
"Bolivia","Chuquisaca","Oropeza","Sucre","ESC. BENJAMIN GUZMAN",-65.25764,-19.03901,181,8,1433,1614,1102,37,286,1388
"Bolivia","Chuquisaca","Oropeza","Sucre","ESC. GUIDO VILLAGOMEZ",-65.28304,-19.02838,465,42,3786,4251,2348,177,1219,3567
"Bolivia","Chuquisaca","Oropeza","Sucre","ESC. HORNO KHASA",-65.25737,-19.01756,528,52,3914,4442,2197,200,1465,3662
"Bolivia","Chuquisaca","Oropeza","Sucre","ESC. JOSEFINA GOYTIA",-65.26051,-19.05899,177,14,1511,1688,1069,37,391,1460
"Bolivia","Chuquisaca","Oropeza","Sucre","ESC. LA RECOLETA",-65.25409,-19.05475,484,24,3405,3889,2508,126,747,3255
"Bolivia","Chuquisaca","Oropeza","Sucre","ESC.MARISCAL DE AYACUCHO",-65.25534,-19.0489,89,1,583,672,507,9,66,573
"Bolivia","Chuquisaca","Oropeza","Sucre","ESC. OVANDO",-65.2598,-19.0377,111,1,728,839,564,18,145,709
"Bolivia","Chuquisaca","Oropeza","Sucre","ESC. ROBERTO ALVARADO",-65.24728,-19.03056,630,31,4423,5053,2964,155,1273,4237
"Bolivia","Chuquisaca","Oropeza","Sucre","ESC.SAGRADA FAMILIA",-65.24627,-19.0241,671,41,4774,5445,3109,251,1373,4482
"Bolivia","Chuquisaca","Oropeza","Sucre","ESC. SAN JAVIER",-65.24428,-19.04221,353,10,3014,3367,2448,64,492,2940
"Bolivia","Chuquisaca","Oropeza","Sucre","ESC. SAN JUANILLO",-65.2558,-19.0316,1119,50,7280,8399,5102,255,1873,6975
"Bolivia","Chuquisaca","Oropeza","Sucre","ESC.TALLER DE INTEGRACION ETI",-65.23871,-19.04204,132,8,1257,1389,1001,31,217,1218
"Bolivia","Chuquisaca","Oropeza","Sucre","ESCUELA ARABATE",-65.15241,-19.07256,67,2,92,159,16,3,71,87
"Bolivia","Chuquisaca","Oropeza","Sucre","ESCUELA DANIEL CALVO",-65.26105,-19.04571,93,2,653,746,540,15,96,636
"Bolivia","Chuquisaca","Oropeza","Sucre","ESCUELA ELIZARDO PEREZ",-65.20616,-19.1318,35,5,255,290,92,15,143,235
"Bolivia","Chuquisaca","Oropeza","Sucre","ESCUELA FALAFAYA",-65.2095,-18.94874,43,6,191,234,85,18,82,167
"Bolivia","Chuquisaca","Oropeza","Sucre","ESCUELA FRAY GABRIEL MARIA LANDINI",-65.12765,-18.77743,119,39,608,727,185,26,358,543
"Bolivia","Chuquisaca","Oropeza","Sucre","ESCUELA FRAY GABRIEL MARISCAL",-65.1773,-18.63784,47,5,192,239,37,12,138,175
"Bolivia","Chuquisaca","Oropeza","Sucre","ESCUELA JOSÉ SAMPA",-65.17965,-18.89784,37,4,210,247,83,9,114,197
"Bolivia","Chuquisaca","Oropeza","Sucre","ESCUELA LLINFI",-65.30132,-18.98218,50,18,429,479,193,9,209,402
"Bolivia","Chuquisaca","Oropeza","Sucre","ESCUELA PUNILLA",-65.37293,-18.95657,32,6,235,267,110,12,107,217
"Bolivia","Chuquisaca","Oropeza","Sucre","ESCUELA SECCIONAL DE CHAUNACA",-65.43951,-18.99047,43,1,294,337,46,10,237,283
"Bolivia","Chuquisaca","Oropeza","Sucre","ESCUELA TUCSUPAYA",-65.27917,-19.0231,355,33,2798,3153,1781,144,840,2621
"Bolivia","Chuquisaca","Oropeza","Sucre","ESTACIÓN DE BOMBEROS",-65.2486,-19.04844,242,4,1870,2112,1433,38,395,1828
"Bolivia","Chuquisaca","Oropeza","Sucre","ESTADIUM PATRIA",-65.25877,-19.03283,550,20,3385,3935,2507,115,743,3250
"Bolivia","Chuquisaca","Oropeza","Sucre","FAC. DERECHO",-65.24686,-19.04547,351,3,2494,2845,1981,40,470,2451
"Bolivia","Chuquisaca","Oropeza","Sucre","FACULTAD DE MEDICINA",-65.26635,-19.04619,867,20,3949,4816,3035,109,785,3820
"Bolivia","Chuquisaca","Oropeza","Sucre","FACULTAD DE TECNOLOGÍA",-65.25661,-19.03967,728,22,3834,4562,2905,76,831,3736
"Bolivia","Chuquisaca","Oropeza","Sucre","FED. DE CHOFERES",-65.24286,-19.03716,419,22,3382,3801,2495,79,786,3281
"Bolivia","Chuquisaca","Oropeza","Sucre","FUNDACION PACHAMAMA",-65.26746,-19.04067,136,9,1120,1256,849,21,241,1090
"Bolivia","Chuquisaca","Oropeza","Sucre","H. VIRGEN DE LA HIEDRA",-65.27728,-19.03624,166,18,1533,1699,1025,60,430,1455
"Bolivia","Chuquisaca","Oropeza","Sucre","IGLESIA SAN MATÍAS",-65.26208,-19.03669,388,22,2753,3141,2097,64,570,2667
"Bolivia","Chuquisaca","Oropeza","Sucre","IPTK-N.AGUIRRE 560 / CERPI",-65.25272,-19.03685,341,10,2395,2736,1845,58,482,2327
"Bolivia","Chuquisaca","Oropeza","Sucre","JARDÍN DE NIÑOS SAN LÁZARO",-65.24966,-19.05094,248,15,1764,2012,1325,37,387,1712
"Bolivia","Chuquisaca","Oropeza","Sucre","KINDER ECHEVERRIA",-65.25982,-19.05163,144,0,925,1069,793,21,111,904
"Bolivia","Chuquisaca","Oropeza","Sucre","KINDER GERARDO VACA GUZMAN",-65.26248,-19.04274,84,3,501,585,396,11,91,487
"Bolivia","Chuquisaca","Oropeza","Sucre","KINDER MUNICIPAL",-65.26814,-19.05075,223,9,1704,1927,1313,42,340,1653
"Bolivia","Chuquisaca","Oropeza","Sucre","KINDER SAN VICENTE DE PAUL",-65.25596,-19.04462,265,7,1731,1996,1413,23,288,1701
"Bolivia","Chuquisaca","Oropeza","Sucre","KINDER SERRANO",-65.24963,-19.04423,98,2,640,738,491,15,132,623
"Bolivia","Chuquisaca","Oropeza","Sucre","LICEO MARÍA JOSEFA MUJIA",-65.26344,-19.04962,276,6,1720,1996,1367,48,299,1666
"Bolivia","Chuquisaca","Oropeza","Sucre","MERCADO YURAC YURAC",-65.27402,-19.02921,184,17,1677,1861,1092,89,479,1571
"Bolivia","Chuquisaca","Oropeza","Sucre","PLAZUELA SAN MATÍAS",-65.26157,-19.03634,271,14,1758,2029,1332,41,371,1703
"Bolivia","Chuquisaca","Oropeza","Sucre","SAL. MULT. BARRIO NUEVOS HORIZONTES",-65.24062,-19.07006,81,6,728,809,436,42,244,680
"Bolivia","Chuquisaca","Oropeza","Sucre","SAL.MULT. PLANTA DIESEL",-65.27349,-19.05489,194,3,1343,1537,1029,32,279,1308
"Bolivia","Chuquisaca","Oropeza","Sucre","SALON MULT. ALTO LOYOLA",-65.25202,-19.02552,224,24,1415,1639,905,56,430,1335
"Bolivia","Chuquisaca","Oropeza","Sucre","SALON MULTIFUNCIONAL AMERICA",-65.26705,-19.0604,176,21,1204,1380,737,47,399,1136
"Bolivia","Chuquisaca","Oropeza","Sucre","SALON MULTIFUNCIONAL EL ABRA",-65.24494,-19.06586,331,25,2380,2711,1506,98,751,2257
"Bolivia","Chuquisaca","Oropeza","Sucre","SALON MULTIFUNCIONAL EL NIÑO",-65.28127,-19.01439,61,4,533,594,395,10,124,519
"Bolivia","Chuquisaca","Oropeza","Sucre","SALON MULTIFUNCIONAL LA HOYADA",-65.26664,-19.05572,130,8,756,886,515,18,215,730
"Bolivia","Chuquisaca","Oropeza","Sucre","SALON MULTIFUNCIONAL PEDRO MEDRANO",-65.23917,-19.02556,19,2,319,338,189,10,118,307
"Bolivia","Chuquisaca","Oropeza","Sucre","SALON MULTIFUNCIONAL SAN FRANCISCO",-65.25436,-19.05559,113,5,1082,1195,826,28,223,1049
"Bolivia","Chuquisaca","Oropeza","Sucre","SALÓN MULTIFUNCIONAL SAN JUAN CACHIMAYU",-65.30952,-19.08966,7,2,132,139,62,3,65,127
"Bolivia","Chuquisaca","Oropeza","Sucre","SEMINARIO TEOLOGICO DEL SUR",-65.25397,-19.03208,322,16,2383,2705,1665,91,611,2276
"Bolivia","Chuquisaca","Oropeza","Sucre","TERMINAL DE BUSES",-65.24707,-19.0392,569,21,3822,4391,2986,73,742,3728
"Bolivia","Chuquisaca","Oropeza","Sucre","U.ED.FRANCISCO CERMEÑO",-65.25917,-19.02858,293,13,2239,2532,1692,49,485,2177
"Bolivia","Chuquisaca","Oropeza","Sucre","U. EDU. GUALBERTO VILLARROEL",-65.53341,-19.0159,157,24,846,1003,235,58,529,764
"Bolivia","Chuquisaca","Oropeza","Sucre","U.E. GASTÓN VILAR CASSO",-65.28537,-19.01114,35,8,639,674,370,38,223,593
"Bolivia","Chuquisaca","Oropeza","Sucre","U.E. LAS AMERICAS",-65.25094,-19.01372,664,53,4428,5092,2729,209,1437,4166
"Bolivia","Chuquisaca","Oropeza","Sucre","UNIDAD EDUCATIVA 6 DE JUNIO",-65.26705,-19.02696,635,59,4275,4910,2651,193,1372,4023
"Bolivia","Chuquisaca","Oropeza","Sucre","UNIDAD EDUCATIVA ALBERTO BOHORQUEZ",-65.29878,-19.02849,97,38,987,1084,397,72,480,877
"Bolivia","Chuquisaca","Oropeza","Sucre","UNIDAD EDUCATIVA ALEGRÍA",-65.27406,-18.99063,182,36,1414,1596,604,79,695,1299
"Bolivia","Chuquisaca","Oropeza","Sucre","UNIDAD EDUCATIVA CANTU MOLINO",-65.23275,-18.86053,30,3,154,184,36,5,110,146
"Bolivia","Chuquisaca","Oropeza","Sucre","UNIDAD EDUCATIVA CHUQUI CHUQUI",-65.1201,-18.82506,77,30,472,549,149,21,272,421
"Bolivia","Chuquisaca","Oropeza","Sucre","UNIDAD EDUCATIVA LA BARRANCA",-65.31851,-18.97461,40,12,451,491,189,24,226,415
"Bolivia","Chuquisaca","Oropeza","Sucre","UNIDAD EDUCATIVA LA PALMA",-65.12672,-18.95262,105,31,554,659,166,20,337,503
"Bolivia","Chuquisaca","Oropeza","Sucre","UNIDAD EDUCATIVA LUIS ESPINAL",-65.11092,-18.89592,58,8,457,515,184,15,250,434
"Bolivia","Chuquisaca","Oropeza","Sucre","UNIDAD EDUCATIVA QUILA QUILA",-65.377,-19.11972,126,20,454,580,183,38,213,396
"Bolivia","Chuquisaca","Oropeza","Sucre","UNIDAD EDUCATIVA RUFFO",-65.2886,-19.05783,61,17,648,709,311,33,287,598
"Bolivia","Chuquisaca","Oropeza","Sucre","UNIDAD EDUCATIVA SIMÓN BOLIVAR LA PALCA",-65.24233,-18.62139,27,1,95,122,21,3,70,91
"Bolivia","Chuquisaca","Oropeza","Sucre","UNIDAD EDUCATIVA SOICO",-65.26456,-18.81216,39,5,103,142,15,4,79,94
"Bolivia","Chuquisaca","Oropeza","Sucre","UNID. ED. HUGO POPPE ENTRAMBASAGUAS",-65.23246,-19.05145,390,39,2913,3303,1971,127,776,2747
"Bolivia","Chuquisaca","Oropeza","Sucre","UNID. ED. JOSE CLEMENTE MAURER",-65.23655,-19.08533,400,62,3216,3616,1716,122,1316,3032
"Bolivia","Chuquisaca","Oropeza","Sucre","UNID.EDUCATIVA VICTORIA DIEZ",-65.30588,-19.00942,689,137,5227,5916,2478,333,2279,4757
"Bolivia","Chuquisaca","Oropeza","Sucre","U.PEDAG.MARISCAL SUCRE",-65.26093,-19.03903,155,4,920,1075,743,21,152,895
"Bolivia","Chuquisaca","Oropeza","Yotala","CASA POSADA DE HUAYLLAS",-65.32174,-19.15824,63,6,188,251,34,8,140,174
"Bolivia","Chuquisaca","Oropeza","Yotala","CENTRO EDUCATIVO SANTA ROSA",-65.26758,-19.16187,184,8,887,1071,420,55,404,824
"Bolivia","Chuquisaca","Oropeza","Yotala","COLEGIO GREGORIO PACHECO",-65.26525,-19.16197,192,25,1040,1232,415,30,570,985
"Bolivia","Chuquisaca","Oropeza","Yotala","COLEGIO SAN ISIDRO DE ANFAYA",-65.21962,-19.25604,46,5,317,363,44,11,257,301
"Bolivia","Chuquisaca","Oropeza","Yotala","COLEGIO TASA PAMPA",-65.25967,-19.30862,22,2,200,222,11,4,183,194
"Bolivia","Chuquisaca","Oropeza","Yotala","ESCUELA ANTONIO TOVAR HINOJOSA",-65.17021,-19.30317,31,4,224,255,60,7,153,213
"Bolivia","Chuquisaca","Oropeza","Yotala","ESCUELA TIPAKA",-65.3103,-19.26145,18,0,133,151,25,6,102,127
"Bolivia","Chuquisaca","Oropeza","Yotala","POSTA DE SALUD Y SALÓN DE LA COMUNIDAD",-65.1908,-19.24057,17,0,132,149,14,3,115,129
"Bolivia","Chuquisaca","Oropeza","Yotala","UNIDAD EDUCATIVA CAMPANARIO",-65.26763,-19.10636,13,2,151,164,73,7,69,142
"Bolivia","Chuquisaca","Oropeza","Yotala","UNIDAD EDUCATIVA GERMAN BUSCH",-65.28329,-19.20276,37,3,188,225,71,5,109,180
"Bolivia","Chuquisaca","Oropeza","Yotala","UNIDAD EDUCATIVA JOSÉ VILLEGAS",-65.29339,-19.1495,16,0,135,151,29,4,102,131
"Bolivia","Chuquisaca","Oropeza","Yotala","UNIDAD EDUCATIVA TUERO CHICO",-65.21132,-19.33957,11,1,96,107,17,1,77,94
"Bolivia","Chuquisaca","Oropeza","Yotala","UNIDAD EDUCATIVA VICTOR SANDI",-65.24226,-19.15815,48,3,348,396,129,18,198,327
"Bolivia","Chuquisaca","Sur Cinti","Camataqui (Villa Abecia)","U. EDU. DANIEL SANCHEZ BUSTAMANTE",-65.2789,-21.0675,17,0,86,103,29,11,46,75
"Bolivia","Chuquisaca","Sur Cinti","Camataqui (Villa Abecia)","UNIDAD EDUCATIVA 23 DE MARZO",-65.23078,-20.97539,222,23,810,1032,282,49,456,738
"Bolivia","Chuquisaca","Sur Cinti","Camataqui (Villa Abecia)","UNIDAD EDUCATIVA 2 DE AGOSTO",-65.36425,-21.02694,24,4,116,140,6,0,106,112
"Bolivia","Chuquisaca","Sur Cinti","Camataqui (Villa Abecia)","UNIDAD EDUCATIVA ACHUMA",-65.3415,-20.9139,6,2,89,95,8,6,73,81
"Bolivia","Chuquisaca","Sur Cinti","Camataqui (Villa Abecia)","UNIDAD EDUCATIVA JAILIA",-65.27052,-20.93037,16,5,120,136,33,10,72,105
"Bolivia","Chuquisaca","Sur Cinti","Camataqui (Villa Abecia)","UNIDAD EDUCATIVA TARCANA",-65.26554,-21.0909,15,0,47,62,10,3,34,44
"Bolivia","Chuquisaca","Sur Cinti","Culpina","ESCUELA CAÑON VERDE",-64.23112,-21.13576,12,0,72,84,47,2,23,70
"Bolivia","Chuquisaca","Sur Cinti","Culpina","ESCUELA EL MANZANAL",-64.4059,-21.0985,45,1,59,104,7,0,51,58
"Bolivia","Chuquisaca","Sur Cinti","Culpina","U. EDU. JOSE ANTONIO ZAMPA",-64.94446,-20.8238,768,89,2870,3638,1084,121,1576,2660
"Bolivia","Chuquisaca","Sur Cinti","Culpina","UNIDAD EDUCATIVA EL CAMPAMENTO",-64.51948,-20.90218,45,2,132,177,29,2,99,128
"Bolivia","Chuquisaca","Sur Cinti","Culpina","UNIDAD EDUCATIVA EL MONTE",-64.91585,-21.00441,59,8,291,350,75,29,179,254
"Bolivia","Chuquisaca","Sur Cinti","Culpina","UNIDAD EDUCATIVA EL PALMAR",-64.31755,-20.85209,100,14,435,535,212,35,174,386
"Bolivia","Chuquisaca","Sur Cinti","Culpina","UNIDAD EDUCATIVA HUAJLITA",-64.60419,-20.82584,45,1,141,186,14,7,119,133
"Bolivia","Chuquisaca","Sur Cinti","Culpina","UNIDAD EDUCATIVA LA CIENEGA",-64.96812,-20.9327,15,1,59,74,24,5,29,53
"Bolivia","Chuquisaca","Sur Cinti","Culpina","UNIDAD EDUCATIVA LA CUEVA",-64.88244,-20.9315,45,3,158,203,21,6,128,149
"Bolivia","Chuquisaca","Sur Cinti","Culpina","UNIDAD EDUCATIVA LA LOMA",-64.72974,-20.85919,72,4,107,179,0,7,96,96
"Bolivia","Chuquisaca","Sur Cinti","Culpina","UNIDAD EDUCATIVA PILAYA",-64.689,-20.94015,36,7,57,93,14,2,34,48
"Bolivia","Chuquisaca","Sur Cinti","Culpina","UNIDAD EDUCATIVA PUCA LAJA",-64.64645,-20.77685,4,0,37,41,4,2,31,35
"Bolivia","Chuquisaca","Sur Cinti","Culpina","UNIDAD EDUCATIVA PUCA PAMPA",-64.5965,-20.77545,74,3,238,312,35,25,175,210
"Bolivia","Chuquisaca","Sur Cinti","Culpina","UNIDAD EDUCATIVA PUMA CKASA",-64.6648,-20.74907,64,1,87,151,12,6,68,80
"Bolivia","Chuquisaca","Sur Cinti","Culpina","UNIDAD EDUCATIVA SAJLINA",-64.99879,-20.80951,113,18,456,569,132,47,259,391
"Bolivia","Chuquisaca","Sur Cinti","Culpina","UNIDAD EDUCATIVA SALITRE",-64.90742,-20.90935,19,4,82,101,14,1,63,77
"Bolivia","Chuquisaca","Sur Cinti","Culpina","UNIDAD EDUCATIVA SAN FRANCISCO",-64.7111,-20.75573,54,7,78,132,16,4,51,67
"Bolivia","Chuquisaca","Sur Cinti","Culpina","UNIDAD EDUCATIVA SUMAYA",-64.78716,-20.75736,63,5,96,159,25,7,59,84
"Bolivia","Chuquisaca","Sur Cinti","Culpina","UNIDAD EDUCATIVA TOJLASA",-64.91499,-20.85254,91,12,367,458,103,31,221,324
"Bolivia","Chuquisaca","Sur Cinti","Las Carreras (Las carretas)","ESCUELA EL MONTE DE SANDOVAL",-65.21051,-21.16683,31,3,124,155,12,5,104,116
"Bolivia","Chuquisaca","Sur Cinti","Las Carreras (Las carretas)","ESCUELA MONTE DE TARAYA",-65.35029,-21.47675,8,0,24,32,0,0,24,24
"Bolivia","Chuquisaca","Sur Cinti","Las Carreras (Las carretas)","ESCUELA SOCPORA",-65.23065,-21.35275,3,2,47,50,16,3,26,42
"Bolivia","Chuquisaca","Sur Cinti","Las Carreras (Las carretas)","UNIDAD EDUCATIVA IMPORA",-65.27929,-21.36126,20,2,99,119,21,3,73,94
"Bolivia","Chuquisaca","Sur Cinti","Las Carreras (Las carretas)","UNIDAD EDUCATIVA JAIME MENDOZA",-65.21003,-21.2103,96,6,441,537,144,23,268,412
"Bolivia","Chuquisaca","Sur Cinti","Las Carreras (Las carretas)","UNIDAD EDUCATIVA LA TORRE",-65.2924,-21.2021,25,3,104,129,18,2,81,99
"Bolivia","Chuquisaca","Sur Cinti","Las Carreras (Las carretas)","UNIDAD EDUCATIVA LIME",-65.2624,-21.2043,42,1,160,202,18,3,138,156
"Bolivia","Chuquisaca","Sur Cinti","Las Carreras (Las carretas)","UNIDAD EDUCATIVA SAN JUAN",-65.21146,-21.21964,16,6,132,148,39,6,81,120
"Bolivia","Chuquisaca","Sur Cinti","Las Carreras (Las carretas)","UNIDAD EDUCATIVA SANTA ROSA",-65.22454,-21.32046,13,1,75,88,18,4,52,70
"Bolivia","Chuquisaca","Sur Cinti","Las Carreras (Las carretas)","UNIDAD EDUCATIVA TARAYA",-65.24155,-21.42857,8,0,95,103,32,5,58,90
"Bolivia","Chuquisaca","Tomina","El Villar","COLEGIO EDUARDO ABAROA",-64.31137,-19.6299,199,24,734,933,203,34,473,676
"Bolivia","Chuquisaca","Tomina","El Villar","ESCUELA SECCIONAL LA REVUELTA",-64.19889,-19.82226,65,8,435,500,106,19,302,408
"Bolivia","Chuquisaca","Tomina","El Villar","U.E. BARBECHOS",-64.29641,-19.5529,6,3,100,106,19,0,78,97
"Bolivia","Chuquisaca","Tomina","El Villar","UNIDAD EDUCATIVA EL DORADO",-64.3289,-19.79042,35,8,220,255,16,8,188,204
"Bolivia","Chuquisaca","Tomina","El Villar","UNIDAD EDUCATIVA SAN BLAS",-64.39065,-19.63341,38,0,135,173,7,5,123,130
"Bolivia","Chuquisaca","Tomina","Padilla","COLEGIO SAN PIO X",-64.3012,-19.30634,275,29,1520,1795,571,43,877,1448
"Bolivia","Chuquisaca","Tomina","Padilla","ESCUELA MANUEL A. PADILLA",-64.30116,-19.30746,292,35,1627,1919,606,59,927,1533
"Bolivia","Chuquisaca","Tomina","Padilla","NUCLEO ESCOLAR ADRIÁN MOYA TAPIA",-64.14172,-19.33275,103,2,235,338,47,4,182,229
"Bolivia","Chuquisaca","Tomina","Padilla","NUCLEO ESCOLAR HUMBERTO DELGADILLO",-64.1024,-19.56468,66,12,385,451,68,25,280,348
"Bolivia","Chuquisaca","Tomina","Padilla","U.E. CACIANO RODAS CARDENAS",-64.0046,-19.2876,19,0,90,109,15,2,73,88
"Bolivia","Chuquisaca","Tomina","Padilla","U.E. FRANZ TAMAYO",-64.23646,-19.50273,17,0,70,87,4,2,64,68
"Bolivia","Chuquisaca","Tomina","Padilla","U.E. MARISCAL SUCRE",-64.2164,-19.37816,15,1,75,90,18,7,49,67
"Bolivia","Chuquisaca","Tomina","Padilla","UNIDAD EDUCATIVA 29 DE MARZO",-64.21652,-19.24916,10,1,39,49,7,3,28,35
"Bolivia","Chuquisaca","Tomina","Padilla","UNIDAD EDUCATIVA 2 DE ABRIL LA CIENEGA",-64.29996,-19.21987,51,5,233,284,29,12,187,216
"Bolivia","Chuquisaca","Tomina","Padilla","UNIDAD EDUCATIVA SUSANA DURAN",-64.00618,-19.42285,16,4,85,101,17,3,61,78
"Bolivia","Chuquisaca","Tomina","Padilla","UNIDAD EDUCATIVA TELEMINA BARJA",-64.175,-19.4771,51,8,206,257,29,8,161,190
"Bolivia","Chuquisaca","Tomina","Sopachuy","COLEGIO 25 DE MAYO",-64.47521,-19.48693,125,12,529,654,169,20,328,497
"Bolivia","Chuquisaca","Tomina","Sopachuy","ESCUELA JUAN BOSING",-64.47478,-19.48648,155,18,740,895,228,44,450,678
"Bolivia","Chuquisaca","Tomina","Sopachuy","ESCUELA SIPICANI",-64.57142,-19.43305,28,1,230,258,13,3,213,226
"Bolivia","Chuquisaca","Tomina","Sopachuy","INTERNADO SANTA ROSA DE AMANCAYA",-64.55762,-19.32515,88,6,451,539,25,7,413,438
"Bolivia","Chuquisaca","Tomina","Sopachuy","U.E. PAMPAS PUNTA",-64.4611,-19.41523,9,0,143,152,23,6,114,137
"Bolivia","Chuquisaca","Tomina","Sopachuy","U.E. PASLAPAYA",-64.51927,-19.42884,3,1,109,112,2,5,101,103
"Bolivia","Chuquisaca","Tomina","Sopachuy","U.E. SAN JUAN DE HORCAS",-64.51885,-19.46673,8,1,123,131,5,3,114,119
"Bolivia","Chuquisaca","Tomina","Sopachuy","UNIDAD EDUCATIVA MAMA HUASI",-64.62706,-19.33403,2,0,176,178,1,1,174,175
"Bolivia","Chuquisaca","Tomina","Sopachuy","UNIDAD EDUCATIVA PAMPAS DEL CARMEN",-64.4129,-19.54599,30,1,108,138,7,3,97,104
"Bolivia","Chuquisaca","Tomina","Sopachuy","UNIDAD EDUCATIVA SECCIONAL MILANES",-64.47321,-19.5312,9,0,70,79,9,3,58,67
"Bolivia","Chuquisaca","Tomina","Tomina","ESCUELA LORENZO CATALA",-64.58754,-19.05812,36,4,288,324,35,13,236,271
"Bolivia","Chuquisaca","Tomina","Tomina","ESCUELA SIMÓN RODRIGUEZ",-64.47535,-19.35414,110,10,526,636,98,36,382,480
"Bolivia","Chuquisaca","Tomina","Tomina","U.E. ANTOFAGASTA",-64.44697,-19.25202,12,10,272,284,42,15,205,247
"Bolivia","Chuquisaca","Tomina","Tomina","U. E. SECCIONAL FAUSTINO SUAREZ",-64.56383,-19.18622,73,1,256,329,11,6,238,249
"Bolivia","Chuquisaca","Tomina","Tomina","UNIDAD EDUCATIVA EDUARDO AVAROA",-64.46201,-19.18713,294,35,1314,1608,393,58,828,1221
"Bolivia","Chuquisaca","Tomina","Tomina","UNIDAD EDUCATIVA KAWASIRI",-64.41315,-19.14396,12,2,74,86,11,3,58,69
"Bolivia","Chuquisaca","Tomina","Tomina","UNIDAD EDUCATIVA SECCIONAL FUERTE RUA",-64.49466,-19.24193,26,1,211,237,3,5,202,205
"Bolivia","Chuquisaca","Tomina","Tomina","UNIDAD EDUCATIVA VILLA FLORES",-64.55251,-19.30332,9,1,101,110,11,3,86,97
"Bolivia","Chuquisaca","Tomina","Tomina","UNIDA EDUCATIVA PUCARA",-64.5126,-19.05801,14,3,149,163,24,5,117,141
"Bolivia","Chuquisaca","Tomina","Villa Alcalá","ESCUELA OSCAR ALFARO",-64.33492,-19.5059,208,3,309,517,47,16,243,290
"Bolivia","Chuquisaca","Tomina","Villa Alcalá","UNIDAD EDUCATIVA ALCALA",-64.38977,-19.36522,167,22,880,1047,283,35,540,823
"Bolivia","Chuquisaca","Yamparaez","Tarabuco","COLEGIO ANICETO ARCE",-64.91212,-19.18131,337,49,1413,1750,469,95,800,1269
"Bolivia","Chuquisaca","Yamparaez","Tarabuco","COLEGIO NACIONAL MIXTO BOLIVIA",-64.90345,-19.06883,129,8,490,619,167,25,290,457
"Bolivia","Chuquisaca","Yamparaez","Tarabuco","COLEGIO PAMPA LUPIARA",-64.78364,-19.25895,131,10,523,654,170,14,329,499
"Bolivia","Chuquisaca","Yamparaez","Tarabuco","ESCUELA ALFREDO MARTINEZ RODAS",-64.86771,-19.02727,25,2,207,232,26,7,172,198
"Bolivia","Chuquisaca","Yamparaez","Tarabuco","ESCUELA COLLACAMANI",-64.90224,-19.25274,85,8,217,302,43,6,160,203
"Bolivia","Chuquisaca","Yamparaez","Tarabuco","ESCUELA GUSTAVO VALDIVIA DE PAJCHA",-65.03048,-18.97762,113,11,380,493,73,14,282,355
"Bolivia","Chuquisaca","Yamparaez","Tarabuco","ESCUELA TUNAS CHILLCA",-64.95135,-19.17794,42,4,164,206,9,3,148,157
"Bolivia","Chuquisaca","Yamparaez","Tarabuco","U. ED. SAN ANTONIO DE TOCA",-64.93372,-19.00779,9,1,119,128,23,5,90,113
"Bolivia","Chuquisaca","Yamparaez","Tarabuco","U. EDU. JAIME VILLA ZAMORA",-64.91453,-19.05788,46,18,312,358,74,8,212,286
"Bolivia","Chuquisaca","Yamparaez","Tarabuco","U. EDU. ROSALIA VDA. DE ANTEZANA",-64.91234,-19.18218,327,57,1488,1815,435,70,926,1361
"Bolivia","Chuquisaca","Yamparaez","Tarabuco","U. EDU. SALVADOR GÓMEZ RODRIGUEZ",-64.76074,-19.27787,46,7,166,212,21,10,128,149
"Bolivia","Chuquisaca","Yamparaez","Tarabuco","U. EDU. SAN JOSÉ DEL PAREDON",-64.83658,-19.25209,80,10,318,398,39,12,257,296
"Bolivia","Chuquisaca","Yamparaez","Tarabuco","UNIDAD EDUCATIVA CAYAMBUCO",-64.86732,-19.09398,22,1,162,184,12,10,139,151
"Bolivia","Chuquisaca","Yamparaez","Tarabuco","UNIDAD EDUCATIVA EL CARMEN",-64.99706,-19.06575,34,2,194,228,14,3,175,189
"Bolivia","Chuquisaca","Yamparaez","Tarabuco","UNIDAD EDUCATIVA LA CIENEGA",-64.99545,-19.15368,112,11,323,435,57,15,240,297
"Bolivia","Chuquisaca","Yamparaez","Tarabuco","UNIDAD EDUCATIVA SARUFAYA",-64.80127,-19.1101,56,10,254,310,32,5,207,239
"Bolivia","Chuquisaca","Yamparaez","Yamparez","COLEGIO ANA LEON DE HUASA CANCHA",-65.04116,-19.17783,72,3,319,391,45,15,256,301
"Bolivia","Chuquisaca","Yamparaez","Yamparez","COLEGIO GERARDO RIOS",-65.07349,-19.25555,77,9,360,437,89,12,250,339
"Bolivia","Chuquisaca","Yamparaez","Yamparez","ESCUELA EDUARDO SEMPERTEGUI",-65.11996,-19.18805,228,38,895,1123,329,58,470,799
"Bolivia","Chuquisaca","Yamparaez","Yamparez","ESCUELA JATUN CKAKA",-65.00366,-19.28829,39,7,213,252,8,4,194,202
"Bolivia","Chuquisaca","Yamparaez","Yamparez","U.E. PATA LLAJTA",-65.07769,-19.11113,4,2,103,107,13,4,84,97
"Bolivia","Chuquisaca","Yamparaez","Yamparez","UNIDAD EDUCATIVA CARAMA",-65.05508,-19.33958,17,1,147,164,10,4,132,142
"Bolivia","Chuquisaca","Yamparaez","Yamparez","UNIDAD EDUCATIVA PULKI AVAROA",-65.12865,-19.24094,124,16,473,597,92,20,345,437
"Bolivia","Chuquisaca","Yamparaez","Yamparez","UNIDAD EDUCATIVA SAJPAYA",-65.12679,-19.15392,21,10,372,393,32,21,309,341
"Bolivia","Chuquisaca","Yamparaez","Yamparez","UNIDAD EDUCATIVA SOTOMAYOR",-64.99535,-19.3425,106,5,620,726,146,21,448,594
"Bolivia","Chuquisaca","Zudáñez","Icla (Ricardo Mujia)","COLEGIO ANTONIO JOSÉ DE SUCRE",-64.79297,-19.36361,153,14,586,739,155,23,394,549
"Bolivia","Chuquisaca","Zudáñez","Icla (Ricardo Mujia)","COLEGIO ELIZARDO PEREZ",-64.78985,-19.29836,93,11,380,473,121,13,235,356
"Bolivia","Chuquisaca","Zudáñez","Icla (Ricardo Mujia)","COLEGIO ROSENDO LA FUENTE",-64.8336,-19.44706,192,0,66,258,10,0,56,66
"Bolivia","Chuquisaca","Zudáñez","Icla (Ricardo Mujia)","ESCUELA CANTAR GALLO",-64.69359,-19.51735,37,3,125,162,20,2,100,120
"Bolivia","Chuquisaca","Zudáñez","Icla (Ricardo Mujia)","ESCUELA JATUN MAYU",-64.72372,-19.40604,27,3,213,240,30,1,179,209
"Bolivia","Chuquisaca","Zudáñez","Icla (Ricardo Mujia)","ESCUELA RODEO",-64.73968,-19.44641,18,0,198,216,10,1,187,197
"Bolivia","Chuquisaca","Zudáñez","Icla (Ricardo Mujia)","ESCUELA SAN JACINTO",-64.7461,-19.32193,31,2,331,362,45,6,278,323
"Bolivia","Chuquisaca","Zudáñez","Icla (Ricardo Mujia)","ESCUELA SANTA LUCIA",-64.72717,-19.56465,27,0,69,96,11,0,58,69
"Bolivia","Chuquisaca","Zudáñez","Icla (Ricardo Mujia)","ESCUELA SUMALA",-64.78291,-19.63519,33,1,93,126,8,1,83,91
"Bolivia","Chuquisaca","Zudáñez","Icla (Ricardo Mujia)","ESCUELA THACO PAMPA",-64.7289,-19.38551,37,2,253,290,19,5,227,246
"Bolivia","Chuquisaca","Zudáñez","Icla (Ricardo Mujia)","U. EDU. SECCIONAL CHUNCA CANCHA BAJA",-64.69682,-19.58073,70,7,299,369,23,10,259,282
"Bolivia","Chuquisaca","Zudáñez","Icla (Ricardo Mujia)","UNIDAD EDUCATIVA SOROMA",-64.82072,-19.50851,18,0,140,158,3,2,135,138
"Bolivia","Chuquisaca","Zudáñez","Presto","ESCUELA ELISARDO PEREZ",-64.94286,-18.77106,85,13,304,389,88,13,190,278
"Bolivia","Chuquisaca","Zudáñez","Presto","ESCUELA JOSÉ MARÍA MARTÍNEZ",-64.87681,-18.74306,220,10,560,780,110,50,390,500
"Bolivia","Chuquisaca","Zudáñez","Presto","PUESTO DE SALUD PUNO KHASA",-64.80189,-18.89501,37,4,146,183,51,7,84,135
"Bolivia","Chuquisaca","Zudáñez","Presto","UNIDAD EDUCATIVA EL PALMAR",-64.9127,-18.6944,10,5,137,147,14,17,101,115
"Bolivia","Chuquisaca","Zudáñez","Presto","UNIDAD EDUCATIVA RICARDO MUJIA",-64.93723,-18.92988,316,35,1108,1424,340,52,681,1021
"Bolivia","Chuquisaca","Zudáñez","Presto","UNIDAD EDUCATIVA TOMOROCO",-64.88657,-18.97326,95,15,351,446,121,15,200,321
"Bolivia","Chuquisaca","Zudáñez","Villa Mojocoya","COLEGIO FRANZ TAMAYO",-64.61874,-18.83001,397,40,1850,2247,610,54,1146,1756
"Bolivia","Chuquisaca","Zudáñez","Villa Mojocoya","ESCUELA GUADALUPE",-64.56116,-18.9363,46,5,238,284,49,5,179,228
"Bolivia","Chuquisaca","Zudáñez","Villa Mojocoya","ESCUELA HILARION VIDES CHOQUE",-64.73502,-18.61781,39,4,237,276,26,2,205,231
"Bolivia","Chuquisaca","Zudáñez","Villa Mojocoya","ESCUELA JAIME MENDOZA",-64.51095,-18.87217,28,2,116,144,25,2,87,112
"Bolivia","Chuquisaca","Zudáñez","Villa Mojocoya","ESCUELA JORGE ANIBARRO ZAPATA",-64.62067,-18.91616,18,4,116,134,21,3,88,109
"Bolivia","Chuquisaca","Zudáñez","Villa Mojocoya","UNIDAD EDUCATIVA EDUARDO AVAROA",-64.61971,-18.76382,59,3,195,254,76,8,108,184
"Bolivia","Chuquisaca","Zudáñez","Villa Zudañez (Tacopaya)","COL. IGNACIO PRUDENCIO BUSTILLOS",-64.70309,-19.11358,254,40,1389,1643,280,46,1023,1303
"Bolivia","Chuquisaca","Zudáñez","Villa Zudañez (Tacopaya)","COL. JAIME DE ZUDAÑEZ",-64.70162,-19.11868,183,21,944,1127,244,41,638,882
"Bolivia","Chuquisaca","Zudáñez","Villa Zudañez (Tacopaya)","ESCUELA MANDINGA",-64.69581,-19.25081,25,4,142,167,11,9,118,129
"Bolivia","Chuquisaca","Zudáñez","Villa Zudañez (Tacopaya)","ESCUELA SAYAN CHACA",-64.63419,-19.24422,41,5,224,265,18,8,193,211
"Bolivia","Chuquisaca","Zudáñez","Villa Zudañez (Tacopaya)","UNIDAD EDUCATIVA CAPILLA LLAVE",-64.70795,-18.98042,36,0,69,105,1,1,67,68
"Bolivia","Chuquisaca","Zudáñez","Villa Zudañez (Tacopaya)","UNIDAD EDUCATIVA HUACA HUASI",-64.78075,-18.98111,14,2,141,155,14,1,124,138
"Bolivia","Cochabamba","Arani","Arani","ESCUELA GUALBERTO VILLARROEL",-65.77542,-17.57345,361,59,2584,2945,907,108,1510,2417
"Bolivia","Cochabamba","Arani","Arani","ESCUELA MIXTA POCOATA",-65.72654,-17.60998,82,16,385,467,86,21,262,348
"Bolivia","Cochabamba","Arani","Arani","LICEO DE SEÑORITAS ARANI",-65.77344,-17.57311,374,52,2410,2784,1009,80,1269,2278
"Bolivia","Cochabamba","Arani","Arani","UNIDAD EDUCATIVA COLLPACIACO",-65.76109,-17.60128,103,18,505,608,116,26,345,461
"Bolivia","Cochabamba","Arani","Vacas","ESCUELA EXPERIMENTAL VACAS",-65.58172,-17.57544,371,73,2590,2961,349,95,2073,2422
"Bolivia","Cochabamba","Arani","Vacas","ESCUELA SECCIONAL RODEO A",-65.63733,-17.6298,111,68,926,1037,90,26,742,832
"Bolivia","Cochabamba","Arani","Vacas","U.E. DAVID MORATO CAÑADAS",-65.64141,-17.53415,30,26,517,547,56,21,414,470
"Bolivia","Cochabamba","Arani","Vacas","UNIDAD EDUCATIVA TOTORAPAMPA",-65.55066,-17.67862,16,5,210,226,14,1,190,204
"Bolivia","Cochabamba","Arque","Arque","ESCUELA E INTERNADO DARIO ANTEZANA V.",-66.29219,-17.94894,98,1,548,646,7,22,518,525
"Bolivia","Cochabamba","Arque","Arque","ESCUELA JUANA AZURDUY - PONGO K'ASA",-66.55169,-17.71174,84,21,375,459,45,25,284,329
"Bolivia","Cochabamba","Arque","Arque","ESCUELA MARCELO QUIROGA SANTA CRUZ",-66.39861,-17.90448,172,11,638,810,65,54,508,573
"Bolivia","Cochabamba","Arque","Arque","ESCUELA NATANIEL AGUIRRE",-66.40426,-17.8204,145,24,746,891,82,32,608,690
"Bolivia","Cochabamba","Arque","Arque","U.E. SAN PEDRO",-66.41895,-17.85651,54,11,193,247,14,3,165,179
"Bolivia","Cochabamba","Arque","Arque","UNIDAD EDUCATIVA CHANGOLLA",-66.46826,-17.77408,26,4,298,324,11,6,277,288
"Bolivia","Cochabamba","Arque","Arque","UNIDAD EDUCATIVA HUAYCHA",-66.32418,-17.89401,24,2,321,345,9,12,298,307
"Bolivia","Cochabamba","Arque","Arque","UNIDAD ESCOLAR TUPAC KATARI - TARUJAYÑA",-66.47985,-17.69246,32,7,445,477,38,13,387,425
"Bolivia","Cochabamba","Arque","Tacopaya","ESCUELA ADOLFO MERCADO",-66.53604,-17.83581,114,22,1030,1144,120,40,848,968
"Bolivia","Cochabamba","Arque","Tacopaya","ESCUELA ELIZARDO PEREZ (TOTORAPAMPA)",-66.61689,-17.88263,66,11,713,779,67,50,585,652
"Bolivia","Cochabamba","Arque","Tacopaya","ESCUELA MARTIN CARDENAS (TUJUTA)",-66.73995,-17.71179,55,3,277,332,25,11,238,263
"Bolivia","Cochabamba","Arque","Tacopaya","ESCUELA SECCIONAL RENE BARRIENTOS",-66.67029,-17.79752,95,15,473,568,61,29,368,429
"Bolivia","Cochabamba","Arque","Tacopaya","ESCUELA VICENTE DONOSO (AGUAS CALIENTES)",-66.6131,-17.82217,35,5,327,362,29,11,282,311
"Bolivia","Cochabamba","Arque","Tacopaya","UNIDAD EDUCATIVA ANICETO ARCE",-66.5975,-17.76939,68,4,290,358,29,21,236,265
"Bolivia","Cochabamba","Arque","Tacopaya","UNIDAD EDUCATIVA AUQUIPAMPA",-66.53737,-17.78284,48,1,523,571,33,17,472,505
"Bolivia","Cochabamba","Arque","Tacopaya","UNIDAD EDUCATIVA MICHAYANI GRANDE",-66.70185,-17.86216,47,0,225,272,12,12,201,213
"Bolivia","Cochabamba","Ayopaya","Ayopaya (Villa de Independencia)","COLEGIO CHAMACOMA",-66.70333,-17.40771,95,6,474,569,67,24,377,444
"Bolivia","Cochabamba","Ayopaya","Ayopaya (Villa de Independencia)","COLEGIO SIMON BOLIVAR FE Y ALEGRIA",-66.81453,-17.38495,230,39,2038,2268,502,89,1408,1910
"Bolivia","Cochabamba","Ayopaya","Ayopaya (Villa de Independencia)","ESCUELA MARIANO BAPTISTA (CALCHANI)",-66.69013,-17.32464,101,19,641,742,33,51,538,571
"Bolivia","Cochabamba","Ayopaya","Ayopaya (Villa de Independencia)","U.E. JOSE MIGUEL LANZA",-66.82125,-17.08193,508,67,2313,2821,498,138,1610,2108
"Bolivia","Cochabamba","Ayopaya","Ayopaya (Villa de Independencia)","UNIDAD EDUCATIVA CHAPISUYO A",-66.62987,-17.35943,100,13,619,719,42,24,540,582
"Bolivia","Cochabamba","Ayopaya","Ayopaya (Villa de Independencia)","UNIDAD EDUCATIVA CHARAHUAYTU",-66.79765,-17.26413,161,45,1018,1179,167,52,754,921
"Bolivia","Cochabamba","Ayopaya","Ayopaya (Villa de Independencia)","UNIDAD EDUCATIVA MACHACA",-66.86737,-17.12325,42,5,225,267,34,9,177,211
"Bolivia","Cochabamba","Ayopaya","Ayopaya (Villa de Independencia)","UNIDAD EDUCATIVA POCANCHE",-66.83318,-16.93553,70,7,399,469,17,24,351,368
"Bolivia","Cochabamba","Ayopaya","Ayopaya (Villa de Independencia)","UNIDAD EDUCATIVA SABINO WALLKU",-66.73064,-17.11669,54,13,393,447,34,14,332,366
"Bolivia","Cochabamba","Ayopaya","Ayopaya (Villa de Independencia)","UNIDAD EDUCATIVA SISI PALERMO",-66.83698,-17.20461,42,5,335,377,34,50,246,280
"Bolivia","Cochabamba","Ayopaya","Ayopaya (Villa de Independencia)","UNIDAD EDUCATIVA TAPAZA",-66.74503,-17.17871,11,3,136,147,15,4,114,129
"Bolivia","Cochabamba","Ayopaya","Ayopaya (Villa de Independencia)","UNIDAD EDUCATIVA VILLA PUCARA",-66.96396,-16.99085,123,27,507,630,74,20,386,460
"Bolivia","Cochabamba","Ayopaya","Cocapata","COLEGIO SECUNDARIO COCAPATA",-66.67577,-16.79244,71,10,258,329,53,19,176,229
"Bolivia","Cochabamba","Ayopaya","Cocapata","ESCUELA 15 DE FEBRERO (EL CHORO)",-66.65108,-16.79413,109,3,605,714,134,23,445,579
"Bolivia","Cochabamba","Ayopaya","Cocapata","ESCUELA CHOQUECAMATA (FALSURI)",-66.63028,-16.83837,27,7,611,638,217,32,355,572
"Bolivia","Cochabamba","Ayopaya","Cocapata","ESCUELA OSCAR ALFARO - VILLA VINTO",-66.46751,-16.84676,189,7,873,1062,170,58,638,808
"Bolivia","Cochabamba","Ayopaya","Cocapata","ESCUELA PEDRO DOMINGO MURILLO -CALIENTES",-66.55274,-17.01225,91,8,471,562,80,30,353,433
"Bolivia","Cochabamba","Ayopaya","Cocapata","ESCUELA SECCIONAL MACHACAYMA",-66.40887,-16.89995,117,6,674,791,112,63,493,605
"Bolivia","Cochabamba","Ayopaya","Cocapata","NUCLEO ESCOLAR PEDRO LAIME CHUSPI",-66.66877,-16.86044,64,0,237,301,47,25,165,212
"Bolivia","Cochabamba","Ayopaya","Cocapata","NUCLEO GERMAN BUSCH (CHILLAVI)",-66.59884,-16.8523,21,5,166,187,31,7,123,154
"Bolivia","Cochabamba","Ayopaya","Cocapata","SEDE SUB - CENTRAL VISCACHAS",-66.45755,-17.10735,26,2,33,59,11,0,20,31
"Bolivia","Cochabamba","Ayopaya","Cocapata","UNIDAD EDUCATIVA CHIARAJE",-66.38669,-17.05231,16,2,225,241,41,18,164,205
"Bolivia","Cochabamba","Ayopaya","Cocapata","UNIDAD EDUCATIVA COLORADO",-66.87921,-15.88327,37,2,197,234,33,4,158,191
"Bolivia","Cochabamba","Ayopaya","Cocapata","UNIDAD EDUCATIVA EL CHORITO",-66.60498,-16.94332,18,3,208,226,58,9,138,196
"Bolivia","Cochabamba","Ayopaya","Cocapata","UNIDAD EDUCATIVA ICARI",-66.3419,-17.02058,52,2,313,365,77,10,224,301
"Bolivia","Cochabamba","Ayopaya","Cocapata","UNIDAD EDUCATIVA MARAVILLAS",-66.71464,-16.60081,67,9,366,433,43,17,297,340
"Bolivia","Cochabamba","Ayopaya","Cocapata","UNIDAD EDUCATIVA TOTORANI",-66.39165,-17.01361,45,2,349,394,38,3,306,344
"Bolivia","Cochabamba","Ayopaya","Cocapata","UNIDAD EDUCATIVA TUNARI (PUCARITA)",-66.73937,-16.93249,98,10,460,558,27,18,405,432
"Bolivia","Cochabamba","Ayopaya","Morochata","COLEGIO RENE BARRIENTOS ORTUÑO -PIUSILLA",-66.49365,-17.23084,91,18,575,666,121,24,412,533
"Bolivia","Cochabamba","Ayopaya","Morochata","ESCUELA 26 DE MAYO - CHAUPISUYO B",-66.55013,-17.30591,84,11,723,807,116,46,550,666
"Bolivia","Cochabamba","Ayopaya","Morochata","ESCUELA GILDARO ANTEZANA ROJAS",-66.60968,-17.18441,130,37,893,1023,88,47,721,809
"Bolivia","Cochabamba","Ayopaya","Morochata","ESCUELA HILARION GRAGEDA - YAYANI",-66.65623,-17.21181,121,30,707,828,118,53,506,624
"Bolivia","Cochabamba","Ayopaya","Morochata","ESCUELA JULIO ESPINOZA CANELAS-PUNACACHI",-66.61133,-17.25125,134,46,714,848,112,59,497,609
"Bolivia","Cochabamba","Ayopaya","Morochata","ESCUELA MARIANO BAPTISTA- MOROCHATA",-66.53392,-17.23173,151,27,1561,1712,177,94,1263,1440
"Bolivia","Cochabamba","Ayopaya","Morochata","UNIDAD EDUCATIVA HUMAMARCA",-66.5562,-17.10199,16,8,235,251,31,14,182,213
"Bolivia","Cochabamba","Ayopaya","Morochata","UNIDAD EDUCATIVA IGLESIANI",-66.50184,-17.31038,17,0,175,192,39,2,134,173
"Bolivia","Cochabamba","Ayopaya","Morochata","UNIDAD EDUCATIVA PUCARANI GRANDE",-66.66244,-17.08579,29,0,118,147,7,3,108,115
"Bolivia","Cochabamba","Bolívar","Bolívar","ESCUELA COYUMA",-66.74062,-18.08522,23,3,86,109,31,7,45,76
"Bolivia","Cochabamba","Bolívar","Bolívar","ESCUELA JORENKO VILLA VERDE",-66.66763,-17.98483,8,5,404,412,79,16,304,383
"Bolivia","Cochabamba","Bolívar","Bolívar","ESCUELA MEJILLONES",-66.68706,-18.08409,92,3,352,444,71,18,260,331
"Bolivia","Cochabamba","Bolívar","Bolívar","ESCUELA SAN JUAN DE LA COMUNA",-66.46785,-17.9682,29,4,137,166,25,9,99,124
"Bolivia","Cochabamba","Bolívar","Bolívar","ESCUELA SIMON BOLIVAR",-66.53779,-17.9682,147,14,641,788,161,35,431,592
"Bolivia","Cochabamba","Bolívar","Bolívar","ESCUELA TANGALIQUE",-66.5484,-18.02263,22,3,224,246,43,9,169,212
"Bolivia","Cochabamba","Bolívar","Bolívar","ESCUELA VILACAYMA",-66.57627,-17.96971,24,14,308,332,76,15,203,279
"Bolivia","Cochabamba","Bolívar","Bolívar","ESCUELA YARVICOYA",-66.51677,-18.01299,65,5,260,325,14,6,235,249
"Bolivia","Cochabamba","Bolívar","Bolívar","NUCLEO ESCOLAR CARPANI",-66.61453,-17.93365,20,3,467,487,68,20,376,444
"Bolivia","Cochabamba","Bolívar","Bolívar","UNIDAD EDUCATIVA CHALLOMA",-66.54604,-17.89978,24,3,185,209,46,13,123,169
"Bolivia","Cochabamba","Bolívar","Bolívar","UNIDAD EDUCATIVA VILAPAMPA",-66.69617,-18.049,4,0,198,202,54,9,135,189
"Bolivia","Cochabamba","Campero","Aiquile","ESCUELA 20 DE DICIEMBRE",-65.17914,-18.20377,436,56,2234,2670,970,111,1097,2067
"Bolivia","Cochabamba","Campero","Aiquile","ESCUELA MANUEL DE UGARTE",-65.18247,-18.20012,405,33,2026,2431,849,62,1082,1931
"Bolivia","Cochabamba","Campero","Aiquile","ESCUELA SIMON RODRIGUEZ",-65.18458,-18.20073,417,54,2337,2754,972,87,1224,2196
"Bolivia","Cochabamba","Campero","Aiquile","NUCLEO EDUCATIVO TIPAJARA",-65.27975,-18.13377,30,6,274,304,45,8,215,260
"Bolivia","Cochabamba","Campero","Aiquile","NUCLEO ESCOLAR EL CERCADO",-65.17767,-18.10226,78,13,326,404,36,8,269,305
"Bolivia","Cochabamba","Campero","Aiquile","NUCLEO ESCOLAR VILLA GRANADO",-65.03775,-18.20921,175,22,907,1082,143,32,710,853
"Bolivia","Cochabamba","Campero","Aiquile","UNIDAD EDUCATIVA CHAQUI MAYU",-65.28205,-18.26553,20,4,158,178,9,4,141,150
"Bolivia","Cochabamba","Campero","Aiquile","UNIDAD EDUCATIVA EJE PAMPA",-65.1711,-18.5389,52,11,284,336,31,17,225,256
"Bolivia","Cochabamba","Campero","Aiquile","UNIDAD EDUCATIVA ESTANZUELA",-64.8748,-18.33058,54,2,228,282,21,4,201,222
"Bolivia","Cochabamba","Campero","Aiquile","UNIDAD EDUCATIVA KEWIÑAL",-65.3177,-18.37376,27,11,188,215,50,15,112,162
"Bolivia","Cochabamba","Campero","Aiquile","UNIDAD EDUCATIVA LAGARPAMPA",-64.98984,-18.45282,71,3,214,285,13,4,194,207
"Bolivia","Cochabamba","Campero","Aiquile","UNIDAD EDUCATIVA LAIME",-65.09598,-18.45015,23,5,175,198,8,9,153,161
"Bolivia","Cochabamba","Campero","Aiquile","UNIDAD EDUCATIVA NOVILLERO",-65.23428,-18.30105,103,11,532,635,130,20,371,501
"Bolivia","Cochabamba","Campero","Aiquile","UNIDAD EDUCATIVA PANAMA",-65.10865,-18.30899,36,3,256,292,44,5,204,248
"Bolivia","Cochabamba","Campero","Aiquile","UNIDAD EDUCATIVA QUIROGA",-65.21684,-18.42329,165,24,849,1014,106,33,686,792
"Bolivia","Cochabamba","Campero","Omereque","ESCUELA CENTRAL PEÑA COLORADA",-64.87029,-18.17198,52,5,342,394,63,13,261,324
"Bolivia","Cochabamba","Campero","Omereque","ESCUELA SECCIONAL CHARI CHARI",-65.01819,-18.02485,12,3,67,79,23,5,36,59
"Bolivia","Cochabamba","Campero","Omereque","ESCUELA SECCIONAL PEREZ",-64.76694,-18.11378,21,2,167,188,32,6,127,159
"Bolivia","Cochabamba","Campero","Omereque","UNIDAD EDUCATIVA HUANACUNI GRANDE",-64.98838,-17.92877,22,2,162,184,22,2,136,158
"Bolivia","Cochabamba","Campero","Omereque","UNIDAD EDUCATIVA OMEREQUE",-64.90799,-18.1062,303,37,1547,1850,467,34,1009,1476
"Bolivia","Cochabamba","Campero","Omereque","UNIDAD EDUCATIVA PERERETA",-64.82058,-18.1318,28,5,178,206,42,9,122,164
"Bolivia","Cochabamba","Campero","Pasorapa","COLEGIO TTE.CNEL. NATANIEL VERDUGUEZ",-64.67598,-18.31635,181,11,748,929,404,26,307,711
"Bolivia","Cochabamba","Campero","Pasorapa","ESCUELA CENTRAL QUINORI",-64.39658,-18.50312,63,1,228,291,35,4,188,223
"Bolivia","Cochabamba","Campero","Pasorapa","SEDE SINDICAL YAJO PAMPA",-64.55951,-18.13656,2,0,37,39,14,0,23,37
"Bolivia","Cochabamba","Campero","Pasorapa","U.E. REDONDO",-64.31445,-18.50069,3,2,69,72,8,4,55,63
"Bolivia","Cochabamba","Campero","Pasorapa","UNIDAD EDUCATIVA PAMPAS",-64.51284,-18.40247,11,0,112,123,21,0,91,112
"Bolivia","Cochabamba","Campero","Pasorapa","UNIDAD EDUCATIVA SEIBAS",-64.57413,-18.49377,36,5,141,177,24,2,110,134
"Bolivia","Cochabamba","Capinota","Capinota","ESCUELA APILLAPAMPA",-66.2554,-17.8624,55,16,662,717,38,24,584,622
"Bolivia","Cochabamba","Capinota","Capinota","ESCUELA CENTRAL MARCAVI",-66.19489,-17.68572,38,14,320,358,20,10,276,296
"Bolivia","Cochabamba","Capinota","Capinota","ESCUELA VICTOR BARRIENTOS",-66.26445,-17.71407,716,109,4531,5247,1681,208,2533,4214
"Bolivia","Cochabamba","Capinota","Capinota","NUCLEO CENTRAL HORNOMA",-66.20175,-17.88647,38,19,363,401,9,8,327,336
"Bolivia","Cochabamba","Capinota","Capinota","UNIDAD EDUCATIVA CUSTODIO AYAVIRI",-66.28507,-17.72167,346,52,2853,3199,1223,93,1485,2708
"Bolivia","Cochabamba","Capinota","Capinota","UNIDAD EDUCATIVA GUSTAVO GARCIA (CHARAMO",-66.29135,-17.61348,91,23,719,810,229,29,438,667
"Bolivia","Cochabamba","Capinota","Capinota","UNIDAD EDUCATIVA JUANA AZURDUY DE PADILLA",-66.26445,-17.71408,103,5,421,524,116,18,282,398
"Bolivia","Cochabamba","Capinota","Capinota","UNIDAD EDUCATIVA TOCOHALLA",-66.13054,-17.86209,20,0,81,101,1,4,76,77
"Bolivia","Cochabamba","Capinota","Capinota","UNIDAD EDUCATIVA YATAMOCO",-66.27116,-17.73293,40,5,475,515,122,13,335,457
"Bolivia","Cochabamba","Capinota","Santivañez","DOMICILIO PARTICULAR",-66.26903,-17.55104,24,4,189,213,44,6,135,179
"Bolivia","Cochabamba","Capinota","Santivañez","ESCUELA PRUDENCIO ARAUCO (SANTIVAÑEZ)",-66.24799,-17.54894,249,24,1618,1867,434,45,1115,1549
"Bolivia","Cochabamba","Capinota","Santivañez","SUB CENTRAL ENRIQUE ENCINAS (EX CALERA)",-66.21689,-17.57849,73,5,509,582,61,13,430,491
"Bolivia","Cochabamba","Capinota","Santivañez","U. E. CASTOR ZAMBRANA HUAYÑACOTA",-66.20436,-17.53515,75,4,419,494,65,6,344,409
"Bolivia","Cochabamba","Capinota","Santivañez","UNIDAD EDUCATIVA CAPORAYA",-66.2821,-17.50345,31,9,247,278,25,5,208,233
"Bolivia","Cochabamba","Capinota","Santivañez","UNIDAD EDUCATIVA JOSE RIVERA",-66.26288,-17.61516,34,2,183,217,54,4,123,177
"Bolivia","Cochabamba","Capinota","Santivañez","UNIDAD EDUCATIVA PAMPA CHURIHUA",-66.14667,-17.61767,18,4,141,159,5,4,128,133
"Bolivia","Cochabamba","Capinota","Santivañez","UNIDAD EDUCATIVA ROCHA RANCHO",-66.18881,-17.54504,83,9,460,543,74,15,362,436
"Bolivia","Cochabamba","Capinota","Sicaya","ESCUELA GERMAN BUSCH",-66.35415,-17.74645,74,23,535,609,81,25,406,487
"Bolivia","Cochabamba","Capinota","Sicaya","NUCLEO HUMANISTICO SICAYA",-66.33362,-17.80072,110,24,817,927,69,42,682,751
"Bolivia","Cochabamba","Carrasco","Chimoré","ESCUELA GERÓNIMO UZEDA FE Y ALEGRIA",-65.15494,-16.99398,1485,117,7075,8560,1647,222,5089,6736
"Bolivia","Cochabamba","Carrasco","Chimoré","ESCUELA LA MISION",-65.14838,-16.71407,39,3,348,387,98,9,238,336
"Bolivia","Cochabamba","Carrasco","Chimoré","NUCLEO EDUCATIVO ENTRE RIOS TACUARAL",-65.20777,-17.08086,60,2,570,630,43,7,518,561
"Bolivia","Cochabamba","Carrasco","Chimoré","NUCLEO ESCOLAR PUERTO AURORA",-65.18625,-16.8472,62,18,475,537,56,11,390,446
"Bolivia","Cochabamba","Carrasco","Chimoré","UNIDAD EDUCATIVA CESAR ZAMA (CHIMORE)",-65.07787,-16.99658,162,21,1626,1788,154,32,1419,1573
"Bolivia","Cochabamba","Carrasco","Chimoré","UNIDAD EDUCATIVA EL CARMEN",-64.90653,-16.16878,32,1,98,130,23,5,69,92
"Bolivia","Cochabamba","Carrasco","Chimoré","UNIDAD EDUCATIVA PUERTO LAS FLORES",-64.67742,-16.40432,12,3,65,77,24,3,35,59
"Bolivia","Cochabamba","Carrasco","Chimoré","UNIDAD EDUCATIVA SAN ANDRÉS",-65.10363,-17.0901,59,5,543,602,25,12,501,526
"Bolivia","Cochabamba","Carrasco","Chimoré","UNIDAD EDUCATIVA SANTA ANITA",-64.82532,-16.11419,42,2,89,131,19,5,63,82
"Bolivia","Cochabamba","Carrasco","Chimoré","UNIDAD EDUCATIVA SANTA ISABEL",-64.72911,-16.50484,19,1,51,70,13,1,36,49
"Bolivia","Cochabamba","Carrasco","Chimoré","UNIDAD EDUCATIVA TRES ISLAS",-64.8566,-16.75232,30,5,170,200,27,3,135,162
"Bolivia","Cochabamba","Carrasco","Chimoré","UNIDAD EDUCATIVA TRINIDADCITO",-64.94166,-16.44957,8,0,61,69,31,0,30,61
"Bolivia","Cochabamba","Carrasco","Entre Ríos (Bulo Bulo)","COLEGIO FRANZ TAMAYO",-64.53572,-17.1993,1086,104,7861,8947,1358,224,6175,7533
"Bolivia","Cochabamba","Carrasco","Entre Ríos (Bulo Bulo)","COLEGIO NACIONAL SAN MARCOS",-64.35905,-17.25389,390,53,3533,3923,441,72,2967,3408
"Bolivia","Cochabamba","Carrasco","Entre Ríos (Bulo Bulo)","ESCUELA EDUARDO AVAROA (ISARZAMA)",-64.68122,-17.13931,202,12,2085,2287,130,27,1916,2046
"Bolivia","Cochabamba","Carrasco","Entre Ríos (Bulo Bulo)","U.E. ESTEBAN ARCE",-64.61887,-17.26742,9,4,254,263,7,8,235,242
"Bolivia","Cochabamba","Carrasco","Entre Ríos (Bulo Bulo)","U. E. JOSÉ CARRASCO (MANCO KAPAC)",-64.56224,-17.18527,270,33,2874,3144,243,48,2550,2793
"Bolivia","Cochabamba","Carrasco","Entre Ríos (Bulo Bulo)","U.E. NACIONAL AYACUCHO",-64.54228,-17.20041,7,0,66,73,10,0,56,66
"Bolivia","Cochabamba","Carrasco","Entre Ríos (Bulo Bulo)","UNIDAD EDUCATIVA RIO BLANCO",-64.45576,-17.22547,260,18,1278,1538,170,42,1048,1218
"Bolivia","Cochabamba","Carrasco","Pocona","CENTRO DE ATENCION AL TURISTA",-65.40996,-17.6073,12,5,369,381,34,9,321,355
"Bolivia","Cochabamba","Carrasco","Pocona","ESCUELA LADISLAO CABRERA",-65.34206,-17.66848,68,11,418,486,61,12,334,395
"Bolivia","Cochabamba","Carrasco","Pocona","NUCLEO ESCOLAR ISMAEL MONTES",-65.38327,-17.72318,80,14,821,901,104,26,677,781
"Bolivia","Cochabamba","Carrasco","Pocona","UNIDAD EDUCATIVA 6 DE AGOSTO",-65.37962,-17.52965,165,22,936,1101,139,44,731,870
"Bolivia","Cochabamba","Carrasco","Pocona","UNIDAD EDUCATIVA CHIMBOATA",-65.28564,-17.66047,24,3,402,426,46,12,341,387
"Bolivia","Cochabamba","Carrasco","Pocona","UNIDAD EDUCATIVA HUAYAPACHA",-65.40794,-17.55243,85,30,837,922,98,35,674,772
"Bolivia","Cochabamba","Carrasco","Pocona","UNIDAD EDUCATIVA JAVIER GONZALES",-65.50449,-17.61416,3,0,61,64,1,1,59,60
"Bolivia","Cochabamba","Carrasco","Pocona","UNIDAD EDUCATIVA LA TRANCA",-65.45638,-17.73257,10,4,109,119,8,0,97,105
"Bolivia","Cochabamba","Carrasco","Pocona","UNIDAD EDUCATIVA MONTE PUNCU",-65.30296,-17.58503,55,13,394,449,46,17,318,364
"Bolivia","Cochabamba","Carrasco","Pocona","UNIDAD EDUCATIVA POCONA",-65.41882,-17.67324,106,18,389,495,72,18,281,353
"Bolivia","Cochabamba","Carrasco","Pojo","COLEGIO VENANCIO LOSS",-64.86312,-17.75708,225,31,1448,1673,246,38,1133,1379
"Bolivia","Cochabamba","Carrasco","Pojo","NUCLEO ESCOLAR DURAZNILLO",-65.01938,-17.78679,39,3,142,181,14,2,123,137
"Bolivia","Cochabamba","Carrasco","Pojo","UNIDAD EDUCATIVA CHALLHUANI",-64.89679,-17.84557,73,0,648,721,13,34,601,614
"Bolivia","Cochabamba","Carrasco","Pojo","UNIDAD EDUCATIVA DIAN PAMPA",-64.70919,-17.71177,31,3,322,353,26,12,281,307
"Bolivia","Cochabamba","Carrasco","Pojo","UNIDAD EDUCATIVA JAIME LAREDO",-64.98014,-17.84581,5,1,104,109,5,3,95,100
"Bolivia","Cochabamba","Carrasco","Pojo","UNIDAD EDUCATIVA KARA HUASI - POJO",-64.74367,-17.73957,23,2,246,269,20,10,214,234
"Bolivia","Cochabamba","Carrasco","Pojo","UNIDAD EDUCATIVA LA HABANA",-64.92303,-17.7378,29,2,289,318,17,2,268,285
"Bolivia","Cochabamba","Carrasco","Pojo","UNIDAD EDUCATIVA PALCA C",-64.97747,-17.70329,20,2,511,531,17,4,488,505
"Bolivia","Cochabamba","Carrasco","Pojo","UNIDAD EDUCATIVA RODEO C",-64.78306,-17.83571,52,1,341,393,4,24,312,316
"Bolivia","Cochabamba","Carrasco","Pojo","UNIDAD EDUCATIVA THAGO LAGUNA",-64.86137,-17.95306,0,0,61,61,0,4,57,57
"Bolivia","Cochabamba","Carrasco","Pojo","UNIDAD EDUCATIVA YUTHUPAMPA",-64.99229,-17.74813,59,7,532,591,25,11,489,514
"Bolivia","Cochabamba","Carrasco","Puerto Villarroel","COLEGIO EDUARDO AVAROA (P.VILLARROEL)",-64.79533,-16.83211,297,17,1057,1354,336,18,686,1022
"Bolivia","Cochabamba","Carrasco","Puerto Villarroel","COLEGIO JUAN PABLO II (SACTA)",-64.76898,-17.11968,408,40,3634,4042,344,74,3176,3520
"Bolivia","Cochabamba","Carrasco","Puerto Villarroel","COLEGIO LIBERTAD",-64.84208,-17.07051,75,6,849,924,64,17,762,826
"Bolivia","Cochabamba","Carrasco","Puerto Villarroel","COLEGIO MARCELO QUIROGA SANTA CRUZ",-65.04104,-17.0115,245,17,2028,2273,215,41,1755,1970
"Bolivia","Cochabamba","Carrasco","Puerto Villarroel","ESCUELA AYOPAYA (P.VILLAROEL)",-65.00072,-16.90683,77,8,900,977,49,15,828,877
"Bolivia","Cochabamba","Carrasco","Puerto Villarroel","ESCUELA BUENAS NUEVAS (VALLE IVIRZA)",-64.91539,-17.11546,182,23,1235,1417,134,22,1056,1190
"Bolivia","Cochabamba","Carrasco","Puerto Villarroel","ESCUELA CENTRAL VILLA NUEVA",-65.00124,-17.11282,71,6,722,793,40,9,667,707
"Bolivia","Cochabamba","Carrasco","Puerto Villarroel","ESCUELA SENDA 6",-64.95086,-17.01844,130,18,1312,1442,84,25,1185,1269
"Bolivia","Cochabamba","Carrasco","Puerto Villarroel","ESCUELA TORIBIO CLAURE (V. HERMOSO)",-64.96452,-17.15555,204,14,1538,1742,156,26,1342,1498
"Bolivia","Cochabamba","Carrasco","Puerto Villarroel","UNIDAD EDUCATIVA 2 DE MARZO",-64.92152,-17.21806,56,4,670,726,30,9,627,657
"Bolivia","Cochabamba","Carrasco","Puerto Villarroel","UNIDAD EDUCATIVA BIARECUATÉ",-64.94436,-16.78322,31,0,59,90,5,0,54,59
"Bolivia","Cochabamba","Carrasco","Puerto Villarroel","UNIDAD EDUCATIVA CESAR ZAMA (P. VILLARRO",-65.07753,-16.99568,20,2,177,197,14,6,155,169
"Bolivia","Cochabamba","Carrasco","Puerto Villarroel","UNIDAD EDUCATIVA ISRAEL",-64.83989,-17.22177,38,7,536,574,45,8,476,521
"Bolivia","Cochabamba","Carrasco","Puerto Villarroel","UNIDAD EDUCATIVA JUANA AZURDUY DE PADILLA",-64.85532,-17.04719,90,3,527,617,79,10,435,514
"Bolivia","Cochabamba","Carrasco","Puerto Villarroel","UNIDAD EDUCATIVA SAN FRANCISCO DE ASIS",-64.85681,-17.03161,1395,123,9073,10468,1583,289,7078,8661
"Bolivia","Cochabamba","Carrasco","Puerto Villarroel","UNIDAD EDUCATIVA VALLE TUNARI",-64.69701,-17.26063,175,17,1599,1774,101,28,1453,1554
"Bolivia","Cochabamba","Carrasco","Totora","COLEGIO 8 DE SEPTIEMBRE",-65.08691,-17.71779,44,9,554,598,51,16,478,529
"Bolivia","Cochabamba","Carrasco","Totora","SEDE DE LA JUNTA VECINAL DE EPIZANA",-65.22901,-17.63718,72,12,785,857,95,28,650,745
"Bolivia","Cochabamba","Carrasco","Totora","SEDE SOCIAL YUNGAS DE VANDIOLA",-65.23582,-17.42609,74,8,477,551,130,12,327,457
"Bolivia","Cochabamba","Carrasco","Totora","UNIDAD EDUCATIVA ANTAQAWA",-65.13827,-17.87289,8,0,131,139,9,1,121,130
"Bolivia","Cochabamba","Carrasco","Totora","UNIDAD EDUCATIVA LAIME TORO",-65.05975,-17.66721,42,8,572,614,46,18,500,546
"Bolivia","Cochabamba","Carrasco","Totora","UNIDAD EDUCATIVA POTRERO",-65.04145,-17.88901,14,1,119,133,5,0,113,118
"Bolivia","Cochabamba","Carrasco","Totora","UNIDAD EDUCATIVA RODEO GRANDE",-65.13137,-17.66049,59,10,861,920,43,12,796,839
"Bolivia","Cochabamba","Carrasco","Totora","UNIDAD EDUCATIVA TIKA PAMPA",-65.25523,-17.7844,17,4,125,142,4,4,113,117
"Bolivia","Cochabamba","Carrasco","Totora","UNIDAD EDUCATIVA TIRAQUE C",-65.09571,-17.67045,14,4,305,319,16,4,281,297
"Bolivia","Cochabamba","Carrasco","Totora","UNIDA EDUCATIVA LA PAZ",-65.19115,-17.74041,425,48,2708,3133,516,83,2061,2577
"Bolivia","Cochabamba","Cercado","Cochabamba","CAMPO FERIAL",-66.12955,-17.41828,634,33,4556,5190,2374,149,2000,4374
"Bolivia","Cochabamba","Cercado","Cochabamba","(CÁRCEL) PENITENCIARIA SAN ANTONIO",-66.15704,-17.40325,92,2,151,243,70,6,73,143
"Bolivia","Cochabamba","Cercado","Cochabamba","(CÁRCEL) PENITENCIARIA SAN SEBASTIAN MUJERES",-66.16058,-17.39862,48,0,77,125,29,0,48,77
"Bolivia","Cochabamba","Cercado","Cochabamba","(CÁRCEL) PENITENCIARIA SAN SEBASTIAN  VARONES",-66.15989,-17.39794,84,1,192,276,61,10,120,181
"Bolivia","Cochabamba","Cercado","Cochabamba","CEMA CENTRO FRUTILLITAS",-66.20207,-17.38553,39,1,481,520,347,14,119,466
"Bolivia","Cochabamba","Cercado","Cochabamba","CENTRO EDUCATIVO P.  MARIA AUXILIADORA",-66.15949,-17.43581,703,41,5203,5906,2680,191,2291,4971
"Bolivia","Cochabamba","Cercado","Cochabamba","CENTRO EDUCATIVO SAN FRANCISCO DE ASIS",-66.16775,-17.41353,185,6,1313,1498,861,18,428,1289
"Bolivia","Cochabamba","Cercado","Cochabamba","CENTRO INMACULADA CONCEPCION",-66.15766,-17.37703,394,9,2504,2898,2142,37,316,2458
"Bolivia","Cochabamba","Cercado","Cochabamba","CENTRO INTEGRADO EL SALVADOR S-VERA CRUZ",-66.1243,-17.46039,436,26,2949,3385,1227,102,1594,2821
"Bolivia","Cochabamba","Cercado","Cochabamba","CENTRO KANATA",-66.15925,-17.41386,145,2,879,1024,560,25,292,852
"Bolivia","Cochabamba","Cercado","Cochabamba","CENTRO PARTICULAR GERONIMO DE OSORIO",-66.1866,-17.397,883,24,5680,6563,3767,147,1742,5509
"Bolivia","Cochabamba","Cercado","Cochabamba","COLEGIO ABAROA",-66.1585,-17.39535,540,12,3076,3616,2308,56,700,3008
"Bolivia","Cochabamba","Cercado","Cochabamba","COLEGIO ALBERT EINSTEIN",-66.17524,-17.38465,368,13,3155,3523,2474,98,570,3044
"Bolivia","Cochabamba","Cercado","Cochabamba","COLEGIO ALEMAN SANTA MARIA",-66.15275,-17.39123,351,8,2029,2380,1666,34,321,1987
"Bolivia","Cochabamba","Cercado","Cochabamba","COLEGIO AMOR DE DIOS",-66.15005,-17.40731,1164,33,6625,7789,4045,135,2412,6457
"Bolivia","Cochabamba","Cercado","Cochabamba","COLEGIO BOLIVAR",-66.1534,-17.39354,297,11,1610,1907,1191,20,388,1579
"Bolivia","Cochabamba","Cercado","Cochabamba","COLEGIO BOLIVIANO ARGENTINO",-66.15808,-17.39156,151,5,713,864,551,10,147,698
"Bolivia","Cochabamba","Cercado","Cochabamba","COLEGIO BRANCO PETRICEVIC",-66.18783,-17.37372,837,32,6224,7061,4425,146,1621,6046
"Bolivia","Cochabamba","Cercado","Cochabamba","COLEGIO BUENAS NUEVAS C",-66.14614,-17.41905,730,42,4605,5335,2290,140,2133,4423
"Bolivia","Cochabamba","Cercado","Cochabamba","COLEGIO CRISTO REY",-66.17203,-17.39057,590,9,4395,4985,3349,88,949,4298
"Bolivia","Cochabamba","Cercado","Cochabamba","COLEGIO DON BOSCO",-66.15103,-17.38246,694,15,4015,4709,3327,58,615,3942
"Bolivia","Cochabamba","Cercado","Cochabamba","COLEGIO FEDERICO FROEBEL",-66.14729,-17.36183,428,14,3451,3879,2475,76,886,3361
"Bolivia","Cochabamba","Cercado","Cochabamba","COLEGIO HISPANO BOLIVIANO",-66.15182,-17.39768,479,14,2579,3058,1866,66,633,2499
"Bolivia","Cochabamba","Cercado","Cochabamba","COLEGIO IRLANDES",-66.13731,-17.37605,71,1,536,607,447,8,80,527
"Bolivia","Cochabamba","Cercado","Cochabamba","COLEGIO ISMAEL MONTES O LUIS ESPINAL",-66.14464,-17.4156,562,33,3962,4524,1912,124,1893,3805
"Bolivia","Cochabamba","Cercado","Cochabamba","COLEGIO JAIME ESCALANTE",-66.15813,-17.368,188,9,1369,1557,1122,21,217,1339
"Bolivia","Cochabamba","Cercado","Cochabamba","COLEGIO LA SALLE",-66.1608,-17.38936,736,11,3643,4379,3037,45,550,3587
"Bolivia","Cochabamba","Cercado","Cochabamba","COLEGIO LA SALLE FISCAL",-66.16738,-17.40489,700,22,4983,5683,3548,98,1315,4863
"Bolivia","Cochabamba","Cercado","Cochabamba","COLEGIO LAURA VICUÑA",-66.19179,-17.4425,129,15,1094,1223,419,33,627,1046
"Bolivia","Cochabamba","Cercado","Cochabamba","COLEGIO LOYOLA",-66.14664,-17.38733,321,4,1795,2116,1486,28,277,1763
"Bolivia","Cochabamba","Cercado","Cochabamba","COLEGIO LUIS QUINTIN VILA",-66.1864,-17.37541,788,21,6106,6894,4295,189,1601,5896
"Bolivia","Cochabamba","Cercado","Cochabamba","COLEGIO MARISTA",-66.16205,-17.36185,580,16,4753,5333,3384,87,1266,4650
"Bolivia","Cochabamba","Cercado","Cochabamba","COLEGIO MARISTA NUESTRA SEÑORA DEL PILAR",-66.16751,-17.35473,778,26,5557,6335,3331,161,2039,5370
"Bolivia","Cochabamba","Cercado","Cochabamba","COLEGIO MARTIN CARDENAS",-66.13716,-17.41997,489,20,4069,4558,2209,94,1746,3955
"Bolivia","Cochabamba","Cercado","Cochabamba","COLEGIO MARYKNOLL",-66.16751,-17.37765,779,8,4947,5726,4183,64,692,4875
"Bolivia","Cochabamba","Cercado","Cochabamba","COLEGIO NACIONAL MIXTO COCHABAMBA",-66.17643,-17.36379,701,29,5441,6142,3787,92,1533,5320
"Bolivia","Cochabamba","Cercado","Cochabamba","COLEGIO PAULO VI",-66.16972,-17.3896,369,8,2610,2979,2079,52,471,2550
"Bolivia","Cochabamba","Cercado","Cochabamba","COLEGIO PIO XII",-66.15453,-17.40197,233,7,1454,1687,1045,21,381,1426
"Bolivia","Cochabamba","Cercado","Cochabamba","COLEGIO RICHARD VON WEIZACKER",-66.18177,-17.37842,305,10,2765,3070,2173,38,544,2717
"Bolivia","Cochabamba","Cercado","Cochabamba","COLEGIO SAN ANTONIO DE PUCARA",-66.1666,-17.45451,1458,92,8964,10422,3375,324,5173,8548
"Bolivia","Cochabamba","Cercado","Cochabamba","COLEGIO SAN FRANCISCO DE ASIS",-66.15719,-17.43316,813,34,5774,6587,3177,138,2425,5602
"Bolivia","Cochabamba","Cercado","Cochabamba","COLEGIO SAN FRANCISCO (VILLA PAGADOR)",-66.11565,-17.43498,820,66,5571,6391,1769,211,3525,5294
"Bolivia","Cochabamba","Cercado","Cochabamba","COLEGIO SAN RAFAEL",-66.13949,-17.39816,653,16,4393,5046,3310,49,1018,4328
"Bolivia","Cochabamba","Cercado","Cochabamba","COLEGIO SANTA LUISA MARILLAC",-66.12972,-17.42876,730,49,5518,6248,2277,172,3020,5297
"Bolivia","Cochabamba","Cercado","Cochabamba","COLEGIO SANTO DOMINGO SAVIO",-66.15925,-17.42091,297,16,2234,2531,1401,60,757,2158
"Bolivia","Cochabamba","Cercado","Cochabamba","COLEGIO SEBASTIAN PAGADOR",-66.11807,-17.4396,1528,101,11230,12758,3900,353,6876,10776
"Bolivia","Cochabamba","Cercado","Cochabamba","COLEGIO SERGIO ALMARAZ PAZ",-66.15983,-17.42155,766,23,5259,6025,3325,143,1768,5093
"Bolivia","Cochabamba","Cercado","Cochabamba","COLEGIO TECNICO HUMANISTICO ABAROA",-66.18008,-17.39791,147,6,1098,1245,738,23,331,1069
"Bolivia","Cochabamba","Cercado","Cochabamba","COLEGIO VENEZUELA",-66.17432,-17.38003,420,16,2985,3405,2348,52,569,2917
"Bolivia","Cochabamba","Cercado","Cochabamba","COLEGIO VENJAMNIN",-66.12346,-17.42547,264,29,2102,2366,892,70,1111,2003
"Bolivia","Cochabamba","Cercado","Cochabamba","COLEGIO YUGOSLAVIA ( EX MARISCAL SANTA CRUZ)",-66.15756,-17.4142,355,11,2438,2793,1665,53,709,2374
"Bolivia","Cochabamba","Cercado","Cochabamba","ESC. FISCAL JUAN XXIII A – JUANCITO PINTO",-66.20342,-17.3892,214,5,1650,1864,1081,31,533,1614
"Bolivia","Cochabamba","Cercado","Cochabamba","ESC. REPUBLICA DEL PERU O I. VASQUEZ",-66.16631,-17.41514,1100,29,6962,8062,4546,136,2251,6797
"Bolivia","Cochabamba","Cercado","Cochabamba","ESCUELA 6 DE AGOSTO",-66.17321,-17.48531,604,71,4681,5285,1408,160,3042,4450
"Bolivia","Cochabamba","Cercado","Cochabamba","ESCUELA ANTOFAGASTA",-66.18551,-17.38673,721,45,5926,6647,4016,133,1732,5748
"Bolivia","Cochabamba","Cercado","Cochabamba","ESCUELA BOLIVAR",-66.15719,-17.40203,239,5,1240,1479,857,19,359,1216
"Bolivia","Cochabamba","Cercado","Cochabamba","ESCUELA BUENAS NUEVAS A",-66.14575,-17.41985,411,25,2759,3170,1307,81,1346,2653
"Bolivia","Cochabamba","Cercado","Cochabamba","ESCUELA CAMARA JUNIOR",-66.15968,-17.42823,346,17,2088,2434,1166,78,827,1993
"Bolivia","Cochabamba","Cercado","Cochabamba","ESCUELA CARLOS MEDINACELI",-66.14594,-17.44799,765,40,5459,6224,2177,157,3085,5262
"Bolivia","Cochabamba","Cercado","Cochabamba","ESCUELA CEFERINO NAMUNCURA",-66.22959,-17.44222,181,8,1063,1244,381,34,640,1021
"Bolivia","Cochabamba","Cercado","Cochabamba","ESCUELA CENTRAL TAQUIÑA A",-66.17831,-17.34379,706,52,5677,6383,2965,161,2499,5464
"Bolivia","Cochabamba","Cercado","Cochabamba","ESCUELA CENTRAL TAQUIÑA C",-66.17863,-17.3427,686,30,5223,5909,2725,147,2321,5046
"Bolivia","Cochabamba","Cercado","Cochabamba","ESCUELA EUSEBIO TUDELA",-66.21059,-17.44574,450,48,3770,4220,1177,135,2410,3587
"Bolivia","Cochabamba","Cercado","Cochabamba","ESCUELA FISCAL JUAN XXIII A",-66.20212,-17.38982,540,14,4012,4552,2580,66,1352,3932
"Bolivia","Cochabamba","Cercado","Cochabamba","ESCUELA GERARDO VARGAS",-66.12848,-17.43969,872,64,5519,6391,1967,190,3298,5265
"Bolivia","Cochabamba","Cercado","Cochabamba","ESCUELA GUALBERTO VILLARROEL",-66.14348,-17.38926,292,4,1962,2254,1557,24,377,1934
"Bolivia","Cochabamba","Cercado","Cochabamba","ESCUELA GUTIERREZ MARISCAL",-66.19385,-17.39756,652,46,5679,6331,3301,162,2170,5471
"Bolivia","Cochabamba","Cercado","Cochabamba","ESCUELA HUMBERTO PORTOCARRERO",-66.14091,-17.45442,592,23,4078,4670,1757,127,2171,3928
"Bolivia","Cochabamba","Cercado","Cochabamba","ESCUELA IV CENTENARIO",-66.18991,-17.35495,698,33,5144,5842,3146,117,1848,4994
"Bolivia","Cochabamba","Cercado","Cochabamba","ESCUELA JOSE GABRIEL DE GUMUCIO",-66.16722,-17.38438,246,3,1779,2025,1468,32,276,1744
"Bolivia","Cochabamba","Cercado","Cochabamba","ESCUELA JOSE MARIA SANTIVAÑEZ",-66.17485,-17.36938,604,10,4205,4809,3397,48,750,4147
"Bolivia","Cochabamba","Cercado","Cochabamba","ESCUELA MARYKNOLL",-66.16147,-17.37132,172,1,1224,1396,1064,15,144,1208
"Bolivia","Cochabamba","Cercado","Cochabamba","ESCUELA MIXTA FISCAL TEMPORAL A",-66.15884,-17.36139,656,29,5205,5861,3175,152,1849,5024
"Bolivia","Cochabamba","Cercado","Cochabamba","ESCUELA OTTO FELIPE BRAWN",-66.18926,-17.36244,555,19,4174,4729,2655,97,1403,4058
"Bolivia","Cochabamba","Cercado","Cochabamba","ESCUELA RICARDO PRUDENCIO",-66.14006,-17.42105,449,22,2988,3437,1337,95,1534,2871
"Bolivia","Cochabamba","Cercado","Cochabamba","ESCUELA WALTER VALLEJO",-66.14645,-17.40012,240,3,1370,1610,861,30,476,1337
"Bolivia","Cochabamba","Cercado","Cochabamba","ESCUELA WILGE RODRIGUEZ",-66.15132,-17.39204,163,6,900,1063,676,22,196,872
"Bolivia","Cochabamba","Cercado","Cochabamba","INSTITUTO AMERICANO",-66.15434,-17.36889,933,22,5993,6926,4669,95,1207,5876
"Bolivia","Cochabamba","Cercado","Cochabamba","INSTITUTO EDUARDO LAREDO",-66.1526,-17.38101,454,2,2164,2618,1825,21,316,2141
"Bolivia","Cochabamba","Cercado","Cochabamba","LICEO ADELA ZAMUDIO",-66.16859,-17.39639,546,8,2869,3415,2130,77,654,2784
"Bolivia","Cochabamba","Cercado","Cochabamba","LICEO ELENA ARZE DE ARZE",-66.16439,-17.37035,568,11,3531,4099,2871,59,590,3461
"Bolivia","Cochabamba","Cercado","Cochabamba","LICEO GUINDALINA LOAYZA",-66.16626,-17.38111,153,7,1293,1446,1083,15,188,1271
"Bolivia","Cochabamba","Cercado","Cochabamba","LICEO  MERCEDES CANDIA DE OVANDO",-66.13917,-17.39435,551,19,3684,4235,2701,90,874,3575
"Bolivia","Cochabamba","Cercado","Cochabamba","SEMINARIO SAN JOSE",-66.19784,-17.38371,361,9,2916,3277,2014,69,824,2838
"Bolivia","Cochabamba","Cercado","Cochabamba","U.E. MADRE DE LA DIVINA PROVIDENCIA",-66.14977,-17.43951,31,4,443,474,186,17,236,422
"Bolivia","Cochabamba","Cercado","Cochabamba","U.E. NACIONAL SAN ISIDRO",-66.15123,-17.46888,545,57,4004,4549,1009,162,2776,3785
"Bolivia","Cochabamba","Cercado","Cochabamba","U. E. SAN NICOLAS CLUB DE LEONES",-66.15354,-17.4825,180,33,1796,1976,381,75,1307,1688
"Bolivia","Cochabamba","Cercado","Cochabamba","UNIDAD EDUCATIVA 14 DE SEPTIEMBRE",-66.18018,-17.36749,87,1,933,1020,708,15,209,917
"Bolivia","Cochabamba","Cercado","Cochabamba","UNIDAD EDUCATIVA 26 DE OCTUBRE",-66.12116,-17.42092,39,0,545,584,269,15,261,530
"Bolivia","Cochabamba","Cercado","Cochabamba","UNIDAD EDUCATIVA 9 DE MARZO",-66.10553,-17.44673,76,15,1007,1083,263,32,697,960
"Bolivia","Cochabamba","Cercado","Cochabamba","UNIDAD EDUCATIVA ALTO COCHABAMBA",-66.14483,-17.42332,48,4,422,470,132,13,273,405
"Bolivia","Cochabamba","Cercado","Cochabamba","UNIDAD EDUCATIVA AMERICA DEL SUR - MEJILLONES A",-66.13793,-17.42199,39,7,342,381,158,11,166,324
"Bolivia","Cochabamba","Cercado","Cochabamba","UNIDAD EDUCATIVA ANDRES BELLO",-66.15125,-17.4158,596,25,3737,4333,1845,91,1776,3621
"Bolivia","Cochabamba","Cercado","Cochabamba","UNIDAD EDUCATIVA ANTONIO DIEZ",-66.17933,-17.47178,93,14,1553,1646,522,57,960,1482
"Bolivia","Cochabamba","Cercado","Cochabamba","UNIDAD EDUCATIVA ATIY",-66.15207,-17.46361,124,12,1138,1262,378,26,722,1100
"Bolivia","Cochabamba","Cercado","Cochabamba","UNIDAD EDUCATIVA BARBARA LAMAS",-66.10529,-17.46267,469,55,3502,3971,796,151,2500,3296
"Bolivia","Cochabamba","Cercado","Cochabamba","UNIDAD EDUCATIVA BOLIVIA (LA MAICA)",-66.21881,-17.41461,145,9,1277,1422,351,42,875,1226
"Bolivia","Cochabamba","Cercado","Cochabamba","UNIDAD EDUCATIVA CATOLICO GUADALUPANO (EX CALIFORNIA AMERICAN SCHOOL)",-66.1447,-17.36928,367,11,2791,3158,2054,50,676,2730
"Bolivia","Cochabamba","Cercado","Cochabamba","UNIDAD EDUCATIVA CLUB DE LEONES",-66.16528,-17.36456,502,19,3494,3996,2514,73,888,3402
"Bolivia","Cochabamba","Cercado","Cochabamba","UNIDAD EDUCATIVA DANIEL SALAMANCA (EX COLEGIO NAL. MIXTO 6 DE AGOSTO)",-66.16353,-17.39569,82,3,583,665,448,10,122,570
"Bolivia","Cochabamba","Cercado","Cochabamba","UNIDAD EDUCATIVA DE LA FUERZA AEREA",-66.16742,-17.42138,196,3,658,854,397,19,239,636
"Bolivia","Cochabamba","Cercado","Cochabamba","UNIDAD EDUCATIVA DEMETRIO CANELAS",-66.20225,-17.42305,217,24,1874,2091,627,56,1167,1794
"Bolivia","Cochabamba","Cercado","Cochabamba","UNIDAD EDUCATIVA DIONISIO MORALES CHOQUE",-66.12429,-17.46519,929,91,7321,8250,1596,285,5349,6945
"Bolivia","Cochabamba","Cercado","Cochabamba","UNIDAD EDUCATIVA DOMINGO SAVIO (EX LORENZO FILHO)",-66.14401,-17.38117,218,1,1194,1412,939,26,228,1167
"Bolivia","Cochabamba","Cercado","Cochabamba","UNIDAD EDUCATIVA EL SALVADOR SAN JAVIER",-66.12055,-17.44695,584,38,3769,4353,1520,85,2126,3646
"Bolivia","Cochabamba","Cercado","Cochabamba","UNIDAD EDUCATIVA ESTADOS UNIDOS",-66.16256,-17.41906,219,11,1660,1879,1034,42,573,1607
"Bolivia","Cochabamba","Cercado","Cochabamba","UNIDAD EDUCATIVA ESTEBAN ARZE",-66.18428,-17.39833,431,8,3409,3840,2256,104,1041,3297
"Bolivia","Cochabamba","Cercado","Cochabamba","UNIDAD EDUCATIVA FACUNDO QUIROGA",-66.18948,-17.37427,47,3,366,413,274,8,81,355
"Bolivia","Cochabamba","Cercado","Cochabamba","UNIDAD EDUCATIVA FELIX CAPRILES",-66.18253,-17.40841,73,4,784,857,534,19,227,761
"Bolivia","Cochabamba","Cercado","Cochabamba","UNIDAD EDUCATIVA GARIBALDI",-66.19059,-17.35455,222,13,1744,1966,1027,25,679,1706
"Bolivia","Cochabamba","Cercado","Cochabamba","UNIDAD EDUCATIVA HNO PACIFICO FELETTI",-66.20975,-17.46777,98,13,905,1003,205,33,654,859
"Bolivia","Cochabamba","Cercado","Cochabamba","UNIDAD EDUCATIVA JOSE IGNACIO SANJINES",-66.20641,-17.38527,95,7,1050,1145,661,27,355,1016
"Bolivia","Cochabamba","Cercado","Cochabamba","UNIDAD EDUCATIVA JUAN JOSE TORREZ",-66.11476,-17.44767,149,17,1415,1564,442,40,916,1358
"Bolivia","Cochabamba","Cercado","Cochabamba","UNIDAD EDUCATIVA MARIA EMILIA RIQUELME (EX MARIA CRISTINA)",-66.20455,-17.39834,479,20,3711,4190,2143,117,1431,3574
"Bolivia","Cochabamba","Cercado","Cochabamba","UNIDAD EDUCATIVA MARIA JOSEFA MUJIA",-66.14333,-17.42708,325,42,2969,3294,862,119,1946,2808
"Bolivia","Cochabamba","Cercado","Cochabamba","UNIDAD EDUCATIVA NATANIEL AGUIRRE",-66.16888,-17.39892,22,1,332,354,237,8,86,323
"Bolivia","Cochabamba","Cercado","Cochabamba","UNIDAD EDUCATIVA NUEVA ESPERANZA",-66.17866,-17.48736,628,77,5669,6297,1543,230,3819,5362
"Bolivia","Cochabamba","Cercado","Cochabamba","UNIDAD EDUCATIVA NUEVA VERA CRUZ",-66.11756,-17.46273,420,21,2889,3309,1009,97,1762,2771
"Bolivia","Cochabamba","Cercado","Cochabamba","UNIDAD EDUCATIVA OBISPO ANAYA",-66.12938,-17.45243,340,21,2445,2785,1038,64,1322,2360
"Bolivia","Cochabamba","Cercado","Cochabamba","UNIDAD EDUCATIVA PRIMERO DE MAYO",-66.20525,-17.46752,798,74,5989,6787,1676,212,4027,5703
"Bolivia","Cochabamba","Cercado","Cochabamba","UNIDAD EDUCATIVA PROF. OSCAR ROJAS CABALLERO",-66.15136,-17.43501,34,2,318,352,157,6,153,310
"Bolivia","Cochabamba","Cercado","Cochabamba","UNIDAD EDUCATIVA RENE BARRIENTOS ORTUÑO",-66.11013,-17.47701,993,89,6018,7011,1732,243,3954,5686
"Bolivia","Cochabamba","Cercado","Cochabamba","UNIDAD EDUCATIVA RENE CRESPO",-66.151,-17.42624,95,6,823,918,275,33,509,784
"Bolivia","Cochabamba","Cercado","Cochabamba","UNIDAD EDUCATIVA ROSENDO PEÑA",-66.19244,-17.37992,45,1,481,526,361,12,107,468
"Bolivia","Cochabamba","Cercado","Cochabamba","UNIDAD EDUCATIVA SAN MIGUEL",-66.14757,-17.40514,471,22,2432,2903,1105,67,1238,2343
"Bolivia","Cochabamba","Cercado","Cochabamba","UNIDAD EDUCATIVA SAN MIGUEL ALTA TENSION",-66.13224,-17.43877,79,16,649,728,215,13,405,620
"Bolivia","Cochabamba","Cercado","Cochabamba","UNIDAD EDUCATIVA SANTA CRUZ - EDUARDO OCAMPO MOSCOSO",-66.15053,-17.41479,20,1,132,152,51,2,78,129
"Bolivia","Cochabamba","Cercado","Cochabamba","UNIDAD EDUCATIVA SANTA MARIA MICAELA",-66.17656,-17.40725,717,16,5180,5897,3518,125,1521,5039
"Bolivia","Cochabamba","Cercado","Cochabamba","UNIDAD EDUCATIVA SANTIAGO",-66.1651,-17.3495,383,23,3641,4024,1680,131,1807,3487
"Bolivia","Cochabamba","Cercado","Cochabamba","UNIDAD EDUCATIVA SIGLO XX - GABRIELA MISTRAL",-66.12198,-17.43334,140,16,1338,1478,485,38,799,1284
"Bolivia","Cochabamba","Cercado","Cochabamba","UNIDAD EDUCATIVA STEFANO HOTELLIER",-66.13995,-17.46966,184,24,1891,2075,487,75,1305,1792
"Bolivia","Cochabamba","Cercado","Cochabamba","UNIDAD EDUCATIVA VERDAD Y VIDA",-66.10658,-17.47467,235,33,2227,2462,598,80,1516,2114
"Bolivia","Cochabamba","Cercado","Cochabamba","UNIDAD EDUCATIVA VISION MUNDIAL",-66.1441,-17.43991,692,39,4831,5523,2164,146,2482,4646
"Bolivia","Cochabamba","Cercado","Cochabamba","UNIDAD EDUCATIVA VOCES LIBRES",-66.13216,-17.47402,23,7,329,352,66,9,247,313
"Bolivia","Cochabamba","Cercado","Cochabamba","UNIDAD EDU. EDUARDO LOPEZ O E.DON BOSCO",-66.17724,-17.4273,373,29,2362,2735,1017,57,1259,2276
"Bolivia","Cochabamba","Cercado","Cochabamba","UNIVERSIDAD CATOLICA",-66.14394,-17.37205,863,26,5636,6499,4383,97,1130,5513
"Bolivia","Cochabamba","Cercado","Cochabamba","UNIVERSIDAD UCATEC (EX CEIVO)",-66.13677,-17.37113,253,8,2127,2380,1606,38,475,2081
"Bolivia","Cochabamba","Chapare","Colomi","NUCLEO ESCOLAR CANDELARIA",-65.92474,-17.27441,156,31,1832,1988,331,88,1382,1713
"Bolivia","Cochabamba","Chapare","Colomi","NUCLEO ESCOLAR TABLAS MONTE",-65.99883,-17.0847,83,16,568,651,48,10,494,542
"Bolivia","Cochabamba","Chapare","Colomi","U.E. ROSARIO",-65.88084,-17.3183,3,3,87,90,36,1,47,83
"Bolivia","Cochabamba","Chapare","Colomi","UNIDAD EDUCATIVA CORANI PAMPA",-65.93583,-17.13022,106,19,1142,1248,205,41,877,1082
"Bolivia","Cochabamba","Chapare","Colomi","UNIDAD EDUCATIVA EL PALMAR",-65.74912,-17.18198,45,4,260,305,55,5,196,251
"Bolivia","Cochabamba","Chapare","Colomi","UNIDAD EDUCATIVA PARACTI (COLOMI)",-65.82558,-17.20783,60,5,516,576,172,25,314,486
"Bolivia","Cochabamba","Chapare","Colomi","UNIDAD EDUCATIVA PUCA MAYU (COLOMI)",-65.90272,-17.01873,1,0,8,9,0,0,8,8
"Bolivia","Cochabamba","Chapare","Colomi","UNIDAD EDUCATIVA SAMUEL FINA SAVIO",-65.8636,-17.34076,914,144,5977,6891,1880,370,3583,5463
"Bolivia","Cochabamba","Chapare","Sacaba","(CÁRCEL) PENITENCIARIA EL ABRA",-66.11572,-17.40493,65,1,223,288,56,4,162,218
"Bolivia","Cochabamba","Chapare","Sacaba","(CÁRCEL) PENITENCIARIA SAN PEDRO (SACABA)",-66.0414,-17.40583,51,2,105,156,21,3,79,100
"Bolivia","Cochabamba","Chapare","Sacaba","COLEGIO BOLIVIANO JAPONES",-66.09353,-17.37924,1004,54,7211,8215,4531,203,2423,6954
"Bolivia","Cochabamba","Chapare","Sacaba","COLEGIO FRANZ TAMAYO (CHIÑATA)",-65.98093,-17.43051,525,41,3978,4503,1427,154,2356,3783
"Bolivia","Cochabamba","Chapare","Sacaba","COLEGIO NATANIEL AGUIRRE",-65.83003,-17.37266,148,8,1266,1414,208,52,998,1206
"Bolivia","Cochabamba","Chapare","Sacaba","COLEGIO PUERTO MEJILLONES",-66.1301,-17.37218,576,26,4465,5041,2823,87,1529,4352
"Bolivia","Cochabamba","Chapare","Sacaba","COLEGIO QUINTANILLA",-66.10987,-17.3848,1591,97,10227,11818,5854,343,3933,9787
"Bolivia","Cochabamba","Chapare","Sacaba","COLEGIO RENE FERNANDEZ BECERRA",-65.91483,-17.42616,124,13,1040,1164,158,16,853,1011
"Bolivia","Cochabamba","Chapare","Sacaba","COLEGIO SEÑOR DE MAYO",-66.11799,-17.37354,919,33,6076,6995,4052,119,1872,5924
"Bolivia","Cochabamba","Chapare","Sacaba","ESCUELA 6 DE JUNIO - TACOPOCA",-66.02658,-17.41193,437,63,3749,4186,1461,150,2075,3536
"Bolivia","Cochabamba","Chapare","Sacaba","ESCUELA CARLOS PEREDO SANDOVAL",-66.05909,-17.3939,1065,98,7387,8452,3470,306,3513,6983
"Bolivia","Cochabamba","Chapare","Sacaba","ESCUELA COPACABANA",-66.10087,-17.39216,460,36,3588,4048,2090,106,1356,3446
"Bolivia","Cochabamba","Chapare","Sacaba","ESCUELA GERMAN BUSCH",-66.0383,-17.40434,745,56,4774,5519,2474,200,2044,4518
"Bolivia","Cochabamba","Chapare","Sacaba","ESCUELA GUADALUPE",-66.07703,-17.38369,843,31,5983,6826,3471,189,2292,5763
"Bolivia","Cochabamba","Chapare","Sacaba","ESCUELA JESUS TERCEROS",-66.12031,-17.38594,438,6,3210,3648,2324,71,809,3133
"Bolivia","Cochabamba","Chapare","Sacaba","ESCUELA MAN CESPED",-66.03825,-17.40714,911,69,6361,7272,3261,258,2773,6034
"Bolivia","Cochabamba","Chapare","Sacaba","ESCUELA NATALIO ARAUCO",-66.04586,-17.40147,675,49,4489,5164,2353,148,1939,4292
"Bolivia","Cochabamba","Chapare","Sacaba","ESCUELA RENE BARRIENTOS ORTUÑO (UCUCHI)",-65.92544,-17.4195,90,8,574,664,139,19,408,547
"Bolivia","Cochabamba","Chapare","Sacaba","INSTITUTO TECNICO SACABA (ITSA)",-66.04596,-17.40543,16,2,126,142,58,5,61,119
"Bolivia","Cochabamba","Chapare","Sacaba","LICEO DE SEÑORITAS SACABA",-66.04489,-17.40398,928,66,6075,7003,3243,194,2572,5815
"Bolivia","Cochabamba","Chapare","Sacaba","U.E. MARCELO QUIROGA SANTA CRUZ (PACATA)",-66.1184,-17.3762,15,1,161,176,104,2,54,158
"Bolivia","Cochabamba","Chapare","Sacaba","U.E. NUEVO AMANECER",-66.03468,-17.45286,29,11,603,632,130,48,414,544
"Bolivia","Cochabamba","Chapare","Sacaba","U.E. TUTIMAYU",-65.95177,-17.41679,49,16,878,927,269,27,566,835
"Bolivia","Cochabamba","Chapare","Sacaba","UNIDAD EDUCATIVA 27 DE AGOSTO",-66.05526,-17.41448,17,4,390,407,115,11,260,375
"Bolivia","Cochabamba","Chapare","Sacaba","UNIDAD EDUCATIVA BOLIVIANO BRITÁNICO",-66.02322,-17.40267,395,42,3050,3445,1205,108,1695,2900
"Bolivia","Cochabamba","Chapare","Sacaba","UNIDAD EDUCATIVA CEILAB",-66.073,-17.38945,14,2,167,181,110,7,48,158
"Bolivia","Cochabamba","Chapare","Sacaba","UNIDAD EDUCATIVA DEL VALLE",-66.1094,-17.38272,203,13,1838,2041,1097,42,686,1783
"Bolivia","Cochabamba","Chapare","Sacaba","UNIDAD EDUCATIVA EDMUNDO BOJANOWSKI",-66.12388,-17.37073,35,1,397,432,249,9,138,387
"Bolivia","Cochabamba","Chapare","Sacaba","UNIDAD EDUCATIVA ENTRE RIOS",-66.06012,-17.40147,9,3,167,176,50,10,104,154
"Bolivia","Cochabamba","Chapare","Sacaba","UNIDAD EDUCATIVA HERNÁN RIVERO FIORILO",-66.07921,-17.40404,177,17,1925,2102,859,57,992,1851
"Bolivia","Cochabamba","Chapare","Sacaba","UNIDAD EDUCATIVA ISRAELÍ EL ABRA",-66.10103,-17.40372,627,66,5585,6212,2018,217,3284,5302
"Bolivia","Cochabamba","Chapare","Sacaba","UNIDAD EDUCATIVA KANATA",-66.10153,-17.38585,89,3,708,797,560,16,129,689
"Bolivia","Cochabamba","Chapare","Sacaba","UNIDAD EDUCATIVA LARATI",-66.01265,-17.34382,30,6,773,803,93,11,663,756
"Bolivia","Cochabamba","Chapare","Sacaba","UNIDAD EDUCATIVA PAMPILLA",-66.0752,-17.18917,195,49,2082,2277,498,128,1407,1905
"Bolivia","Cochabamba","Chapare","Sacaba","UNIDAD EDUCATIVA RENÉ BARRIENTOS ORTUÑO",-66.11898,-17.37671,135,5,1137,1272,714,27,391,1105
"Bolivia","Cochabamba","Chapare","Sacaba","UNIDAD EDUCATIVA REPUBLICA DE ITALIA",-66.04491,-17.40258,156,15,1465,1621,637,34,779,1416
"Bolivia","Cochabamba","Chapare","Sacaba","UNIDAD EDUCATIVA ULINCATE",-65.98841,-17.4069,109,14,1042,1151,384,40,604,988
"Bolivia","Cochabamba","Chapare","Sacaba","UNIDAD EDUCATIVA VILLA GRACIELA",-66.13087,-17.37237,288,15,2428,2716,1496,43,874,2370
"Bolivia","Cochabamba","Chapare","Villa Tunari","COLEGIO FE Y ALEGRIA",-65.40147,-16.91353,164,18,1661,1825,199,43,1401,1600
"Bolivia","Cochabamba","Chapare","Villa Tunari","COLEGIO FRANCISCO VIGNAUD",-65.42472,-16.97513,119,5,521,640,170,7,339,509
"Bolivia","Cochabamba","Chapare","Villa Tunari","COLEGIO MIXTO TECNICO HUM. VILLA BOLIVAR",-65.74024,-16.62949,54,6,496,550,40,6,444,484
"Bolivia","Cochabamba","Chapare","Villa Tunari","COLEGIO NUEVA TACOPAYA",-65.67545,-16.56796,102,7,1124,1226,117,33,967,1084
"Bolivia","Cochabamba","Chapare","Villa Tunari","ESCUELA 27 DE MAYO",-65.30819,-16.74821,115,13,533,648,90,25,405,495
"Bolivia","Cochabamba","Chapare","Villa Tunari","ESCUELA CRISTAL MAYU",-65.64395,-17.00619,193,18,1595,1788,138,31,1408,1546
"Bolivia","Cochabamba","Chapare","Villa Tunari","ESCUELA ELIZARDO PEREZ",-65.64406,-16.73144,242,25,1966,2208,236,45,1660,1896
"Bolivia","Cochabamba","Chapare","Villa Tunari","ESCUELA LA ESTRELLA",-65.49522,-16.72417,47,3,573,620,49,17,504,553
"Bolivia","Cochabamba","Chapare","Villa Tunari","ESCUELA LA ESTRELLA (SAN GABRIEL)",-65.62708,-16.6753,281,4,2075,2356,163,37,1871,2034
"Bolivia","Cochabamba","Chapare","Villa Tunari","ESCUELA SAMUZABETI",-65.57269,-16.81616,201,12,2121,2322,133,49,1927,2060
"Bolivia","Cochabamba","Chapare","Villa Tunari","ESCUELA SAN ANTONIO DE VILLA TUNARI",-65.4173,-16.97306,359,17,1849,2208,607,44,1181,1788
"Bolivia","Cochabamba","Chapare","Villa Tunari","ESCUELA SAN JOSE (V.TUNARI)",-65.46657,-16.81087,152,5,1283,1435,69,17,1192,1261
"Bolivia","Cochabamba","Chapare","Villa Tunari","ESCUELA VILLA 14 DE SEPTIEMBRE",-65.34883,-16.84459,677,73,4890,5567,597,121,4099,4696
"Bolivia","Cochabamba","Chapare","Villa Tunari","NUCLEO ESCOLAR NUEVA AROMA",-65.82585,-16.56242,86,14,917,1003,60,4,839,899
"Bolivia","Cochabamba","Chapare","Villa Tunari","U. E. INDEPENDENCIA (VILLA TUNARI)",-65.79965,-16.4638,88,14,975,1063,41,13,907,948
"Bolivia","Cochabamba","Chapare","Villa Tunari","U.E. SAN BENITO",-65.5032,-16.53337,18,2,56,74,5,1,48,53
"Bolivia","Cochabamba","Chapare","Villa Tunari","U. E. SANTA ROSA DE LA BOCA",-64.7546,-15.93035,28,0,25,53,24,0,1,25
"Bolivia","Cochabamba","Chapare","Villa Tunari","UNIDAD EDUCATIVA 1RO DE MAYO",-65.42921,-16.64719,50,2,591,641,52,16,521,573
"Bolivia","Cochabamba","Chapare","Villa Tunari","UNIDAD EDUCATIVA 27 DE MAYO",-65.46113,-17.0208,18,1,326,344,12,2,311,323
"Bolivia","Cochabamba","Chapare","Villa Tunari","UNIDAD EDUCATIVA JATUN PAMPA",-65.5677,-17.00337,115,14,1017,1132,160,28,815,975
"Bolivia","Cochabamba","Chapare","Villa Tunari","UNIDAD EDUCATIVA MIXTA ETERAZAMA",-65.52284,-16.83394,535,52,4318,4853,672,112,3482,4154
"Bolivia","Cochabamba","Chapare","Villa Tunari","UNIDAD EDUCATIVA MOLETO ICOYA (V.TUNARI)",-65.8701,-16.4744,43,6,645,688,25,14,600,625
"Bolivia","Cochabamba","Chapare","Villa Tunari","UNIDAD EDUCATIVA PARACTITO",-65.46431,-17.03166,228,19,1648,1876,289,54,1286,1575
"Bolivia","Cochabamba","Chapare","Villa Tunari","UNIDAD EDUCATIVA PARACTI (VILLA TUNARI)",-65.82552,-17.20792,65,6,326,391,46,7,267,313
"Bolivia","Cochabamba","Chapare","Villa Tunari","UNIDAD EDUCATIVA PARAISO-TODO SANTOS",-65.29498,-16.90554,149,20,1507,1656,182,41,1264,1446
"Bolivia","Cochabamba","Chapare","Villa Tunari","UNIDAD EDUCATIVA SAN FRANCISCO KM 21",-65.33453,-16.76798,31,7,603,634,32,15,549,581
"Bolivia","Cochabamba","Chapare","Villa Tunari","UNIDAD EDUCATIVA SAN JOSE DE ANGOSTA",-65.90482,-16.42696,75,5,207,282,20,20,162,182
"Bolivia","Cochabamba","Chapare","Villa Tunari","UNIDAD EDUCATIVA SIMON RODRIGUEZ (EX PUCA MAYU (V. TUNARI))",-65.90272,-17.01873,65,9,501,566,44,12,436,480
"Bolivia","Cochabamba","Chapare","Villa Tunari","UNIDAD EDUCATIVA TOCOPILLA",-65.26644,-16.81101,33,7,378,411,22,10,339,361
"Bolivia","Cochabamba","Chapare","Villa Tunari","UNIDAD EDUCATIVA UNCIA",-65.73511,-16.52453,42,10,573,615,26,18,519,545
"Bolivia","Cochabamba","Chapare","Villa Tunari","UNIDAD EDUCATIVA VILLA NUEVA",-65.33994,-16.65689,21,1,314,335,27,10,276,303
"Bolivia","Cochabamba","Esteban Arce","Anzaldo","ESC. ESTEBAN ANDIA ESCOBAR - PACCHA PATA",-65.94566,-17.70326,29,6,157,186,29,7,115,144
"Bolivia","Cochabamba","Esteban Arce","Anzaldo","NUCLEO EDUCATIVO LA VIÑA",-65.85647,-17.96978,46,4,194,240,42,6,142,184
"Bolivia","Cochabamba","Esteban Arce","Anzaldo","U. E. SAN JOSE DE CALAZANS-LITORAL",-65.93351,-17.78299,405,93,2084,2489,570,102,1319,1889
"Bolivia","Cochabamba","Esteban Arce","Anzaldo","UNIDAD EDUCATIVA ALFAMAYU",-65.93799,-17.86563,9,1,68,77,2,2,63,65
"Bolivia","Cochabamba","Esteban Arce","Anzaldo","UNIDAD EDUCATIVA ARTURO SARMIENTO",-65.94575,-17.90018,47,3,252,299,31,16,202,233
"Bolivia","Cochabamba","Esteban Arce","Anzaldo","UNIDAD EDUCATIVA THAGO KASA",-65.82888,-17.89126,13,2,120,133,11,2,105,116
"Bolivia","Cochabamba","Esteban Arce","Arbieto","CENTRO EDUCATIVO GERMAN BUSCH - ARBIETO",-66.01723,-17.58551,372,33,1648,2020,467,62,1086,1553
"Bolivia","Cochabamba","Esteban Arce","Arbieto","ESCUELA SECCIONAL ARPITA",-66.07514,-17.56822,196,20,1007,1203,160,39,788,948
"Bolivia","Cochabamba","Esteban Arce","Arbieto","UNIDAD EDUCATIVA 6 DE JUNIO - MAMANACA",-66.05242,-17.58441,131,13,547,678,138,17,379,517
"Bolivia","Cochabamba","Esteban Arce","Arbieto","UNIDAD EDUCATIVA ANTONIO ARNEZ -ARANJUEZ",-65.97636,-17.5959,56,4,340,396,101,10,225,326
"Bolivia","Cochabamba","Esteban Arce","Arbieto","UNIDAD EDUCATIVA CARLOS CANELAS",-66.09542,-17.49024,262,40,2833,3095,515,128,2150,2665
"Bolivia","Cochabamba","Esteban Arce","Arbieto","UNIDAD ESCOLAR CASIMIRO LOPEZ T.",-66.08762,-17.51215,66,7,354,420,128,6,213,341
"Bolivia","Cochabamba","Esteban Arce","Sacabamba","ESCUELA ELISEO TORRICO - SACABAMBA",-65.77574,-17.81699,112,22,664,776,176,37,429,605
"Bolivia","Cochabamba","Esteban Arce","Sacabamba","ESCUELA SECCIONAL CHALLAQUE",-65.75699,-17.83179,32,5,228,260,57,14,152,209
"Bolivia","Cochabamba","Esteban Arce","Sacabamba","NUCLEO ESCOLAR QUEKOMA",-65.8235,-17.70307,46,10,263,309,22,8,223,245
"Bolivia","Cochabamba","Esteban Arce","Sacabamba","NUCLEO MATARANI",-65.80145,-17.80308,97,12,592,689,103,24,453,556
"Bolivia","Cochabamba","Esteban Arce","Sacabamba","UNIDAD EDUCATIVA APILLAPA",-65.85152,-17.76226,12,3,172,184,20,6,143,163
"Bolivia","Cochabamba","Esteban Arce","Tarata","COLEGIO MY. VICTOR USTARIZ",-66.02438,-17.60891,498,23,1636,2134,548,58,1007,1555
"Bolivia","Cochabamba","Esteban Arce","Tarata","ESCUELA ESTEBAN ARZE",-66.02402,-17.61324,206,25,1195,1401,327,46,797,1124
"Bolivia","Cochabamba","Esteban Arce","Tarata","ESCUELA LUIS TERRAZAS",-66.07424,-17.75421,36,3,182,218,7,6,166,173
"Bolivia","Cochabamba","Esteban Arce","Tarata","ESCUELA RENE BARRIENTOS O.",-66.02374,-17.61071,322,22,1254,1576,383,37,812,1195
"Bolivia","Cochabamba","Esteban Arce","Tarata","UNIDAD EDUCATIVA HUASA RANCHO",-65.96735,-17.61409,31,6,141,172,38,3,94,132
"Bolivia","Cochabamba","Esteban Arce","Tarata","UNIDAD EDUCATIVA HUAYCULI",-65.97934,-17.6437,87,8,537,624,59,14,456,515
"Bolivia","Cochabamba","Esteban Arce","Tarata","UNIDAD EDUCATIVA HUERTA MAYU",-66.11383,-17.63796,42,3,351,393,8,6,334,342
"Bolivia","Cochabamba","Germán Jordán","Cliza","COLEGIO JUAN DE DIOS BALDERRAMA",-65.93368,-17.59121,762,62,4482,5244,1702,131,2587,4289
"Bolivia","Cochabamba","Germán Jordán","Cliza","COLEGIO NACIONAL MIXTO UCUREÑA",-65.90669,-17.58086,264,29,2045,2309,630,42,1344,1974
"Bolivia","Cochabamba","Germán Jordán","Cliza","ESCUELA SUCRE",-65.9311,-17.59395,819,45,3548,4367,1273,112,2118,3391
"Bolivia","Cochabamba","Germán Jordán","Cliza","UNIDAD EDUCATIVA CHULLPAS",-65.94772,-17.60734,134,11,628,762,146,27,444,590
"Bolivia","Cochabamba","Germán Jordán","Cliza","UNIDAD EDUCATIVA HUASACALLE",-65.90952,-17.5931,75,13,537,612,151,11,362,513
"Bolivia","Cochabamba","Germán Jordán","Cliza","UNIDAD EDUCATIVA SANTA LUCIA",-65.9581,-17.58606,94,7,409,503,126,18,258,384
"Bolivia","Cochabamba","Germán Jordán","Toko","COLEGIO AMBROSINI",-65.92783,-17.62949,517,52,2421,2938,476,65,1828,2304
"Bolivia","Cochabamba","Germán Jordán","Toko","UNIDAD EDUCATIVA SICHES",-65.94588,-17.66759,37,8,206,243,29,8,161,190
"Bolivia","Cochabamba","Germán Jordán","Tolata","COLEGIO VICTOR ROSALES",-65.96407,-17.53315,426,35,1615,2041,526,66,988,1514
"Bolivia","Cochabamba","Germán Jordán","Tolata","ESCUELA SAN ISIDRO",-65.97154,-17.56319,110,14,348,458,82,14,238,320
"Bolivia","Cochabamba","Germán Jordán","Tolata","ESCUELA SANTA MARIA (CARCAJE)",-66.0082,-17.54546,427,25,1648,2075,692,64,867,1559
"Bolivia","Cochabamba","Mizque","Alalay","ESCUELA DR. DEMETRIO CANELAS",-65.60884,-17.76655,47,10,382,429,88,14,270,358
"Bolivia","Cochabamba","Mizque","Alalay","U. E. ABRAHAM FLORES VELASQUEZ",-65.69196,-17.72072,73,4,334,407,30,7,293,323
"Bolivia","Cochabamba","Mizque","Alalay","UNIDAD EDUCATIVA QUTURI",-65.5355,-17.7629,26,6,185,211,18,4,157,175
"Bolivia","Cochabamba","Mizque","Alalay","UNIDAD EDUCATIVA YANA KHAKHA",-65.60854,-17.85578,52,1,207,259,11,6,189,200
"Bolivia","Cochabamba","Mizque","Mizque","COLEGIO PEDRO IGNACIO RIVERO",-65.35332,-17.94529,629,74,4377,5006,1495,205,2603,4098
"Bolivia","Cochabamba","Mizque","Mizque","ESCUELA AGUADA",-65.30665,-18.00293,124,14,586,710,74,22,476,550
"Bolivia","Cochabamba","Mizque","Mizque","ESCUELA GUILLERMO VISCARRA",-65.30976,-17.91031,74,6,511,585,41,13,451,492
"Bolivia","Cochabamba","Mizque","Mizque","ESCUELA MIXTA DR. MARTIN CARDENAS",-65.54247,-18.22179,134,26,854,988,239,43,546,785
"Bolivia","Cochabamba","Mizque","Mizque","NUCLEO CENTRO SALVIA",-65.33526,-18.14982,22,4,248,270,16,9,219,235
"Bolivia","Cochabamba","Mizque","Mizque","NUCLEO ESCOLAR BETA RAQAY PAMPA",-65.38233,-18.19124,153,18,1127,1280,27,36,1046,1073
"Bolivia","Cochabamba","Mizque","Mizque","NUCLEO ESCOLAR LAGUNA GRANDE",-65.37489,-18.30198,104,19,827,931,40,18,750,790
"Bolivia","Cochabamba","Mizque","Mizque","NUCLEO JOSÉ CLAURE (U. E. SAN VICENTE)",-65.53803,-18.16495,61,3,353,414,23,8,319,342
"Bolivia","Cochabamba","Mizque","Mizque","SEDE CENTRAL CAMPESINA (KURI)",-65.45872,-17.83207,21,6,295,316,30,14,245,275
"Bolivia","Cochabamba","Mizque","Mizque","SEDE SINDICAL DE CHAHUARANI CHICO",-65.52352,-18.05988,7,8,211,218,13,10,180,193
"Bolivia","Cochabamba","Mizque","Mizque","SEDE SOCIAL DE TIPA TIPA",-65.26866,-18.09922,69,28,479,548,114,16,321,435
"Bolivia","Cochabamba","Mizque","Mizque","UNIDAD EDUCATIVA CAUTA",-65.43818,-18.09074,24,3,175,199,21,9,142,163
"Bolivia","Cochabamba","Mizque","Mizque","UNIDAD EDUCATIVA MOLINERO",-65.38817,-18.26225,56,9,299,355,17,14,259,276
"Bolivia","Cochabamba","Mizque","Mizque","UNIDAD EDUCATIVA SANTIAGO",-65.32516,-18.20377,20,8,313,333,14,10,281,295
"Bolivia","Cochabamba","Mizque","Mizque","UNIDAD EDUCATIVA THAGO THAGO",-65.3672,-17.9808,35,14,447,482,69,27,337,406
"Bolivia","Cochabamba","Mizque","Mizque","UNIDAD EDUCATIVA TIN TIN",-65.45436,-18.0311,114,18,699,813,135,23,523,658
"Bolivia","Cochabamba","Mizque","Mizque","UNIDAD EDUCATIVA UCHHAMA ALTA",-65.50367,-17.95332,9,0,139,148,5,1,133,138
"Bolivia","Cochabamba","Mizque","Vila Vila","ESCUELA HUMBERTO NOGALES",-65.62921,-17.98482,123,16,674,797,51,11,596,647
"Bolivia","Cochabamba","Mizque","Vila Vila","NUCLEO ESCOLAR SIQUIMIRA",-65.73359,-18.01842,37,3,386,423,12,4,367,379
"Bolivia","Cochabamba","Mizque","Vila Vila","NUCLEO ESCOLAR SIVINGANI",-65.68718,-17.91458,60,15,290,350,37,17,221,258
"Bolivia","Cochabamba","Mizque","Vila Vila","UNIDAD EDUCATIVA POCOTAICA",-65.78678,-17.93137,10,1,71,81,4,2,64,68
"Bolivia","Cochabamba","Punata","Cuchumuela (Villa Gualberto Villarroel)","ESCUELA CUCHU MUELA",-65.7948,-17.65219,64,9,578,642,225,20,324,549
"Bolivia","Cochabamba","Punata","Cuchumuela (Villa Gualberto Villarroel)","NUCLEO ESCOLAR YANA RUMI",-65.74833,-17.70206,36,8,256,292,26,7,215,241
"Bolivia","Cochabamba","Punata","Punata","ESCUELA ADELA ZAMUDIO",-65.83555,-17.54252,855,54,4243,5098,1989,207,1993,3982
"Bolivia","Cochabamba","Punata","Punata","ESCUELA ANDRES MARIA TORRICO",-65.8345,-17.54389,632,57,3452,4084,1480,160,1755,3235
"Bolivia","Cochabamba","Punata","Punata","LICEO JOSEFA M. GANDARILLAS (EX SUCRE)",-65.83789,-17.54791,650,47,3300,3950,1624,155,1474,3098
"Bolivia","Cochabamba","Punata","Punata","SEDE SINDICAL THACO",-65.82087,-17.55312,66,14,552,618,147,24,367,514
"Bolivia","Cochabamba","Punata","Punata","U. E. MANUEL A. VILLARROEL (EX BOLIVAR)",-65.83459,-17.54425,640,39,3571,4211,1654,165,1713,3367
"Bolivia","Cochabamba","Punata","Punata","U. E. RENE BARRIENTOS O. - LA VILLA",-65.81705,-17.51416,113,29,506,619,101,21,355,456
"Bolivia","Cochabamba","Punata","Punata","U. E. RUBEN FERRUFINO (CAMACHO RANCHO)",-65.84141,-17.56411,126,18,747,873,222,38,469,691
"Bolivia","Cochabamba","Punata","Punata","UNIDAD EDUCATIVA MAYOR ROCHA (YACANAHUYO",-65.84713,-17.55166,96,25,771,867,308,36,402,710
"Bolivia","Cochabamba","Punata","Punata","UNIDAD EDUCATIVA MOLLE HUMA",-65.8109,-17.52157,84,19,555,639,111,19,406,517
"Bolivia","Cochabamba","Punata","Punata","UNIDAD EDUCATIVA TAJAMAR",-65.86192,-17.55713,95,22,744,839,308,39,375,683
"Bolivia","Cochabamba","Punata","Punata","UNIDAD EDUCATIVA TAMBILLO CHICO",-65.8281,-17.57144,59,8,387,446,108,24,247,355
"Bolivia","Cochabamba","Punata","San Benito (Villa José Quintín Mendoza)","COLEGIO SIMON BOLIVAR (HUARICAYA)",-65.92278,-17.52582,142,22,999,1141,294,24,659,953
"Bolivia","Cochabamba","Punata","San Benito (Villa José Quintín Mendoza)","ESCUELA EXPERIMENTAL PARACAYA",-65.85702,-17.5135,329,44,2533,2862,688,93,1708,2396
"Bolivia","Cochabamba","Punata","San Benito (Villa José Quintín Mendoza)","U. E. 27 DE MAYO (EX JOSE B. PEREIRA)",-65.89712,-17.52321,441,46,3114,3555,1004,98,1966,2970
"Bolivia","Cochabamba","Punata","San Benito (Villa José Quintín Mendoza)","UNIDAD EDUCATIVA SUNCHU PAMPA",-65.91961,-17.55873,150,20,801,951,210,28,543,753
"Bolivia","Cochabamba","Punata","San Benito (Villa José Quintín Mendoza)","UNIDAD EDUCATIVA WAÑAKAHUA",-65.8343,-17.51407,46,6,518,564,130,22,360,490
"Bolivia","Cochabamba","Punata","Tacachi","UNIDAD EDUCATIVA TACACHI",-65.80265,-17.63962,88,6,471,559,178,24,263,441
"Bolivia","Cochabamba","Punata","Villa Rivero","COL TEC IND COMUNITARIO MARCELO QUIROGA",-65.87885,-17.60502,543,36,2422,2965,385,75,1926,2311
"Bolivia","Cochabamba","Punata","Villa Rivero","ESCUELA GUALBERTO VILLARROEL (V. RIVERO)",-65.81674,-17.61485,393,42,1776,2169,719,86,929,1648
"Bolivia","Cochabamba","Punata","Villa Rivero","UNIDAD EDUCATIVA MARTÍN CÁRDENAS HERMOSO",-65.86461,-17.62572,37,5,258,295,35,6,212,247
"Bolivia","Cochabamba","Quillacollo","Colcapirhua","COLEGIO MAX FERNANDEZ",-66.23126,-17.39577,720,28,5274,5994,2955,156,2135,5090
"Bolivia","Cochabamba","Quillacollo","Colcapirhua","ESCUELA JESUS LARA",-66.22623,-17.39318,575,25,4805,5380,2928,110,1742,4670
"Bolivia","Cochabamba","Quillacollo","Colcapirhua","INSTITUTO MARÍA CRISTINA",-66.21936,-17.39718,263,6,1638,1901,968,40,624,1592
"Bolivia","Cochabamba","Quillacollo","Colcapirhua","SEDE SOCIAL CALLAJ CHULLPA (COLCAPIRHUA)",-66.24318,-17.35337,57,8,449,506,213,22,206,419
"Bolivia","Cochabamba","Quillacollo","Colcapirhua","SEDE SOCIAL DE LA OTB MARTIN CARDENAS (EX COMPLEJO EL CARMEN)",-66.21273,-17.3792,36,3,223,259,118,5,97,215
"Bolivia","Cochabamba","Quillacollo","Colcapirhua","U. E. PROF. BENEDICTO DURÁN ORTÍZ",-66.22591,-17.38681,85,1,708,793,385,23,299,684
"Bolivia","Cochabamba","Quillacollo","Colcapirhua","UNIDAD EDUCATIVA DANIEL SALAMANCA",-66.24152,-17.38778,843,58,6585,7428,3511,198,2818,6329
"Bolivia","Cochabamba","Quillacollo","Colcapirhua","UNIDAD EDUCATIVA EL SAUSALITO",-66.21352,-17.38681,645,28,5005,5650,2809,167,2001,4810
"Bolivia","Cochabamba","Quillacollo","Colcapirhua","UNIDAD EDUCATIVA LA SAGRADA FAMILIA",-66.22238,-17.38265,120,14,1624,1744,904,36,670,1574
"Bolivia","Cochabamba","Quillacollo","Colcapirhua","UNIDAD EDUCATIVA SAN JOSÉ DE KAMI",-66.23543,-17.36735,574,43,4339,4913,1944,168,2184,4128
"Bolivia","Cochabamba","Quillacollo","Colcapirhua","UNIDAD EDUCATIVA SAN LORENZO",-66.24113,-17.38883,71,6,718,789,373,15,324,697
"Bolivia","Cochabamba","Quillacollo","Colcapirhua","UNIDAD EDUCATIVA SIMON BOLIVAR (SUMUNPAYA)",-66.23511,-17.40263,15,2,144,159,48,7,87,135
"Bolivia","Cochabamba","Quillacollo","Quillacollo","(CÁRCEL) PENAL SAN PABLO",-66.28239,-17.40005,34,1,107,141,40,1,65,105
"Bolivia","Cochabamba","Quillacollo","Quillacollo","CENTRO INTEGRAL NIÑO JESUS FE Y ALEGRIA",-66.25516,-17.38777,128,10,1113,1241,581,32,490,1071
"Bolivia","Cochabamba","Quillacollo","Quillacollo","CENTRO INTERNADO MISICUNI",-66.32189,-17.1263,21,7,289,310,76,12,194,270
"Bolivia","Cochabamba","Quillacollo","Quillacollo","COLEGIO CRISTINA PRADA",-66.27902,-17.39269,299,8,2508,2807,1593,68,839,2432
"Bolivia","Cochabamba","Quillacollo","Quillacollo","COLEGIO FRANZ TAMAYO",-66.28081,-17.38829,700,32,5075,5775,3034,106,1903,4937
"Bolivia","Cochabamba","Quillacollo","Quillacollo","COLEGIO NACIONAL CALAMA (NUEVA INFRAESTRUCTURA)",-66.27234,-17.41193,23,2,105,128,51,3,49,100
"Bolivia","Cochabamba","Quillacollo","Quillacollo","ESCUELA 12 DE SEPTIEMBRE",-66.27923,-17.41147,676,43,4621,5297,2097,118,2363,4460
"Bolivia","Cochabamba","Quillacollo","Quillacollo","ESCUELA ARTURO QUITÓN",-66.27569,-17.36401,446,34,3281,3727,1260,115,1872,3132
"Bolivia","Cochabamba","Quillacollo","Quillacollo","ESCUELA FELIX MARTINEZ",-66.2527,-17.38772,1055,244,9354,10409,4711,319,4080,8791
"Bolivia","Cochabamba","Quillacollo","Quillacollo","ESCUELA FIDELIA C. DE SANCHEZ",-66.28062,-17.39867,212,10,2271,2483,1508,45,708,2216
"Bolivia","Cochabamba","Quillacollo","Quillacollo","ESCUELA SIMÓN BOLIVAR",-66.27937,-17.3954,498,23,3673,4171,2084,107,1459,3543
"Bolivia","Cochabamba","Quillacollo","Quillacollo","ESCUELA TOMAS BATA",-66.28063,-17.40219,423,33,3703,4126,2039,113,1518,3557
"Bolivia","Cochabamba","Quillacollo","Quillacollo","INSTITUTO PARTICULAR QUILLACOLLO",-66.28365,-17.39573,410,21,3415,3825,2173,94,1127,3300
"Bolivia","Cochabamba","Quillacollo","Quillacollo","INSTITUTO TECNOLOGICO EL PASO",-66.2566,-17.34972,110,12,999,1109,376,28,583,959
"Bolivia","Cochabamba","Quillacollo","Quillacollo","KINDER MARISCAL JOSE BALLIVIAN",-66.26795,-17.40211,523,27,2359,2882,1182,62,1088,2270
"Bolivia","Cochabamba","Quillacollo","Quillacollo","LICEO AMÉRICA",-66.28165,-17.39895,617,25,4759,5376,3114,116,1504,4618
"Bolivia","Cochabamba","Quillacollo","Quillacollo","NORMAL SIMÓN RODRÍGUEZ (EX NUCLEO ESCOLAR PAUCARPATA)",-66.297,-17.36322,388,19,2532,2920,1087,96,1330,2417
"Bolivia","Cochabamba","Quillacollo","Quillacollo","TEOFILO VARGAS CANDIA B",-66.27607,-17.38605,493,23,4126,4619,2284,116,1703,3987
"Bolivia","Cochabamba","Quillacollo","Quillacollo","U. E. JOSE MIGUEL LANZA (ILLATACO)",-66.29857,-17.3701,149,17,1435,1584,441,45,932,1373
"Bolivia","Cochabamba","Quillacollo","Quillacollo","U. E. MILIVOY ETEROVIC MATENDA",-66.26927,-17.39382,272,13,1861,2133,1012,47,789,1801
"Bolivia","Cochabamba","Quillacollo","Quillacollo","U. E. RENE BARRIENOS ORTUÑO (MISICUNI)",-66.32351,-17.11721,45,14,504,549,141,30,319,460
"Bolivia","Cochabamba","Quillacollo","Quillacollo","UNIDAD EDUCATIVA BELLA VISTA",-66.28169,-17.32156,636,70,3889,4525,1131,194,2494,3625
"Bolivia","Cochabamba","Quillacollo","Quillacollo","UNIDAD EDUCATIVA EL PASO",-66.26698,-17.33861,973,78,6333,7306,2231,217,3807,6038
"Bolivia","Cochabamba","Quillacollo","Quillacollo","UNIDAD EDUCATIVA FLORA SALINAS HINOJOSA - AMALIA ECHALAR DE",-66.27919,-17.39159,0,0,16,16,10,0,6,16
"Bolivia","Cochabamba","Quillacollo","Quillacollo","UNIDAD EDUCATIVA HEROINAS",-66.27933,-17.40064,334,18,2434,2768,1302,77,1037,2339
"Bolivia","Cochabamba","Quillacollo","Quillacollo","UNIDAD EDUCATIVA IRONCOLLO",-66.28701,-17.36173,552,61,4171,4723,1610,151,2349,3959
"Bolivia","Cochabamba","Quillacollo","Quillacollo","UNIDAD EDUCATIVA LIRIUNI",-66.29985,-17.28487,10,3,188,198,29,9,147,176
"Bolivia","Cochabamba","Quillacollo","Quillacollo","UNIDAD EDUCATIVA MARIA AUXILIADORA",-66.24287,-17.32961,77,11,760,837,304,36,409,713
"Bolivia","Cochabamba","Quillacollo","Quillacollo","UNIDAD EDUCATIVA MARQUINA",-66.28875,-17.33999,365,39,2802,3167,907,135,1721,2628
"Bolivia","Cochabamba","Quillacollo","Quillacollo","UNIDAD EDUCATIVA MARTIN CARDENAS",-66.29568,-17.38804,153,9,1253,1406,565,63,616,1181
"Bolivia","Cochabamba","Quillacollo","Quillacollo","UNIDAD EDUCATIVA NESTOR ADRIAZOLA (EX COLEGIO NACIONAL CALAMA)",-66.28477,-17.39367,948,52,6841,7789,3587,252,2950,6537
"Bolivia","Cochabamba","Quillacollo","Quillacollo","UNIDAD EDUCATIVA VILLA DE URKUPIÑA",-66.28946,-17.4192,302,28,2780,3082,795,88,1869,2664
"Bolivia","Cochabamba","Quillacollo","Quillacollo","UNIDAD EDUCATIVA VILLA MODERNA",-66.2822,-17.3884,303,13,2050,2353,1045,43,949,1994
"Bolivia","Cochabamba","Quillacollo","Sipe Sipe","ESC. RENE BARRIENTOS ORTUÑO (ITAPAYA)",-66.32016,-17.58389,181,19,1139,1320,312,49,759,1071
"Bolivia","Cochabamba","Quillacollo","Sipe Sipe","ESCUELA BOLVIANA AMERICANA",-66.36395,-17.41975,293,40,2375,2668,635,90,1610,2245
"Bolivia","Cochabamba","Quillacollo","Sipe Sipe","ESCUELA SUCRE (SIPE SIPE)",-66.35757,-17.45498,881,88,6828,7709,2186,297,4257,6443
"Bolivia","Cochabamba","Quillacollo","Sipe Sipe","UNIDAD EDUCATIVA 3 DE ABRIL",-66.33532,-17.4215,112,16,1405,1517,447,54,888,1335
"Bolivia","Cochabamba","Quillacollo","Sipe Sipe","UNIDAD EDUCATIVA ANDRES UZEDA OCAMPO",-66.35824,-17.45489,65,7,469,534,146,11,305,451
"Bolivia","Cochabamba","Quillacollo","Sipe Sipe","UNIDAD EDUCATIVA CARAMARCA COLLPA",-66.305,-17.45254,68,28,586,654,176,21,361,537
"Bolivia","Cochabamba","Quillacollo","Sipe Sipe","UNIDAD EDUCATIVA  CAVILOMA",-66.34575,-17.43804,22,15,549,571,158,27,349,507
"Bolivia","Cochabamba","Quillacollo","Sipe Sipe","UNIDAD EDUCATIVA EDUARDO ABAROA",-66.34507,-17.56399,394,75,2474,2868,645,111,1643,2288
"Bolivia","Cochabamba","Quillacollo","Sipe Sipe","UNIDAD EDUCATIVA SAUCE RANCHO",-66.32941,-17.42615,735,72,4872,5607,1711,205,2884,4595
"Bolivia","Cochabamba","Quillacollo","Sipe Sipe","UNIDAD EDUCATIVA SUTICOLLO",-66.33573,-17.46679,417,25,2313,2730,1040,95,1153,2193
"Bolivia","Cochabamba","Quillacollo","Sipe Sipe","UNIDAD EDUCATIVA TORIBIO CLAURE",-66.37673,-17.44035,12,4,353,365,36,9,304,340
"Bolivia","Cochabamba","Quillacollo","Sipe Sipe","UNIDAD EDUCATIVA UCHU UCHU",-66.47109,-17.37553,14,0,440,454,4,21,415,419
"Bolivia","Cochabamba","Quillacollo","Sipe Sipe","UNIDAD EDUCATIVA VILOMA",-66.37477,-17.41203,225,26,1574,1799,283,54,1211,1494
"Bolivia","Cochabamba","Quillacollo","Tiquipaya","ALDEAS S.O.S",-66.19316,-17.35118,340,19,2682,3022,1473,101,1089,2562
"Bolivia","Cochabamba","Quillacollo","Tiquipaya","COLEGIO CRISTO NACIÓN (UE BOLIVIA JAPÓN)",-66.19818,-17.34682,21,0,94,115,71,0,23,94
"Bolivia","Cochabamba","Quillacollo","Tiquipaya","COLEGIO SAN MIGUEL (TIQUIPAYA)",-66.2195,-17.33651,688,45,4701,5389,2299,146,2211,4510
"Bolivia","Cochabamba","Quillacollo","Tiquipaya","COLEGIO SIMON BOLIVAR (TIQUIPAYA)",-66.22029,-17.33622,844,65,5884,6728,2635,209,2975,5610
"Bolivia","Cochabamba","Quillacollo","Tiquipaya","ESCUELA EUGENIA RAVASCO",-66.20742,-17.36253,152,16,1392,1544,776,26,574,1350
"Bolivia","Cochabamba","Quillacollo","Tiquipaya","ESCUELA ISAAC ATTIE",-66.1954,-17.36948,236,12,2034,2270,1278,47,697,1975
"Bolivia","Cochabamba","Quillacollo","Tiquipaya","ESCUELA SECCIONAL WARIPUCARA",-66.2721,-17.02783,16,0,101,117,4,2,95,99
"Bolivia","Cochabamba","Quillacollo","Tiquipaya","ESCUELA TORIBIO CLAURE",-66.20433,-17.34466,847,55,6649,7496,3403,202,2989,6392
"Bolivia","Cochabamba","Quillacollo","Tiquipaya","NUCLEO EDUCATIVO CHAPISIRCA",-66.14425,-17.14807,111,24,1001,1112,93,31,853,946
"Bolivia","Cochabamba","Quillacollo","Tiquipaya","UNIDAD EDUCATIVA CUATRO ESQUINAS",-66.23293,-17.35942,144,13,1279,1423,669,39,558,1227
"Bolivia","Cochabamba","Quillacollo","Tiquipaya","UNIDAD EDUCATIVA JESUS MAESTRO",-66.19382,-17.333,68,14,988,1056,412,35,527,939
"Bolivia","Cochabamba","Quillacollo","Tiquipaya","UNIDAD EDUCATIVA LIBERTAD",-66.19286,-17.34593,615,33,4959,5574,2443,159,2324,4767
"Bolivia","Cochabamba","Quillacollo","Tiquipaya","UNIDAD EDUCATIVA MONTECILLO",-66.34388,-16.97306,22,1,240,262,8,4,227,235
"Bolivia","Cochabamba","Quillacollo","Tiquipaya","UNIDAD EDUCATIVA NUESTRA SRA. DE ALTAGRACIA",-66.24353,-17.35297,47,5,335,382,156,15,159,315
"Bolivia","Cochabamba","Quillacollo","Vinto","ESCUELA ISMAEL MONTES",-66.32672,-17.3703,394,34,2914,3308,1177,162,1541,2718
"Bolivia","Cochabamba","Quillacollo","Vinto","ESCUELA MARTÍN CARDENAS",-66.31405,-17.40174,924,66,6104,7028,2607,210,3221,5828
"Bolivia","Cochabamba","Quillacollo","Vinto","ESCUELA MELCHOR CUADROS",-66.31646,-17.39582,1244,76,9163,10407,4501,378,4208,8709
"Bolivia","Cochabamba","Quillacollo","Vinto","NUCLEO ESCOLAR SIMON BOLIVAR (THIOMOKO)",-66.34605,-17.39735,86,21,839,925,136,44,638,774
"Bolivia","Cochabamba","Quillacollo","Vinto","UNIDAD EDUCATIVA ANOCARAIRE",-66.31851,-17.38117,411,55,3719,4130,1396,154,2114,3510
"Bolivia","Cochabamba","Quillacollo","Vinto","UNIDAD EDUCATIVA DAVID ARZABE",-66.31459,-17.39948,95,14,968,1063,359,45,550,909
"Bolivia","Cochabamba","Quillacollo","Vinto","UNIDAD EDUCATIVA KERAYA",-66.45165,-17.29583,30,3,286,316,13,5,265,278
"Bolivia","Cochabamba","Quillacollo","Vinto","UNIDAD EDUCATIVA REINO UNIDO",-66.33875,-17.38365,495,77,4437,4932,1328,227,2805,4133
"Bolivia","Cochabamba","Quillacollo","Vinto","UNIDAD EDUCATIVA SAGRADA FAMILIA",-66.31983,-17.39161,318,28,1980,2298,892,91,969,1861
"Bolivia","Cochabamba","Tapacarí","Tapacarí","ESCUELA  CHALLA GRANDE",-66.64311,-17.70757,43,17,344,387,107,30,190,297
"Bolivia","Cochabamba","Tapacarí","Tapacarí","ESCUELA CHUÑU CHUÑINI",-66.59262,-17.69916,7,2,420,427,28,6,384,412
"Bolivia","Cochabamba","Tapacarí","Tapacarí","ESCUELA MONSEÑOR ANGEL GELMI",-66.55774,-17.61193,80,12,464,544,17,13,422,439
"Bolivia","Cochabamba","Tapacarí","Tapacarí","NUCLEO ESCOLAR CHARAPAYA",-66.75413,-17.36775,41,1,233,274,8,4,220,228
"Bolivia","Cochabamba","Tapacarí","Tapacarí","NUCLEO ESCOLAR CONFITAL",-66.73165,-17.67827,43,10,397,440,37,20,330,367
"Bolivia","Cochabamba","Tapacarí","Tapacarí","U.E. ARASAYA",-66.59817,-17.4361,2,2,152,154,3,3,144,147
"Bolivia","Cochabamba","Tapacarí","Tapacarí","U.E. CHILLCA GRANDE",-66.63358,-17.59493,1,1,170,171,7,1,161,168
"Bolivia","Cochabamba","Tapacarí","Tapacarí","U.E. LACOLACONI",-66.83026,-17.65938,3,5,273,276,21,15,232,253
"Bolivia","Cochabamba","Tapacarí","Tapacarí","U.E. LACUYO",-66.68685,-17.63514,69,12,554,623,46,25,471,517
"Bolivia","Cochabamba","Tapacarí","Tapacarí","UNIDAD EDUCATIVA APHARUMIRI",-66.54695,-17.53054,17,0,184,201,0,9,175,175
"Bolivia","Cochabamba","Tapacarí","Tapacarí","UNIDAD EDUCATIVA CALLIRI",-66.48114,-17.53546,5,0,53,58,0,1,52,52
"Bolivia","Cochabamba","Tapacarí","Tapacarí","UNIDAD EDUCATIVA CENTRAL VILLA PEREIRA",-66.7868,-17.44669,80,20,532,612,43,24,445,488
"Bolivia","Cochabamba","Tapacarí","Tapacarí","UNIDAD EDUCATIVA CHULLPA K'ASA",-66.43821,-17.62975,23,0,184,207,13,6,165,178
"Bolivia","Cochabamba","Tapacarí","Tapacarí","UNIDAD EDUCATIVA JAPO K'ASA",-66.7634,-17.6955,84,9,749,833,60,24,656,716
"Bolivia","Cochabamba","Tapacarí","Tapacarí","UNIDAD EDUCATIVA KATARIRI",-66.51272,-17.63324,27,9,423,450,24,12,378,402
"Bolivia","Cochabamba","Tapacarí","Tapacarí","UNIDAD EDUCATIVA KJARKAS",-66.521,-17.69701,33,11,356,389,46,23,276,322
"Bolivia","Cochabamba","Tapacarí","Tapacarí","UNIDAD EDUCATIVA LLAVINI",-66.41062,-17.66616,20,1,327,347,47,11,268,315
"Bolivia","Cochabamba","Tapacarí","Tapacarí","UNIDAD EDUCATIVA NORBERTO JIMENEZ",-66.81584,-17.50673,119,17,391,510,42,23,309,351
"Bolivia","Cochabamba","Tapacarí","Tapacarí","UNIDAD EDUCATIVA RAMADAS",-66.47381,-17.55251,114,7,741,855,85,24,625,710
"Bolivia","Cochabamba","Tapacarí","Tapacarí","UNIDAD EDUCATIVA SAN ANTONIO",-66.83088,-17.54268,33,2,258,291,30,5,221,251
"Bolivia","Cochabamba","Tapacarí","Tapacarí","UNIDAD EDUCATIVA SUCRE",-66.62051,-17.5165,226,18,1465,1691,36,127,1284,1320
"Bolivia","Cochabamba","Tapacarí","Tapacarí","UNIDAD EDUCATIVA TUNAS VINTO-APHARUMIRI",-66.54695,-17.53053,75,6,514,589,10,25,473,483
"Bolivia","Cochabamba","Tapacarí","Tapacarí","UNIDAD EDUCATIVA WACA PLAYA",-66.48648,-17.45753,149,22,864,1013,55,23,764,819
"Bolivia","Cochabamba","Tiraque","Shinahota","ESCUELA GERMAN BUSCH",-65.24871,-16.99495,1092,99,6453,7545,1798,231,4325,6123
"Bolivia","Cochabamba","Tiraque","Shinahota","U.E. DEMETRIO CANELAS",-65.22605,-16.99467,10,3,249,259,23,3,220,243
"Bolivia","Cochabamba","Tiraque","Shinahota","U. E. MARCELO QUIROGA SANTA CRUZ",-65.22232,-17.07844,62,9,707,769,91,24,583,674
"Bolivia","Cochabamba","Tiraque","Shinahota","U.E. MARISCAL SUCRE",-65.2549,-16.99571,18,5,195,213,24,9,157,181
"Bolivia","Cochabamba","Tiraque","Shinahota","U.E. SAN LUIS",-65.28136,-16.95968,19,4,475,494,29,5,437,466
"Bolivia","Cochabamba","Tiraque","Shinahota","UNIDAD EDUCATIVA 4 DE ABRIL",-65.27142,-17.03861,15,1,326,341,16,8,301,317
"Bolivia","Cochabamba","Tiraque","Shinahota","UNIDAD EDUCATIVA CHURO GRANDE",-65.33322,-17.05208,12,1,222,234,11,4,206,217
"Bolivia","Cochabamba","Tiraque","Shinahota","UNIDAD EDUCATIVA IBUELO",-65.33987,-16.96962,400,29,1247,1647,203,24,991,1194
"Bolivia","Cochabamba","Tiraque","Shinahota","UNIDAD EDUCATIVA IVIRIZU VANDIOLA",-65.46212,-17.06077,61,9,388,449,55,11,313,368
"Bolivia","Cochabamba","Tiraque","Shinahota","UNIDAD EDUCATIVA MAJO PAMPA A",-65.36292,-17.03242,14,2,281,295,11,2,266,277
"Bolivia","Cochabamba","Tiraque","Shinahota","UNIDAD EDUCATIVA PUERTO AROMA",-65.17721,-17.12901,5,1,72,77,12,1,58,70
"Bolivia","Cochabamba","Tiraque","Shinahota","UNIDAD EDUCATIVA SAN ISIDRO",-65.32017,-16.99914,29,11,826,855,42,10,763,805
"Bolivia","Cochabamba","Tiraque","Tiraque","COLEGIO JUAN JOSE CARRASCO",-65.72145,-17.42393,833,150,5741,6574,1161,271,4159,5320
"Bolivia","Cochabamba","Tiraque","Tiraque","ESCUELA COTANI BAJO",-65.78638,-17.38104,64,13,802,866,119,80,590,709
"Bolivia","Cochabamba","Tiraque","Tiraque","ESCUELA KOARI (NUCLEO ESC. S. BOLIVAR)",-65.57632,-17.47923,174,19,1153,1327,119,62,953,1072
"Bolivia","Cochabamba","Tiraque","Tiraque","ESCUELA SECCIONAL PAIRUMANI",-65.48745,-17.4773,87,9,709,796,69,20,611,680
"Bolivia","Cochabamba","Tiraque","Tiraque","ESCUELA SECCIONAL SACABAMBILLA",-65.76513,-17.4795,40,7,367,407,54,25,281,335
"Bolivia","Cochabamba","Tiraque","Tiraque","NUCLEO ESCOLAR ILURI GRANDE",-65.82572,-17.39656,0,16,662,662,80,40,526,606
"Bolivia","Cochabamba","Tiraque","Tiraque","UNIDAD EDUCATIVA 3 DE AGOSTO",-65.46495,-17.54261,24,4,344,368,38,19,283,321
"Bolivia","Cochabamba","Tiraque","Tiraque","UNIDAD EDUCATIVA PALCA T",-65.77904,-17.41067,14,4,125,139,29,4,88,117
"Bolivia","Cochabamba","Tiraque","Tiraque","UNIDAD EDUCATIVA RODEO",-65.76229,-17.3932,26,17,307,333,40,21,229,269
"Bolivia","La Paz","Abel Iturralde","Ixiamas","ESC. ESPERANZA DEL MADIDI",-67.17106,-12.61393,46,4,130,176,58,0,68,126
"Bolivia","La Paz","Abel Iturralde","Ixiamas","ESC. GERMAN BUSCH",-68.12748,-13.76644,695,27,2273,2968,993,78,1175,2168
"Bolivia","La Paz","Abel Iturralde","Ixiamas","ESCUELA NUEVA IDIAMAS",-68.44615,-13.64052,7,0,10,17,2,0,8,10
"Bolivia","La Paz","Abel Iturralde","Ixiamas","ESCUELA PUERTO ARAONA",-67.77129,-12.52156,34,0,14,48,1,0,13,14
"Bolivia","La Paz","Abel Iturralde","Ixiamas","ESCUELA PUERTO PEREZ",-68.55753,-12.44095,85,0,134,219,111,2,21,132
"Bolivia","La Paz","Abel Iturralde","Ixiamas","ESCUELA TOMAS CATARI",-68.5165,-13.60102,16,1,110,126,11,1,97,108
"Bolivia","La Paz","Abel Iturralde","Ixiamas","ESCUELA VILLA FATIMA",-67.51065,-13.81614,4,0,25,29,16,0,9,25
"Bolivia","La Paz","Abel Iturralde","Ixiamas","ESC. UNIDAD EDUCATIVA DE TAHUA",-67.90891,-13.86159,19,0,107,126,50,1,56,106
"Bolivia","La Paz","Abel Iturralde","Ixiamas","SEDE DEL CARMEN DEL EMERO",-67.37585,-13.38387,10,0,65,75,61,0,4,65
"Bolivia","La Paz","Abel Iturralde","Ixiamas","U.E. MANURIMI",-67.69769,-12.04555,67,2,107,174,41,0,64,105
"Bolivia","La Paz","Abel Iturralde","Ixiamas","UNIDAD EDUCATIVA 10 DE ABRIL",-68.06606,-13.78335,3,2,72,75,39,2,29,68
"Bolivia","La Paz","Abel Iturralde","Ixiamas","UNIDAD EDUCATIVA EL TIGRE",-68.05921,-11.99998,23,0,53,76,31,1,21,52
"Bolivia","La Paz","Abel Iturralde","San Buenaventura","COL. TUMUPASA B",-67.88744,-14.14472,157,13,986,1143,414,22,537,951
"Bolivia","La Paz","Abel Iturralde","San Buenaventura","ESC. CHAUPY YACHAY HUASI",-68.05549,-14.21644,30,2,120,150,67,5,46,113
"Bolivia","La Paz","Abel Iturralde","San Buenaventura","ESCUELA JOSE MANUEL PANDO",-67.53542,-14.43845,580,38,2262,2842,941,71,1212,2153
"Bolivia","La Paz","Abel Iturralde","San Buenaventura","UNIDAD EDUCATIVA CENTRAL BUENA VISTA",-67.58383,-14.37968,32,4,157,189,52,3,98,150
"Bolivia","La Paz","Abel Iturralde","San Buenaventura","UNIDAD EDUCATIVA SAN MIGUEL",-67.52943,-14.4718,10,1,88,98,32,1,54,86
"Bolivia","La Paz","Aroma","Ayo Ayo","CASA DE GOBIERNO",-68.014,-17.18632,5,4,115,120,17,3,91,108
"Bolivia","La Paz","Aroma","Ayo Ayo","COL. AYO AYO",-68.00532,-17.09241,163,30,1714,1877,426,62,1196,1622
"Bolivia","La Paz","Aroma","Ayo Ayo","COLEGIO JOSÉ BALLIVIÁN",-68.08076,-17.17401,11,0,141,152,40,8,93,133
"Bolivia","La Paz","Aroma","Ayo Ayo","ESC. CALACACHI",-68.14827,-17.06024,45,10,492,537,194,13,275,469
"Bolivia","La Paz","Aroma","Ayo Ayo","ESC. FRANZ TAMAYO",-68.06002,-17.01099,73,15,789,862,230,22,522,752
"Bolivia","La Paz","Aroma","Ayo Ayo","ESC. STA. ROSA DE LIMA",-68.06953,-17.13371,46,6,282,328,75,7,194,269
"Bolivia","La Paz","Aroma","Calamarca","CASA DE GOBIERNO",-68.1799,-16.90021,80,6,1022,1102,295,65,656,951
"Bolivia","La Paz","Aroma","Calamarca","CASA DE GOBIERNO",-68.08315,-16.96971,80,6,1022,1102,295,65,656,951
"Bolivia","La Paz","Aroma","Calamarca","ESC. CENTRAL CHORITOTORA",-68.08884,-16.84568,47,18,404,451,52,18,316,368
"Bolivia","La Paz","Aroma","Calamarca","ESCUELA EDUARDO AVAROA",-68.16341,-16.85044,63,6,540,603,122,14,398,520
"Bolivia","La Paz","Aroma","Calamarca","PLAZA 14 DE SEPTIEMBRE",-68.11526,-16.90584,131,25,1422,1553,612,49,736,1348
"Bolivia","La Paz","Aroma","Calamarca","PLAZA 16 DE JULIO",-68.13773,-16.78787,43,5,470,513,120,30,315,435
"Bolivia","La Paz","Aroma","Calamarca","PLAZA 6 DE AGOSTO",-68.17797,-16.79795,70,22,1143,1213,325,50,746,1071
"Bolivia","La Paz","Aroma","Calamarca","PLAZA PRINCIPAL",-68.14911,-16.99117,49,9,497,546,150,22,316,466
"Bolivia","La Paz","Aroma","Calamarca","PLAZA TOTORANI",-68.17602,-16.96187,71,4,406,477,107,11,284,391
"Bolivia","La Paz","Aroma","Calamarca","U.E. JUAN JOSÉ TORREZ",-68.08725,-16.75592,32,16,439,471,109,20,294,403
"Bolivia","La Paz","Aroma","Calamarca","UNIDAD EDUCATIVA FRANZ TAMAYO",-68.1254,-16.85869,19,6,361,380,68,11,276,344
"Bolivia","La Paz","Aroma","Calamarca","UNIDAD EDUCATIVA SUCANAVI",-68.07444,-16.93009,5,3,139,144,46,6,84,130
"Bolivia","La Paz","Aroma","Collana","CASA SOCIAL",-68.23739,-16.84444,9,0,188,197,31,4,153,184
"Bolivia","La Paz","Aroma","Collana","SEDE SOCIAL",-68.28757,-16.88153,164,24,1652,1816,594,60,974,1568
"Bolivia","La Paz","Aroma","Collana","SEDE SOCIAL",-68.28442,-16.90426,164,24,1652,1816,594,60,974,1568
"Bolivia","La Paz","Aroma","Colquencha","ESC. LADISLAO CABRERA",-68.20877,-16.87736,80,13,743,823,172,32,526,698
"Bolivia","La Paz","Aroma","Colquencha","ESCUELA LITORAL",-68.22531,-16.95084,14,0,184,198,40,5,139,179
"Bolivia","La Paz","Aroma","Colquencha","PLAZA 15 DE AGOSTO",-68.24931,-16.93275,132,25,1862,1994,575,84,1178,1753
"Bolivia","La Paz","Aroma","Colquencha","SEDE SOCIAL",-68.27126,-16.91852,61,20,907,968,286,24,577,863
"Bolivia","La Paz","Aroma","Patacamaya","CASA DE GOBIERNO",-67.87502,-17.19816,27,2,300,327,48,8,242,290
"Bolivia","La Paz","Aroma","Patacamaya","COLEGIO 23 DE MARZO",-67.95469,-17.27477,20,0,487,507,90,11,386,476
"Bolivia","La Paz","Aroma","Patacamaya","COLEGIO FRANZ TAMAYO",-68.02139,-17.22715,53,16,546,599,109,17,404,513
"Bolivia","La Paz","Aroma","Patacamaya","ESC. ROBERTO PABON",-67.91753,-17.24177,967,89,6002,6969,1989,171,3753,5742
"Bolivia","La Paz","Aroma","Patacamaya","ESC. SECCIONAL JATUQUIRA",-67.85796,-17.26879,3,2,64,67,16,2,44,60
"Bolivia","La Paz","Aroma","Patacamaya","ESC. TAYPILLANGA",-67.90216,-17.30549,20,5,395,415,78,9,303,381
"Bolivia","La Paz","Aroma","Patacamaya","ESCUELA COLCHANI",-67.85081,-17.23891,3,15,432,435,85,21,311,396
"Bolivia","La Paz","Aroma","Patacamaya","NUCLEO EDUCATIVO BELEN IQUIACA",-67.94446,-17.1978,23,4,333,356,66,9,254,320
"Bolivia","La Paz","Aroma","Patacamaya","PLAZA 16 DE JULIO",-67.87547,-17.18134,28,3,398,426,80,12,303,383
"Bolivia","La Paz","Aroma","Patacamaya","SEDE MUNICIPAL",-67.82513,-17.22678,2,0,138,140,42,2,94,136
"Bolivia","La Paz","Aroma","Patacamaya","SEDE SOCIAL",-67.92398,-17.28475,43,11,434,477,94,15,314,408
"Bolivia","La Paz","Aroma","Patacamaya","SEDE SOCIAL",-67.9968,-17.24903,43,11,434,477,94,15,314,408
"Bolivia","La Paz","Aroma","Patacamaya","U.E. GERMAN BUSCH",-67.91753,-17.24177,40,5,484,524,210,11,258,468
"Bolivia","La Paz","Aroma","Patacamaya","UNIDAD EDUCATIVA MURUCHAPI",-67.82782,-17.13052,7,0,49,56,7,1,41,48
"Bolivia","La Paz","Aroma","Patacamaya","UNIDAD EDUCATIVA VISCACHANI",-67.9495,-17.17933,61,19,682,743,123,8,532,655
"Bolivia","La Paz","Aroma","Sica Sica (Villa Aroma)","CASA DE GOBIERNO",-67.8598,-17.34229,5,2,361,366,75,17,267,342
"Bolivia","La Paz","Aroma","Sica Sica (Villa Aroma)","COL. 6 DE JUNIO",-67.46742,-17.23661,2,0,151,153,0,0,151,151
"Bolivia","La Paz","Aroma","Sica Sica (Villa Aroma)","COLEGIO TAWANTINSUYO",-67.63738,-17.38684,11,2,371,382,79,8,282,361
"Bolivia","La Paz","Aroma","Sica Sica (Villa Aroma)","COL. NAL. SICA SICA",-67.7421,-17.33211,161,26,1285,1446,530,42,687,1217
"Bolivia","La Paz","Aroma","Sica Sica (Villa Aroma)","COL. TOMAS KATARI",-67.58031,-17.22041,2,3,305,307,21,7,274,295
"Bolivia","La Paz","Aroma","Sica Sica (Villa Aroma)","ESC. JOSE M. PANDO",-67.44505,-17.49286,61,3,447,508,87,4,353,440
"Bolivia","La Paz","Aroma","Sica Sica (Villa Aroma)","ESCUELA EDEN",-67.67335,-17.37538,276,32,2399,2675,700,96,1571,2271
"Bolivia","La Paz","Aroma","Sica Sica (Villa Aroma)","ESCUELA SIMON BOLIVAR",-67.5736,-17.39699,50,7,522,572,90,18,407,497
"Bolivia","La Paz","Aroma","Sica Sica (Villa Aroma)","PLAZA CANTON MACHACAMARCA",-67.59753,-17.45224,49,8,427,476,116,22,281,397
"Bolivia","La Paz","Aroma","Sica Sica (Villa Aroma)","PLAZA PRINCIPAL JARUMA",-67.57709,-17.26054,100,2,640,740,125,16,497,622
"Bolivia","La Paz","Aroma","Sica Sica (Villa Aroma)","PLAZA SAN FRANCISCO",-67.79234,-17.38375,27,1,222,249,40,1,180,220
"Bolivia","La Paz","Aroma","Sica Sica (Villa Aroma)","SEDE SOCIAL AYAMAYA",-67.7303,-17.3847,10,2,253,263,69,4,178,247
"Bolivia","La Paz","Aroma","Sica Sica (Villa Aroma)","UNIDAD EDUCATIVA BARTOLINA SISA A",-67.82572,-17.38552,17,1,191,208,34,1,155,189
"Bolivia","La Paz","Aroma","Sica Sica (Villa Aroma)","UNIDAD EDUCATIVA CHUACOLLO GRANDE",-67.6738,-17.2105,7,3,161,168,12,1,145,157
"Bolivia","La Paz","Aroma","Sica Sica (Villa Aroma)","UNIDAD EDUCATIVA CONANI",-67.52164,-17.43539,169,35,1726,1895,480,64,1147,1627
"Bolivia","La Paz","Aroma","Sica Sica (Villa Aroma)","UNIDAD EDUCATIVA PEDRO DOMINGO MURILLO",-67.51456,-17.48516,17,13,662,679,163,17,469,632
"Bolivia","La Paz","Aroma","Umala","CASA DE GOBIERNO",-67.9584,-17.4303,96,23,788,884,231,40,494,725
"Bolivia","La Paz","Aroma","Umala","CASA DE GOBIERNO",-68.03399,-17.33216,96,23,788,884,231,40,494,725
"Bolivia","La Paz","Aroma","Umala","COL. DE VENTILLA",-68.10613,-17.29234,21,5,312,333,68,9,230,298
"Bolivia","La Paz","Aroma","Umala","COL. NAL. MIXTO SAN JOSE",-67.93179,-17.39158,28,3,337,365,89,13,232,321
"Bolivia","La Paz","Aroma","Umala","ESCUELA SAN MIGUEL DE COPANI",-68.06709,-17.33392,32,8,248,280,45,14,181,226
"Bolivia","La Paz","Aroma","Umala","PLAZA 16 DE JULIO",-68.02159,-17.37343,77,9,478,555,133,18,318,451
"Bolivia","La Paz","Aroma","Umala","PLAZA HUARI BELEN 6 DE AGOSTO",-68.00945,-17.46336,69,2,428,497,79,6,341,420
"Bolivia","La Paz","Aroma","Umala","PLAZA VITUY VINTO",-68.17715,-17.36859,23,1,231,254,70,4,156,226
"Bolivia","La Paz","Aroma","Umala","SEDE SOCIAL",-68.11279,-17.35408,51,1,321,372,78,13,229,307
"Bolivia","La Paz","Aroma","Umala","U.E. KELLHUIRI",-68.15555,-17.32532,8,5,200,208,32,7,156,188
"Bolivia","La Paz","Aroma","Umala","UNIDAD EDUCATIVA LLANGA BELEN",-67.90632,-17.3479,35,4,238,273,89,8,137,226
"Bolivia","La Paz","Bautista Saavedra","Curva","CASA DE GOBIERNO",-69.03347,-15.10095,34,2,118,152,26,11,79,105
"Bolivia","La Paz","Bautista Saavedra","Curva","ESCUELA KAPNA",-68.90353,-14.95543,9,1,43,52,5,5,32,37
"Bolivia","La Paz","Bautista Saavedra","Curva","NUCLEO ESCOLAR UPINUAYA",-69.02789,-15.13118,18,4,86,104,13,2,67,80
"Bolivia","La Paz","Bautista Saavedra","Curva","RECINTO TAIPI CANUMA",-69.13345,-15.03614,0,0,189,189,18,2,169,187
"Bolivia","La Paz","Bautista Saavedra","Curva","SEDE COMUNAL",-68.87193,-14.87294,3,0,25,28,8,0,17,25
"Bolivia","La Paz","Bautista Saavedra","Curva","SEDE SOCIAL",-69.00313,-15.12604,65,8,255,320,52,25,170,222
"Bolivia","La Paz","Bautista Saavedra","Curva","SEDE SOCIAL",-69.00817,-15.12213,65,8,255,320,52,25,170,222
"Bolivia","La Paz","Bautista Saavedra","Curva","SEDE SOCIAL",-69.00968,-15.0953,65,8,255,320,52,25,170,222
"Bolivia","La Paz","Bautista Saavedra","General Juan José Pérez (Charazani)","CALLINSANI",-68.89539,-15.22253,22,8,153,175,21,4,120,141
"Bolivia","La Paz","Bautista Saavedra","General Juan José Pérez (Charazani)","CASA DE GOBIERNO",-68.94041,-15.13295,27,6,197,224,31,13,147,178
"Bolivia","La Paz","Bautista Saavedra","General Juan José Pérez (Charazani)","ESCUELA ATIQUE",-68.93712,-15.19225,7,3,64,71,7,1,53,60
"Bolivia","La Paz","Bautista Saavedra","General Juan José Pérez (Charazani)","ESCUELA CENTRAL MOYAPAMPA",-69.00706,-15.26653,22,2,132,154,28,11,91,119
"Bolivia","La Paz","Bautista Saavedra","General Juan José Pérez (Charazani)","ESCUELA CHARAZANI",-68.98535,-15.17054,116,31,590,706,130,41,388,518
"Bolivia","La Paz","Bautista Saavedra","General Juan José Pérez (Charazani)","ESCUELA GENERAL RAMON GONZALES",-69.0027,-15.19276,22,4,117,139,14,3,96,110
"Bolivia","La Paz","Bautista Saavedra","General Juan José Pérez (Charazani)","ESCUELA PAUJE YUYO",-68.45623,-15.05983,29,0,122,151,18,3,101,119
"Bolivia","La Paz","Bautista Saavedra","General Juan José Pérez (Charazani)","ESCUELA SECCIONAL CHARI",-69.041,-15.17468,0,4,141,141,13,8,116,129
"Bolivia","La Paz","Bautista Saavedra","General Juan José Pérez (Charazani)","ESCUELA SECCIONAL SIATHA",-68.68688,-15.20615,16,2,105,121,18,4,81,99
"Bolivia","La Paz","Bautista Saavedra","General Juan José Pérez (Charazani)","PLAZA 26 DE JULIO",-68.75932,-15.22727,16,3,91,107,15,9,64,79
"Bolivia","La Paz","Bautista Saavedra","General Juan José Pérez (Charazani)","PLAZA AMARKA",-69.05107,-15.22568,44,3,228,272,51,8,166,217
"Bolivia","La Paz","Bautista Saavedra","General Juan José Pérez (Charazani)","PLAZA PRINCIPAL AMARETE",-68.98066,-15.22867,121,26,1016,1137,156,49,785,941
"Bolivia","La Paz","Bautista Saavedra","General Juan José Pérez (Charazani)","SEDE SOCIAL",-69.00725,-15.14073,88,14,476,564,59,18,385,444
"Bolivia","La Paz","Bautista Saavedra","General Juan José Pérez (Charazani)","SEDE SOCIAL",-68.453,-15.13352,88,14,476,564,59,18,385,444
"Bolivia","La Paz","Bautista Saavedra","General Juan José Pérez (Charazani)","UNIDAD EDUCATIVA APACHETA",-69.12223,-15.14201,26,2,181,207,45,12,122,167
"Bolivia","La Paz","Bautista Saavedra","General Juan José Pérez (Charazani)","UNIDAD EDUCATIVA KALLURHUAYA",-68.84801,-15.1727,11,7,170,181,14,6,143,157
"Bolivia","La Paz","Camacho","Escoma","COLEGIO DON BOSCO",-69.1245,-15.64438,317,67,2520,2837,603,141,1709,2312
"Bolivia","La Paz","Camacho","Escoma","PLAZA 26 DE OCTUBRE",-69.15398,-15.6867,41,2,262,303,49,17,194,243
"Bolivia","La Paz","Camacho","Escoma","PLAZA PRINCIPAL",-69.16642,-15.65046,21,5,271,292,94,16,156,250
"Bolivia","La Paz","Camacho","Escoma","PLAZA PRINCIPAL DE COLLASUYO",-69.13799,-15.6649,1,2,121,122,30,0,89,119
"Bolivia","La Paz","Camacho","Humanata","COL. SAN FRANCISCO DE PADUA",-69.11379,-15.45604,246,62,1646,1892,381,165,1038,1419
"Bolivia","La Paz","Camacho","Humanata","COL. SANTA ANA DE CUTUCUTU",-69.18256,-15.43143,32,5,192,224,41,13,133,174
"Bolivia","La Paz","Camacho","Humanata","ESC. S.J. DE PACOLLO",-69.19728,-15.42445,13,1,220,233,58,7,154,212
"Bolivia","La Paz","Camacho","Mocomoco","COLEGIO CARIQUINA CHICO",-69.0692,-15.5392,21,3,133,154,24,9,97,121
"Bolivia","La Paz","Camacho","Mocomoco","COLEGIO TECNICO YOCARGUAYA",-69.0155,-15.58194,51,4,180,231,12,6,158,170
"Bolivia","La Paz","Camacho","Mocomoco","COL. SAN JOSE",-69.06486,-15.39754,19,7,352,371,84,15,246,330
"Bolivia","La Paz","Camacho","Mocomoco","COL. SAN LUIS WILA CALA",-69.04415,-15.35719,92,15,573,665,100,28,430,530
"Bolivia","La Paz","Camacho","Mocomoco","COL. TAJANI",-69.0649,-15.61726,37,14,438,475,105,30,289,394
"Bolivia","La Paz","Camacho","Mocomoco","ESC. QUILLIMA",-69.02345,-15.62034,14,0,363,377,73,14,276,349
"Bolivia","La Paz","Camacho","Mocomoco","ESC. SECCIONAL V. JACHATIRA",-69.03743,-15.53999,0,1,65,65,18,1,45,63
"Bolivia","La Paz","Camacho","Mocomoco","ESC. TUNTUNANI",-68.9683,-15.50293,24,3,102,126,18,2,79,97
"Bolivia","La Paz","Camacho","Mocomoco","ESC. UNIDAD EDUCATIVA PACAURES",-69.0611,-15.5844,67,25,528,595,83,21,399,482
"Bolivia","La Paz","Camacho","Mocomoco","NUCLEO ESCOLAR PUMANA",-69.02091,-15.51972,39,2,222,261,25,12,183,208
"Bolivia","La Paz","Camacho","Mocomoco","NÚCLEO ESCOLAR TAYPI AYCA",-69.08912,-15.5147,5,2,169,174,10,3,154,164
"Bolivia","La Paz","Camacho","Mocomoco","PLAZA MOCO MOCO",-68.99878,-15.45637,211,46,967,1178,262,78,581,843
"Bolivia","La Paz","Camacho","Mocomoco","PLAZA SANTIAGO DE ILAVE",-69.01241,-15.36129,79,19,464,543,75,23,347,422
"Bolivia","La Paz","Camacho","Mocomoco","SEDE SOCIAL",-69.08668,-15.61018,0,1,60,60,21,2,36,57
"Bolivia","La Paz","Camacho","Mocomoco","UNIDAD EDUCATIVA CAJCACHI",-69.0796,-15.59127,12,2,149,161,34,13,100,134
"Bolivia","La Paz","Camacho","Mocomoco","UNIDAD EDUCATIVA ITALAQUE",-69.04504,-15.47639,101,19,432,533,49,37,327,376
"Bolivia","La Paz","Camacho","Mocomoco","UNIDAD EDUCATIVA QUEÑI",-68.97206,-15.43503,56,8,199,255,60,15,116,176
"Bolivia","La Paz","Camacho","Puerto Acosta","COLEGIO NACIONAL MIXTO CHIÑAYA",-69.11092,-15.52736,89,24,447,536,102,29,292,394
"Bolivia","La Paz","Camacho","Puerto Acosta","COLEGIO NACIONAL SALLACUCHO",-69.20315,-15.49551,36,9,328,364,51,21,247,298
"Bolivia","La Paz","Camacho","Puerto Acosta","COL. NICOLAS ACOSTA",-69.25303,-15.53491,222,42,1690,1912,581,86,981,1562
"Bolivia","La Paz","Camacho","Puerto Acosta","ESC. COTA PATA",-69.21085,-15.61913,16,10,211,227,46,12,143,189
"Bolivia","La Paz","Camacho","Puerto Acosta","ESC. JUPANI",-69.25771,-15.49459,33,6,309,342,126,20,157,283
"Bolivia","La Paz","Camacho","Puerto Acosta","ESC. PUERTO BELEN",-69.28316,-15.59171,17,4,361,378,78,1,278,356
"Bolivia","La Paz","Camacho","Puerto Acosta","ESC. SECCIONAL CANCANANI",-69.10598,-15.479,9,2,56,65,4,0,50,54
"Bolivia","La Paz","Camacho","Puerto Acosta","ESCUELA CENTRO BELEN",-69.11071,-15.60047,19,6,232,251,68,10,148,216
"Bolivia","La Paz","Camacho","Puerto Acosta","ESCUELA CHACAHUARA",-69.31122,-15.49251,9,0,53,62,14,7,32,46
"Bolivia","La Paz","Camacho","Puerto Acosta","PLAZA PUERTO PARAJACHI",-69.20171,-15.62851,42,6,700,742,236,10,448,684
"Bolivia","La Paz","Camacho","Puerto Acosta","U.E. PARAJACHI II",-69.21049,-15.64598,12,0,147,159,41,6,100,141
"Bolivia","La Paz","Camacho","Puerto Acosta","UNIDAD EDUCATIVA CENTRO CALANGACHI",-69.25439,-15.63603,28,2,165,193,52,0,111,163
"Bolivia","La Paz","Camacho","Puerto Acosta","UNIDAD EDUCATIVA ORURILLO",-69.31892,-15.53868,9,2,144,153,58,8,76,134
"Bolivia","La Paz","Camacho","Puerto Carabuco","COLEGIO COTAÑANI",-68.96169,-15.61601,16,3,131,147,24,2,102,126
"Bolivia","La Paz","Camacho","Puerto Carabuco","COLEGIO MARTIN CARDENAS",-69.03745,-15.78911,215,25,1074,1289,355,64,630,985
"Bolivia","La Paz","Camacho","Puerto Carabuco","COLEGIO NACIONAL MIXTO CHUANI",-68.98556,-15.64204,33,7,347,380,75,23,242,317
"Bolivia","La Paz","Camacho","Puerto Carabuco","COLEGIO PASARANI",-68.9835,-15.57729,104,15,468,572,97,19,337,434
"Bolivia","La Paz","Camacho","Puerto Carabuco","ESC. MCAL. SUCRE",-68.96303,-15.6083,89,10,495,584,65,32,388,453
"Bolivia","La Paz","Camacho","Puerto Carabuco","ESC. S. M. DE YARICOA",-69.08703,-15.67951,28,8,232,260,50,22,152,202
"Bolivia","La Paz","Camacho","Puerto Carabuco","ESCUELA HUILACUNCA",-68.94692,-15.56903,62,19,296,358,53,13,211,264
"Bolivia","La Paz","Camacho","Puerto Carabuco","PLAZA PRINCIPAL COPUSQUIA",-68.95209,-15.66244,66,9,476,542,56,19,392,448
"Bolivia","La Paz","Camacho","Puerto Carabuco","PLAZA SISASANI",-68.98576,-15.81754,53,7,351,404,75,17,252,327
"Bolivia","La Paz","Camacho","Puerto Carabuco","UNID.EDU. URSULA GOYZUETA",-69.0638,-15.75902,216,37,1524,1740,381,83,1023,1404
"Bolivia","La Paz","Caranavi","Alto Beni","ESC. C. BELLA VISTA",-67.42459,-15.62154,67,6,483,550,130,30,317,447
"Bolivia","La Paz","Caranavi","Alto Beni","ESC. N. SARARIA",-67.51301,-15.39834,90,4,481,571,114,35,328,442
"Bolivia","La Paz","Caranavi","Alto Beni","ESCUELA CASERIO NUEVE",-67.39796,-15.59869,56,0,316,372,66,8,242,308
"Bolivia","La Paz","Caranavi","Alto Beni","ESCUELA PIQUENDO",-67.38728,-15.59628,95,6,638,733,128,28,476,604
"Bolivia","La Paz","Caranavi","Alto Beni","LOCAL AMAS DE CASA",-67.44894,-15.54566,31,7,227,258,60,3,157,217
"Bolivia","La Paz","Caranavi","Alto Beni","N. ESC. SAN ANTONIO",-67.17532,-15.6578,167,13,929,1096,154,21,741,895
"Bolivia","La Paz","Caranavi","Alto Beni","SEDE SOCIAL",-67.44275,-15.55506,107,14,577,684,138,15,410,548
"Bolivia","La Paz","Caranavi","Alto Beni","SEDE SOCIAL",-67.46413,-15.481,107,14,577,684,138,15,410,548
"Bolivia","La Paz","Caranavi","Alto Beni","UNIDAD EDUCATIVA PUENTE ALTO BENI",-67.3764,-15.56314,13,5,146,159,24,4,113,137
"Bolivia","La Paz","Caranavi","Alto Beni","UNIDAD EDUCATIVA VILLA EL PORVENIR",-67.24788,-15.60961,26,1,313,339,35,7,270,305
"Bolivia","La Paz","Caranavi","Alto Beni","UNIDAD EDUCATIVA VILLA LITORAL",-67.24664,-15.60868,20,4,266,286,22,11,229,251
"Bolivia","La Paz","Caranavi","Caranavi","COL. GUILLERMO MOLINA",-67.44241,-15.77615,204,14,911,1115,133,27,737,870
"Bolivia","La Paz","Caranavi","Caranavi","COL. JHON F. KENEDDY",-67.56451,-15.83448,1199,55,4839,6038,1946,141,2697,4643
"Bolivia","La Paz","Caranavi","Caranavi","COL. LOS ANDES",-67.57357,-15.75793,59,7,519,578,86,6,420,506
"Bolivia","La Paz","Caranavi","Caranavi","COL. MADRE MARIA FEDERICA",-67.56628,-15.83424,728,47,3533,4261,1531,105,1850,3381
"Bolivia","La Paz","Caranavi","Caranavi","COL. SAN LORENZO",-67.50715,-15.79369,95,5,903,998,129,23,746,875
"Bolivia","La Paz","Caranavi","Caranavi","ESC. CARRASCO LA RESERVA",-67.51271,-15.73402,199,20,1453,1652,153,38,1242,1395
"Bolivia","La Paz","Caranavi","Caranavi","ESC. C. DE CHOJNA",-67.56999,-15.95466,14,1,259,273,55,4,199,254
"Bolivia","La Paz","Caranavi","Caranavi","ESC. F. INCAHUARA",-67.59956,-15.97782,16,0,55,71,3,1,51,54
"Bolivia","La Paz","Caranavi","Caranavi","ESC. MSCAL. SANTA CRUZ",-67.4963,-15.74751,69,9,397,466,35,7,346,381
"Bolivia","La Paz","Caranavi","Caranavi","ESC. N. CHORO",-67.63139,-16.03343,23,2,133,156,36,4,91,127
"Bolivia","La Paz","Caranavi","Caranavi","ESC. P. DOMINGO MURILLO",-67.47856,-15.93649,263,19,1631,1894,334,55,1223,1557
"Bolivia","La Paz","Caranavi","Caranavi","ESC. SAN PEDRO",-67.61211,-16.00981,19,1,102,121,4,7,90,94
"Bolivia","La Paz","Caranavi","Caranavi","ESC. SECCIONAL SANTA ANA",-67.54862,-15.89038,73,9,367,440,57,10,291,348
"Bolivia","La Paz","Caranavi","Caranavi","ESC. SIMON BOLIVAR",-67.59677,-15.62007,162,19,770,932,136,33,582,718
"Bolivia","La Paz","Caranavi","Caranavi","ESC. TUPAC KATARI",-67.4232,-15.8093,84,8,484,568,66,13,397,463
"Bolivia","La Paz","Caranavi","Caranavi","ESCUELA CENTRAL VILLAMONTES",-67.31539,-15.8295,44,2,262,306,34,4,222,256
"Bolivia","La Paz","Caranavi","Caranavi","ESCUELA SIMON BOLIVAR DE SANTA FE",-67.62475,-15.80753,84,4,524,608,143,16,361,504
"Bolivia","La Paz","Caranavi","Caranavi","ESC. UYUNENSE",-67.58036,-15.86842,53,10,419,472,68,19,322,390
"Bolivia","La Paz","Caranavi","Caranavi","INSTITUTO AMERICANO",-67.56655,-15.8344,19,0,69,88,31,2,36,67
"Bolivia","La Paz","Caranavi","Caranavi","SEDE SOCIAL",-67.60384,-15.68305,170,6,1140,1310,137,75,922,1059
"Bolivia","La Paz","Caranavi","Caranavi","SEDE SOCIAL",-67.67484,-15.74946,170,6,1140,1310,137,75,922,1059
"Bolivia","La Paz","Caranavi","Caranavi","SEDE SOCIAL",-67.62841,-15.68759,170,6,1140,1310,137,75,922,1059
"Bolivia","La Paz","Caranavi","Caranavi","U. E. RENE ZENON PORTILLO CHAVARRIA",-67.54003,-15.77183,34,1,279,313,66,7,205,271
"Bolivia","La Paz","Caranavi","Caranavi","U.E. SUAZO",-67.56655,-15.8344,17,1,86,103,34,4,47,81
"Bolivia","La Paz","Caranavi","Caranavi","U.E. VENEZUELA",-67.56655,-15.8344,22,1,87,109,24,3,59,83
"Bolivia","La Paz","Caranavi","Caranavi","UNIDAD EDUCATIVA MANCHEGO",-67.60762,-15.852,15,1,163,178,60,2,100,160
"Bolivia","La Paz","Caranavi","Caranavi","UNIDAD EDUCATIVA NUEVA LLUSTA 2DA",-67.39731,-15.85297,51,3,317,368,38,7,269,307
"Bolivia","La Paz","Caranavi","Caranavi","UNIDAD EDUCATIVA SIMON BOLIVAR",-67.55769,-15.83356,647,26,2798,3445,1060,84,1628,2688
"Bolivia","La Paz","Franz Tamayo","Apolo","ESC. CENTRAL ATEN",-68.33105,-14.93176,44,8,245,289,139,17,81,220
"Bolivia","La Paz","Franz Tamayo","Apolo","ESC. CENTRAL INCA",-68.43272,-14.81314,49,6,240,289,75,11,148,223
"Bolivia","La Paz","Franz Tamayo","Apolo","ESC. MACHUA",-68.41223,-14.66684,25,7,162,187,56,13,86,142
"Bolivia","La Paz","Franz Tamayo","Apolo","ESC. MOJOS",-68.89278,-14.56084,2,2,25,27,5,1,17,22
"Bolivia","La Paz","Franz Tamayo","Apolo","ESC. NAZARIO PARDO VALLE",-68.51307,-14.63398,1132,137,4104,5236,2147,188,1632,3779
"Bolivia","La Paz","Franz Tamayo","Apolo","ESC. NAZARIO PARDO VALLE",-68.41825,-14.71928,1132,137,4104,5236,2147,188,1632,3779
"Bolivia","La Paz","Franz Tamayo","Apolo","ESC. PATA SAN ANTONIO",-68.65208,-14.56562,0,2,102,102,34,19,47,81
"Bolivia","La Paz","Franz Tamayo","Apolo","ESC. PUCHAHUI",-68.44442,-14.86157,75,6,378,453,168,16,188,356
"Bolivia","La Paz","Franz Tamayo","Apolo","ESC. SANTA CATALINA",-68.49142,-14.74016,99,15,363,462,130,23,195,325
"Bolivia","La Paz","Franz Tamayo","Apolo","ESCUELA CORREO",-68.44034,-14.95642,21,2,164,185,12,1,149,161
"Bolivia","La Paz","Franz Tamayo","Apolo","ESCUELA MUNAYPATA",-68.30943,-15.0214,50,5,222,272,78,4,135,213
"Bolivia","La Paz","Franz Tamayo","Apolo","UNIDADA EDUCATIVA TOREWA",-67.5419,-14.5968,45,0,21,66,8,1,12,20
"Bolivia","La Paz","Franz Tamayo","Apolo","UNIDAD EDUCATIVA INDIGENA TOREWA",-67.60982,-14.71774,15,0,18,33,3,1,14,17
"Bolivia","La Paz","Franz Tamayo","Pelechuco","ESC. CANTON SUCHES",-69.33424,-14.81951,38,3,173,211,78,7,85,163
"Bolivia","La Paz","Franz Tamayo","Pelechuco","ESC. COL. FRANZ TAMAYO",-69.27006,-15.06253,54,11,433,487,172,26,224,396
"Bolivia","La Paz","Franz Tamayo","Pelechuco","ESC. NAZARIO PARDO VALLE",-69.06972,-14.82036,100,13,606,706,249,34,310,559
"Bolivia","La Paz","Franz Tamayo","Pelechuco","ESC. PUINA",-69.13412,-14.61019,14,0,90,104,22,4,64,86
"Bolivia","La Paz","Franz Tamayo","Pelechuco","ESCUELA AGUA BLANCA",-69.10895,-14.8218,16,3,163,179,64,5,91,155
"Bolivia","La Paz","Franz Tamayo","Pelechuco","ESCUELA DE PUYO PUYO",-69.17246,-14.99942,13,2,171,184,106,3,60,166
"Bolivia","La Paz","Franz Tamayo","Pelechuco","ESCUELA SAN MIGUEL DE THAPI",-68.93021,-14.77682,19,0,103,122,63,4,36,99
"Bolivia","La Paz","Franz Tamayo","Pelechuco","ESCUELA SORAPATA",-68.97952,-14.79948,19,2,110,129,53,9,46,99
"Bolivia","La Paz","Franz Tamayo","Pelechuco","IGLESIA COPACABANA DE ANTIQUILLA",-69.28759,-14.88028,36,9,281,317,68,9,195,263
"Bolivia","La Paz","Franz Tamayo","Pelechuco","NUCLEO  EDUCATIVO HICHOCOLLO",-69.29661,-14.95523,12,2,220,232,70,14,134,204
"Bolivia","La Paz","Franz Tamayo","Pelechuco","SEDE DEL SINDICATO",-69.02939,-14.9247,73,2,278,351,81,27,168,249
"Bolivia","La Paz","General Jose Manuel","Catacora","ESC. THOLA COLLO",-69.55451,-17.23441,14,0,78,92,16,2,60,76
"Bolivia","La Paz","General Jose Manuel","Catacora","NUCLEO ESCOLAR CATACORA",-69.48728,-17.16064,40,0,187,227,37,6,144,181
"Bolivia","La Paz","General Jose Manuel","Catacora","NUCLEO ESCOLAR PAIRUMANI GRANDE",-69.4282,-17.32692,9,1,85,94,19,3,62,81
"Bolivia","La Paz","General Jose Manuel","Catacora","PLAZA 6 DE AGOSTO",-69.46824,-17.29597,7,1,84,91,6,0,77,83
"Bolivia","La Paz","General Jose Manuel","Santiago de Machaca","COLEGIO BAUTISTA SAAVEDRA",-69.25512,-17.206,42,0,100,142,10,1,89,99
"Bolivia","La Paz","General Jose Manuel","Santiago de Machaca","COLEGIO PEDRO KRAMER",-69.21403,-17.28709,14,0,49,63,13,1,35,48
"Bolivia","La Paz","General Jose Manuel","Santiago de Machaca","ESCUELA ATACUNI",-69.15105,-17.17518,5,0,54,59,2,0,52,54
"Bolivia","La Paz","General Jose Manuel","Santiago de Machaca","ESCUELA CENTRAL HUARI PHUJO",-69.04736,-17.13798,6,0,82,88,7,1,74,81
"Bolivia","La Paz","General Jose Manuel","Santiago de Machaca","ESCUELA SANTIAGO DE MACHACA",-69.19207,-17.06675,244,25,1208,1452,220,32,931,1151
"Bolivia","La Paz","General Jose Manuel","Santiago de Machaca","PLAZA VILLA EXALTACION",-69.27541,-17.24455,4,0,125,129,18,0,107,125
"Bolivia","La Paz","Gualberto Villarroel","Chacarilla","ESC. PUERTO AROMA",-68.16104,-17.46223,8,3,204,212,42,6,153,195
"Bolivia","La Paz","Gualberto Villarroel","Chacarilla","PLAZA CHACARILLA",-68.20435,-17.58085,53,1,279,332,47,10,221,268
"Bolivia","La Paz","Gualberto Villarroel","Chacarilla","PLAZA ROSAPATA",-68.10223,-17.49878,25,2,262,287,43,8,209,252
"Bolivia","La Paz","Gualberto Villarroel","Papel Pampa","CASA DE GOBIERNO",-67.82444,-17.66832,94,16,772,866,170,18,568,738
"Bolivia","La Paz","Gualberto Villarroel","Papel Pampa","CASA DE GOBIERNO",-67.76893,-17.81909,94,16,772,866,170,18,568,738
"Bolivia","La Paz","Gualberto Villarroel","Papel Pampa","ESC. TITUZA",-67.57115,-17.60931,9,2,88,97,17,3,66,83
"Bolivia","La Paz","Gualberto Villarroel","Papel Pampa","ESCUELA CIRCA CRUZANI",-67.62467,-17.71481,2,0,65,67,7,1,57,64
"Bolivia","La Paz","Gualberto Villarroel","Papel Pampa","ESCUELA COLQUE AMAYA ALTA",-67.78625,-17.57081,14,4,266,280,51,8,203,254
"Bolivia","La Paz","Gualberto Villarroel","Papel Pampa","PLAZA MOLLEBAMBA",-67.82986,-17.73928,55,7,622,677,123,15,477,600
"Bolivia","La Paz","Gualberto Villarroel","Papel Pampa","PLAZA PRINCIPAL UNO PATA",-67.71118,-17.69406,54,4,417,471,88,16,309,397
"Bolivia","La Paz","Gualberto Villarroel","Papel Pampa","PLAZA RIVERA ALTA",-67.66396,-17.59161,15,2,271,286,98,8,163,261
"Bolivia","La Paz","Gualberto Villarroel","Papel Pampa","SEDE SINDICAL",-67.6296,-17.74787,3,0,72,75,10,0,62,72
"Bolivia","La Paz","Gualberto Villarroel","Papel Pampa","SEDE SOCIAL CAYLLA CHURO",-67.56867,-17.6794,4,0,50,54,8,0,42,50
"Bolivia","La Paz","Gualberto Villarroel","Papel Pampa","UNIDAD EDUCATIVA PACOLLO",-67.8727,-17.78063,3,0,129,132,9,2,118,127
"Bolivia","La Paz","Gualberto Villarroel","Papel Pampa","UNIDAD EDUCATIVA SAN JOSE",-67.75399,-17.72414,25,4,183,208,53,2,124,177
"Bolivia","La Paz","Gualberto Villarroel","San Pedro de Curahuara","CASA COMUNAL",-68.05531,-17.53329,3,3,87,90,23,1,60,83
"Bolivia","La Paz","Gualberto Villarroel","San Pedro de Curahuara","CASA DE GOBIERNO",-68.04781,-17.65329,75,4,516,591,52,16,444,496
"Bolivia","La Paz","Gualberto Villarroel","San Pedro de Curahuara","COLEGIO HERNANDO SILES",-67.91642,-17.5809,79,6,530,609,52,21,451,503
"Bolivia","La Paz","Gualberto Villarroel","San Pedro de Curahuara","COLEGIO LUIS ESPINAL",-67.98427,-17.54257,46,1,377,423,30,2,344,374
"Bolivia","La Paz","Gualberto Villarroel","San Pedro de Curahuara","COLEGIO WISCO KARI",-67.96583,-17.72286,6,0,425,431,121,9,295,416
"Bolivia","La Paz","Gualberto Villarroel","San Pedro de Curahuara","ESC. CHILAGUALA",-68.01054,-17.47809,10,0,89,99,9,2,78,87
"Bolivia","La Paz","Gualberto Villarroel","San Pedro de Curahuara","ESC. JUAN CANCIO COLQUE",-68.10113,-17.65724,4,0,38,42,11,2,25,36
"Bolivia","La Paz","Gualberto Villarroel","San Pedro de Curahuara","PLAZA JANKO MARCA",-67.87048,-17.66836,0,0,397,397,0,4,393,393
"Bolivia","La Paz","Gualberto Villarroel","San Pedro de Curahuara","PLAZA PEDRO DOMINGO MURILLO",-67.87997,-17.63544,9,0,368,377,86,3,279,365
"Bolivia","La Paz","Gualberto Villarroel","San Pedro de Curahuara","PLAZA ROSARIO",-67.8949,-17.73604,4,0,313,317,5,20,288,293
"Bolivia","La Paz","Gualberto Villarroel","San Pedro de Curahuara","SEDE SINDICAL",-67.83096,-17.56285,0,2,88,88,5,3,78,83
"Bolivia","La Paz","Ingaví","Desaguadero","COL. BATALLON COLORADOS",-69.03388,-16.56696,310,26,2535,2845,1635,66,808,2443
"Bolivia","La Paz","Ingaví","Desaguadero","ESC. AZAFRANAL",-68.99149,-16.58226,27,3,289,316,90,6,190,280
"Bolivia","La Paz","Ingaví","Desaguadero","ESC. MCAL. ANDRES DE SANTA CRUZ",-68.95457,-16.58847,57,12,463,520,112,29,310,422
"Bolivia","La Paz","Ingaví","Desaguadero","UNIDAD EDUCATIVA SIMÓN BOLÍVAR",-68.93962,-16.63942,19,5,143,162,54,11,73,127
"Bolivia","La Paz","Ingaví","Guaqui","COLEGIO DANIEL SANCHEZ BUSTAMANTE",-68.83635,-16.59753,162,19,780,942,234,43,484,718
"Bolivia","La Paz","Ingaví","Guaqui","COL. TOMAS KATARI",-68.79683,-16.58405,165,47,1601,1766,335,59,1160,1495
"Bolivia","La Paz","Ingaví","Guaqui","ESC. ISMAEL MONTES",-68.85074,-16.59324,223,17,873,1096,281,41,534,815
"Bolivia","La Paz","Ingaví","Guaqui","UNIDAD EDUCATIVA WILACOLLO",-68.91432,-16.59871,17,4,168,185,38,9,117,155
"Bolivia","La Paz","Ingaví","Jesús de Machaca","COLEGIO CHAMA",-68.57966,-16.79505,17,6,292,309,78,10,198,276
"Bolivia","La Paz","Ingaví","Jesús de Machaca","COL. HOLANDA",-68.89614,-16.80193,38,7,415,453,110,18,280,390
"Bolivia","La Paz","Ingaví","Jesús de Machaca","COL. MEJILLONES",-68.80325,-16.82421,16,6,304,320,81,7,210,291
"Bolivia","La Paz","Ingaví","Jesús de Machaca","COL. REP. DE NORUEGA",-68.74157,-16.77844,31,15,376,407,98,8,255,353
"Bolivia","La Paz","Ingaví","Jesús de Machaca","ESC. FRANZ TAMAYO",-68.61249,-16.78762,0,2,107,107,22,3,80,102
"Bolivia","La Paz","Ingaví","Jesús de Machaca","ESC. NUCLEO CUIPA ESPANA DE MACHACA",-68.63845,-16.79134,4,6,273,277,27,9,231,258
"Bolivia","La Paz","Ingaví","Jesús de Machaca","ESC. SAN FELIPE DE CORPA",-68.8671,-16.67783,73,4,955,1028,135,36,780,915
"Bolivia","La Paz","Ingaví","Jesús de Machaca","ESC. SECC. KHONKHO",-68.67211,-16.7936,21,2,140,161,30,4,104,134
"Bolivia","La Paz","Ingaví","Jesús de Machaca","ESCUELA GERMAN BUSCH",-68.70154,-16.77555,22,4,334,356,62,9,259,321
"Bolivia","La Paz","Ingaví","Jesús de Machaca","PLAZA DEL PUEBLO",-68.76755,-16.77356,29,4,331,360,61,6,260,321
"Bolivia","La Paz","Ingaví","Jesús de Machaca","PLAZA PRINCIPAL",-68.80595,-16.74199,77,18,635,712,164,15,438,602
"Bolivia","La Paz","Ingaví","Jesús de Machaca","PLAZA VILLA ASUNCION DE MACHACA",-68.85337,-16.69936,27,2,378,405,95,6,275,370
"Bolivia","La Paz","Ingaví","Jesús de Machaca","POSTA SANITARIA",-68.63844,-16.84721,33,10,168,201,35,5,118,153
"Bolivia","La Paz","Ingaví","Jesús de Machaca","SEDE SOCIAL",-68.83674,-16.71817,33,7,428,461,93,24,304,397
"Bolivia","La Paz","Ingaví","Jesús de Machaca","SEDE SOCIAL",-68.5472,-16.81992,33,7,428,461,93,24,304,397
"Bolivia","La Paz","Ingaví","San Andrés de Machaca","COLEGIO BOLIVIANO JAPONES",-68.95058,-17.02766,46,3,171,217,17,3,148,165
"Bolivia","La Paz","Ingaví","San Andrés de Machaca","COLEGIO TUPAK KATARI DE CONCHACOLLO",-68.99821,-16.7345,10,1,257,267,59,5,192,251
"Bolivia","La Paz","Ingaví","San Andrés de Machaca","COL. VILLA PUSUMA ALTO MACHACA",-69.16449,-16.80326,23,3,153,176,17,2,131,148
"Bolivia","La Paz","Ingaví","San Andrés de Machaca","ESC. FRANZ TAMAYO",-69.09547,-16.73553,23,1,96,119,7,1,87,94
"Bolivia","La Paz","Ingaví","San Andrés de Machaca","ESC. LITORAL CHUNCARCOTA",-69.02103,-16.79199,9,3,127,136,23,6,95,118
"Bolivia","La Paz","Ingaví","San Andrés de Machaca","ESC. NUCLEO LAQUINAMAYA",-69.19246,-16.94843,43,3,238,281,47,3,185,232
"Bolivia","La Paz","Ingaví","San Andrés de Machaca","ESCUELA DE SAN ANDRES DE MACHACA",-68.96825,-16.95646,100,9,355,455,69,17,260,329
"Bolivia","La Paz","Ingaví","San Andrés de Machaca","PLAZA PRINCIPAL",-68.76829,-16.93683,21,8,169,190,51,4,106,157
"Bolivia","La Paz","Ingaví","San Andrés de Machaca","SEDE SOCIAL(COMUNIDAD MAURI)",-69.13435,-16.83909,10,1,110,120,16,0,93,109
"Bolivia","La Paz","Ingaví","San Andrés de Machaca","UNIDAD EDUCATIVA ANTAQUIRANI",-69.07945,-16.8683,4,1,79,83,20,1,57,77
"Bolivia","La Paz","Ingaví","San Andrés de Machaca","UNIDAD EDUCATIVA ROSA PATA ERBEN KALLA",-68.91935,-16.83392,9,1,143,152,27,7,108,135
"Bolivia","La Paz","Ingaví","Taraco","COL. NUCLEO FRAY JOSE ZAMPA",-68.82944,-16.43332,24,6,212,236,37,4,165,202
"Bolivia","La Paz","Ingaví","Taraco","COL. OVANDO CANDIA",-68.94234,-16.44834,40,16,562,602,90,30,426,516
"Bolivia","La Paz","Ingaví","Taraco","ESC. TARACO",-68.8576,-16.45572,158,24,1348,1506,269,60,995,1264
"Bolivia","La Paz","Ingaví","Taraco","SEDE SOCIAL",-68.79443,-16.43522,6,6,229,235,47,9,167,214
"Bolivia","La Paz","Ingaví","Tiahuanacu","COLEGIO JOSE BALLIVIAN",-68.74157,-16.44234,90,17,1170,1260,212,55,886,1098
"Bolivia","La Paz","Ingaví","Tiahuanacu","COLEGIO NACIONAL ARTURO POSNANSKI",-68.67873,-16.55647,311,56,3225,3536,900,175,2094,2994
"Bolivia","La Paz","Ingaví","Tiahuanacu","ESC. CENTRAL PILLAPI",-68.7683,-16.5035,57,13,957,1014,225,31,688,913
"Bolivia","La Paz","Ingaví","Viacha","CASA DE GOBIERNO",-68.25248,-16.80821,19,5,177,196,41,12,119,160
"Bolivia","La Paz","Ingaví","Viacha","COLEGIO BALLIVIAN",-68.29795,-16.65053,1101,111,8727,9828,3309,320,4987,8296
"Bolivia","La Paz","Ingaví","Viacha","COLEGIO JHONN F. KENNEDI",-68.17124,-16.77349,53,16,692,745,183,30,463,646
"Bolivia","La Paz","Ingaví","Viacha","COL. HACIA EL MAR",-68.24142,-16.75815,55,16,601,656,101,37,447,548
"Bolivia","La Paz","Ingaví","Viacha","COL. NAL. MIXTO CALAMA",-68.30962,-16.82777,32,14,398,430,93,17,274,367
"Bolivia","La Paz","Ingaví","Viacha","ESC. 18 DE NOVIEMBRE",-68.2989,-16.64955,463,43,3785,4248,1450,129,2163,3613
"Bolivia","La Paz","Ingaví","Viacha","ESC. ACHICA ARRIBA",-68.18732,-16.71439,48,6,767,815,179,47,535,714
"Bolivia","La Paz","Ingaví","Viacha","ESC. CENTRO TILATA",-68.23033,-16.58882,888,115,10123,11011,2890,388,6730,9620
"Bolivia","La Paz","Ingaví","Viacha","ESC. EVARISTO VALLE",-68.29871,-16.65074,563,69,5014,5577,1890,189,2866,4756
"Bolivia","La Paz","Ingaví","Viacha","ESC. SAN LUIS",-68.29977,-16.65029,379,32,3724,4103,1550,114,2028,3578
"Bolivia","La Paz","Ingaví","Viacha","ESC. VILIROCO",-68.24899,-16.61097,246,33,3367,3613,817,195,2322,3139
"Bolivia","La Paz","Ingaví","Viacha","PLAZA JOSE BALLIVIAN",-68.23183,-16.8031,20,5,309,329,87,11,206,293
"Bolivia","La Paz","Ingaví","Viacha","PLAZA PRINCIPAL",-68.42336,-16.81759,51,2,256,307,57,7,190,247
"Bolivia","La Paz","Ingaví","Viacha","SAN PEDRO DE CHONCHOCORO",-68.29809,-16.65042,18,0,111,129,62,1,48,110
"Bolivia","La Paz","Ingaví","Viacha","SEDE SOCIAL",-68.37337,-16.87176,4,4,160,164,37,6,113,150
"Bolivia","La Paz","Ingaví","Viacha","UNIDAD EDUCATIVA BATALLA DE INGAVI",-68.24085,-16.63196,15,3,58,73,20,1,34,54
"Bolivia","La Paz","Ingaví","Viacha","UNIDAD EDUCATIVA LITORAL",-68.29734,-16.85302,31,5,262,293,54,7,196,250
"Bolivia","La Paz","Ingaví","Viacha","UNIDAD EDUCATIVA TONCOPUJIO",-68.29401,-16.8719,6,4,160,166,18,4,134,152
"Bolivia","La Paz","Inquisivi","Cajuata","CASA DE GOBIERNO",-67.1912,-16.74741,128,24,1066,1194,132,26,884,1016
"Bolivia","La Paz","Inquisivi","Cajuata","CASA DE GOBIERNO",-67.26615,-16.62763,128,24,1066,1194,132,26,884,1016
"Bolivia","La Paz","Inquisivi","Cajuata","ESCUELA",-67.28862,-16.5991,62,11,374,436,60,10,293,353
"Bolivia","La Paz","Inquisivi","Cajuata","ESCUELA HUARITOLO",-67.20372,-16.72687,51,15,364,415,59,14,276,335
"Bolivia","La Paz","Inquisivi","Cajuata","UNIDAD EDUCATIVA CIRCUATA",-67.23114,-16.64647,97,18,808,905,155,35,600,755
"Bolivia","La Paz","Inquisivi","Cajuata","UNIDAD EDUCATIVA MIGUILLAS",-67.33664,-16.55579,55,5,357,412,25,1,326,351
"Bolivia","La Paz","Inquisivi","Cajuata","UNIDA EDUCATIVA CAJUATA",-67.17103,-16.69801,262,62,1722,1984,366,64,1230,1596
"Bolivia","La Paz","Inquisivi","Colquiri","CASA DE GOBIERNO",-66.98113,-17.55202,98,51,737,835,156,45,485,641
"Bolivia","La Paz","Inquisivi","Colquiri","CASA DE GOBIERNO",-66.90228,-17.38338,98,51,737,835,156,45,485,641
"Bolivia","La Paz","Inquisivi","Colquiri","CASA DE GOBIERNO",-66.93718,-17.58477,98,51,737,835,156,45,485,641
"Bolivia","La Paz","Inquisivi","Colquiri","COLEGIO ALTO DE LA ALIANZA",-66.8511,-17.5196,23,4,259,282,57,41,157,214
"Bolivia","La Paz","Inquisivi","Colquiri","COLEGIO SIMON BOLIVAR",-66.99767,-17.44226,62,12,553,615,114,31,396,510
"Bolivia","La Paz","Inquisivi","Colquiri","ESC. SIMON BOLIVAR",-66.9579,-17.54244,19,3,161,180,39,9,110,149
"Bolivia","La Paz","Inquisivi","Colquiri","ESCUELA ANICETO ARCE",-66.87982,-17.35054,24,9,205,229,37,7,152,189
"Bolivia","La Paz","Inquisivi","Colquiri","ESCUELA CAQUENA ENTRE RIOS",-67.00492,-17.32234,21,0,222,243,12,2,208,220
"Bolivia","La Paz","Inquisivi","Colquiri","ESCUELA CENTRAL UYUNI",-66.91545,-17.44477,39,37,280,319,68,20,155,223
"Bolivia","La Paz","Inquisivi","Colquiri","ESCUELA JOSE MIGUEL LANZA",-66.94537,-17.36096,80,19,618,698,119,13,467,586
"Bolivia","La Paz","Inquisivi","Colquiri","ESCUELA PIPINI",-66.92647,-17.48633,25,3,191,216,45,11,132,177
"Bolivia","La Paz","Inquisivi","Colquiri","ESCUELA SECCIONAL CHUALLA",-66.86385,-17.45984,11,0,157,168,31,4,122,153
"Bolivia","La Paz","Inquisivi","Colquiri","ESCUELA SECCIONAL CORIRI",-66.86787,-17.39233,15,3,92,107,14,4,71,85
"Bolivia","La Paz","Inquisivi","Colquiri","LADISLAO CABRERA",-67.13279,-17.38032,344,57,2869,3213,1250,153,1409,2659
"Bolivia","La Paz","Inquisivi","Colquiri","U.E. MARISCAL DE ZEPITA",-67.12341,-17.3896,174,29,1489,1663,602,68,790,1392
"Bolivia","La Paz","Inquisivi","Colquiri","UNIDAD EDUCATIVA MARQUIRIVI",-66.84624,-17.48428,16,0,205,221,37,3,165,202
"Bolivia","La Paz","Inquisivi","Ichoca","CASA DE GOBIERNO",-67.28601,-17.123,4,6,107,111,30,3,68,98
"Bolivia","La Paz","Inquisivi","Ichoca","ESC. CENTRAL LURUTA",-67.12575,-17.23102,29,3,156,185,43,3,107,150
"Bolivia","La Paz","Inquisivi","Ichoca","ESCUELA JOSE ANTONIO DE SUCRE",-67.30527,-17.25527,13,6,321,334,38,8,269,307
"Bolivia","La Paz","Inquisivi","Ichoca","ESCUELA PEDRO DOMINGO MURILLO",-67.25848,-17.18484,19,6,209,228,22,6,175,197
"Bolivia","La Paz","Inquisivi","Ichoca","ESCUELA REPUBLICA DE VENEZUELA",-67.08401,-17.15735,25,8,130,155,19,6,97,116
"Bolivia","La Paz","Inquisivi","Ichoca","UNIDAD EDUCATIVA",-67.18003,-17.14062,141,15,569,710,91,19,444,535
"Bolivia","La Paz","Inquisivi","Ichoca","UNIDAD EDUCATIVA GERMAN BUSCH",-67.17284,-17.24399,1,5,173,174,62,4,102,164
"Bolivia","La Paz","Inquisivi","Inquisivi","ESC. CENTRAL CAVARI",-66.99092,-17.07948,81,14,373,454,53,21,285,338
"Bolivia","La Paz","Inquisivi","Inquisivi","ESC. EDUARDO AVAROA",-66.922,-16.79497,77,8,374,451,24,12,330,354
"Bolivia","La Paz","Inquisivi","Inquisivi","ESC. PEDRO DOMINGO MURILLO",-67.13365,-16.87514,52,5,334,386,50,16,263,313
"Bolivia","La Paz","Inquisivi","Inquisivi","ESCUELA ELIODORO CAMACHO",-67.13739,-16.90743,149,13,777,926,244,39,481,725
"Bolivia","La Paz","Inquisivi","Inquisivi","ESCUELA SIMON BOLIVAR",-66.91412,-17.25326,67,37,245,312,39,15,154,193
"Bolivia","La Paz","Inquisivi","Inquisivi","PLAZA DE LA FERIA DE VILLA VICTORIA",-67.01423,-17.23652,15,0,86,101,10,1,75,85
"Bolivia","La Paz","Inquisivi","Inquisivi","PLAZA PRINCIPAL",-66.86905,-16.60352,126,5,576,702,50,8,513,563
"Bolivia","La Paz","Inquisivi","Inquisivi","PLAZA PRINCIPAL 16 DE JULIO",-66.94501,-16.51898,201,12,654,855,125,12,505,630
"Bolivia","La Paz","Inquisivi","Inquisivi","SEDE SOCIAL",-67.09277,-16.88889,26,2,80,106,28,1,49,77
"Bolivia","La Paz","Inquisivi","Inquisivi","SEDE SOCIAL",-67.08649,-16.69044,26,2,80,106,28,1,49,77
"Bolivia","La Paz","Inquisivi","Inquisivi","UNIDAD EDUCATIVA ESCOLA",-67.01402,-16.88219,79,8,446,525,57,11,370,427
"Bolivia","La Paz","Inquisivi","Inquisivi","UNIDAD EDUCATIVA KANAMARCA",-67.07207,-16.34529,44,3,212,256,25,4,180,205
"Bolivia","La Paz","Inquisivi","Inquisivi","UNIDAD EDUCATIVA MARISCAL SUCRE",-67.08443,-16.78866,13,2,140,153,22,3,113,135
"Bolivia","La Paz","Inquisivi","Inquisivi","UNIDAD EDUCATIVA SIGUAS",-66.93951,-17.17848,31,20,283,314,49,24,190,239
"Bolivia","La Paz","Inquisivi","Inquisivi","UNIDAD EDUCATIVA TUPAK KATARI",-67.07355,-16.99531,83,24,470,553,83,67,296,379
"Bolivia","La Paz","Inquisivi","Licoma Pampa","ESCUELA ELIODORO CAMACHO",-67.20383,-16.80501,149,25,821,970,134,37,625,759
"Bolivia","La Paz","Inquisivi","Licoma Pampa","ESCUELA MIXTA CHARAPAXI",-67.1801,-16.84146,29,1,175,204,16,4,154,170
"Bolivia","La Paz","Inquisivi","Quime","ESC. PONGO B2",-67.27655,-16.98723,18,7,192,210,34,9,142,176
"Bolivia","La Paz","Inquisivi","Quime","ESC. TEODOMIRO URQUIOLA",-67.21542,-16.97982,292,70,2265,2557,758,137,1300,2058
"Bolivia","La Paz","Inquisivi","Quime","ESCUELA HUAYNACOTA",-67.28345,-17.03332,0,1,26,26,10,0,15,25
"Bolivia","La Paz","Inquisivi","Quime","ESCUELA SIMON BOLIVAR",-67.33048,-16.93823,119,14,492,611,255,13,210,465
"Bolivia","La Paz","Inquisivi","Quime","ESCUELA U.E. TITIAMAYA",-67.1907,-16.92141,4,0,110,114,21,4,85,106
"Bolivia","La Paz","Inquisivi","Quime","UNIDAD EDUCATIVA CHOQUETANGA",-67.31809,-16.8389,49,16,412,461,116,16,264,380
"Bolivia","La Paz","Larecaja","Combaya","ESC. CENTRAL SOREJAYA",-68.76491,-15.8242,22,5,333,355,61,21,246,307
"Bolivia","La Paz","Larecaja","Combaya","ESC. NUCLEO TICAMBLAYA",-68.73175,-15.83537,23,18,186,209,46,8,114,160
"Bolivia","La Paz","Larecaja","Combaya","UNIDAD EDUCATIVA EDUARDO AVAROA",-68.7542,-15.80447,52,29,293,345,67,19,178,245
"Bolivia","La Paz","Larecaja","Combaya","UNIDAD EDUCATIVA HUAYCHO",-68.73401,-15.81383,17,6,170,187,7,10,147,154
"Bolivia","La Paz","Larecaja","Guanay","ESC. C. CRESPO",-67.8819,-15.50123,409,21,1763,2172,783,46,913,1696
"Bolivia","La Paz","Larecaja","Guanay","ESC. CENTRAL CARURA",-67.96386,-15.42661,72,9,465,537,127,8,321,448
"Bolivia","La Paz","Larecaja","Guanay","ESC. MARIAPU",-68.05544,-15.40095,5,1,72,77,54,2,15,69
"Bolivia","La Paz","Larecaja","Guanay","ESC. SAN JUAN DE CHALLANA",-67.86722,-15.50406,7,0,60,67,49,1,10,59
"Bolivia","La Paz","Larecaja","Guanay","ESC. SECC. DE POROMA",-67.876,-15.66636,33,3,156,189,32,1,120,152
"Bolivia","La Paz","Larecaja","Guanay","ESC. SECC. MIXTA LA FABULOSA",-68.24464,-16.07889,3,0,42,45,3,0,39,42
"Bolivia","La Paz","Larecaja","Guanay","ESC. SECC. TRAPICHEPONTE",-67.74178,-15.64004,42,3,182,224,36,3,140,176
"Bolivia","La Paz","Larecaja","Guanay","ESCUELA PABLO AMAYA",-68.21191,-15.97806,11,0,79,90,21,8,50,71
"Bolivia","La Paz","Larecaja","Guanay","ESCUELA PAJONAL VILAQUE",-68.05408,-15.41886,22,3,146,168,89,2,52,141
"Bolivia","La Paz","Larecaja","Guanay","LA AGUADA",-67.92878,-15.49115,25,0,181,206,108,1,72,180
"Bolivia","La Paz","Larecaja","Guanay","NUCLEO ESCOLAR DE AMAGUAYA",-68.25602,-15.95273,15,0,80,95,30,1,49,79
"Bolivia","La Paz","Larecaja","Guanay","SEDE SOCIAL",-67.85902,-15.60936,1,2,45,46,15,0,28,43
"Bolivia","La Paz","Larecaja","Guanay","SINDICATO",-68.22674,-16.06047,1,0,59,60,9,7,43,52
"Bolivia","La Paz","Larecaja","Guanay","UNIDAD EDUCATIVA ALTO CHIJINI",-67.88482,-15.41975,5,0,37,42,9,0,28,37
"Bolivia","La Paz","Larecaja","Guanay","UNIDAD EDUCATIVA BUENOS AIRES",-67.68906,-15.70198,32,3,222,254,67,3,149,216
"Bolivia","La Paz","Larecaja","Guanay","UNIDAD EDUCATIVA CANDELARIA",-67.94775,-15.4421,32,4,465,497,110,3,348,458
"Bolivia","La Paz","Larecaja","Guanay","UNIDAD EDUCATIVA NACIONAL GUANAY",-67.88155,-15.49581,457,27,1864,2321,823,65,949,1772
"Bolivia","La Paz","Larecaja","Guanay","UNIDAD EDUCATIVA YOLOSANI",-67.79774,-15.57438,14,1,82,96,20,2,59,79
"Bolivia","La Paz","Larecaja","Mapiri","COLEGIO 1º DE MAYO",-68.20412,-15.28964,95,6,534,629,195,12,321,516
"Bolivia","La Paz","Larecaja","Mapiri","ESC. 16 DE JULIO",-68.21772,-15.31103,466,39,1816,2282,756,63,958,1714
"Bolivia","La Paz","Larecaja","Mapiri","ESC. CENTRAL DE SANTA ROSA",-68.32465,-15.31801,497,19,1423,1920,510,44,850,1360
"Bolivia","La Paz","Larecaja","Mapiri","ESC. DE SARAMPIUNI",-68.22166,-15.3938,19,0,118,137,27,2,89,116
"Bolivia","La Paz","Larecaja","Mapiri","ESC. MONJE ZAPATA",-68.26091,-15.20526,98,6,419,517,112,17,284,396
"Bolivia","La Paz","Larecaja","Mapiri","ESCUELA CHIMATE",-68.1562,-15.3971,33,1,153,186,36,5,111,147
"Bolivia","La Paz","Larecaja","Mapiri","ESC. UNIDAD EDUCATIVA VILAQUE GRANDE",-68.1724,-15.3626,26,3,189,215,49,4,133,182
"Bolivia","La Paz","Larecaja","Quiabaya","ESC. MIXTA JULIO CORDERO",-68.70292,-15.63772,182,34,1025,1207,291,64,636,927
"Bolivia","La Paz","Larecaja","Sorata","COL. JUAN XXIII",-68.65056,-15.77354,235,59,1651,1886,550,74,968,1518
"Bolivia","La Paz","Larecaja","Sorata","ESC. CENTRAL CARAZANI",-68.76967,-15.73627,18,2,197,215,35,20,140,175
"Bolivia","La Paz","Larecaja","Sorata","ESC. CENTRAL CHEJE",-68.6847,-15.79368,39,1,292,331,23,5,263,286
"Bolivia","La Paz","Larecaja","Sorata","ESC. CENTRAL CHOJLLA",-68.35152,-15.8526,28,2,76,104,16,1,57,73
"Bolivia","La Paz","Larecaja","Sorata","ESC. CENTRAL DE YANI",-68.53834,-15.63402,96,12,601,697,382,36,171,553
"Bolivia","La Paz","Larecaja","Sorata","ESC. FERNANDO ELOY GUACHALLA",-68.65588,-15.80826,99,54,809,908,147,48,560,707
"Bolivia","La Paz","Larecaja","Sorata","ESC. NEMECIO AYALA",-68.7309,-15.713,31,8,181,212,35,8,130,165
"Bolivia","La Paz","Larecaja","Sorata","ESC. NUCLEO ABISPAYA",-68.69788,-15.7081,41,12,314,355,77,21,204,281
"Bolivia","La Paz","Larecaja","Sorata","ESC. NUCLEO COCOY",-68.44633,-15.78752,1,0,292,293,152,19,121,273
"Bolivia","La Paz","Larecaja","Sorata","ESC. NUCLEO LARIPATA",-68.66778,-15.75021,91,25,807,898,226,39,517,743
"Bolivia","La Paz","Larecaja","Sorata","ESC. NUCLEO SAN ANTONIO DE MILLIPA",-68.61856,-15.87464,15,7,790,805,229,22,532,761
"Bolivia","La Paz","Larecaja","Sorata","ESC. SECC. DE ANKOMA SUR",-68.5121,-15.74682,17,8,162,179,87,7,60,147
"Bolivia","La Paz","Larecaja","Sorata","ESC. SECCIONAL CHUSSI",-68.2317,-15.6224,2,1,166,168,28,1,136,164
"Bolivia","La Paz","Larecaja","Sorata","ESCUELA COMBILILI",-68.7889,-15.75265,8,0,83,91,33,6,44,77
"Bolivia","La Paz","Larecaja","Sorata","ESCUELA MACHACAMARCA",-68.78627,-15.72192,24,0,154,178,14,1,139,153
"Bolivia","La Paz","Larecaja","Sorata","ESCUELA PACOLLO",-68.64767,-15.85605,5,0,200,205,58,8,134,192
"Bolivia","La Paz","Larecaja","Sorata","ESCUELA SANTA MARIA",-68.21433,-15.58872,54,4,115,169,26,4,81,107
"Bolivia","La Paz","Larecaja","Sorata","ESC. UNIDAD EDUCATIVA OKARA",-68.3903,-15.67581,11,4,50,61,16,2,28,44
"Bolivia","La Paz","Larecaja","Sorata","H.A.M. DE SORATA",-68.64867,-15.77538,290,53,1733,2023,547,94,1039,1586
"Bolivia","La Paz","Larecaja","Tacacoma","COL. CENTRAL SAN AGUSTIN",-68.50902,-15.37926,75,11,346,421,77,18,240,317
"Bolivia","La Paz","Larecaja","Tacacoma","ESC. ANANEA",-68.6505,-15.5341,28,1,192,220,93,6,92,185
"Bolivia","La Paz","Larecaja","Tacacoma","ESC. CENTRAL CHUMISA",-68.65643,-15.58669,56,6,464,520,114,14,330,444
"Bolivia","La Paz","Larecaja","Tacacoma","ESCUELA PALLAYUNGA",-68.60498,-15.46068,60,1,212,272,48,10,153,201
"Bolivia","La Paz","Larecaja","Tacacoma","ESCUELA XVI DE JULIO",-68.64725,-15.59322,140,16,967,1107,467,54,430,897
"Bolivia","La Paz","Larecaja","Tacacoma","ESC. UNIDAD EDUCATIVA CAMILLAYA",-68.57066,-15.43699,17,3,81,98,24,1,53,77
"Bolivia","La Paz","Larecaja","Tacacoma","NUCLEO ESCOLAR INCACHACA",-68.47215,-15.32096,70,2,213,283,124,2,85,209
"Bolivia","La Paz","Larecaja","Tacacoma","PLAZA COLLABAMBA",-68.64456,-15.51472,19,2,111,130,67,7,35,102
"Bolivia","La Paz","Larecaja","Teoponte","COL. NAL. MIXTO TEOPONTE",-67.81804,-15.49505,263,23,1142,1405,404,22,693,1097
"Bolivia","La Paz","Larecaja","Teoponte","COL. NUCLEO TAJLIHUI",-67.70219,-15.67721,20,1,143,163,21,8,113,134
"Bolivia","La Paz","Larecaja","Teoponte","ESC.EDUARDO AVAROA",-67.64935,-15.67183,15,4,127,142,15,6,102,117
"Bolivia","La Paz","Larecaja","Teoponte","ESC. MIXTA TOMACHI",-67.73718,-15.47837,86,2,316,402,104,10,200,304
"Bolivia","La Paz","Larecaja","Teoponte","ESC.NUCLEO VILLA AROMA",-67.7086,-15.59438,33,4,371,404,56,10,301,357
"Bolivia","La Paz","Larecaja","Teoponte","NUCLEO RED UNO",-67.6581,-15.5712,12,1,59,71,4,2,52,56
"Bolivia","La Paz","Larecaja","Teoponte","SEDE SOCIAL",-67.60563,-15.41431,228,13,1044,1272,240,22,769,1009
"Bolivia","La Paz","Larecaja","Tipuani","ESC. 16 DE JULIO",-68.04258,-15.5816,225,7,651,876,204,10,430,634
"Bolivia","La Paz","Larecaja","Tipuani","ESC. EDUARDO AVAROA",-68.01199,-15.56615,478,18,1581,2059,646,37,880,1526
"Bolivia","La Paz","Larecaja","Tipuani","ESC. MIXTA GERMAN BUSCH",-68.00401,-15.56263,40,2,192,232,77,6,107,184
"Bolivia","La Paz","Larecaja","Tipuani","ESC. NESTOR PAZ ZAMORA",-68.0163,-15.51995,11,0,56,67,4,2,50,54
"Bolivia","La Paz","Larecaja","Tipuani","ESCUELA CHUQUINI",-68.08243,-15.61108,281,9,787,1068,198,15,565,763
"Bolivia","La Paz","Larecaja","Tipuani","UNIDAD EDUCATIVA PEDRO DOMINGO MURILLO",-68.10115,-15.59577,97,5,388,485,150,9,224,374
"Bolivia","La Paz","Loayza","Cairoma","COLEGIO GERMAN BUSCH",-67.54138,-16.90495,136,27,1065,1201,246,55,737,983
"Bolivia","La Paz","Loayza","Cairoma","COLEGIO LUIS ESPINAL",-67.57736,-16.92918,29,10,325,354,92,2,221,313
"Bolivia","La Paz","Loayza","Cairoma","ESCUELA DE SAYA",-67.54543,-16.71021,8,2,105,113,40,5,58,98
"Bolivia","La Paz","Loayza","Cairoma","ESCUELA TIENDA PATA",-67.50883,-16.886,14,1,126,140,38,5,82,120
"Bolivia","La Paz","Loayza","Cairoma","PLAZA LLOJA",-67.57372,-16.74774,22,1,184,206,10,1,172,182
"Bolivia","La Paz","Loayza","Cairoma","PLAZA TORRE PAMPA",-67.58032,-16.83131,63,8,346,409,67,10,261,328
"Bolivia","La Paz","Loayza","Cairoma","UNIDAD EDUCATIVA BARTOLINA SISA",-67.4908,-16.65928,23,0,118,141,13,8,97,110
"Bolivia","La Paz","Loayza","Cairoma","UNIDAD EDUCATIVA BOLIVAR",-67.54518,-16.87182,69,19,489,558,68,16,386,454
"Bolivia","La Paz","Loayza","Cairoma","UNIDAD EDUCATIVA BOLIVIA-VILOCO",-67.49796,-16.87398,159,5,706,865,165,22,514,679
"Bolivia","La Paz","Loayza","Cairoma","UNIDAD EDUCATIVA LIBERTAD",-67.56012,-16.81969,55,9,341,396,54,14,264,318
"Bolivia","La Paz","Loayza","Cairoma","UNIDAD EDUCATIVA SACANI",-67.61375,-16.94436,16,3,365,381,57,8,297,354
"Bolivia","La Paz","Loayza","Luribay","COLEGIO AZAMBO",-67.63184,-17.00489,29,4,371,400,66,13,288,354
"Bolivia","La Paz","Loayza","Luribay","COLEGIO VILLA LITORAL",-67.6229,-17.08772,37,2,383,420,47,8,326,373
"Bolivia","La Paz","Loayza","Luribay","COL. RVDO. VICTOR ARUAZO-PLAZA PRINCIPAL",-67.6609,-17.06249,88,10,630,718,135,19,466,601
"Bolivia","La Paz","Loayza","Luribay","ESCUELA ANQUIMOA",-67.66051,-16.99854,49,6,587,636,60,11,510,570
"Bolivia","La Paz","Loayza","Luribay","ESCUELA EL PORVENIR",-67.55268,-17.03213,44,3,617,661,107,12,495,602
"Bolivia","La Paz","Loayza","Luribay","ESCUELA MURMUNTANI",-67.5434,-17.08703,20,1,171,191,13,4,153,166
"Bolivia","La Paz","Loayza","Luribay","ESC. UNIDAD EDUCATIVA BRAVO",-67.68433,-16.95887,17,3,198,215,19,3,173,192
"Bolivia","La Paz","Loayza","Luribay","PLAZA 5 DE AGOSTO",-67.60162,-17.11526,64,5,422,486,57,11,349,406
"Bolivia","La Paz","Loayza","Luribay","PLAZA 6 DE AGOSTO",-67.68541,-17.13404,60,4,349,409,33,24,288,321
"Bolivia","La Paz","Loayza","Luribay","PLAZA TOTORA",-67.68784,-17.09565,5,0,90,95,11,0,79,90
"Bolivia","La Paz","Loayza","Luribay","UNIDAD EDUCATIVA COLLIRI",-67.7193,-17.04746,32,1,225,257,31,8,185,216
"Bolivia","La Paz","Loayza","Luribay","UNIDAD EDUCATIVA PEDRO DOMINGO MURILLO",-67.57441,-17.14605,88,8,596,684,94,3,491,585
"Bolivia","La Paz","Loayza","Luribay","UNIDAD EDUCATIVA POROMA",-67.54092,-17.17032,23,1,299,322,37,1,260,297
"Bolivia","La Paz","Loayza","Malla","ESCUELA SIMON BOLIVAR",-67.42189,-17.06216,3,0,99,102,3,2,94,97
"Bolivia","La Paz","Loayza","Malla","PLAZA 14 DE SEPTIEMBRE",-67.45062,-17.03962,13,2,408,421,55,5,346,401
"Bolivia","La Paz","Loayza","Malla","UNIDAD EDUCATIVA FRANZ TAMAYO",-67.49815,-16.9908,38,2,254,292,55,9,188,243
"Bolivia","La Paz","Loayza","Sapahaqui","ESCUELA EDUARDO AVAROA",-67.71152,-16.88625,43,2,413,456,44,5,362,406
"Bolivia","La Paz","Loayza","Sapahaqui","ESCUELA SIXILLA BAJA",-67.79269,-17.05937,0,1,325,325,42,2,280,322
"Bolivia","La Paz","Loayza","Sapahaqui","MURUHUTA",-67.83468,-17.10299,43,2,373,416,66,16,289,355
"Bolivia","La Paz","Loayza","Sapahaqui","PLAZA PRINCIPAL HUANCANE",-67.92168,-16.96859,13,2,321,334,52,5,262,314
"Bolivia","La Paz","Loayza","Sapahaqui","UNIDAD EDUCATIVA CHIVISIVI",-67.87543,-16.95139,49,7,565,614,86,4,468,554
"Bolivia","La Paz","Loayza","Sapahaqui","UNIDAD EDUCATIVA OCUIRI",-67.75996,-17.09802,21,0,228,249,20,6,202,222
"Bolivia","La Paz","Loayza","Sapahaqui","UNIDAD EDUCATIVA SAN MARCOS",-67.81051,-16.99369,192,11,1391,1583,215,51,1114,1329
"Bolivia","La Paz","Loayza","Sapahaqui","UNIDAD EDUCATIVA SAPAHAQUI",-67.95024,-16.88832,204,31,1625,1829,323,69,1202,1525
"Bolivia","La Paz","Loayza","Sapahaqui","UNIDAD EDUCATIVA TACOBAMBA",-67.93534,-16.89507,63,3,616,679,93,17,503,596
"Bolivia","La Paz","Loayza","Sapahaqui","UNIDAD EDUCATIVA URUPAYA",-67.86726,-16.83526,12,0,94,106,16,2,76,92
"Bolivia","La Paz","Loayza","Yaco","COLEGIO REPUBLICA VENEZUELA",-67.33579,-17.27501,43,5,589,632,169,21,394,563
"Bolivia","La Paz","Loayza","Yaco","ESCUELA CHALLOMA",-67.48557,-17.17411,22,2,235,257,12,5,216,228
"Bolivia","La Paz","Loayza","Yaco","ESCUELA UMALACO",-67.44422,-17.08424,4,1,74,78,8,1,64,72
"Bolivia","La Paz","Loayza","Yaco","PLAZA 14 DE SEPTIEMBRE",-67.37626,-17.18333,9,2,116,125,23,7,84,107
"Bolivia","La Paz","Loayza","Yaco","PLAZA CENTRAL",-67.33892,-17.17855,27,11,431,458,98,46,276,374
"Bolivia","La Paz","Loayza","Yaco","UNIDAD EDUCATIVA CHUCAMARCA",-67.45103,-17.09326,34,4,238,272,34,10,190,224
"Bolivia","La Paz","Loayza","Yaco","UNIDAD EDUCATIVA DANIEL GOMEZ GARCIA",-67.44017,-17.25055,36,7,284,320,50,20,207,257
"Bolivia","La Paz","Loayza","Yaco","UNIDAD EDUCATIVA GERMAN BUSCH",-67.34483,-17.1474,18,0,119,137,25,5,89,114
"Bolivia","La Paz","Loayza","Yaco","UNIDAD EDUCATIVA HURNUNI",-67.40517,-17.3487,12,1,240,252,87,5,147,234
"Bolivia","La Paz","Loayza","Yaco","UNIDAD EDUCATIVA SIMON BOLIVAR",-67.35043,-17.13314,0,7,137,137,38,5,87,125
"Bolivia","La Paz","Loayza","Yaco","UNIDAD EDUCATIVA YACO",-67.41138,-17.1584,84,13,368,452,78,25,252,330
"Bolivia","La Paz","Los Andes","Batallas","COLEGIO DON BOSCO",-68.46431,-16.31361,60,18,729,789,166,29,516,682
"Bolivia","La Paz","Los Andes","Batallas","COLEGIO TÉCNICO HUMANÍSTICO CHIRAPACA",-68.49313,-16.29834,21,4,406,427,136,16,250,386
"Bolivia","La Paz","Los Andes","Batallas","COL. FISCAL BOLIVIANO CUBANO",-68.52594,-16.30013,64,13,724,788,224,26,461,685
"Bolivia","La Paz","Los Andes","Batallas","COL. PEDRO DOMINGO MURILLO",-68.50931,-16.1562,62,11,535,597,213,23,288,501
"Bolivia","La Paz","Los Andes","Batallas","ESCUELA GENOVEVA RIOS",-68.53124,-16.30003,339,47,2937,3276,953,124,1813,2766
"Bolivia","La Paz","Los Andes","Batallas","PLAZA LA PAZ",-68.51289,-16.34104,36,4,566,602,193,19,350,543
"Bolivia","La Paz","Los Andes","Batallas","PLAZA PRINCIPAL",-68.54729,-16.10482,112,16,1192,1304,434,57,685,1119
"Bolivia","La Paz","Los Andes","Batallas","PLAZA PRINCIPAL",-68.46272,-16.2592,112,16,1192,1304,434,57,685,1119
"Bolivia","La Paz","Los Andes","Batallas","PLAZA TUPAC KATARI",-68.50398,-16.23213,75,17,642,717,150,35,440,590
"Bolivia","La Paz","Los Andes","Batallas","PLAZA TUQUIA",-68.46532,-16.21404,67,13,684,751,186,44,441,627
"Bolivia","La Paz","Los Andes","Batallas","PLAZA V. ASUNCION DE CALUYO",-68.51057,-16.32793,15,0,198,213,34,4,160,194
"Bolivia","La Paz","Los Andes","Batallas","SEDE SOCIAL",-68.56298,-16.25858,16,3,250,266,77,9,161,238
"Bolivia","La Paz","Los Andes","Laja","COL. PEDRO DOMINGO MURILLO",-68.38843,-16.53407,294,57,3397,3691,824,159,2357,3181
"Bolivia","La Paz","Los Andes","Laja","COL. TEC. HUMANISTICO TAMBILLO",-68.50755,-16.57151,56,13,515,571,151,28,323,474
"Bolivia","La Paz","Los Andes","Laja","ESC. QUINTUPATA",-68.50268,-16.62749,3,3,135,138,30,1,101,131
"Bolivia","La Paz","Los Andes","Laja","ESCUELA REPUBLICA DE IRAN",-68.30653,-16.52587,113,16,1084,1197,287,47,734,1021
"Bolivia","La Paz","Los Andes","Laja","MERCADO SAN JUAN",-68.46218,-16.69142,36,13,460,496,56,24,367,423
"Bolivia","La Paz","Los Andes","Laja","PLAZA CURVA PUCARA",-68.57091,-16.59581,22,12,579,601,99,21,447,546
"Bolivia","La Paz","Los Andes","Laja","PLAZA PRINCIPAL",-68.55198,-16.5294,38,22,1018,1056,176,53,767,943
"Bolivia","La Paz","Los Andes","Laja","PLAZA PRINCIPAL",-68.55477,-16.65492,38,22,1018,1056,176,53,767,943
"Bolivia","La Paz","Los Andes","Laja","PLAZA PRINCIPAL",-68.56635,-16.57367,38,22,1018,1056,176,53,767,943
"Bolivia","La Paz","Los Andes","Laja","U.E. CALLAMARCA",-68.57652,-16.6364,2,3,380,382,73,19,285,358
"Bolivia","La Paz","Los Andes","Laja","U.E. GUALBERTO VILLARROEL DE SACACANI",-68.50606,-16.68419,0,0,216,216,48,8,160,208
"Bolivia","La Paz","Los Andes","Laja","UNIDAD EDUCATIVA COPAJIRA",-68.44736,-16.59749,38,10,617,655,118,33,456,574
"Bolivia","La Paz","Los Andes","Pucarani","COLEGIO CHIARPATA",-68.52587,-16.35778,30,20,480,510,148,25,287,435
"Bolivia","La Paz","Los Andes","Pucarani","COLEGIO COHANA",-68.65945,-16.37055,25,16,685,710,136,25,508,644
"Bolivia","La Paz","Los Andes","Pucarani","COLEGIO MARIO GUTIERREZ",-68.5423,-16.40942,80,43,1028,1108,366,92,527,893
"Bolivia","La Paz","Los Andes","Pucarani","COLEGIO SAN SALVADOR",-68.37844,-16.37475,133,40,1707,1840,473,103,1091,1564
"Bolivia","La Paz","Los Andes","Pucarani","COL.NAL.CHOJÑA COLLO",-68.42926,-16.44215,17,9,393,410,128,35,221,349
"Bolivia","La Paz","Los Andes","Pucarani","ESC. CENTRAL CHIPAMAYA",-68.42702,-16.38573,34,7,457,491,140,21,289,429
"Bolivia","La Paz","Los Andes","Pucarani","ESC. JOSE SALMON BALLIVIAN",-68.47432,-16.39758,294,81,3005,3299,1094,162,1668,2762
"Bolivia","La Paz","Los Andes","Pucarani","ESCUELA ANTOFAGASTA",-68.33107,-16.42799,88,53,1728,1816,627,161,887,1514
"Bolivia","La Paz","Los Andes","Pucarani","ESCUELA CATAVI",-68.58923,-16.48189,61,22,675,736,193,30,430,623
"Bolivia","La Paz","Los Andes","Pucarani","ESCUELA CHOJASIVI",-68.69275,-16.44042,10,10,676,686,231,26,409,640
"Bolivia","La Paz","Los Andes","Pucarani","PLAZA 6 DE AGOSTO",-68.41537,-16.33457,120,31,1482,1602,323,63,1065,1388
"Bolivia","La Paz","Los Andes","Pucarani","PLAZA PRINCIPAL",-68.66112,-16.44403,67,16,725,792,110,11,588,698
"Bolivia","La Paz","Los Andes","Pucarani","PLAZA VILLA ROSARIO DE CORAPATA",-68.37347,-16.4377,72,22,920,992,390,47,461,851
"Bolivia","La Paz","Los Andes","Puerto Pérez","ESC. GUALBERTO VILLARROEL",-68.59356,-16.35726,65,6,453,518,151,26,270,421
"Bolivia","La Paz","Los Andes","Puerto Pérez","ESC. MIXTO 16 DE JULIO",-68.76075,-16.30686,62,27,874,936,173,36,638,811
"Bolivia","La Paz","Los Andes","Puerto Pérez","ESCUELA CENTRAL CASCACHI",-68.67452,-16.3437,37,13,518,555,91,35,379,470
"Bolivia","La Paz","Los Andes","Puerto Pérez","ESCUELA PUERTO PEREZ",-68.60112,-16.28587,90,20,1047,1137,243,26,758,1001
"Bolivia","La Paz","Los Andes","Puerto Pérez","ESCUELAS POPULARES DON BOSCO",-68.58698,-16.34699,28,2,314,342,91,9,212,303
"Bolivia","La Paz","Los Andes","Puerto Pérez","UNIDAD EDUCATIVA CUMANA",-68.63633,-16.34833,20,4,257,277,42,5,206,248
"Bolivia","La Paz","Manco Kapac","Copacabana","CENTRO DE SALUD SIRIPACA",-69.06173,-16.09907,39,7,243,282,25,3,208,233
"Bolivia","La Paz","Manco Kapac","Copacabana","COLEGIO CHALLA",-69.18937,-15.98997,64,12,938,1002,47,15,864,911
"Bolivia","La Paz","Manco Kapac","Copacabana","COL. NACIONAL MIXTO COPACABANA",-69.08396,-16.1632,569,57,3967,4536,1210,144,2556,3766
"Bolivia","La Paz","Manco Kapac","Copacabana","ESC. 16 DE JULIO",-69.0842,-16.20929,110,16,881,991,288,36,541,829
"Bolivia","La Paz","Manco Kapac","Copacabana","ESC. COL. TEC. HUMANISTICO HUACUYO",-69.03305,-16.17805,71,3,409,480,81,16,309,390
"Bolivia","La Paz","Manco Kapac","Copacabana","ESCUELA SECCIONAL SAMPAYA",-69.1012,-16.08231,44,7,321,365,47,15,252,299
"Bolivia","La Paz","Manco Kapac","Copacabana","ESCUELA VILLA ROSARIO",-68.98846,-16.14534,37,9,328,365,68,11,240,308
"Bolivia","La Paz","Manco Kapac","San Pedro de Tiquina","COLEGIO VILLA AMACARI",-68.86105,-16.25432,14,8,184,198,48,5,123,171
"Bolivia","La Paz","Manco Kapac","San Pedro de Tiquina","COL. SIMON BOLIVAR",-68.85252,-16.22503,260,19,1043,1303,306,53,665,971
"Bolivia","La Paz","Manco Kapac","San Pedro de Tiquina","ESC. MIXTA SAN PABLO DE TIQUINA",-68.84653,-16.21544,75,20,651,726,249,30,352,601
"Bolivia","La Paz","Manco Kapac","San Pedro de Tiquina","PLAZA 25 DE JUNIO",-68.88103,-16.26364,31,2,212,243,62,4,144,206
"Bolivia","La Paz","Manco Kapac","San Pedro de Tiquina","SEDE SOCIAL",-68.89336,-16.22142,52,8,303,355,55,7,233,288
"Bolivia","La Paz","Manco Kapac","Tito Yupanqui","COLEGIO NACIONAL MIXTO TITO YUPANQUI",-68.95449,-16.19247,122,25,653,775,215,21,392,607
"Bolivia","La Paz","Manco Kapac","Tito Yupanqui","ESCUELA HUATAPAMPA",-68.95433,-16.17676,14,1,165,179,39,8,117,156
"Bolivia","La Paz","Muñecas","Aucapata","COLEGIO 2 DE AGOSTO",-68.76146,-15.4182,101,10,391,492,52,22,307,359
"Bolivia","La Paz","Muñecas","Aucapata","ESCUELA DR. ANGEL GEMIO ERGUETA",-68.72099,-15.48481,66,2,169,235,51,16,100,151
"Bolivia","La Paz","Muñecas","Aucapata","IGLESIA SANTO DOMINGO",-68.72872,-15.4539,72,10,195,267,34,13,138,172
"Bolivia","La Paz","Muñecas","Aucapata","NUCLEO ESCOLAR YANAHUAYA",-68.6969,-15.45401,110,22,384,494,83,22,257,340
"Bolivia","La Paz","Muñecas","Aucapata","UNIDAD EDUCATIVA ROSARIO",-68.6216,-15.4223,168,12,489,657,91,20,366,457
"Bolivia","La Paz","Muñecas","Ayata","COL. NEMESIO ALIAGA BENAVENTE",-68.8305,-15.45652,245,60,811,1056,118,57,576,694
"Bolivia","La Paz","Muñecas","Ayata","ESC. SAN JUANITO",-68.75811,-15.3747,58,3,367,425,44,19,301,345
"Bolivia","La Paz","Muñecas","Ayata","ESCUELA CAMATA",-68.74616,-15.23502,79,17,385,464,72,18,278,350
"Bolivia","La Paz","Muñecas","Ayata","ESCUELA NUCLEO ELIZARDO PEREZ DE M.",-68.80567,-15.50827,81,30,444,525,97,28,289,386
"Bolivia","La Paz","Muñecas","Ayata","ESCUELA SAIHUANI",-68.77344,-15.44397,102,15,420,522,32,17,356,388
"Bolivia","La Paz","Muñecas","Ayata","ESCUELA SECCIONAL MULTIGRADO UPANI",-68.80933,-15.49444,52,5,276,328,7,29,235,242
"Bolivia","La Paz","Muñecas","Ayata","UNIDAD EDUCATIVA VILLA ROSARIO",-68.62227,-15.22997,0,3,87,87,13,3,68,81
"Bolivia","La Paz","Muñecas","Chuma","COLEGIO HUMANISTICO SOCOCONI",-68.87901,-15.7106,67,11,508,575,57,13,427,484
"Bolivia","La Paz","Muñecas","Chuma","COLEGIO POCOAYA",-68.91715,-15.4475,16,1,118,134,26,8,83,109
"Bolivia","La Paz","Muñecas","Chuma","CUSAHUAYA",-68.84715,-15.66148,7,3,206,213,14,3,186,200
"Bolivia","La Paz","Muñecas","Chuma","ESC. TIMUSI",-68.86244,-15.66374,31,1,266,297,35,7,223,258
"Bolivia","La Paz","Muñecas","Chuma","ESCUELA CENTRAL TITICACHI",-68.81434,-15.50673,63,10,409,472,88,21,290,378
"Bolivia","La Paz","Muñecas","Chuma","ESCUELA CHAJLAYA",-68.90194,-15.68445,57,5,535,592,104,20,406,510
"Bolivia","La Paz","Muñecas","Chuma","ESCUELA DE LUQUISANI",-68.81457,-15.51897,24,6,269,293,93,17,153,246
"Bolivia","La Paz","Muñecas","Chuma","ESCUELA DE TUILUNI",-68.92104,-15.48239,27,9,258,285,68,25,156,224
"Bolivia","La Paz","Muñecas","Chuma","ESCUELA MAXIMILIANO ORTIZ",-68.89848,-15.4816,252,37,830,1082,184,54,555,739
"Bolivia","La Paz","Muñecas","Chuma","ESCUELA PALOHUAYA",-68.8721,-15.63676,14,1,124,138,28,4,91,119
"Bolivia","La Paz","Muñecas","Chuma","PLAZA CAPAYQUE",-68.80988,-15.69481,13,4,212,225,18,9,181,199
"Bolivia","La Paz","Muñecas","Chuma","PLAZA JICHUHUAYA",-68.8353,-15.69286,13,0,104,117,20,1,83,103
"Bolivia","La Paz","Murillo","Achocalla","COLEGIO 16 DE AGOSTO",-68.17045,-16.55337,114,6,1115,1229,320,26,763,1083
"Bolivia","La Paz","Murillo","Achocalla","ESCUELA ASUNTA QUILLVIRI",-68.11919,-16.72616,81,18,1012,1093,238,67,689,927
"Bolivia","La Paz","Murillo","Achocalla","ESCUELA CHAÑOCAHUA",-68.14516,-16.63919,347,30,3694,4041,1028,129,2507,3535
"Bolivia","La Paz","Murillo","Achocalla","ESCUELA MARQUIRIVI",-68.15418,-16.5915,278,37,2011,2289,498,51,1425,1923
"Bolivia","La Paz","Murillo","Achocalla","ESCUELA VILLA CONCEPCION",-68.13874,-16.60526,28,9,522,550,101,27,385,486
"Bolivia","La Paz","Murillo","Achocalla","U. E.  ANTONIO DIAZ VILLAMIL",-68.16837,-16.57798,148,34,1803,1951,514,52,1203,1717
"Bolivia","La Paz","Murillo","Achocalla","U. E. RENE BARRIENTOS ORTUÑO",-68.1705,-16.56838,143,13,1235,1378,410,29,783,1193
"Bolivia","La Paz","Murillo","Achocalla","UNIDAD EDUCATIVA TUNI",-68.13835,-16.67672,26,2,348,374,69,7,270,339
"Bolivia","La Paz","Murillo","El Alto de La Paz","CENTRO EDUCATIVO CATOLICO MERCEDES",-68.2159,-16.56526,214,28,2435,2649,824,121,1462,2286
"Bolivia","La Paz","Murillo","El Alto de La Paz","COL 18 DE DICIEMBRE",-68.17837,-16.58624,338,27,3263,3601,1006,144,2086,3092
"Bolivia","La Paz","Murillo","El Alto de La Paz","COL 1RO DE MAYO",-68.19975,-16.53636,657,49,7853,8510,3644,396,3764,7408
"Bolivia","La Paz","Murillo","El Alto de La Paz","COL 25 DE JULIO",-68.18322,-16.58162,838,75,6599,7437,2202,295,4027,6229
"Bolivia","La Paz","Murillo","El Alto de La Paz","COL ATIPIRIS",-68.17815,-16.59096,321,40,2932,3253,866,149,1877,2743
"Bolivia","La Paz","Murillo","El Alto de La Paz","COL BASILL MILLER",-68.17461,-16.48812,230,19,2919,3149,1330,130,1440,2770
"Bolivia","La Paz","Murillo","El Alto de La Paz","COL BOLIVIA",-68.17217,-16.5416,467,46,4155,4622,1592,215,2302,3894
"Bolivia","La Paz","Murillo","El Alto de La Paz","COL CALAMA",-68.19262,-16.53144,626,52,7137,7763,2855,316,3914,6769
"Bolivia","La Paz","Murillo","El Alto de La Paz","COL EDUARDO AVAROA",-68.18268,-16.52774,319,22,2726,3045,1119,115,1470,2589
"Bolivia","La Paz","Murillo","El Alto de La Paz","COLEGIO 23 DE MARZO",-68.1777,-16.61965,770,87,6619,7389,1738,305,4489,6227
"Bolivia","La Paz","Murillo","El Alto de La Paz","COLEGIO 27 DE MAYO",-68.18954,-16.59973,595,88,5668,6263,1618,298,3664,5282
"Bolivia","La Paz","Murillo","El Alto de La Paz","COLEGIO 6 DE JUNIO",-68.20706,-16.55554,516,40,4530,5046,1597,147,2746,4343
"Bolivia","La Paz","Murillo","El Alto de La Paz","COLEGIO ADRIAN CASTILLO NAVA",-68.18089,-16.47932,842,92,8873,9715,3409,395,4977,8386
"Bolivia","La Paz","Murillo","El Alto de La Paz","COLEGIO ANDRES DE STA CRUZ",-68.21678,-16.48222,623,80,6837,7460,2609,386,3762,6371
"Bolivia","La Paz","Murillo","El Alto de La Paz","COLEGIO ANTONIO PAREDES CANDIA",-68.21078,-16.47959,918,144,10853,11771,3838,538,6333,10171
"Bolivia","La Paz","Murillo","El Alto de La Paz","COLEGIO BOLIVIA MAR",-68.19718,-16.58017,264,24,2518,2782,660,107,1727,2387
"Bolivia","La Paz","Murillo","El Alto de La Paz","COLEGIO DON BOSCO",-68.22162,-16.56328,746,78,7399,8145,2631,249,4441,7072
"Bolivia","La Paz","Murillo","El Alto de La Paz","COLEGIO FERNANDO NOGALES CASTRO",-68.23376,-16.52565,289,37,3484,3773,1511,133,1803,3314
"Bolivia","La Paz","Murillo","El Alto de La Paz","COLEGIO HUAYNA POTOSI",-68.18628,-16.47742,666,114,8029,8695,2771,410,4734,7505
"Bolivia","La Paz","Murillo","El Alto de La Paz","COLEGIO ILLIMANI",-68.20894,-16.54332,694,71,7226,7920,2297,267,4591,6888
"Bolivia","La Paz","Murillo","El Alto de La Paz","COLEGIO LUIS ESPINAL CAMPS",-68.22268,-16.52322,980,111,9286,10266,3175,314,5686,8861
"Bolivia","La Paz","Murillo","El Alto de La Paz","COLEGIO LUIS ESPINAL CAMPS (AEROPUERTO)",-68.19802,-16.51796,352,33,2977,3329,1046,156,1742,2788
"Bolivia","La Paz","Murillo","El Alto de La Paz","COLEGIO MARISCAL ANDRES DE SANTA CRUZ",-68.14963,-16.53367,133,16,1349,1482,748,42,543,1291
"Bolivia","La Paz","Murillo","El Alto de La Paz","COLEGIO MARTIN CARDENAS",-68.20902,-16.5227,1058,70,9815,10873,4851,385,4509,9360
"Bolivia","La Paz","Murillo","El Alto de La Paz","COLEGIO M QUIROGA SANTA CRUZ",-68.20879,-16.48692,295,158,4768,5063,1919,264,2427,4346
"Bolivia","La Paz","Murillo","El Alto de La Paz","COLEGIO NESTOR PAZ",-68.23247,-16.54344,495,45,4940,5435,1684,272,2939,4623
"Bolivia","La Paz","Murillo","El Alto de La Paz","COLEGIO PARTICULAR SAN MIGUEL",-68.21574,-16.49355,224,15,2154,2378,1059,100,980,2039
"Bolivia","La Paz","Murillo","El Alto de La Paz","COLEGIO PUERTO DEL ROSARIO",-68.19044,-16.54459,1107,83,10673,11780,4517,402,5671,10188
"Bolivia","La Paz","Murillo","El Alto de La Paz","COLEGIO PUERTO DEL ROSARIO",-68.19044,-16.54459,1107,83,10673,11780,4517,402,5671,10188
"Bolivia","La Paz","Murillo","El Alto de La Paz","COLEGIO SAN JOSE",-68.17645,-16.48123,876,111,10039,10915,4092,467,5369,9461
"Bolivia","La Paz","Murillo","El Alto de La Paz","COLEGIO WALTER ALPIRE 1ER PATIO",-68.21351,-16.49505,515,36,4904,5419,2435,204,2229,4664
"Bolivia","La Paz","Murillo","El Alto de La Paz","COLEGIO WALTER ALPIRE 2DO PATIO",-68.21351,-16.49505,233,30,3092,3325,1664,90,1308,2972
"Bolivia","La Paz","Murillo","El Alto de La Paz","COL ESPAÑA",-68.19041,-16.58716,1083,87,9120,10203,2893,393,5747,8640
"Bolivia","La Paz","Murillo","El Alto de La Paz","COL GRAN BRETAÑA",-68.18764,-16.49338,490,42,5632,6122,2556,229,2805,5361
"Bolivia","La Paz","Murillo","El Alto de La Paz","COL HEROES DEL PACIFICO",-68.15602,-16.52656,396,13,4315,4711,2896,119,1287,4183
"Bolivia","La Paz","Murillo","El Alto de La Paz","COL LIBERTADOR S. BOLIVAR",-68.17521,-16.52682,462,34,4467,4929,1991,177,2265,4256
"Bolivia","La Paz","Murillo","El Alto de La Paz","COL MUTUAL LA PAZ",-68.19092,-16.55765,361,43,4042,4403,1871,136,1992,3863
"Bolivia","La Paz","Murillo","El Alto de La Paz","COL PUERTO MEJILLONES",-68.15205,-16.52655,788,41,7782,8570,5150,204,2387,7537
"Bolivia","La Paz","Murillo","El Alto de La Paz","COL RAFAEL MENDOZA",-68.19506,-16.49104,492,48,4903,5395,2342,267,2246,4588
"Bolivia","La Paz","Murillo","El Alto de La Paz","COL. REPUBLICA DE ITALIA",-68.1873,-16.5898,215,25,2000,2215,636,91,1248,1884
"Bolivia","La Paz","Murillo","El Alto de La Paz","COL ROTARY CHUQUIAGO MARCA",-68.16711,-16.53573,1011,81,8411,9422,3437,350,4543,7980
"Bolivia","La Paz","Murillo","El Alto de La Paz","COL SANTA MARIA DE LOS ANGELES",-68.17751,-16.49472,613,57,6809,7422,3221,351,3180,6401
"Bolivia","La Paz","Murillo","El Alto de La Paz","COL SAN VICENTE DE PAUL",-68.20663,-16.50516,720,71,7407,8127,2690,299,4347,7037
"Bolivia","La Paz","Murillo","El Alto de La Paz","COL. TEC. HUMANISTICO JOSE BALLIVIAN",-68.1784,-16.48976,313,42,3459,3772,1487,184,1746,3233
"Bolivia","La Paz","Murillo","El Alto de La Paz","COL TOPATER",-68.19929,-16.5635,482,35,5105,5587,1886,196,2988,4874
"Bolivia","La Paz","Murillo","El Alto de La Paz","COL TUNARI",-68.19628,-16.49841,1276,134,13812,15088,5846,623,7209,13055
"Bolivia","La Paz","Murillo","El Alto de La Paz","COL VICENTE TEJADA",-68.15522,-16.51924,558,55,5652,6210,2603,228,2766,5369
"Bolivia","La Paz","Murillo","El Alto de La Paz","ESC BALLIVIAN",-68.17644,-16.49026,328,44,3921,4249,1573,201,2103,3676
"Bolivia","La Paz","Murillo","El Alto de La Paz","ESC BOLIVAR MUNICIPAL",-68.18821,-16.53657,303,36,3647,3950,1409,147,2055,3464
"Bolivia","La Paz","Murillo","El Alto de La Paz","ESC ELIZARDO PEREZ",-68.1898,-16.48761,428,43,4525,4953,1912,218,2352,4264
"Bolivia","La Paz","Murillo","El Alto de La Paz","ESC JUVENAL MARIACA",-68.17067,-16.49689,715,55,7081,7796,3574,293,3159,6733
"Bolivia","La Paz","Murillo","El Alto de La Paz","ESC LIBERTAD EN LAS AMERICAS",-68.15623,-16.53351,767,73,7221,7988,3007,258,3883,6890
"Bolivia","La Paz","Murillo","El Alto de La Paz","ESC LOS ANDES",-68.18398,-16.49493,304,34,3283,3587,1507,147,1595,3102
"Bolivia","La Paz","Murillo","El Alto de La Paz","ESC LUIS ESPINAL CAMPS",-68.16608,-16.4796,245,31,2568,2813,916,116,1505,2421
"Bolivia","La Paz","Murillo","El Alto de La Paz","ESC PRIMAVERA",-68.1945,-16.53725,174,13,1555,1729,685,64,793,1478
"Bolivia","La Paz","Murillo","El Alto de La Paz","ESC TARAPACA",-68.18806,-16.60872,554,71,5829,6383,1548,243,3967,5515
"Bolivia","La Paz","Murillo","El Alto de La Paz","ESCUELA 16 DE FEBRERO",-68.22742,-16.50302,661,95,7448,8109,2757,268,4328,7085
"Bolivia","La Paz","Murillo","El Alto de La Paz","ESCUELA BRASIL",-68.20975,-16.49082,456,38,5008,5464,2223,211,2536,4759
"Bolivia","La Paz","Murillo","El Alto de La Paz","ESCUELA GUAQUI",-68.17409,-16.47567,563,74,6164,6727,2203,301,3586,5789
"Bolivia","La Paz","Murillo","El Alto de La Paz","ESCUELA JUAN CARLOS FLORES BEDREGAL",-68.22012,-16.50096,693,95,7769,8462,3069,266,4339,7408
"Bolivia","La Paz","Murillo","El Alto de La Paz","ESCUELA JUAN CARLOS FLORES BEDREGAL",-68.22012,-16.50096,693,95,7769,8462,3069,266,4339,7408
"Bolivia","La Paz","Murillo","El Alto de La Paz","ESCUELA JUAN JOSE TORREZ",-68.17109,-16.47051,363,55,4053,4416,1349,196,2453,3802
"Bolivia","La Paz","Murillo","El Alto de La Paz","ESCUELA RAFAEL PABON",-68.17429,-16.46312,305,75,4175,4480,1240,279,2581,3821
"Bolivia","La Paz","Murillo","El Alto de La Paz","ESCUELA RAUL SALMON DE LA BARRA",-68.21005,-16.49883,282,31,3411,3693,1445,154,1781,3226
"Bolivia","La Paz","Murillo","El Alto de La Paz","ESCUELA REPUBLICA DE CHINA POPULAR",-68.23643,-16.50772,422,72,4824,5246,1516,168,3068,4584
"Bolivia","La Paz","Murillo","El Alto de La Paz","ESCUELA TEJADA TRIANGULAR",-68.15996,-16.52431,273,22,2802,3075,1340,107,1333,2673
"Bolivia","La Paz","Murillo","El Alto de La Paz","ESCUELA TUPAC KATARI",-68.19848,-16.48532,330,45,3613,3943,1557,150,1861,3418
"Bolivia","La Paz","Murillo","El Alto de La Paz","INSTITUTO EDUCATIVO JESUS DE NAZARETH",-68.21307,-16.52458,459,45,4099,4558,1855,130,2069,3924
"Bolivia","La Paz","Murillo","El Alto de La Paz","SEDE SOCIAL JUNTA VECINAL",-68.19644,-16.54614,155,21,1394,1549,521,34,818,1339
"Bolivia","La Paz","Murillo","El Alto de La Paz","SEDE VECINAL",-68.1711,-16.51802,39,3,471,510,281,18,169,450
"Bolivia","La Paz","Murillo","El Alto de La Paz","U.E. AMIGOS DEL CHACO",-68.20364,-16.52415,86,11,1048,1134,424,31,582,1006
"Bolivia","La Paz","Murillo","El Alto de La Paz","U.E. CRISTAL",-68.20247,-16.59457,68,12,1343,1411,390,32,909,1299
"Bolivia","La Paz","Murillo","El Alto de La Paz","U.E. FUERZA AEREA ARGENTINA",-68.25346,-16.49715,66,16,934,1000,283,46,589,872
"Bolivia","La Paz","Murillo","El Alto de La Paz","U.E. GRAL. ARMANDO ESCOBAR URIA",-68.15063,-16.52961,145,3,1622,1767,1077,52,490,1567
"Bolivia","La Paz","Murillo","El Alto de La Paz","U.E. OSCAR ALFARO",-68.23621,-16.48713,444,61,4838,5282,1745,229,2803,4548
"Bolivia","La Paz","Murillo","El Alto de La Paz","UE PARTICULAR INTERANDINO BOLIVIANO",-68.18138,-16.49701,34,2,196,230,99,8,87,186
"Bolivia","La Paz","Murillo","El Alto de La Paz","U.E. SAN ANDRES",-68.15803,-16.53902,165,13,1751,1916,724,56,958,1682
"Bolivia","La Paz","Murillo","El Alto de La Paz","U.E. TOKIO",-68.17825,-16.47219,254,22,2749,3003,901,195,1631,2532
"Bolivia","La Paz","Murillo","El Alto de La Paz","U. E. VILLA ADELA YUNGUYO",-68.21577,-16.52021,380,45,3453,3833,1447,167,1794,3241
"Bolivia","La Paz","Murillo","El Alto de La Paz","U. E. VILLA ADELA YUNGUYO",-68.21643,-16.51679,380,45,3453,3833,1447,167,1794,3241
"Bolivia","La Paz","Murillo","El Alto de La Paz","UNIDAD EDUCATIVA 12 DE OCTUBRE",-68.1631,-16.51261,455,32,4604,5059,2562,138,1872,4434
"Bolivia","La Paz","Murillo","El Alto de La Paz","UNIDAD EDUCATIVA 25 DE JULIO",-68.21799,-16.50818,450,53,4141,4591,1412,204,2472,3884
"Bolivia","La Paz","Murillo","El Alto de La Paz","UNIDAD EDUCATIVA 3 DE MAYO",-68.21262,-16.54766,509,72,5791,6300,1877,199,3643,5520
"Bolivia","La Paz","Murillo","El Alto de La Paz","UNIDAD EDUCATIVA 6 DE JUNIO",-68.22369,-16.53518,476,42,4617,5093,1571,163,2841,4412
"Bolivia","La Paz","Murillo","El Alto de La Paz","UNIDAD EDUCATIVA ADELA ZAMUDIO",-68.19314,-16.52711,174,19,2157,2331,883,87,1168,2051
"Bolivia","La Paz","Murillo","El Alto de La Paz","UNIDAD EDUCATIVA  ALTO DE LA ALIANZA",-68.18938,-16.52214,340,31,3555,3895,1476,146,1902,3378
"Bolivia","La Paz","Murillo","El Alto de La Paz","UNIDAD EDUCATIVA ANDRES BELLO",-68.16715,-16.51139,109,16,1031,1140,577,26,412,989
"Bolivia","La Paz","Murillo","El Alto de La Paz","UNIDAD EDUCATIVA ANDRES BELLO (U. E. 16 DE JULIO)",-68.16715,-16.51139,72,3,577,649,357,16,201,558
"Bolivia","La Paz","Murillo","El Alto de La Paz","UNIDAD EDUCATIVA ANICETO ARCE",-68.18877,-16.55329,177,30,1945,2122,776,62,1077,1853
"Bolivia","La Paz","Murillo","El Alto de La Paz","UNIDAD EDUCATIVA BAUTISTA SAAVEDRA",-68.23381,-16.48594,839,109,8195,9034,3042,352,4692,7734
"Bolivia","La Paz","Murillo","El Alto de La Paz","UNIDAD EDUCATIVA BRASILIA",-68.15981,-16.51867,424,31,4386,4810,2189,148,2018,4207
"Bolivia","La Paz","Murillo","El Alto de La Paz","UNIDAD EDUCATIVA CARLOS PALENQUE",-68.18768,-16.52626,334,21,3284,3618,1331,154,1778,3109
"Bolivia","La Paz","Murillo","El Alto de La Paz","UNIDAD EDUCATIVA DONOZO TORRES",-68.15047,-16.52236,360,20,3654,4014,2192,105,1337,3529
"Bolivia","La Paz","Murillo","El Alto de La Paz","UNIDAD EDUCATIVA ECOLOGICO LOS PINOS",-68.17538,-16.5999,506,47,4661,5167,1207,202,3205,4412
"Bolivia","La Paz","Murillo","El Alto de La Paz","UNIDAD EDUCATIVA EDUARDO AVAROA I",-68.29729,-16.49421,45,17,638,683,201,27,393,594
"Bolivia","La Paz","Murillo","El Alto de La Paz","UNIDAD EDUCATIVA EVA PERON",-68.15955,-16.50945,437,35,4267,4704,2171,150,1911,4082
"Bolivia","La Paz","Murillo","El Alto de La Paz","UNIDAD EDUCATIVA FRANZ TAMAYO",-68.25333,-16.50809,484,54,5632,6116,1700,232,3646,5346
"Bolivia","La Paz","Murillo","El Alto de La Paz","UNIDAD EDUCATIVA GRAN PODER",-68.19362,-16.55863,261,18,2224,2485,850,91,1265,2115
"Bolivia","La Paz","Murillo","El Alto de La Paz","UNIDAD EDUCATIVA ILLIMANI",-68.18507,-16.46561,441,56,4632,5073,1563,258,2755,4318
"Bolivia","La Paz","Murillo","El Alto de La Paz","UNIDAD EDUCATIVA INGAVI",-68.1793,-16.46868,421,55,4620,5041,1480,261,2824,4304
"Bolivia","La Paz","Murillo","El Alto de La Paz","UNIDAD EDUCATIVA INTEGRACION",-68.16405,-16.50175,310,25,2597,2907,1405,84,1083,2488
"Bolivia","La Paz","Murillo","El Alto de La Paz","UNIDAD EDUCATIVA JUAN CAPRILES",-68.15948,-16.5062,357,36,3402,3759,1632,96,1638,3270
"Bolivia","La Paz","Murillo","El Alto de La Paz","UNIDAD EDUCATIVA JUAN JOSE TORRES",-68.2122,-16.53901,522,59,5218,5740,1935,197,3027,4962
"Bolivia","La Paz","Murillo","El Alto de La Paz","UNIDAD EDUCATIVA LA PAZ",-68.20005,-16.52881,340,34,2798,3138,1226,106,1432,2658
"Bolivia","La Paz","Murillo","El Alto de La Paz","UNIDAD EDUCATIVA MARISCAL ANTONIO JOSE E",-68.22196,-16.47654,638,73,6087,6725,1994,312,3708,5702
"Bolivia","La Paz","Murillo","El Alto de La Paz","UNIDAD EDUCATIVA MERCEDES ELIO DE RIVERO",-68.23167,-16.55686,300,46,3477,3777,973,116,2342,3315
"Bolivia","La Paz","Murillo","El Alto de La Paz","UNIDAD EDUCATIVA NORUEGA",-68.19359,-16.4826,559,75,5561,6120,2065,300,3121,5186
"Bolivia","La Paz","Murillo","El Alto de La Paz","UNIDAD EDUCATIVA PABLO ZARATE VILLCA",-68.19443,-16.47187,23,4,403,426,126,22,251,377
"Bolivia","La Paz","Murillo","El Alto de La Paz","UNIDAD EDUCATIVA PROGRESO",-68.25311,-16.47828,449,97,5662,6111,1942,284,3339,5281
"Bolivia","La Paz","Murillo","El Alto de La Paz","UNIDAD EDUCATIVA REP. DEL URUGUAY",-68.27645,-16.51882,40,8,550,590,228,17,297,525
"Bolivia","La Paz","Murillo","El Alto de La Paz","UNIDAD EDUCATIVA REPUBLICA DE CUBA",-68.18736,-16.52857,425,64,5159,5584,1716,234,3145,4861
"Bolivia","La Paz","Murillo","El Alto de La Paz","UNIDAD EDUCATIVA REPUBLICA DE CUBA",-68.20181,-16.47474,425,64,5159,5584,1716,234,3145,4861
"Bolivia","La Paz","Murillo","El Alto de La Paz","UNIDAD EDUCATIVA REPUBLICA DE FRANCIA",-68.19515,-16.5501,686,64,6429,7115,2256,285,3824,6080
"Bolivia","La Paz","Murillo","El Alto de La Paz","UNIDAD EDUCATIVA SAN JUAN DE CALAMA",-68.19692,-16.52204,346,42,3643,3989,1473,121,2007,3480
"Bolivia","La Paz","Murillo","El Alto de La Paz","UNIDAD EDUCATIVA SAN LUIS",-68.20049,-16.54089,468,45,4851,5319,1876,169,2761,4637
"Bolivia","La Paz","Murillo","El Alto de La Paz","UNIDAD EDUCATIVA SAN ROQUE",-68.27818,-16.47489,1063,189,11300,12363,3640,629,6842,10482
"Bolivia","La Paz","Murillo","El Alto de La Paz","UNIDAD EDUCATIVA SANTA ROSA DE LIMA",-68.1677,-16.45551,179,21,1769,1948,504,121,1123,1627
"Bolivia","La Paz","Murillo","El Alto de La Paz","UNIDAD EDUCATIVA SANTIAGO I",-68.16467,-16.52485,481,31,4108,4589,1971,154,1952,3923
"Bolivia","La Paz","Murillo","El Alto de La Paz","UNIDAD EDUCATIVA TECNICA YUNGUYO",-68.22483,-16.49496,393,59,4853,5246,1809,184,2801,4610
"Bolivia","La Paz","Murillo","El Alto de La Paz","UNIDAD EDUCATIVA THE STRONGEST",-68.19981,-16.47943,191,23,2072,2263,743,113,1193,1936
"Bolivia","La Paz","Murillo","El Alto de La Paz","UNIDAD EDUCATIVA TUPAC AMARU",-68.20243,-16.57245,208,15,2137,2345,642,88,1392,2034
"Bolivia","La Paz","Murillo","El Alto de La Paz","UNIDAD EDUCATIVA UNION EUROPEA",-68.17921,-16.53997,1265,109,12979,14244,6059,474,6337,12396
"Bolivia","La Paz","Murillo","El Alto de La Paz","UNIDAD EDUCATIVA VILLA ALEMANIA",-68.20655,-16.51637,345,28,3017,3362,1348,116,1525,2873
"Bolivia","La Paz","Murillo","El Alto de La Paz","UNIDAD EDUCATIVA VILLA COOPERATIVA",-68.22495,-16.47322,415,83,4399,4814,1389,197,2730,4119
"Bolivia","La Paz","Murillo","El Alto de La Paz","UNID. EDUC.  M. QUIROGA SANTA CRUZ",-68.17841,-16.5187,242,32,2762,3004,1151,116,1463,2614
"Bolivia","La Paz","Murillo","Mecapaca","COLEGIO 6 DE JUNIO",-67.93151,-16.8046,5,0,270,275,38,1,231,269
"Bolivia","La Paz","Murillo","Mecapaca","COL. SAN SIMON DE AYACUCHO",-67.98664,-16.8034,67,9,353,420,77,13,254,331
"Bolivia","La Paz","Murillo","Mecapaca","ESCUELA EL PALOMAR",-68.00471,-16.7009,76,18,1072,1148,237,33,784,1021
"Bolivia","La Paz","Murillo","Mecapaca","ESCUELA HUARICANA ALTO",-67.93894,-16.73059,45,9,794,839,130,14,641,771
"Bolivia","La Paz","Murillo","Mecapaca","ESCUELA JANKOSUNI",-67.87069,-16.79541,8,0,252,260,29,1,222,251
"Bolivia","La Paz","Murillo","Mecapaca","ESCUELA SANTIAGO DE COLLANA",-67.96983,-16.66847,40,5,599,639,97,12,485,582
"Bolivia","La Paz","Murillo","Mecapaca","ESCUELA SIMONA MANZANEDA",-68.01966,-16.66984,204,17,1878,2082,571,49,1241,1812
"Bolivia","La Paz","Murillo","Mecapaca","PLAZA PRINCIPAL HUAJCHILLA",-68.05293,-16.62848,128,7,1429,1557,477,40,905,1382
"Bolivia","La Paz","Murillo","Mecapaca","UNIDAD EDUCATIVA LLUTO",-68.02113,-16.59331,20,11,267,287,35,21,200,235
"Bolivia","La Paz","Murillo","Mecapaca","UNIDAD EDUCATIVA MILLOCATO",-67.9091,-16.73255,19,2,315,334,37,5,271,308
"Bolivia","La Paz","Murillo","Mecapaca","UNID. EDUC. CONDOR DE LOS ANDES",-68.06098,-16.73627,14,4,336,350,38,9,285,323
"Bolivia","La Paz","Murillo","Nuestra Señora de La Paz","CANCHA DEPORTIVA",-68.108,-16.50108,488,31,4394,4882,2337,98,1928,4265
"Bolivia","La Paz","Murillo","Nuestra Señora de La Paz","CANCHA DEPORTIVA",-68.09735,-16.52828,488,31,4394,4882,2337,98,1928,4265
"Bolivia","La Paz","Murillo","Nuestra Señora de La Paz","(CÁRCEL) COF MIRAFLORES",-68.11906,-16.50092,19,1,37,56,24,0,12,36
"Bolivia","La Paz","Murillo","Nuestra Señora de La Paz","(CÁRCEL) COF OBRAJES",-68.10977,-16.52685,49,0,91,140,55,3,33,88
"Bolivia","La Paz","Murillo","Nuestra Señora de La Paz","(CÁRCEL) PANOPTICO",-68.13491,-16.50283,288,4,491,779,238,16,233,471
"Bolivia","La Paz","Murillo","Nuestra Señora de La Paz","C. E. ADVENTISTA BELLO HORIZONTE",-68.14233,-16.50962,49,3,276,325,170,4,99,269
"Bolivia","La Paz","Murillo","Nuestra Señora de La Paz","CENTRO DE CAPACITACION INTI PAXSI",-68.09966,-16.56521,147,20,1528,1675,906,25,577,1483
"Bolivia","La Paz","Murillo","Nuestra Señora de La Paz","COL. AMERICAN SCHOOL",-68.13224,-16.49319,174,5,1645,1819,1132,28,480,1612
"Bolivia","La Paz","Murillo","Nuestra Señora de La Paz","COL. AMOR DE DIOS",-68.11962,-16.51487,492,14,3097,3589,2449,48,586,3035
"Bolivia","La Paz","Murillo","Nuestra Señora de La Paz","COL. CANADA",-68.14336,-16.50653,338,23,3090,3428,1674,84,1309,2983
"Bolivia","La Paz","Murillo","Nuestra Señora de La Paz","COL. CARACAS",-68.10925,-16.49185,164,19,2109,2273,854,71,1165,2019
"Bolivia","La Paz","Murillo","Nuestra Señora de La Paz","COL. CERVANTES",-68.12268,-16.49229,241,5,2333,2574,1925,28,375,2300
"Bolivia","La Paz","Murillo","Nuestra Señora de La Paz","COL. COPACABANA",-68.116,-16.49115,615,41,6023,6638,3634,164,2184,5818
"Bolivia","La Paz","Murillo","Nuestra Señora de La Paz","COL. CRISTO REY",-68.11716,-16.49006,472,38,5029,5501,2771,162,2058,4829
"Bolivia","La Paz","Murillo","Nuestra Señora de La Paz","COL DANIEL SANCHEZ BUSTAMANTE",-68.14701,-16.50356,951,63,7627,8578,3660,200,3704,7364
"Bolivia","La Paz","Murillo","Nuestra Señora de La Paz","COL DANIEL SANCHEZ BUSTAMANTE",-68.14701,-16.50356,951,63,7627,8578,3660,200,3704,7364
"Bolivia","La Paz","Murillo","Nuestra Señora de La Paz","COLEGIO 6 DE JUNIO",-68.10533,-16.52268,749,37,7987,8736,5501,162,2287,7788
"Bolivia","La Paz","Murillo","Nuestra Señora de La Paz","COLEGIO  ADOLFO  COSTA DU RELS",-68.12815,-16.47907,937,107,9552,10489,3476,413,5556,9032
"Bolivia","La Paz","Murillo","Nuestra Señora de La Paz","COLEGIO AMORETTI",-68.12887,-16.51681,359,35,2687,3046,1965,62,625,2590
"Bolivia","La Paz","Murillo","Nuestra Señora de La Paz","COLEGIO ANTONIO DIAZ VILLAMIL",-68.13431,-16.49114,416,9,3298,3714,2229,59,1001,3230
"Bolivia","La Paz","Murillo","Nuestra Señora de La Paz","COLEGIO AVE MARIA",-68.11795,-16.47431,999,85,8459,9458,5018,223,3133,8151
"Bolivia","La Paz","Murillo","Nuestra Señora de La Paz","COLEGIO AVE MARIA",-68.11795,-16.47431,999,85,8459,9458,5018,223,3133,8151
"Bolivia","La Paz","Murillo","Nuestra Señora de La Paz","COLEGIO BOLIVAR",-68.13287,-16.50506,219,4,1926,2145,1410,37,475,1885
"Bolivia","La Paz","Murillo","Nuestra Señora de La Paz","COLEGIO CANADIENSE",-68.1338,-16.50349,138,5,1267,1405,932,10,320,1252
"Bolivia","La Paz","Murillo","Nuestra Señora de La Paz","COLEGIO DELIA GAMBARTE",-68.10197,-16.50602,214,14,1670,1884,661,96,899,1560
"Bolivia","La Paz","Murillo","Nuestra Señora de La Paz","COLEGIO DON BOSCO",-68.10194,-16.50008,480,37,4722,5202,2385,178,2122,4507
"Bolivia","La Paz","Murillo","Nuestra Señora de La Paz","COLEGIO FRANCIA",-68.1449,-16.48456,167,10,1655,1822,966,63,616,1582
"Bolivia","La Paz","Murillo","Nuestra Señora de La Paz","COLEGIO FRANCO BOLIVIANO",-68.07697,-16.53309,1454,27,9591,11045,7542,152,1870,9412
"Bolivia","La Paz","Murillo","Nuestra Señora de La Paz","COLEGIO GERMAN BUSCH",-68.14012,-16.4923,301,12,2679,2980,1835,71,761,2596
"Bolivia","La Paz","Murillo","Nuestra Señora de La Paz","COLEGIO HOLANDA",-68.15083,-16.49805,1282,103,11070,12352,5057,312,5598,10655
"Bolivia","La Paz","Murillo","Nuestra Señora de La Paz","COLEGIO HOLANDA",-68.15083,-16.49805,1282,103,11070,12352,5057,312,5598,10655
"Bolivia","La Paz","Murillo","Nuestra Señora de La Paz","COLEGIO IGNACIO CALDERON",-68.14203,-16.51064,448,30,4516,4964,2644,88,1754,4398
"Bolivia","La Paz","Murillo","Nuestra Señora de La Paz","COLEGIO IRENE NAVA",-68.11196,-16.46699,777,50,6498,7275,3348,174,2926,6274
"Bolivia","La Paz","Murillo","Nuestra Señora de La Paz","COLEGIO ITALIA",-68.16149,-16.49363,477,40,4954,5431,2332,142,2440,4772
"Bolivia","La Paz","Murillo","Nuestra Señora de La Paz","COLEGIO ITALIA",-68.16149,-16.49363,477,40,4954,5431,2332,142,2440,4772
"Bolivia","La Paz","Murillo","Nuestra Señora de La Paz","COLEGIO JERUSALEM",-68.10326,-16.50195,347,31,3295,3642,1462,119,1683,3145
"Bolivia","La Paz","Murillo","Nuestra Señora de La Paz","COLEGIO LUIS ALBERTO PABON",-68.13418,-16.49122,164,5,1608,1772,1018,58,527,1545
"Bolivia","La Paz","Murillo","Nuestra Señora de La Paz","COLEGIO MAX TOLEDO",-68.15351,-16.49414,694,62,6847,7541,3709,171,2905,6614
"Bolivia","La Paz","Murillo","Nuestra Señora de La Paz","COLEGIO MAX TOLEDO",-68.15351,-16.49414,694,62,6847,7541,3709,171,2905,6614
"Bolivia","La Paz","Murillo","Nuestra Señora de La Paz","COLEGIO NUESTRA SEÑORA DE FATIMA",-68.12103,-16.47554,260,12,2429,2689,1246,104,1067,2313
"Bolivia","La Paz","Murillo","Nuestra Señora de La Paz","COLEGIO RENE BARRIENTOS",-68.07787,-16.53858,404,10,2490,2894,2055,34,391,2446
"Bolivia","La Paz","Murillo","Nuestra Señora de La Paz","COLEGIO SAINT PETERS",-68.13634,-16.50428,171,36,1737,1908,1289,23,389,1678
"Bolivia","La Paz","Murillo","Nuestra Señora de La Paz","COLEGIO SAN IGNACIO",-68.09715,-16.53659,826,10,2927,3753,2340,40,537,2877
"Bolivia","La Paz","Murillo","Nuestra Señora de La Paz","COLEGIO SAN LUIS",-68.13464,-16.51359,570,27,6069,6639,3939,105,1998,5937
"Bolivia","La Paz","Murillo","Nuestra Señora de La Paz","COLEGIO SERGIO VILLEGAS",-68.09919,-16.51187,512,46,4716,5228,2035,165,2470,4505
"Bolivia","La Paz","Murillo","Nuestra Señora de La Paz","COLEGIO SIMON RODRIGUEZ",-68.12112,-16.47591,493,28,3834,4327,2054,80,1672,3726
"Bolivia","La Paz","Murillo","Nuestra Señora de La Paz","COLEGIO TOPATER",-68.10408,-16.49198,320,28,3267,3587,1508,93,1638,3146
"Bolivia","La Paz","Murillo","Nuestra Señora de La Paz","COLEGIO VILLARROEL",-68.14117,-16.49612,378,19,3172,3550,1967,79,1107,3074
"Bolivia","La Paz","Murillo","Nuestra Señora de La Paz","COLEGIO VILLARROEL",-68.14117,-16.4961,378,19,3172,3550,1967,79,1107,3074
"Bolivia","La Paz","Murillo","Nuestra Señora de La Paz","COL. EXPERIMENTAL HUGO DAVILA",-68.11927,-16.49929,531,19,4620,5151,3472,84,1045,4517
"Bolivia","La Paz","Murillo","Nuestra Señora de La Paz","COL. FELIPE 2DO. GUZMAN",-68.12112,-16.50593,420,4,2238,2658,1689,44,501,2190
"Bolivia","La Paz","Murillo","Nuestra Señora de La Paz","COL. FRANZ TAMAYO",-68.15231,-16.49047,621,43,6283,6904,3522,133,2585,6107
"Bolivia","La Paz","Murillo","Nuestra Señora de La Paz","COL. GREGORIO REYNOLDS",-68.13242,-16.51624,403,12,3564,3967,2513,106,933,3446
"Bolivia","La Paz","Murillo","Nuestra Señora de La Paz","COL. GUILLEN PINTO",-68.15572,-16.487,440,59,4970,5410,2167,111,2633,4800
"Bolivia","La Paz","Murillo","Nuestra Señora de La Paz","COL. HERSCHELL",-68.10605,-16.52725,639,23,4356,4995,3064,89,1180,4244
"Bolivia","La Paz","Murillo","Nuestra Señora de La Paz","COL. LORETTO",-68.07858,-16.5454,368,7,2531,2899,2168,35,321,2489
"Bolivia","La Paz","Murillo","Nuestra Señora de La Paz","COL. LUIS ESPINAL CAMPS",-68.14557,-16.52328,759,79,7471,8230,2797,297,4298,7095
"Bolivia","La Paz","Murillo","Nuestra Señora de La Paz","COL. LUIS VELASCO FLORES",-68.15797,-16.46071,80,21,1440,1520,428,37,954,1382
"Bolivia","La Paz","Murillo","Nuestra Señora de La Paz","COL. MARIA AUXILIADORA",-68.13763,-16.50292,224,14,2250,2474,1613,56,567,2180
"Bolivia","La Paz","Murillo","Nuestra Señora de La Paz","COL. MARIEN GARTEN",-68.16064,-16.49042,436,33,4756,5192,2232,115,2376,4608
"Bolivia","La Paz","Murillo","Nuestra Señora de La Paz","COL. NACIONAL AYACUCHO",-68.13404,-16.49409,257,5,1650,1907,1077,41,527,1604
"Bolivia","La Paz","Murillo","Nuestra Señora de La Paz","COL. SAN FRANCISCO",-68.13798,-16.49661,221,12,1804,2025,1268,48,476,1744
"Bolivia","La Paz","Murillo","Nuestra Señora de La Paz","COL. SAN JAVIER",-68.15145,-16.48675,205,9,2253,2458,1500,62,682,2182
"Bolivia","La Paz","Murillo","Nuestra Señora de La Paz","COL. SAN MARTIN",-68.14119,-16.49969,265,16,2143,2408,1349,50,728,2077
"Bolivia","La Paz","Murillo","Nuestra Señora de La Paz","COL. SANTA ANA",-68.13152,-16.49671,156,6,1384,1540,1065,15,298,1363
"Bolivia","La Paz","Murillo","Nuestra Señora de La Paz","COL SERGIO ALMARAZ",-68.11177,-16.49919,439,19,4025,4464,2262,126,1618,3880
"Bolivia","La Paz","Murillo","Nuestra Señora de La Paz","COMPLEJO DEPORTIVO CAMIRI",-68.11738,-16.47857,228,7,2261,2489,1551,40,663,2214
"Bolivia","La Paz","Murillo","Nuestra Señora de La Paz","COMPLEJO DEPORTIVO SAN LUIS",-68.13494,-16.5137,93,3,1118,1211,817,26,272,1089
"Bolivia","La Paz","Murillo","Nuestra Señora de La Paz","COOP. EDUCACIONAL SAN MARCOS LTDA",-68.13071,-16.49973,110,2,910,1020,639,19,250,889
"Bolivia","La Paz","Murillo","Nuestra Señora de La Paz","DIR DISTRITAL DE EDUCACION",-68.12583,-16.49939,296,13,2235,2531,1636,30,556,2192
"Bolivia","La Paz","Murillo","Nuestra Señora de La Paz","E.N.S.A.F.",-68.11926,-16.50412,249,6,2128,2377,1691,26,405,2096
"Bolivia","La Paz","Murillo","Nuestra Señora de La Paz","ESC. ABRAHAM LINCOLN",-68.14679,-16.47846,294,31,3303,3597,1529,109,1634,3163
"Bolivia","La Paz","Murillo","Nuestra Señora de La Paz","ESC. ALCIDES ARGUEDAS",-68.141,-16.50126,135,4,1163,1298,738,23,398,1136
"Bolivia","La Paz","Murillo","Nuestra Señora de La Paz","ESC. ALFREDO VARGAS",-68.12498,-16.48322,504,22,4654,5158,2764,167,1701,4465
"Bolivia","La Paz","Murillo","Nuestra Señora de La Paz","ESC. ALONZO DE MENDOZA",-68.12307,-16.50274,109,1,849,958,645,17,186,831
"Bolivia","La Paz","Murillo","Nuestra Señora de La Paz","ESC. ALONZO DE MENDOZA (U.E. BICHITO DE LUZ)",-68.12307,-16.50274,423,6,3195,3618,2488,82,619,3107
"Bolivia","La Paz","Murillo","Nuestra Señora de La Paz","ESC. ALTO TEMBLADERANI",-68.14673,-16.51458,152,13,1316,1468,444,41,818,1262
"Bolivia","La Paz","Murillo","Nuestra Señora de La Paz","ESC. CHUCURA",-68.10157,-16.27567,2,4,62,64,12,7,39,51
"Bolivia","La Paz","Murillo","Nuestra Señora de La Paz","ESC. CLUB DE LEONES",-68.15932,-16.49451,805,66,8556,9361,4139,267,4084,8223
"Bolivia","La Paz","Murillo","Nuestra Señora de La Paz","ESC. CLUB DE LEONES",-68.15932,-16.49451,805,66,8556,9361,4139,267,4084,8223
"Bolivia","La Paz","Murillo","Nuestra Señora de La Paz","ESC ECUADOR",-68.12662,-16.50871,403,12,2193,2596,1785,23,373,2158
"Bolivia","La Paz","Murillo","Nuestra Señora de La Paz","ESC. EDUARDO AVAROA",-68.14451,-16.49651,583,31,5181,5764,3038,133,1979,5017
"Bolivia","La Paz","Murillo","Nuestra Señora de La Paz","ESC. EDUCACIONAL LUIS  ERNEST",-68.15179,-16.46655,154,9,1860,2014,1069,52,730,1799
"Bolivia","La Paz","Murillo","Nuestra Señora de La Paz","ESC. FRANCISCO DE MIRANDA",-68.09369,-16.53112,429,42,4542,4971,1991,133,2376,4367
"Bolivia","La Paz","Murillo","Nuestra Señora de La Paz","ESC. GENOVEVA RIOS",-68.10799,-16.50161,561,34,5280,5841,2583,163,2500,5083
"Bolivia","La Paz","Murillo","Nuestra Señora de La Paz","ESC. GIL TAPIA RADA",-68.15082,-16.45705,358,52,4327,4685,2055,118,2102,4157
"Bolivia","La Paz","Murillo","Nuestra Señora de La Paz","ESC. GRAL. JOSE MANUEL PANDO",-68.14954,-16.50061,155,13,1820,1975,940,41,826,1766
"Bolivia","La Paz","Murillo","Nuestra Señora de La Paz","ESC IND PEDRO DOMINGO MURILLO",-68.15194,-16.47472,542,44,4544,5086,2448,135,1917,4365
"Bolivia","La Paz","Murillo","Nuestra Señora de La Paz","ESC. JOSE SANTOS",-68.14185,-16.53238,349,40,3453,3802,1248,124,2041,3289
"Bolivia","La Paz","Murillo","Nuestra Señora de La Paz","ESC. LADISLAO CABRERA",-68.14954,-16.50061,568,44,5104,5672,2501,170,2389,4890
"Bolivia","La Paz","Murillo","Nuestra Señora de La Paz","ESC LA MERCED",-68.11915,-16.46617,692,74,6376,7068,2523,180,3599,6122
"Bolivia","La Paz","Murillo","Nuestra Señora de La Paz","ESC. LIMANIPATA 10 DE JUNIO",-68.14423,-16.4425,113,14,1442,1555,421,35,972,1393
"Bolivia","La Paz","Murillo","Nuestra Señora de La Paz","ESC. MCAL SANTA CRUZ",-68.13808,-16.49557,78,3,660,738,412,12,233,645
"Bolivia","La Paz","Murillo","Nuestra Señora de La Paz","ESC. MSCAL ANDRES DE SANTA CRUZ",-67.67603,-15.76266,25,3,205,230,41,2,159,200
"Bolivia","La Paz","Murillo","Nuestra Señora de La Paz","ESC MSCAL ANTONIO JOSE DE SUCRE",-68.07882,-16.48678,57,21,722,779,183,12,506,689
"Bolivia","La Paz","Murillo","Nuestra Señora de La Paz","ESC NATALIA PALACIOS",-68.13138,-16.49431,311,20,2708,3019,1921,49,718,2639
"Bolivia","La Paz","Murillo","Nuestra Señora de La Paz","ESC. NICOLAS  FERNANDEZ NARANJO",-68.1405,-16.48321,803,90,8289,9092,3687,219,4293,7980
"Bolivia","La Paz","Murillo","Nuestra Señora de La Paz","ESC PABLO ITURRI",-68.10268,-16.45948,620,60,5124,5744,1729,178,3157,4886
"Bolivia","La Paz","Murillo","Nuestra Señora de La Paz","ESC PANAMA",-68.12434,-16.49475,450,7,3456,3906,2736,68,645,3381
"Bolivia","La Paz","Murillo","Nuestra Señora de La Paz","ESC. REMBERTO TAPIA",-68.14641,-16.50409,399,42,4556,4955,2112,146,2256,4368
"Bolivia","La Paz","Murillo","Nuestra Señora de La Paz","ESC. REPUBLICA DEL PERU",-68.12861,-16.50675,102,1,588,690,452,9,126,578
"Bolivia","La Paz","Murillo","Nuestra Señora de La Paz","ESC. RURAL CANAVIRI",-68.13701,-16.17418,26,8,187,213,54,2,123,177
"Bolivia","La Paz","Murillo","Nuestra Señora de La Paz","ESC. SAGRADO CORAZON DE JESUS",-68.14336,-16.50653,683,56,7063,7746,2748,200,4059,6807
"Bolivia","La Paz","Murillo","Nuestra Señora de La Paz","ESC. SAN JOSE",-68.12814,-16.52707,348,21,3872,4220,2099,95,1657,3756
"Bolivia","La Paz","Murillo","Nuestra Señora de La Paz","ESC. SAN MARTIN",-68.11597,-16.49783,666,42,6132,6798,3862,233,1995,5857
"Bolivia","La Paz","Murillo","Nuestra Señora de La Paz","ESC. SAN MIGUEL",-68.14462,-16.54603,51,6,488,539,115,13,354,469
"Bolivia","La Paz","Murillo","Nuestra Señora de La Paz","ESC SANTA ROSA DE LIMA",-68.03819,-16.53689,448,63,5381,5829,1329,192,3797,5126
"Bolivia","La Paz","Murillo","Nuestra Señora de La Paz","ESC. SERGIO SUAREZ",-68.13206,-16.48701,670,57,6254,6924,2747,164,3286,6033
"Bolivia","La Paz","Murillo","Nuestra Señora de La Paz","ESCUELA 13 DE JUNIO CHINCHAYA",-68.08366,-16.48442,56,18,653,709,132,19,484,616
"Bolivia","La Paz","Murillo","Nuestra Señora de La Paz","ESCUELA 6 DE AGOSTO",-68.11748,-16.49531,236,18,2365,2601,1569,49,729,2298
"Bolivia","La Paz","Murillo","Nuestra Señora de La Paz","ESCUELA AGUSTIN ASPIAZU",-68.12946,-16.50753,447,11,3167,3614,2455,62,639,3094
"Bolivia","La Paz","Murillo","Nuestra Señora de La Paz","ESCUELA ALTO ACHUMANI",-68.05845,-16.51433,618,46,6259,6877,3573,129,2511,6084
"Bolivia","La Paz","Murillo","Nuestra Señora de La Paz","ESCUELA CALLAPA (PLAZA DE CALLAPA)",-68.09043,-16.49957,140,13,1291,1431,327,55,896,1223
"Bolivia","La Paz","Murillo","Nuestra Señora de La Paz","ESCUELA CHASQUIPAMPA",-68.04555,-16.54921,1021,79,10620,11641,4104,312,6125,10229
"Bolivia","La Paz","Murillo","Nuestra Señora de La Paz","ESCUELA CIUDAD DEL NIÑO",-68.09786,-16.49375,223,18,2315,2538,1129,111,1057,2186
"Bolivia","La Paz","Murillo","Nuestra Señora de La Paz","ESCUELA ELOY ALVAREZ PLATA",-68.14813,-16.48382,157,2,1559,1716,1077,35,445,1522
"Bolivia","La Paz","Murillo","Nuestra Señora de La Paz","ESCUELA JOHN F. KENNEDY",-68.1515,-16.47704,139,5,1301,1440,764,29,503,1267
"Bolivia","La Paz","Murillo","Nuestra Señora de La Paz","ESCUELA JUAN PABLO II",-68.1031,-16.53394,318,14,2822,3140,2154,39,615,2769
"Bolivia","La Paz","Murillo","Nuestra Señora de La Paz","ESCUELA PEDRO POVEDA",-68.11266,-16.5103,408,22,3418,3826,1789,96,1511,3300
"Bolivia","La Paz","Murillo","Nuestra Señora de La Paz","ESCUELA PEDRO POVEDA",-68.11266,-16.5103,408,22,3418,3826,1789,96,1511,3300
"Bolivia","La Paz","Murillo","Nuestra Señora de La Paz","ESCUELA PILOTO NACIONES UNIDAS",-68.1187,-16.49925,132,7,1191,1323,877,20,287,1164
"Bolivia","La Paz","Murillo","Nuestra Señora de La Paz","ESCUELA REPUBLICA DE JAPON",-68.14366,-16.51144,634,47,5956,6590,2582,191,3136,5718
"Bolivia","La Paz","Murillo","Nuestra Señora de La Paz","ESCUELA REPUBLICA DE JAPON",-68.14366,-16.51144,634,47,5956,6590,2582,191,3136,5718
"Bolivia","La Paz","Murillo","Nuestra Señora de La Paz","ESCUELA REPUBLICA DEL BRASIL",-68.14114,-16.49013,263,13,2453,2716,1571,57,812,2383
"Bolivia","La Paz","Murillo","Nuestra Señora de La Paz","ESCUELA ROSEMARI DE BARRIENTOS",-68.08743,-16.52519,1191,18,7850,9041,6275,101,1456,7731
"Bolivia","La Paz","Murillo","Nuestra Señora de La Paz","ESCUELA SANTA ROSA LA FLORIDA",-68.09236,-16.54617,605,19,3640,4245,2534,57,1030,3564
"Bolivia","La Paz","Murillo","Nuestra Señora de La Paz","ESCUELA SUPERIOR DE FORMACIÓN DE MAESTROS SIMON BOLIVAR",-68.11337,-16.51854,255,16,2820,3075,1843,70,891,2734
"Bolivia","La Paz","Murillo","Nuestra Señora de La Paz","ESCUELA VICTOR PAZ ESTENSORO",-68.08412,-16.51657,324,24,2934,3258,1563,77,1270,2833
"Bolivia","La Paz","Murillo","Nuestra Señora de La Paz","ESC. WALTER STRAUB",-68.06351,-16.54204,534,13,4299,4833,2707,135,1444,4151
"Bolivia","La Paz","Murillo","Nuestra Señora de La Paz","FACULTAD DE TECNOLOGIA (U.M.S.A)",-68.12685,-16.50758,216,3,1075,1291,883,17,172,1055
"Bolivia","La Paz","Murillo","Nuestra Señora de La Paz","INSTITUTO AMERICANO",-68.13234,-16.50628,518,32,4253,4771,3290,107,824,4114
"Bolivia","La Paz","Murillo","Nuestra Señora de La Paz","INSTITUTO AMERICANO",-68.13234,-16.50628,518,32,4253,4771,3290,107,824,4114
"Bolivia","La Paz","Murillo","Nuestra Señora de La Paz","INSTITUTO AMERICANO OBRAJES",-68.10566,-16.52666,469,17,4081,4550,3137,79,848,3985
"Bolivia","La Paz","Murillo","Nuestra Señora de La Paz","INSTITUTO DOMINGO SAVIO",-68.08488,-16.53951,377,11,1687,2064,1337,26,313,1650
"Bolivia","La Paz","Murillo","Nuestra Señora de La Paz","INSTITUTO MENDEZ ARCOS",-68.13995,-16.5042,356,10,3726,4082,2767,62,887,3654
"Bolivia","La Paz","Murillo","Nuestra Señora de La Paz","KINDER. BOLIVIA",-68.14942,-16.45182,203,20,2238,2441,942,57,1219,2161
"Bolivia","La Paz","Murillo","Nuestra Señora de La Paz","KINDER FLORA PEREZ DE SAAVEDRA",-68.14472,-16.48339,137,18,1613,1750,895,50,650,1545
"Bolivia","La Paz","Murillo","Nuestra Señora de La Paz","KINDER NAZARIO PARDO",-68.12493,-16.51608,213,8,1861,2074,1047,61,745,1792
"Bolivia","La Paz","Murillo","Nuestra Señora de La Paz","LICEO BOLIVIA",-68.13096,-16.51116,181,6,1296,1477,1035,31,224,1259
"Bolivia","La Paz","Murillo","Nuestra Señora de La Paz","LICEO LA PAZ",-68.13188,-16.50126,184,2,1210,1394,881,24,303,1184
"Bolivia","La Paz","Murillo","Nuestra Señora de La Paz","LICEO TEC.H. NUESTRA SRA DE LA PAZ",-68.13543,-16.49124,220,4,1729,1949,1161,41,523,1684
"Bolivia","La Paz","Murillo","Nuestra Señora de La Paz","PARQUE MIRADOR KILLI KILLI",-68.12752,-16.49444,269,19,2437,2706,1555,89,774,2329
"Bolivia","La Paz","Murillo","Nuestra Señora de La Paz","PLAZA DANIEL RODRIGUEZ",-68.09914,-16.53118,240,9,2405,2645,1329,54,1013,2342
"Bolivia","La Paz","Murillo","Nuestra Señora de La Paz","POLIFUNCIONAL SAN ISIDRO (IGLESIA SAN ISIDRO)",-68.107,-16.51307,176,17,1566,1742,814,47,688,1502
"Bolivia","La Paz","Murillo","Nuestra Señora de La Paz","SEDE JUNTA VECINAL",-68.11436,-16.50176,47,8,587,634,247,6,326,573
"Bolivia","La Paz","Murillo","Nuestra Señora de La Paz","SEDE SOCIAL CAJA FERROVIARIA",-68.15063,-16.44667,111,11,1350,1461,414,30,895,1309
"Bolivia","La Paz","Murillo","Nuestra Señora de La Paz","SEDE SOCIAL CARPANI",-68.0458,-16.45051,42,27,491,533,34,10,420,454
"Bolivia","La Paz","Murillo","Nuestra Señora de La Paz","SEDE SOCIAL DE CUSICANCHA",-68.16608,-16.48517,113,15,1205,1318,476,49,665,1141
"Bolivia","La Paz","Murillo","Nuestra Señora de La Paz","SEDE SOCIAL PLAN AUTOPISTA",-68.14625,-16.45818,164,16,1598,1762,775,45,762,1537
"Bolivia","La Paz","Murillo","Nuestra Señora de La Paz","SEDE SOCIAL PURA PURA",-68.15314,-16.47277,222,7,2201,2423,1105,64,1025,2130
"Bolivia","La Paz","Murillo","Nuestra Señora de La Paz","SEDE SOCIAL VILLA LITORAL",-68.10748,-16.50479,91,15,1008,1099,466,22,505,971
"Bolivia","La Paz","Murillo","Nuestra Señora de La Paz","SEMINARIO NAZARENO",-68.09364,-16.55968,101,1,554,655,427,8,118,545
"Bolivia","La Paz","Murillo","Nuestra Señora de La Paz","TECNICO AYACUCHO",-68.12161,-16.48541,1357,58,11903,13260,8561,237,3047,11608
"Bolivia","La Paz","Murillo","Nuestra Señora de La Paz","TECNICO AYACUCHO",-68.12161,-16.48541,1357,58,11903,13260,8561,237,3047,11608
"Bolivia","La Paz","Murillo","Nuestra Señora de La Paz","U. E. ABRAHAM REYES (FE Y ALEGRIA)",-68.16405,-16.48898,555,58,5865,6420,2519,167,3121,5640
"Bolivia","La Paz","Murillo","Nuestra Señora de La Paz","U. E. ANDINA",-68.11532,-16.46878,252,16,1986,2238,1079,39,852,1931
"Bolivia","La Paz","Murillo","Nuestra Señora de La Paz","U.E. CARLOS SALINAS",-68.13042,-16.4982,60,2,503,563,326,14,161,487
"Bolivia","La Paz","Murillo","Nuestra Señora de La Paz","U.E. EL PEDREGAL (URB. PEDREGAL)",-68.05286,-16.54382,86,10,1091,1177,375,35,671,1046
"Bolivia","La Paz","Murillo","Nuestra Señora de La Paz","U. E. FF. AA. DE LA NACIÓN",-68.08987,-16.52197,358,17,2923,3281,1732,76,1098,2830
"Bolivia","La Paz","Murillo","Nuestra Señora de La Paz","U.E. FILADELFIA",-68.16099,-16.50017,53,11,763,816,279,36,437,716
"Bolivia","La Paz","Murillo","Nuestra Señora de La Paz","U.E. GRAN BRETAÑA",-68.10885,-16.5197,10,0,76,86,43,1,32,75
"Bolivia","La Paz","Murillo","Nuestra Señora de La Paz","U. E. KINDER CAROLA IÑIGUEZ (FE Y ALEGRIA)",-68.16422,-16.48865,188,10,1615,1803,658,32,915,1573
"Bolivia","La Paz","Murillo","Nuestra Señora de La Paz","U. E. PANTALEON DALENCE",-68.14204,-16.51047,165,10,1890,2055,1199,44,637,1836
"Bolivia","La Paz","Murillo","Nuestra Señora de La Paz","U.E. SAN ANDRÉS",-68.07038,-16.53759,348,11,2701,3049,2009,59,622,2631
"Bolivia","La Paz","Murillo","Nuestra Señora de La Paz","U.E. WALDO BALLIVIAN",-68.11192,-16.5086,461,24,5077,5538,2780,169,2104,4884
"Bolivia","La Paz","Murillo","Nuestra Señora de La Paz","UNIDAD EDUCATIVA 24 DE JUNIO",-68.10389,-16.49494,554,47,5633,6187,2554,215,2817,5371
"Bolivia","La Paz","Murillo","Nuestra Señora de La Paz","UNIDAD EDUCATIVA ARABE DE EGIPTO",-68.1409,-16.4971,150,13,1683,1833,1044,26,600,1644
"Bolivia","La Paz","Murillo","Nuestra Señora de La Paz","UNIDAD EDUCATIVA CARLOS MEDINACELLI",-68.14066,-16.51231,484,20,4452,4936,2561,134,1737,4298
"Bolivia","La Paz","Murillo","Nuestra Señora de La Paz","UNIDAD EDUCATIVA CRISTIANA VIDA NUEVA",-68.11804,-16.48913,257,13,2715,2972,1681,66,955,2636
"Bolivia","La Paz","Murillo","Nuestra Señora de La Paz","UNIDAD EDUCATIVA FABRIL 18 DE MAYO",-68.14603,-16.49241,321,14,2914,3235,1856,67,977,2833
"Bolivia","La Paz","Murillo","Nuestra Señora de La Paz","UNIDAD EDUCATIVA FABRIL 18 DE MAYO",-68.14603,-16.49241,321,14,2914,3235,1856,67,977,2833
"Bolivia","La Paz","Murillo","Nuestra Señora de La Paz","UNIDAD EDUCATIVA JUPAPINA",-68.0744,-16.58935,144,11,1176,1320,524,40,601,1125
"Bolivia","La Paz","Murillo","Nuestra Señora de La Paz","UNIDAD EDUCATIVA LITORAL A",-68.151,-16.47124,374,23,3347,3721,1673,96,1555,3228
"Bolivia","La Paz","Murillo","Nuestra Señora de La Paz","UNIDAD EDUCATIVA LOS PINOS",-68.07632,-16.54179,663,13,4322,4985,3695,100,514,4209
"Bolivia","La Paz","Murillo","Nuestra Señora de La Paz","UNIDAD EDUCATIVA MALLASA",-68.08762,-16.57032,169,17,1674,1843,775,36,846,1621
"Bolivia","La Paz","Murillo","Nuestra Señora de La Paz","UNIDAD EDUCATIVA PRIVADA LA PAZ",-68.14587,-16.4988,151,12,1459,1610,796,35,616,1412
"Bolivia","La Paz","Murillo","Nuestra Señora de La Paz","UNIDAD EDUCATIVA PRIVADA LA PAZ",-68.14587,-16.4988,151,12,1459,1610,796,35,616,1412
"Bolivia","La Paz","Murillo","Nuestra Señora de La Paz","UNIDAD EDUCATIVA PUERTO RICO",-68.13956,-16.51244,345,30,3573,3918,1885,120,1538,3423
"Bolivia","La Paz","Murillo","Nuestra Señora de La Paz","UNIDAD EDUCATIVA REPUBLICA DE CHINA",-68.1278,-16.4945,300,16,2812,3112,1704,69,1023,2727
"Bolivia","La Paz","Murillo","Nuestra Señora de La Paz","UNIDAD EDUCATIVA REPUBLICA DE CUBA",-68.13556,-16.50287,334,14,2639,2973,1903,50,672,2575
"Bolivia","La Paz","Murillo","Nuestra Señora de La Paz","UNIDAD EDUCATIVA ROSARIO (URB. EL ROSARIO)",-68.11529,-16.52871,24,1,507,531,284,11,211,495
"Bolivia","La Paz","Murillo","Nuestra Señora de La Paz","UNIDAD EDUCATIVA SAN JOSE (U. E. MANUEL B. MARIACA)",-68.15286,-16.48993,284,15,3352,3636,1943,70,1324,3267
"Bolivia","La Paz","Murillo","Nuestra Señora de La Paz","UNIDAD EDUCATIVA VALLE HERMOSO",-68.10799,-16.4883,256,23,3022,3278,1358,80,1561,2919
"Bolivia","La Paz","Murillo","Nuestra Señora de La Paz","UNIDAD EDUCATIVA VILLA HARCA",-68.04404,-16.09133,35,6,291,326,101,13,171,272
"Bolivia","La Paz","Murillo","Nuestra Señora de La Paz","UNID. EDUC. 20 DE OCTUBRE N° 1",-68.16086,-16.46114,107,21,1283,1390,354,30,878,1232
"Bolivia","La Paz","Murillo","Nuestra Señora de La Paz","UNID EDUCATIVA BETESTA",-68.04996,-16.54382,227,25,2750,2977,952,99,1674,2626
"Bolivia","La Paz","Murillo","Nuestra Señora de La Paz","UNID. EDUC. HUGO BANZER SUAREZ",-68.14326,-16.51199,178,15,1665,1843,909,28,713,1622
"Bolivia","La Paz","Murillo","Nuestra Señora de La Paz","UNID. EDUC. JAIME ESCALANTE",-68.14835,-16.51145,414,55,3784,4198,1398,106,2225,3623
"Bolivia","La Paz","Murillo","Nuestra Señora de La Paz","UNID. EDUC. JOAQUIN HERNANN",-68.02591,-16.54834,95,25,1081,1176,172,19,865,1037
"Bolivia","La Paz","Murillo","Nuestra Señora de La Paz","UNID. EDUC. JORGE VARGAS",-68.13081,-16.53269,213,11,2192,2405,1060,93,1028,2088
"Bolivia","La Paz","Murillo","Nuestra Señora de La Paz","UNID. EDUC. RAUL SALMON DE LA BARRA",-68.1396,-16.52271,293,31,2955,3248,1034,97,1793,2827
"Bolivia","La Paz","Murillo","Palca","COL PEDRO DOMINGO MURILLO",-67.95261,-16.56124,247,50,1923,2170,259,95,1519,1778
"Bolivia","La Paz","Murillo","Palca","ESCUELA CAYIMBAYA",-67.75253,-16.71384,53,15,595,648,162,31,387,549
"Bolivia","La Paz","Murillo","Palca","ESCUELA COHONI",-67.83873,-16.7112,152,46,1329,1481,147,76,1060,1207
"Bolivia","La Paz","Murillo","Palca","ESCUELA COTAÑA",-67.71759,-16.72519,50,6,542,592,76,14,446,522
"Bolivia","La Paz","Murillo","Palca","ESCUELA QUILLIHUAYA",-67.90135,-16.66606,107,17,935,1042,111,29,778,889
"Bolivia","La Paz","Murillo","Palca","ESCUELA TAHUAPALCA",-67.87465,-16.72088,39,12,498,537,54,15,417,471
"Bolivia","La Paz","Murillo","Palca","ESCUELA TIRATA",-67.78961,-16.76238,29,0,257,286,25,0,232,257
"Bolivia","La Paz","Murillo","Palca","UNIDAD EDUCATIVA UNI",-67.9979,-16.5432,46,13,755,801,73,34,635,708
"Bolivia","La Paz","Nor Yungas","Coripata","CASA CULTURAL SAN JUAN DE CORIPATA",-67.56571,-16.25786,39,7,498,537,70,9,412,482
"Bolivia","La Paz","Nor Yungas","Coripata","COLEGIO ANDRES DE SANTA CRUZ",-67.64132,-16.27026,284,34,2254,2538,856,133,1231,2087
"Bolivia","La Paz","Nor Yungas","Coripata","COLEGIO FRAZ TAMAYO FE Y ALEGRIA",-67.6668,-16.28096,146,12,1020,1166,419,58,531,950
"Bolivia","La Paz","Nor Yungas","Coripata","COLEGIO SANTIAGO TOCORONI",-67.55057,-16.26809,112,8,907,1019,193,32,674,867
"Bolivia","La Paz","Nor Yungas","Coripata","ESCUELA CAPITAN LUIS REVERO SANCHEZ",-67.60426,-16.31971,709,67,4092,4801,1462,156,2407,3869
"Bolivia","La Paz","Nor Yungas","Coripata","ESCUELA MILLUHUAYA ALTO",-67.61317,-16.37393,74,6,735,809,194,20,515,709
"Bolivia","La Paz","Nor Yungas","Coroico","CASA DE GOBIERNO",-67.7733,-16.11081,68,5,472,540,145,24,298,443
"Bolivia","La Paz","Nor Yungas","Coroico","COL. TEC. HUM. CRUZ LOMA",-67.6988,-16.19916,89,10,853,942,226,32,585,811
"Bolivia","La Paz","Nor Yungas","Coroico","ESC. FELIX REYES ORTIZ",-67.72715,-16.18757,363,35,1842,2205,754,80,973,1727
"Bolivia","La Paz","Nor Yungas","Coroico","ESCUELA FRANZ TAMAYO",-67.73856,-16.14407,84,9,487,571,133,13,332,465
"Bolivia","La Paz","Nor Yungas","Coroico","ESCUELA JHON F. KENNEDY",-67.68882,-16.07204,53,7,513,566,96,17,393,489
"Bolivia","La Paz","Nor Yungas","Coroico","ESCUELA PACOLLO",-67.79175,-16.20483,104,8,633,737,148,25,452,600
"Bolivia","La Paz","Nor Yungas","Coroico","ESCUELA SANTA ROSA DE QUILO QUILO",-67.81871,-16.03682,57,8,706,763,111,19,568,679
"Bolivia","La Paz","Nor Yungas","Coroico","ESCUELA UNDUAVI",-67.90942,-16.31096,7,1,58,65,13,4,40,53
"Bolivia","La Paz","Nor Yungas","Coroico","U.E. YOLOSA",-67.74015,-16.23356,62,6,424,486,129,9,280,409
"Bolivia","La Paz","Nor Yungas","Coroico","UNIDAD EDUCATIVA PUENTE ARMAS",-67.64138,-16.03312,78,4,441,519,77,11,349,426
"Bolivia","La Paz","Nor Yungas","Coroico","UNIDAD EDU. SAN PEDRO",-67.72571,-16.19051,361,40,2079,2440,833,77,1129,1962
"Bolivia","La Paz","Omasuyos","Achacachi","CASA DE GOBIERNO",-68.81913,-16.16913,61,26,744,805,206,33,479,685
"Bolivia","La Paz","Omasuyos","Achacachi","COLEGIO ANTOFAGASTA",-68.69424,-15.9962,48,14,695,743,198,24,459,657
"Bolivia","La Paz","Omasuyos","Achacachi","COLEGIO FRANZ TAMAYO",-68.74367,-15.92973,63,26,882,945,209,41,606,815
"Bolivia","La Paz","Omasuyos","Achacachi","COLEGIO MARISCAL SANTA CRUZ",-68.68538,-16.04263,489,72,3710,4199,1320,204,2114,3434
"Bolivia","La Paz","Omasuyos","Achacachi","COLEGIO OMASUYOS",-68.68598,-16.04657,386,76,3572,3958,1253,182,2061,3314
"Bolivia","La Paz","Omasuyos","Achacachi","COLEGIO SIMON BOLIVAR",-68.59965,-16.0757,16,3,403,419,121,33,246,367
"Bolivia","La Paz","Omasuyos","Achacachi","COLEGIO SUÑASIVI",-68.64019,-15.98684,84,14,641,725,140,49,438,578
"Bolivia","La Paz","Omasuyos","Achacachi","ESC. SIMON BOLIVIAR",-68.69108,-16.04526,299,80,2719,3018,969,141,1529,2498
"Bolivia","La Paz","Omasuyos","Achacachi","ESCUELA AJLLATA GRANDE",-68.7886,-16.02371,96,37,1289,1385,515,50,687,1202
"Bolivia","La Paz","Omasuyos","Achacachi","ESCUELA APLICACION HUARIZATA",-68.66218,-15.97352,191,40,1450,1641,508,89,813,1321
"Bolivia","La Paz","Omasuyos","Achacachi","ESCUELA APURAYA",-68.74739,-16.0668,49,18,759,808,190,33,518,708
"Bolivia","La Paz","Omasuyos","Achacachi","ESCUELA BELEN",-68.70184,-16.01776,49,11,490,539,112,22,345,457
"Bolivia","La Paz","Omasuyos","Achacachi","ESCUELA CENTRAL CASAMAYA",-68.59995,-16.04042,32,6,354,386,85,27,236,321
"Bolivia","La Paz","Omasuyos","Achacachi","ESCUELA KILLOSA",-68.70744,-15.93228,10,0,126,136,35,7,84,119
"Bolivia","La Paz","Omasuyos","Achacachi","ESCUELA VILLA LIPE",-68.75453,-16.05257,55,17,672,727,166,40,449,615
"Bolivia","La Paz","Omasuyos","Achacachi","ESCUELA WALATA CHICO",-68.65627,-15.93059,31,6,260,291,60,5,189,249
"Bolivia","La Paz","Omasuyos","Achacachi","NUCLEO ECOLAR MURUMAMANI",-68.69246,-15.90919,19,2,499,518,84,14,399,483
"Bolivia","La Paz","Omasuyos","Achacachi","NUCLEO EDUCATIVO TAHARI",-68.6852,-15.95393,8,2,421,429,138,17,264,402
"Bolivia","La Paz","Omasuyos","Achacachi","NÚCLEO ESCOLAR CHALLUYO",-68.61758,-15.99023,20,14,435,455,91,21,309,400
"Bolivia","La Paz","Omasuyos","Achacachi","NUCLEO TACAMARA",-68.61773,-16.02135,88,17,831,919,193,51,570,763
"Bolivia","La Paz","Omasuyos","Achacachi","PLAZA VILLA ASUNCION DE CORPAPUTO",-68.55613,-16.0707,65,14,503,568,115,20,354,469
"Bolivia","La Paz","Omasuyos","Ancoraimes","COLEGIO CAJIATA",-68.85471,-15.91954,4,4,324,328,32,11,277,309
"Bolivia","La Paz","Omasuyos","Ancoraimes","COLEGIO MACAMACA",-68.94691,-15.83644,37,6,663,700,116,22,519,635
"Bolivia","La Paz","Omasuyos","Ancoraimes","ESCUELA FRANZ TAMAYO",-68.90729,-15.89587,186,29,1152,1338,298,74,751,1049
"Bolivia","La Paz","Omasuyos","Ancoraimes","ESCUELA SECCIONAL CHIÑAJA",-68.83353,-15.76956,1,2,94,95,14,2,76,90
"Bolivia","La Paz","Omasuyos","Ancoraimes","ESCUELA SOTALAYA",-68.83341,-15.92723,3,8,316,319,53,8,247,300
"Bolivia","La Paz","Omasuyos","Ancoraimes","ESCUELA TURRINI",-68.89091,-15.87126,14,3,288,302,67,10,208,275
"Bolivia","La Paz","Omasuyos","Ancoraimes","MOROCOLLO PLAZA PRINCIPAL",-68.88557,-15.91232,103,23,909,1012,222,49,615,837
"Bolivia","La Paz","Omasuyos","Ancoraimes","NUCLEO ESCOLAR DE PATAPATANI",-68.82576,-15.78231,5,1,109,114,17,1,90,107
"Bolivia","La Paz","Omasuyos","Ancoraimes","PLAZA 14 DE FEBRERO",-68.81345,-15.88548,95,10,955,1050,184,37,724,908
"Bolivia","La Paz","Omasuyos","Ancoraimes","SEDE SOCIAL CHOJÑAPATA",-68.87042,-15.79118,7,0,97,104,20,1,76,96
"Bolivia","La Paz","Omasuyos","Ancoraimes","SEDE SOCIAL INKA CATURAPI",-68.82888,-15.76071,20,8,285,305,105,3,169,274
"Bolivia","La Paz","Omasuyos","Ancoraimes","TEC. HUMANISTA POCOATA GRANDE",-68.79222,-15.94282,31,13,597,628,138,24,422,560
"Bolivia","La Paz","Omasuyos","Chúa Cocani","CASA DE GOBIERNO",-68.76876,-16.1837,53,7,480,533,162,14,297,459
"Bolivia","La Paz","Omasuyos","Chúa Cocani","ESCUELA CHUA COCANI",-68.74966,-16.18941,150,11,725,875,265,31,418,683
"Bolivia","La Paz","Omasuyos","Chúa Cocani","ESCUELA CORPACHILAYA",-68.71874,-16.19794,39,5,330,369,120,10,195,315
"Bolivia","La Paz","Omasuyos","Chúa Cocani","UNIDAD EDUCATIVA COMPI",-68.7893,-16.17562,55,21,704,759,166,32,485,651
"Bolivia","La Paz","Omasuyos","Huarina","CASA DE GOBIERNO",-68.57069,-16.24477,46,2,380,426,78,6,294,372
"Bolivia","La Paz","Omasuyos","Huarina","ESCUELA APUVILLQUE MOROCOLLO",-68.64399,-16.13322,38,12,312,350,75,23,202,277
"Bolivia","La Paz","Omasuyos","Huarina","ESCUELA BERNABE LEDEZMA",-68.54478,-16.12266,57,13,574,631,182,26,353,535
"Bolivia","La Paz","Omasuyos","Huarina","ESCUELA MARISCAL DE SANTA CRUZ",-68.60149,-16.19093,305,49,2169,2474,705,103,1312,2017
"Bolivia","La Paz","Omasuyos","Huarina","ESCUELA UNIDAD EDUCATIVAO COROMATA BAJA",-68.56112,-16.15195,35,8,323,358,113,11,191,304
"Bolivia","La Paz","Omasuyos","Huatajata","COLEGIO NACIONAL MIXTO HUATAJATA",-68.70113,-16.2081,170,26,1382,1552,536,51,769,1305
"Bolivia","La Paz","Omasuyos","Huatajata","ESCUELA SANCA JAHUIRA",-68.66814,-16.21417,28,13,329,357,111,14,191,302
"Bolivia","La Paz","Omasuyos","Santiago de Huata","COLEGIO CENTRAL POREJONI",-68.83286,-16.10552,36,14,329,365,51,7,257,308
"Bolivia","La Paz","Omasuyos","Santiago de Huata","COLEGIO SANTIAGO DE HUATA",-68.81879,-16.05531,191,71,1619,1810,532,94,922,1454
"Bolivia","La Paz","Omasuyos","Santiago de Huata","ESCUELA WATARI",-68.86102,-16.07956,25,5,189,214,44,13,127,171
"Bolivia","La Paz","Omasuyos","Santiago de Huata","PLAZA WICHI WICHI",-68.87871,-16.09691,51,9,541,592,125,17,390,515
"Bolivia","La Paz","Pacajes","Calacoto","COL. ANTOFAGASTA",-69.04382,-17.42133,14,3,179,193,46,5,125,171
"Bolivia","La Paz","Pacajes","Calacoto","COL. CAMACHO",-68.75751,-17.42726,66,2,156,222,28,2,124,152
"Bolivia","La Paz","Pacajes","Calacoto","COLEGIO FRANZ TAMAYO",-68.85695,-17.30775,27,0,223,250,51,3,169,220
"Bolivia","La Paz","Pacajes","Calacoto","COLEGIO HEROES DEL PACIFICO",-68.76153,-17.86703,6,1,125,131,25,0,99,124
"Bolivia","La Paz","Pacajes","Calacoto","COLEGIO PLAYA VINTO",-68.91974,-17.76429,15,3,107,122,14,1,89,103
"Bolivia","La Paz","Pacajes","Calacoto","COL. HUARISCATA",-68.80087,-17.83315,26,0,142,168,13,1,128,141
"Bolivia","La Paz","Pacajes","Calacoto","COL. J. SARCO KRAMER",-68.81659,-17.42351,39,3,135,174,34,2,96,130
"Bolivia","La Paz","Pacajes","Calacoto","ESC. LAGUNA BLANCA",-68.61784,-17.6079,7,0,127,134,18,3,106,124
"Bolivia","La Paz","Pacajes","Calacoto","ESC. N. LERCO",-68.47871,-17.5797,32,2,205,237,42,6,155,197
"Bolivia","La Paz","Pacajes","Calacoto","ESC. PABLO LAVADENS",-68.63289,-17.28291,97,4,445,542,114,18,309,423
"Bolivia","La Paz","Pacajes","Calacoto","ESCUELA ACHAVICO",-68.92034,-17.41066,5,1,56,61,8,2,45,53
"Bolivia","La Paz","Pacajes","Calacoto","ESCUELA PLAYA VERDE",-68.56482,-17.37746,19,2,185,204,30,4,149,179
"Bolivia","La Paz","Pacajes","Calacoto","ESC. ULLOMA",-68.49041,-17.4915,10,2,181,191,50,2,127,177
"Bolivia","La Paz","Pacajes","Calacoto","PLAZA AUDIENCIA",-68.6291,-17.47268,19,3,368,387,72,2,291,363
"Bolivia","La Paz","Pacajes","Calacoto","PLAZA CHALLUYO",-69.03053,-17.35813,22,4,113,135,33,3,73,106
"Bolivia","La Paz","Pacajes","Calacoto","PLAZA PRINCIPAL",-68.91343,-17.47115,30,2,110,140,10,3,95,105
"Bolivia","La Paz","Pacajes","Calacoto","SEDE SOCIAL MAX TOLEDO",-68.68167,-17.2371,33,1,149,182,34,3,111,145
"Bolivia","La Paz","Pacajes","Caquiaviri","COL. CALLA LLALLAGUA",-68.68002,-16.92397,34,0,142,176,14,5,123,137
"Bolivia","La Paz","Pacajes","Caquiaviri","ESC. ACHIRI",-69.00089,-17.21467,226,17,874,1100,226,27,604,830
"Bolivia","La Paz","Pacajes","Caquiaviri","ESC. ANTAQUIRA VILLA BELEN",-68.66805,-17.08638,41,2,279,320,66,4,207,273
"Bolivia","La Paz","Pacajes","Caquiaviri","ESC. CALAMA QUINTAVI",-68.86324,-17.26844,5,0,32,37,12,0,20,32
"Bolivia","La Paz","Pacajes","Caquiaviri","ESC. CAQUIAVIRI",-68.60491,-17.02134,202,23,908,1110,210,31,644,854
"Bolivia","La Paz","Pacajes","Caquiaviri","ESC. CENTRAL",-68.57354,-16.90038,44,3,320,364,54,11,252,306
"Bolivia","La Paz","Pacajes","Caquiaviri","ESC. CHOJNA PAMPA DE VICHAYA",-68.71049,-17.12527,2,0,103,105,29,0,74,103
"Bolivia","La Paz","Pacajes","Caquiaviri","ESC. JIHUACUTA",-68.78035,-17.1179,46,8,336,382,62,14,252,314
"Bolivia","La Paz","Pacajes","Caquiaviri","ESC. VILLA CHOCOROSI",-68.84946,-17.14096,32,4,213,245,80,5,124,204
"Bolivia","La Paz","Pacajes","Caquiaviri","NUCLEO ESCOLAR VICHAYA",-68.66454,-16.85874,37,5,342,379,98,9,230,328
"Bolivia","La Paz","Pacajes","Caquiaviri","PLAZA 14 DE SEPTIEMBRE",-68.71069,-16.90587,18,4,262,280,37,3,218,255
"Bolivia","La Paz","Pacajes","Caquiaviri","PLAZA SAN MIGUEL",-68.7556,-17.03869,37,3,318,355,80,10,225,305
"Bolivia","La Paz","Pacajes","Caquiaviri","SEDE SOCIAL",-68.94909,-17.09862,20,2,62,82,25,1,34,59
"Bolivia","La Paz","Pacajes","Charaña","COLEGIO EDUARDO AVAROA",-69.44685,-17.59194,183,9,599,782,218,16,356,574
"Bolivia","La Paz","Pacajes","Charaña","COL. TEC. HUMANISTICO TOPATER",-69.10415,-17.43627,5,0,72,77,26,2,44,70
"Bolivia","La Paz","Pacajes","Charaña","ESC. CHINOCAVI",-69.33294,-17.72286,14,1,84,98,14,1,68,82
"Bolivia","La Paz","Pacajes","Charaña","ESC. EDUARDO AVAROA",-69.24786,-17.5377,3,0,42,45,14,2,26,40
"Bolivia","La Paz","Pacajes","Charaña","ESC. GUALBERTO VILLARROEL",-69.11758,-17.51751,5,1,51,56,8,2,40,48
"Bolivia","La Paz","Pacajes","Charaña","ESC. RIO BLANCO",-69.07213,-17.8919,25,3,136,161,61,5,67,128
"Bolivia","La Paz","Pacajes","Charaña","ESC. SICUANI CONDOROCA",-69.46599,-17.4963,26,1,123,149,19,1,102,121
"Bolivia","La Paz","Pacajes","Comanche","COLEGIO COMANCHE",-68.42522,-16.95766,138,18,938,1076,244,38,638,882
"Bolivia","La Paz","Pacajes","Comanche","COL. TOCOPILLA CANTUYO",-68.50373,-16.83876,24,3,324,348,68,10,243,311
"Bolivia","La Paz","Pacajes","Comanche","ESC. KELLA KELLA",-68.41179,-16.9197,5,2,126,131,53,3,68,121
"Bolivia","La Paz","Pacajes","Comanche","SEDE SOCIAL",-68.46437,-17.07932,37,6,289,326,84,5,194,278
"Bolivia","La Paz","Pacajes","Comanche","SEDE SOCIAL",-68.54688,-16.92686,37,6,289,326,84,5,194,278
"Bolivia","La Paz","Pacajes","Coro Coro","CASA DE  GOBIERNO",-68.49454,-17.2455,21,3,279,300,73,12,191,264
"Bolivia","La Paz","Pacajes","Coro Coro","COL. CANCASILLA",-68.60786,-17.10883,18,2,121,139,36,3,80,116
"Bolivia","La Paz","Pacajes","Coro Coro","COLEGIO JOSE MANUEL PANDO",-68.49117,-17.2136,37,8,389,426,93,17,271,364
"Bolivia","La Paz","Pacajes","Coro Coro","COL. JAYUMA LLALLAGUA",-68.48241,-17.29913,9,2,128,137,37,2,87,124
"Bolivia","La Paz","Pacajes","Coro Coro","ESC. PEDRO DOMINGO MURILLO",-68.2065,-17.1975,0,2,191,191,30,9,150,180
"Bolivia","La Paz","Pacajes","Coro Coro","ESC. SECCIONAL ANCO AQUE",-68.19199,-17.17361,1,7,331,332,91,7,226,317
"Bolivia","La Paz","Pacajes","Coro Coro","ESC. TOPOHOCO",-68.24099,-17.16903,19,14,316,335,58,18,226,284
"Bolivia","La Paz","Pacajes","Coro Coro","ESC. VICENTA JUARISTE EGUINO",-68.45507,-17.1773,244,9,1228,1472,313,58,848,1161
"Bolivia","La Paz","Pacajes","Coro Coro","NUCLEO ESC. CENTRAL ENEQUELLA",-68.15412,-17.14132,32,3,297,329,77,4,213,290
"Bolivia","La Paz","Pacajes","Coro Coro","PLAZA APOSTOL SANTIAGO",-68.13311,-17.18174,37,17,289,326,70,16,186,256
"Bolivia","La Paz","Pacajes","Coro Coro","PLAZA CANTON ROSAPATA",-68.58238,-17.21777,30,2,136,166,29,4,101,130
"Bolivia","La Paz","Pacajes","Coro Coro","PLAZA MEJILLONES",-68.50258,-17.08385,50,6,279,329,79,5,189,268
"Bolivia","La Paz","Pacajes","Coro Coro","PLAZA PRINCIPAL",-68.64835,-17.14039,33,4,194,227,34,9,147,181
"Bolivia","La Paz","Pacajes","Nazacara de Pacajes","PLAZA PRINCIPAL",-68.76462,-16.93795,56,3,275,331,49,7,216,265
"Bolivia","La Paz","Pacajes","Santiago de Callapa","COL.TECNICO HUMANISTICO TUPAC AMARU",-68.33572,-17.34924,37,5,161,198,39,6,111,150
"Bolivia","La Paz","Pacajes","Santiago de Callapa","ESC. HUAYLLAPANTA",-68.26348,-17.27865,9,3,86,95,27,3,53,80
"Bolivia","La Paz","Pacajes","Santiago de Callapa","ESC. HUICHURAYA",-68.43911,-17.33394,15,2,115,130,30,3,80,110
"Bolivia","La Paz","Pacajes","Santiago de Callapa","ESC. N. CANUHUTA",-68.47823,-17.42123,50,2,291,341,65,4,220,285
"Bolivia","La Paz","Pacajes","Santiago de Callapa","ESC. POQUEVILLQUE",-68.27715,-17.32858,17,1,118,135,23,4,90,113
"Bolivia","La Paz","Pacajes","Santiago de Callapa","ESCUELA LIBERTADOR SIMON BOLIVIAR",-68.2121,-17.43119,12,1,150,162,41,2,106,147
"Bolivia","La Paz","Pacajes","Santiago de Callapa","ESCUELA ROMERO PAMPA",-68.23565,-17.35947,23,4,231,254,75,7,145,220
"Bolivia","La Paz","Pacajes","Santiago de Callapa","PLAZA 29 DE JUNIO",-68.18311,-17.36895,17,6,273,290,67,14,186,253
"Bolivia","La Paz","Pacajes","Santiago de Callapa","PLAZA SANTIAGO DE CALLAPA",-68.35594,-17.4794,145,11,449,594,113,19,306,419
"Bolivia","La Paz","Pacajes","Santiago de Callapa","PLAZA VILLA PUCHUNI",-68.31937,-17.2838,24,4,169,193,52,5,108,160
"Bolivia","La Paz","Pacajes","Santiago de Callapa","P. S. FRANCISCO YARIBAY",-68.41264,-17.24828,54,0,225,279,44,3,178,222
"Bolivia","La Paz","Pacajes","Santiago de Callapa","UNIDAD EDUCATIVA HUAJRUMA",-68.39203,-17.57708,7,0,76,83,31,1,44,75
"Bolivia","La Paz","Pacajes","Waldo Ballivián","PATIO HISTORICO TUMARAPI",-68.18797,-17.08567,68,9,919,987,207,35,668,875
"Bolivia","La Paz","Sur Yungas","Chulumani (Villa de la Libertad)","CASA DE GOBIERNO",-67.58398,-16.3884,66,11,536,602,122,10,393,515
"Bolivia","La Paz","Sur Yungas","Chulumani (Villa de la Libertad)","COLEGIO AGUSTIN ASPIAZU",-67.52634,-16.40942,810,48,4209,5019,1510,168,2483,3993
"Bolivia","La Paz","Sur Yungas","Chulumani (Villa de la Libertad)","COLEGIO GRAL.ARMANDO ESCOBAR URIA",-67.51199,-16.43177,85,6,648,733,237,18,387,624
"Bolivia","La Paz","Sur Yungas","Chulumani (Villa de la Libertad)","COLEGIO JUAN RAMOS DE TAGMA",-67.47916,-16.37452,88,9,756,844,250,29,468,718
"Bolivia","La Paz","Sur Yungas","Chulumani (Villa de la Libertad)","ESC. COLOPAMPA",-67.53527,-16.28799,6,3,136,142,20,1,112,132
"Bolivia","La Paz","Sur Yungas","Chulumani (Villa de la Libertad)","PLAZA PRINCIPAL",-67.50503,-16.44271,29,6,445,474,80,14,345,425
"Bolivia","La Paz","Sur Yungas","Chulumani (Villa de la Libertad)","U.E. TÉCNICO HUMANÍSTICO PASTO PATA",-67.47044,-16.36745,95,11,725,820,263,24,427,690
"Bolivia","La Paz","Sur Yungas","Chulumani (Villa de la Libertad)","UNIDAD EDUCATIVA HUANCANE",-67.53661,-16.3786,238,18,1579,1817,437,64,1060,1497
"Bolivia","La Paz","Sur Yungas","Irupana (Villa de Lanza)","CANCHA DE UNION HUIRI",-67.35191,-16.30181,41,9,450,491,47,13,381,428
"Bolivia","La Paz","Sur Yungas","Irupana (Villa de Lanza)","COLEGIO TTE.CNL. RAFAEL PABON",-67.79365,-16.57078,221,27,865,1086,328,28,482,810
"Bolivia","La Paz","Sur Yungas","Irupana (Villa de Lanza)","COL. NUCLEO ROSARIO",-67.6368,-16.65357,19,3,178,197,41,5,129,170
"Bolivia","La Paz","Sur Yungas","Irupana (Villa de Lanza)","ESC. CENTRAL LA PLAZUELA",-67.40361,-16.52655,50,2,273,323,69,5,197,266
"Bolivia","La Paz","Sur Yungas","Irupana (Villa de Lanza)","ESC. T.C. RAFAEL PABON",-67.34905,-16.49079,26,2,170,196,28,5,135,163
"Bolivia","La Paz","Sur Yungas","Irupana (Villa de Lanza)","ESC. VICTOR CENTELLAS",-67.4448,-16.42614,48,15,330,378,123,8,184,307
"Bolivia","La Paz","Sur Yungas","Irupana (Villa de Lanza)","ESC. VICTORIO LANZA",-67.43213,-16.40116,62,8,553,615,134,76,335,469
"Bolivia","La Paz","Sur Yungas","Irupana (Villa de Lanza)","PLAZA 25 DE JULIO",-67.70308,-16.60368,49,15,342,391,64,9,254,318
"Bolivia","La Paz","Sur Yungas","Irupana (Villa de Lanza)","U. E. AGUSTIN ASPIAZU",-67.45403,-16.47174,471,54,2962,3433,978,111,1819,2797
"Bolivia","La Paz","Sur Yungas","Irupana (Villa de Lanza)","U.E. CHICALOMA",-67.4781,-16.4439,100,29,730,830,232,28,441,673
"Bolivia","La Paz","Sur Yungas","Irupana (Villa de Lanza)","U.E. CURIHUATI",-67.53439,-16.62459,12,1,102,114,31,1,69,100
"Bolivia","La Paz","Sur Yungas","Irupana (Villa de Lanza)","U.E. NUCLEO ALEJANDRO PEREZ",-67.39616,-16.48061,11,1,119,130,22,5,91,113
"Bolivia","La Paz","Sur Yungas","Irupana (Villa de Lanza)","U.E. SIQUILJARA",-67.43041,-16.4995,4,0,49,53,7,5,37,44
"Bolivia","La Paz","Sur Yungas","Irupana (Villa de Lanza)","UNIDAD EDUCATIVA TACA",-67.59009,-16.6741,14,23,247,261,51,9,164,215
"Bolivia","La Paz","Sur Yungas","La Asunta","CASA DE GOBIERNO",-67.16822,-16.02656,74,7,437,511,130,12,288,418
"Bolivia","La Paz","Sur Yungas","La Asunta","CASA DE GOBIERNO",-67.42729,-16.3161,74,7,437,511,130,12,288,418
"Bolivia","La Paz","Sur Yungas","La Asunta","COLEGIO LAS MERCEDES",-67.34164,-16.28541,156,24,1110,1266,239,16,831,1070
"Bolivia","La Paz","Sur Yungas","La Asunta","COLEGIO PEDRO DOMINGO MURILLO",-67.17278,-15.99563,156,30,1193,1349,296,29,838,1134
"Bolivia","La Paz","Sur Yungas","La Asunta","ESC. BATALLON COLORADOS",-67.23377,-16.24007,61,6,344,405,63,14,261,324
"Bolivia","La Paz","Sur Yungas","La Asunta","ESC. PEDRO DOMINGO MURILLO",-67.23003,-16.17662,70,18,594,664,97,20,459,556
"Bolivia","La Paz","Sur Yungas","La Asunta","ESC. RENE BARRIENTOS ORTUNO",-67.19631,-16.12306,868,75,4955,5823,1599,235,3046,4645
"Bolivia","La Paz","Sur Yungas","La Asunta","ESCUELA PUERTO RICO",-67.23912,-15.91417,169,22,904,1073,268,26,588,856
"Bolivia","La Paz","Sur Yungas","La Asunta","ESC. YANAMAYU",-67.24638,-16.25433,66,11,479,545,94,12,362,456
"Bolivia","La Paz","Sur Yungas","La Asunta","PLAZA 5 DE AGOSTO",-67.32188,-16.29534,92,8,686,778,130,23,525,655
"Bolivia","La Paz","Sur Yungas","La Asunta","PLAZA PRINCIPAL",-67.28065,-16.28432,17,10,498,515,92,19,377,469
"Bolivia","La Paz","Sur Yungas","La Asunta","PLAZA PRINCIPAL PICHARI",-67.1724,-16.03647,33,1,172,205,28,1,142,170
"Bolivia","La Paz","Sur Yungas","La Asunta","SEDE SOCIAL 16 DE JULIO",-67.21876,-15.98921,94,13,604,698,66,18,507,573
"Bolivia","La Paz","Sur Yungas","La Asunta","SEDE SOCIAL CHARIA",-67.17044,-16.06197,76,6,627,703,139,17,465,604
"Bolivia","La Paz","Sur Yungas","La Asunta","SEDE SOCIAL - ESC. FISCAL CALIZAYA",-67.17819,-16.20132,102,15,857,959,287,34,521,808
"Bolivia","La Paz","Sur Yungas","La Asunta","U.E. SANTA ROSA",-67.29982,-16.29054,34,3,420,454,42,13,362,404
"Bolivia","La Paz","Sur Yungas","La Asunta","UNIDAD EDUCATIVA CENTRAL QUINUNI",-67.12872,-16.24596,180,33,1240,1420,297,44,866,1163
"Bolivia","La Paz","Sur Yungas","La Asunta","UNIDAD EDUCATIVA NUEVOS HORIZONTES",-67.0814,-16.07017,59,9,353,412,79,9,256,335
"Bolivia","La Paz","Sur Yungas","La Asunta","UNIDAD EDUCATIVA SIGUANI GRANDE",-67.1498,-16.02148,157,12,782,939,155,15,600,755
"Bolivia","La Paz","Sur Yungas","Palos Blancos","COLEGIO GRAL.JUAN JOSE TORREZ",-67.15504,-15.43328,93,8,438,531,95,18,317,412
"Bolivia","La Paz","Sur Yungas","Palos Blancos","COLEGIO INICUA ALTO",-67.21655,-15.49705,240,26,1316,1556,198,42,1050,1248
"Bolivia","La Paz","Sur Yungas","Palos Blancos","ESC. CENTRAL SAPECHO",-67.33434,-15.55851,175,12,932,1107,202,28,690,892
"Bolivia","La Paz","Sur Yungas","Palos Blancos","ESC. FRANZ TAMAYO",-66.97848,-15.79254,129,7,568,697,93,28,440,533
"Bolivia","La Paz","Sur Yungas","Palos Blancos","ESC. MAPURICHUQUI",-67.38571,-15.53334,13,0,104,117,10,2,92,102
"Bolivia","La Paz","Sur Yungas","Palos Blancos","ESC. REMOLINOS",-67.10275,-15.70205,20,4,165,185,28,2,131,159
"Bolivia","La Paz","Sur Yungas","Palos Blancos","ESC. SAN MIGUEL DE HUACHI",-67.13039,-15.67505,117,7,556,673,148,21,380,528
"Bolivia","La Paz","Sur Yungas","Palos Blancos","ESC. SANTA ANA DE MOSETENES",-67.42593,-15.51087,61,13,519,580,101,17,388,489
"Bolivia","La Paz","Sur Yungas","Palos Blancos","ESC. SECC. PUERTO CARMEN",-67.10754,-15.72647,76,3,513,589,53,15,442,495
"Bolivia","La Paz","Sur Yungas","Palos Blancos","ESCUELA 13 DE MAYO",-67.05286,-15.7359,75,8,370,445,70,7,285,355
"Bolivia","La Paz","Sur Yungas","Palos Blancos","ESCUELA COCOCHI",-67.03598,-15.76373,76,4,517,593,46,9,458,504
"Bolivia","La Paz","Sur Yungas","Palos Blancos","ESCUELA UNIDAD EDUCATIVA POPOY",-67.16382,-15.64156,87,4,507,594,91,11,401,492
"Bolivia","La Paz","Sur Yungas","Palos Blancos","ESC. UNI. EDUCATIVA PALOS BLANCOS",-67.24989,-15.58425,754,39,3769,4523,1274,160,2296,3570
"Bolivia","La Paz","Sur Yungas","Yanacachi","AGENCIA CANTONAL",-67.67539,-16.40772,18,2,195,213,43,5,145,188
"Bolivia","La Paz","Sur Yungas","Yanacachi","ESC. EDUARDO AVAROA",-67.77512,-16.40746,84,5,727,811,161,19,542,703
"Bolivia","La Paz","Sur Yungas","Yanacachi","ESCUELA PUENTE VILLA",-67.64563,-16.40512,125,7,605,730,113,27,458,571
"Bolivia","La Paz","Sur Yungas","Yanacachi","UNIDAD ED. FELIX ERNESTO MOSCOSO",-67.73924,-16.39802,105,20,837,942,162,40,615,777
"Bolivia","Oruro","Abaroa","Challapata","CASA COMUNAL",-66.867,-18.81626,4,3,52,56,17,4,28,45
"Bolivia","Oruro","Abaroa","Challapata","COL. NEMECIO BARRIENTOS",-66.41433,-18.8165,93,52,1851,1944,183,92,1524,1707
"Bolivia","Oruro","Abaroa","Challapata","COL. SIMON BOLIVAR",-66.2065,-19.07044,133,23,724,857,184,53,464,648
"Bolivia","Oruro","Abaroa","Challapata","ESC. ELIZARDO PEREZ",-66.63439,-18.78513,35,5,201,236,65,11,120,185
"Bolivia","Oruro","Abaroa","Challapata","ESC. GUALBERTO VILLARROEL",-66.17815,-19.14781,57,6,487,544,131,30,320,451
"Bolivia","Oruro","Abaroa","Challapata","ESC. GUALBERTO VILLARROEL",-66.17815,-19.14781,57,6,487,544,131,30,320,451
"Bolivia","Oruro","Abaroa","Challapata","IGLESIA",-66.75696,-18.90541,77,27,481,558,134,26,294,428
"Bolivia","Oruro","Abaroa","Challapata","U.E. ANTOFAGASTA",-66.76142,-18.9058,156,18,984,1140,464,54,448,912
"Bolivia","Oruro","Abaroa","Challapata","U. E. CHIRITAMBO",-66.49629,-18.74333,6,0,37,43,9,8,20,29
"Bolivia","Oruro","Abaroa","Challapata","U. E. CHURACANI",-66.6879,-18.88193,17,3,190,207,94,8,85,179
"Bolivia","Oruro","Abaroa","Challapata","U. E. COCHUYO",-66.19255,-19.04616,15,6,176,191,26,12,132,158
"Bolivia","Oruro","Abaroa","Challapata","U. E. CRUCE AGUAS CALIENTES",-66.59532,-18.75354,23,16,336,359,105,23,192,297
"Bolivia","Oruro","Abaroa","Challapata","U. E. EDUARDO AVAROA",-66.77432,-18.89956,455,46,2647,3102,1299,159,1143,2442
"Bolivia","Oruro","Abaroa","Challapata","U.E. GERMAN BUSCH",-66.64656,-18.83978,15,3,175,190,77,13,82,159
"Bolivia","Oruro","Abaroa","Challapata","U.E. HUANCANE",-66.87584,-18.70498,33,7,353,386,153,32,161,314
"Bolivia","Oruro","Abaroa","Challapata","U.E. MONS. RICARDO BENI MORO",-66.77174,-18.89699,218,23,1153,1371,559,63,508,1067
"Bolivia","Oruro","Abaroa","Challapata","U. E. REPUBLICA ARGENTINA",-66.77376,-18.89994,480,63,2859,3339,1366,218,1212,2578
"Bolivia","Oruro","Abaroa","Challapata","U. E. SAN JUAN DE DIOS",-66.77537,-18.89861,375,36,2256,2631,1116,125,979,2095
"Bolivia","Oruro","Abaroa","Challapata","U. E. WILAÑEQUE",-66.87421,-18.79802,5,2,63,68,14,4,43,57
"Bolivia","Oruro","Abaroa","Santuario de Quillacas","COL. NAL. MIXTO SEVARUYO",-66.8639,-19.36308,91,17,762,853,194,30,521,715
"Bolivia","Oruro","Abaroa","Santuario de Quillacas","ESC. SORAGA",-66.81366,-19.37804,29,1,236,265,30,4,201,231
"Bolivia","Oruro","Abaroa","Santuario de Quillacas","U.E. SANTUARIO DE QUILLACAS",-66.9434,-19.23514,100,14,679,779,171,16,478,649
"Bolivia","Oruro","Carangas","Choque Cota","ESC. JOSE BALLIVIAN",-67.89426,-18.09751,147,10,493,640,85,13,385,470
"Bolivia","Oruro","Carangas","Choque Cota","U.E. GERMAN BUSCH",-67.9801,-18.24933,16,0,63,79,8,0,55,63
"Bolivia","Oruro","Carangas","Corque","COL.  JOSE TRIFIRO",-67.68045,-18.34875,433,22,1058,1491,262,38,736,998
"Bolivia","Oruro","Carangas","Corque","COL. QUITA QUITA",-67.59264,-18.57433,20,1,125,145,28,1,95,123
"Bolivia","Oruro","Carangas","Corque","ESC. CENTRAL ANDAPATA LUPE",-67.7664,-18.57256,23,2,134,157,41,1,90,131
"Bolivia","Oruro","Carangas","Corque","ESC. ELIZARDO PEREZ",-67.96458,-18.42258,4,0,192,196,39,1,152,191
"Bolivia","Oruro","Carangas","Corque","ESC. GERMAN BUSCH",-67.63393,-18.19181,3,0,124,127,39,2,83,122
"Bolivia","Oruro","Carangas","Corque","ESC. RAFAEL PABON",-67.86765,-18.61046,5,2,314,319,77,8,227,304
"Bolivia","Oruro","Carangas","Corque","ESC. SECCIONAL VILLA NUEVA",-67.52446,-18.50015,2,0,90,92,10,1,79,89
"Bolivia","Oruro","Carangas","Corque","ESC. SECCIONAL VILLA REMEDIOS",-67.53616,-18.34178,12,9,103,115,15,2,77,92
"Bolivia","Oruro","Carangas","Corque","NUCLEO JANCOCALA",-67.63593,-18.40875,19,3,119,138,29,4,83,112
"Bolivia","Oruro","Carangas","Corque","PROYECTO CRISTIAN CHILDRENS",-67.89956,-18.54068,37,4,348,385,73,7,264,337
"Bolivia","Oruro","Carangas","Corque","U. E. CONDORIRI",-67.87078,-18.28468,3,0,143,146,14,5,124,138
"Bolivia","Oruro","Carangas","Corque","U. E. EDUARDO AVAROA",-67.93131,-18.25961,8,2,108,116,23,2,81,104
"Bolivia","Oruro","Carangas","Corque","U.E. FRANZ TAMAYO",-67.92997,-18.34328,2,0,199,201,11,1,187,198
"Bolivia","Oruro","Carangas","Corque","U. E. FRANZ TAMAYO - VILLA ESPERANZA.-",-67.79691,-18.69382,37,2,227,264,37,2,186,223
"Bolivia","Oruro","Carangas","Corque","U.E. HUAYLLAPACHA",-67.78386,-18.20815,11,0,109,120,9,1,99,108
"Bolivia","Oruro","Carangas","Corque","U.E. HUAYLLOCO",-67.60744,-18.62654,41,3,157,198,34,4,116,150
"Bolivia","Oruro","Carangas","Corque","U.E. ISMAEL MONTES",-67.63055,-18.2567,9,0,123,132,27,2,94,121
"Bolivia","Oruro","Carangas","Corque","U.E. VILLA COPACABANA",-67.58656,-18.33602,23,1,205,228,63,4,137,200
"Bolivia","Oruro","Carangas","Corque","U.E. VILLA TARUCACHI",-67.69584,-18.17327,33,2,135,168,15,3,115,130
"Bolivia","Oruro","Cercado","Caracollo","CASA COMUNAL",-67.36098,-17.5586,27,6,232,259,52,6,168,220
"Bolivia","Oruro","Cercado","Caracollo","ESC. ARCA DE NOE",-67.14415,-17.53467,27,5,221,248,52,9,155,207
"Bolivia","Oruro","Cercado","Caracollo","ESC. CASIMIRO OLAÑETA",-67.71239,-17.75884,15,6,98,113,23,1,68,91
"Bolivia","Oruro","Cercado","Caracollo","ESC. CENTRAL HORENCO",-67.08439,-17.67966,41,13,508,549,114,30,351,465
"Bolivia","Oruro","Cercado","Caracollo","ESC. ELIZARDO PEREZ",-67.23847,-17.7678,25,6,325,350,76,20,223,299
"Bolivia","Oruro","Cercado","Caracollo","ESC. GUALBERTO VILLARROEL",-67.60866,-17.84485,2,1,156,158,48,7,100,148
"Bolivia","Oruro","Cercado","Caracollo","ESC. MARISCAL SUCRE",-67.21998,-17.63756,576,68,4543,5119,1534,200,2741,4275
"Bolivia","Oruro","Cercado","Caracollo","ESC. RENE BERNAL ESCALANTE",-67.26373,-17.41522,26,8,227,253,35,9,175,210
"Bolivia","Oruro","Cercado","Caracollo","ESC. SECCIONAL ANCOTANGA",-67.41176,-17.80681,10,3,108,118,45,1,59,104
"Bolivia","Oruro","Cercado","Caracollo","ESC. TUPAC KATARI",-67.32282,-17.67462,4,0,35,39,4,1,30,34
"Bolivia","Oruro","Cercado","Caracollo","PLAZA 21 DE SEPTIEMBRE",-67.63667,-17.79293,11,1,182,193,52,1,128,180
"Bolivia","Oruro","Cercado","Caracollo","U. E. ADELA ZAMUDIO B",-67.61005,-17.79552,0,1,66,66,14,0,51,65
"Bolivia","Oruro","Cercado","Caracollo","U.E. ALEMANIA",-67.29485,-17.58746,66,8,484,550,117,23,336,453
"Bolivia","Oruro","Cercado","Caracollo","U.E. AYACUCHO",-67.32822,-17.88792,52,11,267,319,94,12,150,244
"Bolivia","Oruro","Cercado","Caracollo","U.E. FLORENCIO ALVARADO",-67.67155,-17.89358,10,6,203,213,49,6,142,191
"Bolivia","Oruro","Cercado","Caracollo","U.E. JAIME LAREDO UNZUETA",-67.29126,-17.76572,3,5,55,58,12,0,38,50
"Bolivia","Oruro","Cercado","Caracollo","U.E. LITORAL",-67.21841,-17.63715,141,11,632,773,202,35,384,586
"Bolivia","Oruro","Cercado","Caracollo","U.E. MARISCAL SUCRE B",-67.49707,-17.77807,134,14,707,841,232,28,433,665
"Bolivia","Oruro","Cercado","Caracollo","U.E. MAX FERNANDEZ",-67.10453,-17.55754,38,3,436,474,98,9,326,424
"Bolivia","Oruro","Cercado","Caracollo","U.E. OTTO SAUCEDO RIVERA",-67.3471,-17.80727,20,2,156,176,70,8,76,146
"Bolivia","Oruro","Cercado","Caracollo","U.ESC. MARCELO QUIROGA SANTA CRUZ",-67.3585,-17.954,25,1,192,217,43,1,147,190
"Bolivia","Oruro","Cercado","Caracollo","U.E. SEBASTIAN PAGADOR",-67.32516,-17.52224,40,5,342,382,68,12,257,325
"Bolivia","Oruro","Cercado","Caracollo","U.E. SIMON BOLIVAR PRIMARIO",-67.65617,-17.79859,45,6,342,387,105,28,203,308
"Bolivia","Oruro","Cercado","Caracollo","U. E. VICTOR PAZ ESTENSORO",-67.22767,-17.52121,18,1,83,101,33,3,46,79
"Bolivia","Oruro","Cercado","El Choro","ESC. GUALBERTO VILLARROEL",-67.1244,-18.28041,30,8,229,259,83,5,133,216
"Bolivia","Oruro","Cercado","El Choro","ESC. JOSE BALLIVIAN",-67.23971,-18.07711,100,12,470,570,107,20,331,438
"Bolivia","Oruro","Cercado","El Choro","ESC. SEBASTIAN  PAGADOR",-67.11596,-18.35524,115,12,573,688,132,41,388,520
"Bolivia","Oruro","Cercado","El Choro","PLAZA PRINCIPAL",-67.16006,-18.20486,43,3,241,284,73,13,152,225
"Bolivia","Oruro","Cercado","El Choro","U. E. SAN FELIPE DE CHAITAVI",-67.19747,-18.2947,13,2,164,177,56,6,100,156
"Bolivia","Oruro","Cercado","Oruro","(CÁRCEL) PENAL SAN PEDRO.-",-67.11382,-17.94748,51,5,177,228,87,2,83,170
"Bolivia","Oruro","Cercado","Oruro","CEMEI.-",-67.10611,-17.95222,62,3,565,627,374,17,171,545
"Bolivia","Oruro","Cercado","Oruro","CENTRO DE ALFABETIZACION HUAJARA III.-",-67.09458,-17.94664,52,7,453,505,213,16,217,430
"Bolivia","Oruro","Cercado","Oruro","CENTRO DE MADRES VILLA DORINA.-  (U.ESC. GTANJA CAPACHOS)",-67.0959,-17.93653,51,2,529,580,219,21,287,506
"Bolivia","Oruro","Cercado","Oruro","CENTRO EDUCATIVO ALCIRA CARDONA.-",-67.13569,-17.98138,301,20,2236,2537,1192,72,952,2144
"Bolivia","Oruro","Cercado","Oruro","CENTRO EDUCATIVO LUIS ESPINAL.-",-67.10418,-17.97677,133,6,1049,1182,638,39,366,1004
"Bolivia","Oruro","Cercado","Oruro","COL. ANICETO ARCE.-",-67.10963,-17.95758,239,11,1749,1988,1161,39,538,1699
"Bolivia","Oruro","Cercado","Oruro","COL. DONATO VASQUEZ",-67.11268,-17.96753,167,16,1394,1561,1032,28,318,1350
"Bolivia","Oruro","Cercado","Oruro","COLEGIO JESUS MARIA FE Y ALEGRIA.-",-67.1079,-17.95973,127,4,1082,1209,843,11,224,1067
"Bolivia","Oruro","Cercado","Oruro","COL. IGNACIO LEON.-",-67.11066,-17.96957,271,9,2057,2328,1535,47,466,2001
"Bolivia","Oruro","Cercado","Oruro","COL. JORGE OBLITAS.-",-67.11667,-17.97098,218,5,1470,1688,1017,48,400,1417
"Bolivia","Oruro","Cercado","Oruro","COL. MARCOS BELTRAN AVILA.-",-67.12161,-17.98581,323,13,1753,2076,949,52,739,1688
"Bolivia","Oruro","Cercado","Oruro","COL. MIXTO SAN JOSE.-",-67.1077,-17.96691,108,5,902,1010,553,19,325,878
"Bolivia","Oruro","Cercado","Oruro","COL. NAL. ANTONIO JOSE DE SAINZ.-",-67.11235,-17.97625,296,9,1926,2222,1206,61,650,1856
"Bolivia","Oruro","Cercado","Oruro","COL. NAL. JUAN MISAEL SARACHO.-",-67.10977,-17.96565,212,7,1694,1906,1283,34,370,1653
"Bolivia","Oruro","Cercado","Oruro","COL. NAL. MIXTO BOLIVIA.-",-67.11076,-17.96816,635,27,3246,3881,1758,98,1363,3121
"Bolivia","Oruro","Cercado","Oruro","COL. NAL. MIXTO CARMEN GUZMAN DE MIER",-67.09805,-17.96961,716,42,5553,6269,2944,258,2309,5253
"Bolivia","Oruro","Cercado","Oruro","COL.NAL.MIXTO MEJILLONES (V. CHALLACOLLO)",-67.13516,-18.00865,237,14,1290,1527,473,85,718,1191
"Bolivia","Oruro","Cercado","Oruro","COL. NAL. SIMON BOLIVAR.-",-67.11548,-17.97176,308,12,2228,2536,1608,43,565,2173
"Bolivia","Oruro","Cercado","Oruro","COL. PARTICULAR ANGLO AMERICANO.-",-67.12007,-17.96936,288,12,2233,2521,1432,66,723,2155
"Bolivia","Oruro","Cercado","Oruro","COL. PARTICULAR BOLIVIA JAPON-.",-67.11596,-17.96645,200,11,1473,1673,1003,28,431,1434
"Bolivia","Oruro","Cercado","Oruro","COL. PARTICULAR LA SALLE.-",-67.12745,-17.98239,341,18,2698,3039,1614,99,967,2581
"Bolivia","Oruro","Cercado","Oruro","COL. PARTICULAR NACIONES UNIDAS.-",-67.11937,-17.9807,108,9,691,799,354,96,232,586
"Bolivia","Oruro","Cercado","Oruro","COL. PARTICULAR REEKIE.-",-67.1146,-17.97336,196,8,1654,1850,1229,34,383,1612
"Bolivia","Oruro","Cercado","Oruro","ESC. FRANZ TAMAYO (LOS PINOS).-",-67.13069,-17.9254,133,17,1159,1292,421,34,687,1108
"Bolivia","Oruro","Cercado","Oruro","ESC. JACINTO RODRIGUEZ (LA AURORA).-",-67.12757,-17.91296,359,22,3129,3488,1641,108,1358,2999
"Bolivia","Oruro","Cercado","Oruro","ESC. JUAN PABLO.-",-67.13759,-17.97069,435,34,2906,3341,1374,92,1406,2780
"Bolivia","Oruro","Cercado","Oruro","ESC. MIXTA FERROVIARIA.-",-67.1043,-17.96417,438,23,3645,4083,2496,74,1052,3548
"Bolivia","Oruro","Cercado","Oruro","FAC. DE DERECHO (ESC. 10 DE FEBRERO)",-67.10728,-17.96463,88,5,716,804,515,7,189,704
"Bolivia","Oruro","Cercado","Oruro","FACULTAD DE AGRONOMIA-.",-67.1356,-17.99495,136,3,827,963,371,25,428,799
"Bolivia","Oruro","Cercado","Oruro","FACULTAD DE MEDICINA.-",-67.11997,-17.95705,285,15,2294,2579,1257,93,929,2186
"Bolivia","Oruro","Cercado","Oruro","FACULTAD TECNICA.-",-67.10745,-17.95388,269,18,2399,2668,1640,56,685,2325
"Bolivia","Oruro","Cercado","Oruro","FUNDACION INFOCAL.-",-67.13299,-17.97652,157,9,1200,1357,648,28,515,1163
"Bolivia","Oruro","Cercado","Oruro","INICIAL CARMEN GUZMAN DE MIER-.",-67.09798,-17.96936,51,4,407,458,217,16,170,387
"Bolivia","Oruro","Cercado","Oruro","INST. DE APRENDIZAJE INDUSTRIAL - I.A.I.",-67.10339,-17.95443,432,26,3789,4221,2091,115,1557,3648
"Bolivia","Oruro","Cercado","Oruro","INST. NORMAL SUPERIOR ANGEL MENDOZA J.",-67.11544,-17.95136,279,16,2280,2559,1330,74,860,2190
"Bolivia","Oruro","Cercado","Oruro","KINDER CHIRIPUJIO-.",-67.13878,-17.97487,58,5,317,375,161,6,145,306
"Bolivia","Oruro","Cercado","Oruro","KINDER EDITH ZAMORA DE PAZ",-67.06566,-17.59109,91,7,642,733,310,10,315,625
"Bolivia","Oruro","Cercado","Oruro","KINDER JUANCITO PINTO.-",-67.1338,-17.97651,222,23,1612,1834,865,51,673,1538
"Bolivia","Oruro","Cercado","Oruro","LICEO ANTOFAGASTA.-",-67.11086,-17.95904,130,3,1109,1239,753,28,325,1078
"Bolivia","Oruro","Cercado","Oruro","LICEO TEC. HUMANISTICO ADOLFO BALLIVIAN",-67.11545,-17.97227,124,6,997,1121,697,20,274,971
"Bolivia","Oruro","Cercado","Oruro","U.E. ABY AYALA  (MAGDALENA POSTEL II)",-67.0858,-17.96687,34,1,402,436,203,13,185,388
"Bolivia","Oruro","Cercado","Oruro","U. E. ALTO ORURO-.",-67.11981,-17.97776,90,7,657,747,270,35,345,615
"Bolivia","Oruro","Cercado","Oruro","U.E. BOLIVIA VINTO.-",-67.06182,-17.97608,590,73,4246,4836,1541,406,2226,3767
"Bolivia","Oruro","Cercado","Oruro","U. E. CARMELA CERRUTO-.",-67.12911,-17.98492,75,6,423,498,206,18,193,399
"Bolivia","Oruro","Cercado","Oruro","U. E. EDUARDO AVAROA",-67.10896,-17.96172,202,10,1711,1913,1309,44,348,1657
"Bolivia","Oruro","Cercado","Oruro","U. E. EJERCITO NACIONAL.-",-67.11467,-17.94708,452,31,3461,3913,1885,105,1440,3325
"Bolivia","Oruro","Cercado","Oruro","U.E. EL CARMEN",-67.06756,-17.97467,128,12,1135,1263,479,51,593,1072
"Bolivia","Oruro","Cercado","Oruro","U. E. GUIDO VILLAGOMEZ.-",-67.12384,-17.95729,193,15,1750,1943,819,66,850,1669
"Bolivia","Oruro","Cercado","Oruro","U. E. HIJOS DEL SOL II",-67.14334,-17.97866,68,5,293,361,98,75,115,213
"Bolivia","Oruro","Cercado","Oruro","U.E. HUAJARA",-67.09364,-17.94298,389,44,3361,3750,1680,121,1516,3196
"Bolivia","Oruro","Cercado","Oruro","U. E. JESUS DE NAZARETH.-",-67.09926,-17.98237,425,41,3179,3604,1434,156,1548,2982
"Bolivia","Oruro","Cercado","Oruro","U. E. JOHN F. KENNEDY",-67.11703,-17.95129,448,28,3490,3938,1760,138,1564,3324
"Bolivia","Oruro","Cercado","Oruro","U. E. JOSE IGNACIO DE SANJINEZ.-",-67.11224,-17.97953,442,20,3127,3569,1909,88,1110,3019
"Bolivia","Oruro","Cercado","Oruro","U. E. JOSE MARIA SIERRA GALVARRO.-",-67.10973,-17.97574,491,26,3831,4322,2450,94,1261,3711
"Bolivia","Oruro","Cercado","Oruro","U. E. JUAN VELEZ DE CORDOBA (INCA POZO).",-67.12063,-17.94589,175,19,1556,1731,634,72,831,1465
"Bolivia","Oruro","Cercado","Oruro","U. E. KANTUTA II (JOSERMO MURILLO)-.",-67.10438,-17.94779,283,49,2285,2568,969,131,1136,2105
"Bolivia","Oruro","Cercado","Oruro","U.E. LOS ANGELES DE NAZARIA IGNACIA",-67.0696,-17.97254,133,9,952,1085,306,36,601,907
"Bolivia","Oruro","Cercado","Oruro","U. E. LUIS MARIO CAREAGA.-",-67.06567,-17.59111,652,57,3966,4618,1685,131,2093,3778
"Bolivia","Oruro","Cercado","Oruro","U.E. MARCELO QUIROGA SANTA CRUZ",-67.11663,-17.93236,43,5,649,692,291,15,338,629
"Bolivia","Oruro","Cercado","Oruro","U.E. MARIA  DE NAZARETH",-67.0949,-17.98389,194,22,1558,1752,566,97,873,1439
"Bolivia","Oruro","Cercado","Oruro","U. E. MCAL. ANDRES DE SANTA CRUZ.-",-67.11391,-17.95798,361,25,2527,2888,1422,83,997,2419
"Bolivia","Oruro","Cercado","Oruro","U. E. MCAL. ANTONIO JOSE DE SUCRE.-",-67.11536,-17.96788,328,16,2490,2818,1720,42,712,2432
"Bolivia","Oruro","Cercado","Oruro","U.E. MEJILLONES II(SECUNDARIO)",-67.13734,-18.00333,59,5,340,399,118,28,189,307
"Bolivia","Oruro","Cercado","Oruro","U. E. MISAEL PACHECO LOMA.-",-67.10031,-17.96391,194,6,1567,1761,932,47,582,1514
"Bolivia","Oruro","Cercado","Oruro","U. E. MOVIMIENTO SIN TECHO",-67.07934,-17.97713,507,61,3764,4271,947,165,2591,3538
"Bolivia","Oruro","Cercado","Oruro","U.E. NAL. MIXTO HUAJARA SECUNDARIO",-67.09364,-17.94298,106,13,924,1030,362,114,435,797
"Bolivia","Oruro","Cercado","Oruro","U.E. NIÑO QUIRQUINCHO FELIZ",-67.03982,-17.97784,188,23,1463,1651,551,113,776,1327
"Bolivia","Oruro","Cercado","Oruro","U. E. ORURO OTAWA (SECUNDARIA)",-67.10309,-17.97182,213,17,1686,1899,905,40,724,1629
"Bolivia","Oruro","Cercado","Oruro","U. E. OSCAR UNZAGA DE LA VEGA.-",-67.11453,-17.94222,446,43,3640,4086,1752,198,1647,3399
"Bolivia","Oruro","Cercado","Oruro","U. E. OSCAR UNZAGA DE LA VEGA II",-67.1145,-17.9421,183,15,1168,1351,558,42,553,1111
"Bolivia","Oruro","Cercado","Oruro","U.E. PARTICULAR ARRIETA",-67.11098,-17.9635,27,1,301,328,215,8,77,292
"Bolivia","Oruro","Cercado","Oruro","U.E. SAN LUIS",-67.07831,-17.93586,49,8,414,463,126,49,231,357
"Bolivia","Oruro","Cercado","Oruro","U. E. SANTA ROSA.-",-67.07967,-17.97144,339,24,2098,2437,1054,111,909,1963
"Bolivia","Oruro","Cercado","Oruro","U. ESC. BENEMERITOS DE LA PATRIA.-",-67.12161,-17.98581,230,14,1568,1798,698,61,795,1493
"Bolivia","Oruro","Cercado","Oruro","U. ESC. DIOS ES AMOR.-",-67.09901,-17.98909,99,20,887,986,317,30,520,837
"Bolivia","Oruro","Cercado","Oruro","U. ESC. EL KASSO - EL PROGRESO.-",-67.08046,-17.97144,32,7,281,313,85,10,179,264
"Bolivia","Oruro","Cercado","Oruro","U. ESC. EL PATICO.-",-67.08788,-17.93559,16,8,270,286,96,15,151,247
"Bolivia","Oruro","Cercado","Oruro","U. ESC. FRANCISCO FAJARDO.-",-67.10979,-17.95128,248,10,2030,2278,1172,75,773,1945
"Bolivia","Oruro","Cercado","Oruro","U. ESC. HIJOS DEL SOL (PLAN 500)",-67.14334,-17.97866,325,13,1820,2145,727,53,1027,1754
"Bolivia","Oruro","Cercado","Oruro","U. ESC. KANTUTA.-",-67.10198,-17.94742,586,69,4563,5149,2098,302,2094,4192
"Bolivia","Oruro","Cercado","Oruro","U. ESC. LUIS LLOSA - ESPAÑA.-",-67.10973,-17.96015,100,0,987,1087,700,20,267,967
"Bolivia","Oruro","Cercado","Oruro","U. ESC. MELVIN JONES",-67.11378,-17.94639,254,17,1955,2209,1168,79,691,1859
"Bolivia","Oruro","Cercado","Oruro","U. ESC. ORURO OTAWA (PRIMARIA)",-67.10278,-17.97236,290,24,2604,2894,1561,61,958,2519
"Bolivia","Oruro","Cercado","Oruro","U. ESC. SAN IGNACIO DE LOYOLA.-",-67.10327,-17.97707,621,33,4667,5288,2581,131,1922,4503
"Bolivia","Oruro","Cercado","Oruro","U. ESC. SAN ISIDRO",-67.08199,-17.9849,202,34,1756,1958,632,83,1007,1639
"Bolivia","Oruro","Cercado","Oruro","U. ESC. SAN JUAN DE DIOS.-",-67.0648,-17.98498,65,13,664,729,214,27,410,624
"Bolivia","Oruro","Cercado","Oruro","U. ESC. SANTA ANA I  ARENALES.-",-67.08875,-17.9662,47,4,504,551,213,16,271,484
"Bolivia","Oruro","Cercado","Oruro","U. ESC. SEBASTIAN PAGADOR(PRIMARIO)",-67.10513,-17.96682,190,15,1580,1770,1041,41,483,1524
"Bolivia","Oruro","Cercado","Oruro","U. ESC. URU URU.-",-67.13344,-17.97674,319,9,2200,2519,1130,91,970,2100
"Bolivia","Oruro","Cercado","Oruro","U.E. SOCAMANI-.",-67.04722,-17.96745,107,22,857,964,258,58,519,777
"Bolivia","Oruro","Cercado","Oruro","U.E. TOMAS BARRON.-",-67.11607,-17.93777,926,88,7014,7940,3184,304,3438,6622
"Bolivia","Oruro","Cercado","Oruro","U. E. VIRGEN DEL MAR II.-",-67.0981,-17.95885,251,26,2376,2627,1278,131,941,2219
"Bolivia","Oruro","Cercado","Oruro","U.E. VIRGEN DEL MAR III",-67.0981,-17.95885,37,1,142,179,91,2,48,139
"Bolivia","Oruro","Cercado","Soracachi","COL. EDUARDO AVAROA",-66.93476,-17.90583,31,5,480,511,160,23,292,452
"Bolivia","Oruro","Cercado","Soracachi","COL. NAL. IRUMA",-66.95744,-17.82625,34,6,354,388,112,21,215,327
"Bolivia","Oruro","Cercado","Soracachi","COL. NAL. MIXTO SORACACHI",-67.04009,-17.80021,98,19,844,942,298,59,468,766
"Bolivia","Oruro","Cercado","Soracachi","ESC. CACHI CACHI",-66.90673,-17.92398,25,14,298,323,108,14,162,270
"Bolivia","Oruro","Cercado","Soracachi","ESC. CARLOS BELTRAN MORALES",-66.74974,-17.84505,41,3,283,324,38,8,234,272
"Bolivia","Oruro","Cercado","Soracachi","ESC. CENTRAL PARIA",-67.02174,-17.82162,67,14,696,763,216,40,426,642
"Bolivia","Oruro","Cercado","Soracachi","ESC. ELIZARDO PEREZ",-66.92491,-17.94757,15,3,244,259,59,18,164,223
"Bolivia","Oruro","Cercado","Soracachi","ESC. LITORAL",-66.8653,-17.87313,10,0,189,199,20,4,165,185
"Bolivia","Oruro","Cercado","Soracachi","ESC. MULTIGRADO CULLCUPAMPA",-66.84515,-17.81123,33,5,221,254,56,24,136,192
"Bolivia","Oruro","Cercado","Soracachi","ESC. SECCIONAL CONDORCHINOCA",-66.92383,-17.81707,21,6,259,280,47,10,196,243
"Bolivia","Oruro","Cercado","Soracachi","ESC. SECCIONAL SAN JUAN PAMPA",-67.02293,-17.80466,40,5,292,332,130,11,146,276
"Bolivia","Oruro","Cercado","Soracachi","ESC. SIMON BOLIVAR",-66.95678,-17.63055,69,7,335,404,87,17,224,311
"Bolivia","Oruro","Cercado","Soracachi","ESC. SIMON BOLIVAR",-66.93806,-17.64721,69,7,335,404,87,17,224,311
"Bolivia","Oruro","Cercado","Soracachi","PLAZA DE TOLAPALCA",-66.839,-17.85507,43,8,321,364,62,17,234,296
"Bolivia","Oruro","Cercado","Soracachi","PLAZA TENIENTE BULLAIN",-67.00915,-17.9779,42,17,867,909,266,49,535,801
"Bolivia","Oruro","Cercado","Soracachi","U. E. CALAPATA",-67.07857,-17.81657,8,2,225,233,66,9,148,214
"Bolivia","Oruro","Cercado","Soracachi","U.E. EDUARDO AVAROA",-66.95867,-18.05556,45,6,486,531,120,17,343,463
"Bolivia","Oruro","Cercado","Soracachi","U.E. FRANZ TAMAYO",-67.03432,-17.68199,23,6,120,143,34,7,73,107
"Bolivia","Oruro","Cercado","Soracachi","U. E. JATITA",-67.15078,-17.74948,22,3,199,221,51,2,143,194
"Bolivia","Oruro","Cercado","Soracachi","U. E. K'ASA HUASA",-67.01914,-18.04029,16,11,232,248,90,15,116,206
"Bolivia","Oruro","Cercado","Soracachi","U. E. MCAL. ANTONIO JOSE DE SUCRE",-66.99371,-17.6637,6,0,134,140,43,9,82,125
"Bolivia","Oruro","Cercado","Soracachi","U. ESC. SIMON BOLIVAR",-66.88591,-17.77803,22,7,211,233,48,9,147,195
"Bolivia","Oruro","Ladislao Cabrera","Pampa Aullagas","ESC. FRANZ TAMAYO",-67.14696,-19.40474,3,0,140,143,47,7,86,133
"Bolivia","Oruro","Ladislao Cabrera","Pampa Aullagas","ESC. MARIA SANCHEZ FERNANDEZ",-67.06307,-19.19442,136,26,960,1096,279,42,613,892
"Bolivia","Oruro","Ladislao Cabrera","Pampa Aullagas","U.E. GUALBERTO VILLARROEL",-67.06329,-19.28214,28,2,268,296,90,7,169,259
"Bolivia","Oruro","Ladislao Cabrera","Salinas de Garcí Mendoza","COL. ANTOFAGASTA",-67.73315,-19.52218,55,6,465,520,110,17,332,442
"Bolivia","Oruro","Ladislao Cabrera","Salinas de Garcí Mendoza","COL. FRANZ TAMAYO",-67.67596,-19.63522,228,15,1143,1371,351,61,716,1067
"Bolivia","Oruro","Ladislao Cabrera","Salinas de Garcí Mendoza","ESC. AMERICA SAN MARTIN",-67.59932,-19.27503,46,3,198,244,49,7,139,188
"Bolivia","Oruro","Ladislao Cabrera","Salinas de Garcí Mendoza","ESC. CENTRAL PUQUI",-67.37225,-19.57412,45,6,349,394,54,12,277,331
"Bolivia","Oruro","Ladislao Cabrera","Salinas de Garcí Mendoza","ESC. ILDEFONSO MURGUIA",-67.94785,-19.71597,7,3,54,61,4,0,47,51
"Bolivia","Oruro","Ladislao Cabrera","Salinas de Garcí Mendoza","ESC. VILLA ESPERANZA",-67.28278,-19.39601,21,2,183,204,47,9,125,172
"Bolivia","Oruro","Ladislao Cabrera","Salinas de Garcí Mendoza","PLAZA PRINCIPAL",-67.76024,-19.25545,6,3,161,167,104,4,50,154
"Bolivia","Oruro","Ladislao Cabrera","Salinas de Garcí Mendoza","U.E. BOLIVIA LUCA",-67.8995,-19.59013,17,1,73,90,9,1,62,71
"Bolivia","Oruro","Ladislao Cabrera","Salinas de Garcí Mendoza","U. E. CONCEPCION DE BELEN",-67.88071,-19.19479,26,1,86,112,46,4,35,81
"Bolivia","Oruro","Ladislao Cabrera","Salinas de Garcí Mendoza","U.E. GERMAN BUSCH",-67.57353,-19.85675,4,0,41,45,11,2,28,39
"Bolivia","Oruro","Ladislao Cabrera","Salinas de Garcí Mendoza","U.E. OTTO SAUCEDO RIVERA",-67.42625,-19.13229,142,12,754,896,232,43,467,699
"Bolivia","Oruro","Litoral","Cruz de Machacamarca","AMB. COMITE CIVICO",-68.34784,-18.80327,1,0,78,79,18,2,58,76
"Bolivia","Oruro","Litoral","Cruz de Machacamarca","CASA COMUNAL",-68.05518,-18.69846,5,0,97,102,40,2,55,95
"Bolivia","Oruro","Litoral","Cruz de Machacamarca","ESC. CRUZ DE MACHACAMARCA",-67.75741,-18.74025,12,11,192,204,83,1,97,180
"Bolivia","Oruro","Litoral","Cruz de Machacamarca","ESC. TCNL. RAFAEL PABON.-",-68.27777,-18.77197,0,0,119,119,29,1,89,118
"Bolivia","Oruro","Litoral","Escara","CASA COMUNAL",-68.16998,-18.85891,5,2,82,87,34,2,44,78
"Bolivia","Oruro","Litoral","Escara","CASA DEL NOTARIO",-68.20262,-18.80862,0,2,155,155,54,2,97,151
"Bolivia","Oruro","Litoral","Escara","U.E. FRANZ TAMAYO",-68.16997,-18.85826,37,32,317,354,137,5,143,280
"Bolivia","Oruro","Litoral","Esmeralda","ESC. SEBASTIAN PAGADOR",-68.25356,-18.88226,8,1,185,193,77,0,107,184
"Bolivia","Oruro","Litoral","Esmeralda","IGLESIA",-67.93938,-18.92884,10,2,182,192,65,1,114,179
"Bolivia","Oruro","Litoral","Esmeralda","IGLESIA",-68.28327,-18.84608,10,2,182,192,65,1,114,179
"Bolivia","Oruro","Litoral","Esmeralda","U.E. PEDRO DOMINGO MURILLO",-68.20913,-18.91374,1,0,118,119,53,0,65,118
"Bolivia","Oruro","Litoral","Huachacalla","ESC. FE Y ALEGRIA",-68.26381,-18.79456,313,3,341,654,125,9,204,329
"Bolivia","Oruro","Litoral","Yunguyo de Litoral","ESC. JOSE BALLIVIAN",-68.31896,-18.85273,32,0,94,126,43,6,45,88
"Bolivia","Oruro","Mejillones","Carangas","ESC. ELIODORO VILLAZON",-68.62348,-18.93954,29,0,139,168,61,1,77,138
"Bolivia","Oruro","Mejillones","La Rivera","U.E. LA RIVERA",-68.63965,-19.0056,0,3,250,250,124,2,121,245
"Bolivia","Oruro","Mejillones","Todos Santos","U.E. EDUARDO AVAROA",-68.7207,-19.0161,62,5,192,254,63,3,121,184
"Bolivia","Oruro","Nor Carangas","Huayllamarca (Santiago de Huayllamarca)","COL. CHOJÑOHUMA",-67.99887,-17.75547,10,5,118,128,23,2,88,111
"Bolivia","Oruro","Nor Carangas","Huayllamarca (Santiago de Huayllamarca)","COL. LLANQUERA",-67.69202,-17.98834,75,4,423,498,106,12,301,407
"Bolivia","Oruro","Nor Carangas","Huayllamarca (Santiago de Huayllamarca)","ESC. GERMAN BUSCH",-67.63836,-18.05427,24,2,140,164,59,4,75,134
"Bolivia","Oruro","Nor Carangas","Huayllamarca (Santiago de Huayllamarca)","ESC. JESUS BELEN",-68.02042,-17.79224,4,0,119,123,34,2,83,117
"Bolivia","Oruro","Nor Carangas","Huayllamarca (Santiago de Huayllamarca)","ESC. TUNUPA",-67.88644,-17.80342,30,2,197,227,51,6,138,189
"Bolivia","Oruro","Nor Carangas","Huayllamarca (Santiago de Huayllamarca)","PLAZA PRINCIPAL",-67.9429,-17.83473,103,16,685,788,153,23,493,646
"Bolivia","Oruro","Nor Carangas","Huayllamarca (Santiago de Huayllamarca)","U. E. MEJILLONES",-67.91051,-17.86477,16,0,125,141,27,5,93,120
"Bolivia","Oruro","Nor Carangas","Huayllamarca (Santiago de Huayllamarca)","U.E. PEDRO DOMINGO MURILLO",-67.8089,-17.91016,27,7,298,325,89,3,199,288
"Bolivia","Oruro","Nor Carangas","Huayllamarca (Santiago de Huayllamarca)","U. E. SAN MIGUEL",-67.74892,-17.9582,17,7,392,409,123,12,250,373
"Bolivia","Oruro","Nor Carangas","Huayllamarca (Santiago de Huayllamarca)","U.E. SEBASTIAN PAGADOR",-67.85006,-17.99825,24,0,125,149,30,1,94,124
"Bolivia","Oruro","Pantaleón Dalence","Machacamarca","COL. P. D. MURILLO.-",-67.01683,-18.17177,247,32,1563,1810,542,53,936,1478
"Bolivia","Oruro","Pantaleón Dalence","Machacamarca","ESC. ADOLFO MIER",-67.00506,-18.10496,30,1,194,224,68,8,117,185
"Bolivia","Oruro","Pantaleón Dalence","Machacamarca","ESC. GERMAN BUSCH",-66.96426,-18.16933,89,9,398,487,130,14,245,375
"Bolivia","Oruro","Pantaleón Dalence","Villa Huanuni","COL. AYACUCHO",-66.84127,-18.28592,584,47,3859,4443,1144,193,2475,3619
"Bolivia","Oruro","Pantaleón Dalence","Villa Huanuni","ESC. DANIEL SANCHEZ BUSTAMANTE",-66.81483,-18.27406,27,2,130,157,47,9,72,119
"Bolivia","Oruro","Pantaleón Dalence","Villa Huanuni","ESC. EDUARDO AVAROA",-66.83648,-18.28687,514,57,4060,4574,1162,179,2662,3824
"Bolivia","Oruro","Pantaleón Dalence","Villa Huanuni","ESC. FRANZ TAMAYO",-66.84327,-18.28328,342,39,2940,3282,823,133,1945,2768
"Bolivia","Oruro","Pantaleón Dalence","Villa Huanuni","ESC. HUALLATIRI",-66.57692,-18.26101,29,3,189,218,31,3,152,183
"Bolivia","Oruro","Pantaleón Dalence","Villa Huanuni","ESC. OSCAR ALFARO",-66.84819,-18.07138,32,6,247,279,119,10,112,231
"Bolivia","Oruro","Pantaleón Dalence","Villa Huanuni","PLAZA PRINCIPAL",-66.74792,-18.36819,24,1,249,273,50,8,190,240
"Bolivia","Oruro","Pantaleón Dalence","Villa Huanuni","U.E. 12 DE ABRIL",-66.83877,-18.28987,121,6,358,479,134,18,200,334
"Bolivia","Oruro","Pantaleón Dalence","Villa Huanuni","U.E. MARISCAL SUCRE DE TARUCAMARCA",-66.74748,-18.27423,2,2,90,92,8,6,74,82
"Bolivia","Oruro","Pantaleón Dalence","Villa Huanuni","U.E. TAYAQUIRA",-66.68075,-18.28287,22,9,324,346,45,6,264,309
"Bolivia","Oruro","Pantaleón Dalence","Villa Huanuni","U.E. VENEZUELA",-66.83852,-18.28969,42,1,237,279,122,7,107,229
"Bolivia","Oruro","Pantaleón Dalence","Villa Huanuni","U.E. VICTOR MANUEL AYLLON",-66.79549,-18.15128,41,3,230,271,72,16,139,211
"Bolivia","Oruro","Poopó","Antequera (Bolívar)","ESC. MARISCAL ANTONIO JOSE DE SUCRE",-66.75814,-18.60952,11,2,137,148,42,5,88,130
"Bolivia","Oruro","Poopó","Antequera (Bolívar)","ESC. SEBASTIAN PAGADOR",-66.84234,-18.47896,136,19,1065,1201,557,51,438,995
"Bolivia","Oruro","Poopó","Antequera (Bolívar)","PLAZA 2 DE FEBRERO",-66.74583,-18.57221,14,5,141,155,58,8,70,128
"Bolivia","Oruro","Poopó","Paza","COL. JUAN LECHIN OQUENDO",-66.87602,-18.49693,82,7,534,616,201,17,309,510
"Bolivia","Oruro","Poopó","Paza","COL. OSCAR UNZAGA DE LA VEGA",-66.9222,-18.59495,145,16,849,994,337,42,454,791
"Bolivia","Oruro","Poopó","Paza","COL. URMIRI",-66.87689,-18.57802,15,1,117,132,68,1,47,115
"Bolivia","Oruro","Poopó","Paza","ESC. MARISCAL SUCRE.-",-66.75761,-18.69305,114,18,758,872,216,76,448,664
"Bolivia","Oruro","Poopó","Paza","U.E. GUILLERMO GUTIERREZ",-66.88187,-18.52423,23,7,261,284,100,6,148,248
"Bolivia","Oruro","Poopó","Poopó (Villa Poopó)","ESC. EDUARDO AVAROA",-66.99586,-18.28933,26,5,114,140,29,8,72,101
"Bolivia","Oruro","Poopó","Poopó (Villa Poopó)","ESC. ISMAEL MONTES",-66.96783,-18.37966,276,47,2328,2604,760,113,1408,2168
"Bolivia","Oruro","Poopó","Poopó (Villa Poopó)","ESC. MARISCAL SUCRE",-66.82631,-18.37954,13,2,111,124,22,7,80,102
"Bolivia","Oruro","Poopó","Poopó (Villa Poopó)","ESC. PUÑACA",-67.01503,-18.40687,5,0,55,60,5,3,47,52
"Bolivia","Oruro","Poopó","Poopó (Villa Poopó)","PLAZA SIMON BOLIVAR",-66.85959,-18.29434,75,10,414,489,112,20,272,384
"Bolivia","Oruro","Poopó","Poopó (Villa Poopó)","U.E. GERMAN BUSCH",-66.96021,-18.49657,0,0,49,49,11,2,36,47
"Bolivia","Oruro","Poopó","Poopó (Villa Poopó)","U.E. LIBERTADOR SIMON BOLIVAR",-66.97563,-18.45356,5,5,106,111,16,0,85,101
"Bolivia","Oruro","Sabaya","Chipaya","ESC. PUENTE TOPATER",-67.91399,-19.03246,41,1,114,155,11,5,97,108
"Bolivia","Oruro","Sabaya","Chipaya","ESC. SAN IGNACIO",-68.0725,-19.09496,20,0,70,90,6,1,63,69
"Bolivia","Oruro","Sabaya","Chipaya","U.E. SANTA ANA",-68.08934,-19.04418,227,9,411,638,129,8,265,394
"Bolivia","Oruro","Sabaya","Coipasa","U.E. COIPASA",-68.27831,-19.2763,36,3,346,382,186,4,153,339
"Bolivia","Oruro","Sabaya","Sabaya","CASA COMUNAL",-68.73852,-18.73852,1,0,167,168,118,0,49,167
"Bolivia","Oruro","Sabaya","Sabaya","CASA COMUNAL",-68.47369,-19.00466,1,0,167,168,118,0,49,167
"Bolivia","Oruro","Sabaya","Sabaya","CASA DEL NOTARIO",-68.5004,-19.06247,14,0,91,105,61,1,29,90
"Bolivia","Oruro","Sabaya","Sabaya","ESC. EDUARDO AVAROA",-68.87798,-19.03987,0,4,30,30,8,4,14,22
"Bolivia","Oruro","Sabaya","Sabaya","ESC. FELIX FERNANDEZ",-68.52093,-18.96744,4,0,97,101,67,0,30,97
"Bolivia","Oruro","Sabaya","Sabaya","ESC. FRANZ TAMAYO",-68.35445,-19.19073,0,2,298,298,183,4,109,292
"Bolivia","Oruro","Sabaya","Sabaya","ESC. FRANZ TAMAYO",-68.31431,-18.76981,0,2,298,298,183,4,109,292
"Bolivia","Oruro","Sabaya","Sabaya","ESC. GERMAN BUSCH",-68.61129,-18.82781,11,0,201,212,80,2,119,199
"Bolivia","Oruro","Sabaya","Sabaya","ESC. GUALBERTO VILLARROEL",-68.78839,-18.57318,2,3,107,109,35,2,67,102
"Bolivia","Oruro","Sabaya","Sabaya","ESC. ILDEFONSO MURGUIA",-68.89094,-18.69991,8,1,199,207,104,1,93,197
"Bolivia","Oruro","Sabaya","Sabaya","ESC. JOSE MARIA EGUES CUELLAR",-68.37302,-19.01429,145,8,404,549,192,20,184,376
"Bolivia","Oruro","Sabaya","Sabaya","ESC. JOSE MARIA MONTAÑO",-68.53316,-18.90277,2,0,113,115,92,0,21,113
"Bolivia","Oruro","Sabaya","Sabaya","ESC. JOSE MERIDA MONTAÑO",-68.64622,-18.70486,15,0,103,118,78,1,24,102
"Bolivia","Oruro","Sabaya","Sabaya","ESC. PITACOLLO",-68.59029,-19.05312,3,1,85,88,14,0,70,84
"Bolivia","Oruro","Sabaya","Sabaya","ESC. SEBASTIAN  PAGADOR",-68.37182,-19.01886,0,3,154,154,105,1,45,150
"Bolivia","Oruro","Sabaya","Sabaya","ESC. VERALINES",-68.55422,-19.20341,4,0,121,125,90,2,29,119
"Bolivia","Oruro","Sabaya","Sabaya","IGLESIA",-68.80792,-18.79146,0,0,54,54,32,0,22,54
"Bolivia","Oruro","Sabaya","Sabaya","PLAZA 25 DE JULIO MIRAFLORES",-68.54026,-18.65128,0,0,33,33,20,0,13,33
"Bolivia","Oruro","Sabaya","Sabaya","PLAZA SIMON BOLIVAR",-68.52158,-18.8665,12,0,67,79,41,0,26,67
"Bolivia","Oruro","Sabaya","Sabaya","U. E.  CONCEPCION COMUJO",-68.38916,-19.21006,2,1,104,106,67,0,36,103
"Bolivia","Oruro","Sabaya","Sabaya","U.E. JOSE ANTONIO ARCE",-68.68381,-18.44296,24,0,126,150,80,0,46,126
"Bolivia","Oruro","Sabaya","Sabaya","U.E. LIBERTADOR SIMON BOLIVAR",-68.61559,-19.27332,69,5,224,293,121,13,85,206
"Bolivia","Oruro","Sabaya","Sabaya","U.E. MARIA EVANS CUELLAR",-68.34265,-19.09297,6,0,120,126,96,1,23,119
"Bolivia","Oruro","Sabaya","Sabaya","U.E. PEDRO DOMINGO MURILLO",-68.53796,-18.92385,3,0,138,141,90,2,46,136
"Bolivia","Oruro","Sajama","Curahuara de Carangas","COL. BOLIVIA",-68.97609,-18.13643,46,4,160,206,74,7,75,149
"Bolivia","Oruro","Sajama","Curahuara de Carangas","ESC. EDUARDO SAGARNAGA",-68.41264,-17.84149,592,39,1589,2181,355,73,1122,1477
"Bolivia","Oruro","Sajama","Curahuara de Carangas","U.E. HACIA EL MAR",-68.83837,-18.00538,7,0,67,74,17,0,50,67
"Bolivia","Oruro","Sajama","Curahuara de Carangas","U.E. LITORAL B",-68.93645,-18.2223,29,1,148,177,56,6,85,141
"Bolivia","Oruro","Sajama","Turco","CASA COMUNAL",-68.94479,-18.53836,11,0,57,68,18,0,39,57
"Bolivia","Oruro","Sajama","Turco","ESC. CENTRAL TURCO",-68.19347,-18.18156,204,16,956,1160,212,23,705,917
"Bolivia","Oruro","Sajama","Turco","ESC. GUALBERTO VILLARROEL - IRUNI.-",-68.5331,-18.60372,2,0,40,42,6,0,34,40
"Bolivia","Oruro","Sajama","Turco","ESC. WALBERTO VILLARROEL",-68.62778,-18.34289,5,0,31,36,6,1,24,30
"Bolivia","Oruro","Sajama","Turco","NUCLEO ESCOLAR TITIRI",-68.33176,-18.38792,23,0,73,96,6,6,61,67
"Bolivia","Oruro","Sajama","Turco","U.E. ASUNCION DE HUAJRIRE",-68.37857,-18.21539,1,0,21,22,5,1,15,20
"Bolivia","Oruro","Sajama","Turco","U.E. EDUARDO AVAROA",-67.94069,-18.01298,21,1,96,117,16,2,77,93
"Bolivia","Oruro","Sajama","Turco","U.E. PEDRO DOMINGO MURILLO A",-68.71188,-18.17634,64,5,377,441,59,10,303,362
"Bolivia","Oruro","Sajama","Turco","U.E. PORVENIR",-68.94597,-18.35423,43,1,283,326,108,13,161,269
"Bolivia","Oruro","San Pedro De Totora","San Pedro de Totora","COL. NAL. CALAZAYA",-68.29729,-17.66094,64,7,295,359,30,6,252,282
"Bolivia","Oruro","San Pedro De Totora","San Pedro de Totora","COMEDOR ESCOLAR",-68.31258,-17.89262,17,1,100,117,29,4,66,95
"Bolivia","Oruro","San Pedro De Totora","San Pedro de Totora","ESC. CENTRAL SORA SORA",-68.10621,-17.9355,13,2,223,236,24,4,193,217
"Bolivia","Oruro","San Pedro De Totora","San Pedro de Totora","ESC. FRANZ TAMAYO",-68.09863,-17.82198,10,1,185,195,30,3,151,181
"Bolivia","Oruro","San Pedro De Totora","San Pedro de Totora","ESC. LITORAL DE CULTA.-",-68.03839,-17.97308,29,0,197,226,18,9,170,188
"Bolivia","Oruro","San Pedro De Totora","San Pedro de Totora","ESC. MARQUIRIVI",-67.9737,-17.95451,13,0,69,82,26,2,41,67
"Bolivia","Oruro","San Pedro De Totora","San Pedro de Totora","U.E. CENTRO REVITO",-68.02218,-17.91033,7,0,76,83,18,2,56,74
"Bolivia","Oruro","San Pedro De Totora","San Pedro de Totora","U.E. ROMEROCOTA",-68.25556,-17.92027,0,2,77,77,4,14,57,61
"Bolivia","Oruro","San Pedro De Totora","San Pedro de Totora","U.E. SEBASTIAN PAGADOR",-68.28579,-17.79087,14,1,127,141,13,1,112,125
"Bolivia","Oruro","San Pedro De Totora","San Pedro de Totora","U.E. TOTORA",-68.14532,-17.7922,149,17,789,938,119,46,607,726
"Bolivia","Oruro","San Pedro De Totora","San Pedro de Totora","U.E. VINO HUTA",-68.2402,-17.8328,12,1,132,144,14,2,115,129
"Bolivia","Oruro","Saucarí","Toledo","CASA COMUNAL",-67.42073,-18.08936,27,0,115,142,41,3,71,112
"Bolivia","Oruro","Saucarí","Toledo","CASA COMUNAL",-67.00774,-18.14512,27,0,115,142,41,3,71,112
"Bolivia","Oruro","Saucarí","Toledo","CASA COMUNAL CENTRAL MOLLOCO",-67.49101,-18.40378,4,4,77,81,14,1,58,72
"Bolivia","Oruro","Saucarí","Toledo","CASA DEL NOTARIO",-67.58843,-18.20439,13,0,67,80,18,1,48,66
"Bolivia","Oruro","Saucarí","Toledo","COL. NACIONAL TOLEDO",-67.4108,-18.1808,250,14,998,1248,299,37,648,947
"Bolivia","Oruro","Saucarí","Toledo","ESC. EDUARDO AVAROA",-67.58844,-18.20436,10,1,95,105,26,17,51,77
"Bolivia","Oruro","Saucarí","Toledo","ESC. ELIZARDO PEREZ 1",-67.28907,-18.29798,32,2,137,169,31,5,99,130
"Bolivia","Oruro","Saucarí","Toledo","ESC. GERMAN BUSCH 1",-67.54126,-18.26623,31,1,139,170,54,5,79,133
"Bolivia","Oruro","Saucarí","Toledo","ESC. GERMAN BUSCH II",-67.40559,-18.50244,1,0,123,124,24,5,94,118
"Bolivia","Oruro","Saucarí","Toledo","ESC. ISAC PORTO CARRERA",-67.59666,-18.02896,38,2,149,187,28,2,117,145
"Bolivia","Oruro","Saucarí","Toledo","ESC. M. M. VACA GUZMAN.-",-67.2721,-17.47592,70,5,282,352,87,9,181,268
"Bolivia","Oruro","Saucarí","Toledo","ESC. PUMASARA",-67.35503,-18.6561,21,0,120,141,19,3,98,117
"Bolivia","Oruro","Saucarí","Toledo","U.E. ANTONIO JOSE DE SUCRE",-67.51073,-18.37418,10,0,38,48,11,0,27,38
"Bolivia","Oruro","Saucarí","Toledo","U.E. BARTOLINA SISA",-67.46616,-18.43586,6,1,101,107,21,2,77,98
"Bolivia","Oruro","Saucarí","Toledo","U.E. FRANZ TAMAYO",-67.59203,-18.1406,5,0,45,50,16,2,27,43
"Bolivia","Oruro","Saucarí","Toledo","U. E. GUALBERTO VILLARROEL",-67.49483,-17.94513,17,2,121,138,27,1,91,118
"Bolivia","Oruro","Saucarí","Toledo","U.E. MARCELO QUIROGA SANTA CRUZ",-67.40546,-18.39192,20,1,61,81,9,0,51,60
"Bolivia","Oruro","Saucarí","Toledo","U.E. OTTO SAUCEDO",-67.5033,-18.48854,5,2,125,130,31,2,90,121
"Bolivia","Oruro","Saucarí","Toledo","U. ESC. TIJLLACAHUA",-67.46854,-17.94667,19,0,69,88,26,3,40,66
"Bolivia","Oruro","Sebastian Pagador","Santiago de Huari","COL. MIXTO GUALBERTO VILLARROEL",-66.77557,-19.00875,215,27,1528,1743,585,126,790,1375
"Bolivia","Oruro","Sebastian Pagador","Santiago de Huari","ESC. CAICO BOLIVAR",-66.75815,-19.25462,9,1,88,97,39,1,47,86
"Bolivia","Oruro","Sebastian Pagador","Santiago de Huari","ESC. CALACOTA",-66.46594,-19.14192,8,0,69,77,16,3,50,66
"Bolivia","Oruro","Sebastian Pagador","Santiago de Huari","ESC. CASTILLA HUMA",-66.71346,-19.14007,38,4,229,267,86,9,130,216
"Bolivia","Oruro","Sebastian Pagador","Santiago de Huari","ESC. CONDO K",-66.8055,-19.17203,14,2,140,154,67,3,68,135
"Bolivia","Oruro","Sebastian Pagador","Santiago de Huari","ESC. LLAPALLAPANI",-66.81982,-19.01081,17,2,117,134,25,6,84,109
"Bolivia","Oruro","Sebastian Pagador","Santiago de Huari","ESC. VICHAJ LUPE",-66.7529,-19.25462,42,1,245,287,68,12,164,232
"Bolivia","Oruro","Sebastian Pagador","Santiago de Huari","NUCLEO ESCOLAR BOLIVIA",-66.74451,-19.15185,14,1,284,298,50,3,230,280
"Bolivia","Oruro","Sebastian Pagador","Santiago de Huari","NUCLEO MARCA LAGUNILLAS",-66.27309,-19.23056,34,7,472,506,107,23,335,442
"Bolivia","Oruro","Sebastian Pagador","Santiago de Huari","U. E. LUCUMPAYA",-66.69658,-19.29461,8,0,57,65,10,1,46,56
"Bolivia","Oruro","Sebastian Pagador","Santiago de Huari","U.E. NAZACARA",-66.48449,-19.15744,0,3,121,121,41,7,70,111
"Bolivia","Oruro","Sebastian Pagador","Santiago de Huari","U.E. SAN PEDRO DE CONDO",-66.74747,-19.04341,105,9,553,658,205,24,315,520
"Bolivia","Oruro","Sebastian Pagador","Santiago de Huari","U. E. URMIRI DE QUILLACAS",-66.72021,-19.22743,39,3,211,250,43,4,161,204
"Bolivia","Oruro","Sebastian Pagador","Santiago de Huari","U. E. VILLA VERDE",-66.76753,-19.11843,23,3,130,153,43,2,82,125
"Bolivia","Oruro","Sur Carangas","Andamarca (Santiago de Andamarca)","ESC. SEBASTIAN PAGADOR",-67.50749,-18.77982,183,24,688,871,200,12,452,652
"Bolivia","Oruro","Sur Carangas","Andamarca (Santiago de Andamarca)","U.E. MEJILLONES",-67.50016,-18.87049,84,25,540,624,111,8,396,507
"Bolivia","Oruro","Sur Carangas","Andamarca (Santiago de Andamarca)","U.E. ORINOCA",-67.25661,-18.96682,110,3,804,914,64,11,726,790
"Bolivia","Oruro","Sur Carangas","Belén de Andamarca","COL. TEC. HUMANISTICO SIMON BOLIVAR",-67.64007,-18.8171,46,7,330,376,123,7,193,316
"Bolivia","Oruro","Sur Carangas","Belén de Andamarca","ESC. ANICETO ARCE",-67.75741,-18.74025,0,4,178,178,36,5,133,169
"Bolivia","Oruro","Sur Carangas","Belén de Andamarca","ESC. ELIZARDO PEREZ",-67.67679,-18.76107,11,0,101,112,20,3,78,98
"Bolivia","Oruro","Sur Carangas","Belén de Andamarca","U.E. BOLIVIA",-67.69051,-18.75176,16,7,183,199,38,9,129,167
"Bolivia","Oruro","Tomas Barrón","Eucaliptus","COL. NAL. EUCALIPTUS",-67.51264,-17.59574,6,1,62,68,11,0,50,61
"Bolivia","Oruro","Tomas Barrón","Eucaliptus","ESC. HUANCAROMA",-67.49158,-17.66445,18,0,121,139,18,0,103,121
"Bolivia","Oruro","Tomas Barrón","Eucaliptus","ESC. MARISCAL ANTONIO JOSE DE SUCRE",-67.39827,-17.62614,24,4,167,191,19,3,141,160
"Bolivia","Oruro","Tomas Barrón","Eucaliptus","ESC. TUPAC KATARI",-67.45214,-17.5953,4,2,200,204,36,6,156,192
"Bolivia","Oruro","Tomas Barrón","Eucaliptus","U.E. BENEDETO VINCENTI",-67.50977,-17.59444,216,21,1308,1524,381,32,874,1255
"Bolivia","Oruro","Tomas Barrón","Eucaliptus","U.E. MACHACAMARCA",-67.35824,-17.64213,10,0,105,115,11,4,90,101
"Bolivia","Oruro","Tomas Barrón","Eucaliptus","U.E. QUELCATA",-67.48569,-17.56117,56,13,325,381,55,8,249,304
"Bolivia","Pando","Abuná","Ingavi (Humaita)","U.E. DERREPENTE",-66.94105,-10.93787,0,0,68,68,37,12,19,56
"Bolivia","Pando","Abuná","Ingavi (Humaita)","U.E. HUMAITA",-66.44747,-10.82152,119,2,372,491,178,7,185,363
"Bolivia","Pando","Abuná","Ingavi (Humaita)","U.E. INGAVI",-66.82959,-10.95218,44,4,99,143,43,3,49,92
"Bolivia","Pando","Abuná","Ingavi (Humaita)","U.E. LAS AMALIAS",-66.79862,-10.97642,5,0,25,30,1,1,23,24
"Bolivia","Pando","Abuná","Santa Rosa del Abun","U.E. ABUNA",-67.45408,-10.60663,141,5,236,377,114,8,109,223
"Bolivia","Pando","Abuná","Santa Rosa del Abun","U.E. AUGUSTO GUTIERREZ BANZER",-67.35876,-10.85149,1,0,80,81,20,2,58,78
"Bolivia","Pando","Abuná","Santa Rosa del Abun","U.E. GENOVEVA RÍOS",-67.42355,-10.9903,63,5,223,286,45,2,171,216
"Bolivia","Pando","Abuná","Santa Rosa del Abun","U.E. PEDRO DOMINGO MURRILLO",-67.32189,-10.64891,16,0,100,116,8,0,92,100
"Bolivia","Pando","Abuná","Santa Rosa del Abun","U.E.  ZACARIAS MORENO",-67.48418,-10.87283,41,0,203,244,127,2,74,201
"Bolivia","Pando","Federico Román","Nuevo Manoa (Nueva Esperanza)","U.E. GRAL. FEDERICO ROMÁN",-65.50873,-10.47329,103,1,148,251,95,2,50,145
"Bolivia","Pando","Federico Román","Nuevo Manoa (Nueva Esperanza)","U.E. LA GRAN CRUZ",-65.40121,-10.36206,19,2,61,80,7,1,51,58
"Bolivia","Pando","Federico Román","Nuevo Manoa (Nueva Esperanza)","U.E.  MANUEL ESTREMADOIRO MARTINEZ",-65.34017,-10.05819,213,1,270,483,159,3,107,266
"Bolivia","Pando","Federico Román","Nuevo Manoa (Nueva Esperanza)","U.E.  MONTE SINAI",-65.31994,-10.25371,30,9,137,167,11,6,111,122
"Bolivia","Pando","Federico Román","Nuevo Manoa (Nueva Esperanza)","U.E. RUFINO CHAO",-65.59814,-10.53096,44,3,52,96,30,0,19,49
"Bolivia","Pando","Federico Román","Santos Mercado","19 DE OCTUBRE",-66.15702,-10.52243,181,2,367,548,177,6,182,359
"Bolivia","Pando","Federico Román","Santos Mercado","U.E. 11 DE SEPTIEMBRE",-66.40456,-10.258,54,1,170,224,50,2,117,167
"Bolivia","Pando","Federico Román","Santos Mercado","U.E.  23 DE MARZO",-66.30795,-10.4217,116,5,347,463,169,9,164,333
"Bolivia","Pando","Federico Román","Villa Nueva (Loma Alta)","U.E.  ANDRES IDAGUA",-65.96667,-10.79472,161,6,476,637,216,7,247,463
"Bolivia","Pando","Federico Román","Villa Nueva (Loma Alta)","U.E. ENAREVENA",-66.10579,-10.57579,9,0,51,60,28,0,23,51
"Bolivia","Pando","Federico Román","Villa Nueva (Loma Alta)","U.E. JUANA AZURDUY DE PADILLA",-66.15096,-10.79327,39,3,77,116,31,0,43,74
"Bolivia","Pando","Federico Román","Villa Nueva (Loma Alta)","U.E.  ROBERTO GONZALES",-65.88841,-10.6848,57,5,184,241,76,1,102,178
"Bolivia","Pando","Madre De Dios","El Sena","U.E.  2 DE AGOSTO",-67.05062,-11.45478,6,4,71,77,51,2,14,65
"Bolivia","Pando","Madre De Dios","El Sena","U.E. 4 DE AGOSTO",-67.01925,-12.17563,26,1,86,112,26,1,58,84
"Bolivia","Pando","Madre De Dios","El Sena","U.E. DE PEKIN",-67.65797,-12.00184,43,1,72,115,43,1,27,70
"Bolivia","Pando","Madre De Dios","El Sena","U.E. EL SENA",-67.24951,-11.48288,498,19,1417,1915,740,25,633,1373
"Bolivia","Pando","Madre De Dios","El Sena","U.E. EL TURI (RIO MANURAPE)",-67.28406,-11.69199,4,2,46,50,27,4,13,40
"Bolivia","Pando","Madre De Dios","El Sena","U.E. LAS MERCEDES",-67.27101,-11.87276,7,2,73,80,35,1,35,70
"Bolivia","Pando","Madre De Dios","El Sena","U.E. PALMA REAL",-67.72301,-11.65824,67,2,174,241,89,5,78,167
"Bolivia","Pando","Madre De Dios","El Sena","U.E. REMANSO",-67.29217,-11.76813,6,1,66,72,20,0,45,65
"Bolivia","Pando","Madre De Dios","El Sena","U.E. SAN FRANCISCO",-67.31672,-12.17345,50,5,166,216,53,6,102,155
"Bolivia","Pando","Madre De Dios","El Sena","U.E. SANTA ELENA",-67.48461,-11.78688,17,2,62,79,17,0,43,60
"Bolivia","Pando","Madre De Dios","El Sena","U.E. SANTA ROSA",-67.38081,-12.04853,30,0,54,84,25,0,29,54
"Bolivia","Pando","Madre De Dios","Puerto Gonzalo Moreno","U.E. 2 DE AGOSTO",-66.41665,-11.36894,29,1,141,170,44,4,92,136
"Bolivia","Pando","Madre De Dios","Puerto Gonzalo Moreno","U.E. AGUA DULCE",-66.20935,-11.00872,71,0,134,205,61,2,71,132
"Bolivia","Pando","Madre De Dios","Puerto Gonzalo Moreno","U.E. LUZ EN EL CAMINO",-66.17489,-11.08213,419,13,992,1411,426,29,524,950
"Bolivia","Pando","Madre De Dios","Puerto Gonzalo Moreno","U.E. MIRAFLORES",-66.40204,-11.10459,33,2,168,201,37,2,127,164
"Bolivia","Pando","Madre De Dios","Puerto Gonzalo Moreno","U.E. PEDRO HERRERA",-66.13277,-11.03917,184,5,501,685,266,7,223,489
"Bolivia","Pando","Madre De Dios","Puerto Gonzalo Moreno","U.E.  PORTACHUELO DIOS ES AMOR",-66.26447,-11.31525,108,8,329,437,50,4,267,317
"Bolivia","Pando","Madre De Dios","San Lorenzo","ESCUELA EDUARDO ABAROA",-66.95135,-11.30087,11,0,74,85,50,1,23,73
"Bolivia","Pando","Madre De Dios","San Lorenzo","U.E. 21 DE SEPTIEMBRE",-66.93037,-11.5493,9,0,60,69,24,0,36,60
"Bolivia","Pando","Madre De Dios","San Lorenzo","U.E.  24 DE SEPTIEMBRE",-66.9321,-11.72435,248,13,785,1033,256,13,503,759
"Bolivia","Pando","Madre De Dios","San Lorenzo","U.E. 27 DE MAYO",-66.81934,-11.2835,19,5,144,163,35,5,99,134
"Bolivia","Pando","Madre De Dios","San Lorenzo","U.E. 6 DE AGOSTO",-66.80107,-11.51633,0,0,118,118,0,1,117,117
"Bolivia","Pando","Madre De Dios","San Lorenzo","U.E.  6 DE JUNIO",-66.84736,-11.30354,9,1,62,71,2,0,59,61
"Bolivia","Pando","Madre De Dios","San Lorenzo","U.E.  BRUNO RACUA",-66.98441,-11.34711,12,0,81,93,38,6,37,75
"Bolivia","Pando","Madre De Dios","San Lorenzo","U.E. DE IBERIA",-66.74494,-11.69689,11,1,30,41,9,0,20,29
"Bolivia","Pando","Madre De Dios","San Lorenzo","U.E. DE ROSARIO",-66.93926,-12.29388,33,0,52,85,27,0,25,52
"Bolivia","Pando","Madre De Dios","San Lorenzo","U.E.  FEDERICO HECKER",-66.9248,-12.17911,27,0,70,97,31,1,38,69
"Bolivia","Pando","Madre De Dios","San Lorenzo","U.E. GALILEA",-66.56686,-11.41806,34,5,146,180,39,7,95,134
"Bolivia","Pando","Madre De Dios","San Lorenzo","U.E.  GENOVEVA RIOS",-66.80064,-11.27083,23,0,55,78,29,3,23,52
"Bolivia","Pando","Madre De Dios","San Lorenzo","U.E. GREGORIA DESTRE MATURANA",-66.5792,-11.1674,19,2,165,184,58,2,103,161
"Bolivia","Pando","Madre De Dios","San Lorenzo","U.E. NUEVO HORIZONTE",-66.67747,-11.44474,1,0,43,44,20,1,22,42
"Bolivia","Pando","Madre De Dios","San Lorenzo","U.E. PTO. COPACABANA",-66.68026,-11.54849,99,1,113,212,57,9,46,103
"Bolivia","Pando","Madre De Dios","San Lorenzo","U.E.  SOLEDAD",-66.9871,-11.57613,66,2,173,239,73,2,96,169
"Bolivia","Pando","Madre De Dios","San Lorenzo","U.E. VISTA ALEGRE",-66.6041,-11.3245,35,2,202,237,97,4,99,196
"Bolivia","Pando","Manuripi","Filadelfia","U.E. ALTA GRACIA",-68.25834,-11.60331,89,1,39,128,3,0,35,38
"Bolivia","Pando","Manuripi","Filadelfia","U.E. BUYUYO",-68.80491,-11.61425,14,1,127,141,33,4,89,122
"Bolivia","Pando","Manuripi","Filadelfia","U.E. CHIVE",-68.58688,-12.39163,93,9,220,313,105,8,98,203
"Bolivia","Pando","Manuripi","Filadelfia","U.E. CURICHON",-68.56036,-12.00636,24,4,101,125,48,0,49,97
"Bolivia","Pando","Manuripi","Filadelfia","U.E. DE HOLANDA",-68.71101,-11.76399,46,2,185,231,56,8,119,175
"Bolivia","Pando","Manuripi","Filadelfia","U.E. DE LA CRUZ",-68.10158,-11.98084,7,0,32,39,9,1,22,31
"Bolivia","Pando","Manuripi","Filadelfia","U.E. FILADELFIA",-68.74851,-11.32842,105,3,346,451,156,5,182,338
"Bolivia","Pando","Manuripi","Filadelfia","U.E.  FLORIDA",-68.63426,-12.19954,7,1,90,97,34,0,55,89
"Bolivia","Pando","Manuripi","Filadelfia","U.E.  JUANCITO PINTO",-68.98754,-11.87768,51,4,208,259,82,3,119,201
"Bolivia","Pando","Manuripi","Filadelfia","U.E. LUZ DE AMERICA",-68.6104,-12.12153,10,1,114,124,52,4,57,109
"Bolivia","Pando","Manuripi","Filadelfia","U.E. NUEVA ALIANZA",-68.35039,-11.37201,57,1,288,345,126,4,157,283
"Bolivia","Pando","Manuripi","Filadelfia","U.E. NUEVA EMPRESA",-68.81753,-11.49919,57,5,326,383,131,3,187,318
"Bolivia","Pando","Manuripi","Filadelfia","U.E. SAN ANTONIO",-68.58239,-12.04789,4,1,48,52,16,0,31,47
"Bolivia","Pando","Manuripi","Filadelfia","U.E. UCIA",-68.97458,-11.75343,14,5,67,81,5,0,57,62
"Bolivia","Pando","Manuripi","Filadelfia","U.E. VILLA AMERICA",-68.49368,-11.61459,14,1,93,107,44,3,45,89
"Bolivia","Pando","Manuripi","Filadelfia","U.E. VILLA BELLA",-68.72463,-11.44835,30,3,131,161,73,1,54,127
"Bolivia","Pando","Manuripi","Puerto Rico","U.E. BATRAJA",-67.32244,-11.29704,27,4,216,243,105,5,102,207
"Bolivia","Pando","Manuripi","Puerto Rico","U.E. DE LAS ARENAS",-67.69072,-11.58415,195,0,21,216,4,0,17,21
"Bolivia","Pando","Manuripi","Puerto Rico","U.E. DE PALESTINA",-67.09533,-11.03269,21,0,56,77,25,0,31,56
"Bolivia","Pando","Manuripi","Puerto Rico","U.E.  GERMAN BUSCH",-67.17651,-11.30694,0,7,396,396,151,57,181,332
"Bolivia","Pando","Manuripi","Puerto Rico","U.E. HIROSHIMA",-67.83469,-11.39288,7,0,24,31,17,1,6,23
"Bolivia","Pando","Manuripi","Puerto Rico","U.E.  LA SALLE EMETERIO RUIZ",-67.5565,-11.10394,735,18,1582,2317,735,42,787,1522
"Bolivia","Pando","Manuripi","Puerto Rico","U.E.  LOS MANDARINOS",-67.44718,-11.24423,1,2,28,29,11,2,13,24
"Bolivia","Pando","Manuripi","Puerto Rico","U.E. MANCHESTER",-67.999,-11.47539,39,0,59,98,41,0,18,59
"Bolivia","Pando","Manuripi","Puerto Rico","U.E.  SAN ANTONIO",-67.39052,-11.29652,7,0,85,92,15,3,67,82
"Bolivia","Pando","Manuripi","Puerto Rico","U.E.  SILVERIO ROJAS GONZALES",-66.75974,-11.58043,13,2,96,109,37,0,57,94
"Bolivia","Pando","Manuripi","San Pedro","U.E.  12 DE ABRIL",-66.18632,-10.82638,120,2,155,275,90,3,60,150
"Bolivia","Pando","Manuripi","San Pedro","U.E. FORTALEZA",-66.32966,-10.84701,140,0,177,317,77,1,99,176
"Bolivia","Pando","Manuripi","San Pedro","U.E.  JORGE HAENSEL",-66.44067,-10.94822,20,2,135,155,86,1,46,132
"Bolivia","Pando","Nicolás Suárez","Bella Flor","ESC. SANTA ELENA",-67.82802,-11.04349,7,0,11,18,6,0,5,11
"Bolivia","Pando","Nicolás Suárez","Bella Flor","U.E. BUENA VISTA",-67.67737,-11.09413,45,1,80,125,46,1,32,78
"Bolivia","Pando","Nicolás Suárez","Bella Flor","U.E. DE FLORIDA",-67.63081,-11.11081,5,0,18,23,1,0,17,18
"Bolivia","Pando","Nicolás Suárez","Bella Flor","U.E.  HUGO ANTEQUERA",-67.89793,-11.08514,94,4,320,414,178,9,129,307
"Bolivia","Pando","Nicolás Suárez","Bella Flor","U.E. JORGE BENITO VERA",-67.27247,-10.31881,154,2,277,431,132,7,136,268
"Bolivia","Pando","Nicolás Suárez","Bella Flor","U.E.  KM. 35 DE KARAMANU",-68.34393,-11.14225,62,5,251,313,84,6,156,240
"Bolivia","Pando","Nicolás Suárez","Bella Flor","U.E.  KM. 60 DE SAN ANTONIO",-68.09121,-11.16999,48,4,143,191,50,0,89,139
"Bolivia","Pando","Nicolás Suárez","Bella Flor","U.E. MAPAJO",-67.6199,-10.62717,30,1,69,99,32,0,36,68
"Bolivia","Pando","Nicolás Suárez","Bella Flor","U.E. SANTA LOURDES",-68.47906,-11.13931,23,0,103,126,50,2,51,101
"Bolivia","Pando","Nicolás Suárez","Bella Flor","U.E. SIMON BOLÍVAR",-67.61858,-10.90335,15,0,142,157,37,5,100,137
"Bolivia","Pando","Nicolás Suárez","Bolpebra (Mukden)","U.E. BIOCEANICA",-69.37039,-11.13272,45,1,123,168,74,1,47,121
"Bolivia","Pando","Nicolás Suárez","Bolpebra (Mukden)","U.E. DE BOLPEBRA",-69.56477,-10.94741,21,2,76,97,25,4,45,70
"Bolivia","Pando","Nicolás Suárez","Bolpebra (Mukden)","U.E. DE MUKDEN",-69.02858,-11.1877,48,3,222,270,168,6,45,213
"Bolivia","Pando","Nicolás Suárez","Bolpebra (Mukden)","U.E. DE YAMINAHUA",-69.42874,-10.93892,21,0,57,78,16,4,37,53
"Bolivia","Pando","Nicolás Suárez","Bolpebra (Mukden)","U.E.  GENOVEVA RIOS",-69.06962,-11.28025,62,3,218,280,111,3,101,212
"Bolivia","Pando","Nicolás Suárez","Bolpebra (Mukden)","U.E. NUEVA CANAÁN",-69.22169,-11.14435,49,0,74,123,26,3,45,71
"Bolivia","Pando","Nicolás Suárez","Bolpebra (Mukden)","U.E. SAN MIGUEL",-69.48006,-10.95564,4,0,12,16,0,0,12,12
"Bolivia","Pando","Nicolás Suárez","Bolpebra (Mukden)","U.E.  SANTA LUCIA",-69.01627,-11.25383,21,0,101,122,55,6,40,95
"Bolivia","Pando","Nicolás Suárez","Bolpebra (Mukden)","U.E. TRES ESTRELLAS",-69.27618,-11.33935,15,0,65,80,28,1,36,64
"Bolivia","Pando","Nicolás Suárez","Cobija","CARCEL PUBLICA (VILLA BUSCH)",-68.78143,-11.08489,37,2,131,168,61,4,64,125
"Bolivia","Pando","Nicolás Suárez","Cobija","KINDER VICTOR LEON ARUETA (VACA DIEZ MEDIO)",-68.76038,-11.02101,82,1,280,362,195,7,77,272
"Bolivia","Pando","Nicolás Suárez","Cobija","U. E. 11 DE OCTUBRE",-68.75275,-11.01869,404,10,1729,2133,1009,47,663,1672
"Bolivia","Pando","Nicolás Suárez","Cobija","U. E.  AMERICA",-68.75782,-11.01896,121,6,541,662,353,20,162,515
"Bolivia","Pando","Nicolás Suárez","Cobija","U. E. COBIJA",-68.77015,-11.03708,761,16,2513,3274,1543,61,893,2436
"Bolivia","Pando","Nicolás Suárez","Cobija","U.E. DE BELLA VISTA",-68.78143,-11.08489,184,9,920,1104,462,21,428,890
"Bolivia","Pando","Nicolás Suárez","Cobija","U.E. DEFENSORES DEL ACRE",-68.76064,-11.02505,535,21,2110,2645,1216,46,827,2043
"Bolivia","Pando","Nicolás Suárez","Cobija","U.E. GERMAN BUSCH",-67.17651,-11.30694,190,7,954,1144,543,18,386,929
"Bolivia","Pando","Nicolás Suárez","Cobija","U. E. INSTITUTO AMERICANO",-68.75738,-11.02217,161,3,694,855,454,19,218,672
"Bolivia","Pando","Nicolás Suárez","Cobija","U. E. JOSÉ MANUEL PANDO",-68.75738,-11.02217,546,28,2464,3010,1387,72,977,2364
"Bolivia","Pando","Nicolás Suárez","Cobija","U. E. JUANA AZURDUY DE PADILLA",-68.77395,-11.03823,194,1,502,696,318,8,175,493
"Bolivia","Pando","Nicolás Suárez","Cobija","U. E. MANUELA ROJAS",-68.77524,-11.03517,367,15,1822,2189,1158,57,592,1750
"Bolivia","Pando","Nicolás Suárez","Cobija","U.E. MARIANO BAPTISTA (EDIFICIO SEDUCA)",-68.7578,-11.02304,233,4,916,1149,592,44,276,868
"Bolivia","Pando","Nicolás Suárez","Cobija","U. E. MARISCAL SUCRE",-68.75624,-11.01813,615,21,2466,3081,1265,66,1114,2379
"Bolivia","Pando","Nicolás Suárez","Cobija","U.E. NUEVA ESPERANZA",-68.88235,-11.1152,16,0,84,100,53,3,28,81
"Bolivia","Pando","Nicolás Suárez","Cobija","U. E. ROGELIA MENACHO DE BALCAZAR",-68.74956,-11.01224,356,17,1672,2028,967,50,638,1605
"Bolivia","Pando","Nicolás Suárez","Cobija","U. E. SIMON BOLIVAR",-68.78709,-11.03764,170,6,1195,1365,638,33,518,1156
"Bolivia","Pando","Nicolás Suárez","Cobija","U. E. SOFIA CALPIÑEIRO",-68.75566,-11.01603,564,11,2347,2911,1518,65,753,2271
"Bolivia","Pando","Nicolás Suárez","Cobija","U. E. VACA DIEZ (INTERMEDIO)",-68.76405,-11.02211,136,156,842,978,394,19,273,667
"Bolivia","Pando","Nicolás Suárez","Cobija","U. E. VACA DIEZ (MEDIO)",-68.76039,-11.02054,166,0,576,742,379,20,177,556
"Bolivia","Pando","Nicolás Suárez","Cobija","U.E. VILLA CRUZ",-68.77383,-11.03098,595,19,2955,3550,1735,84,1117,2852
"Bolivia","Pando","Nicolás Suárez","Porvenir","U.E. BRUNO RACUA",-68.68311,-11.23532,288,9,1125,1413,462,29,625,1087
"Bolivia","Pando","Nicolás Suárez","Porvenir","U.E.  GUTEMBERT CRUZ",-68.84592,-11.22069,33,1,191,224,108,1,81,189
"Bolivia","Pando","Nicolás Suárez","Porvenir","U.E. MONS. SANTISTEBAN",-68.68311,-11.23532,264,9,953,1217,435,13,496,931
"Bolivia","Pando","Nicolás Suárez","Porvenir","U.E. VILLA BELLA",-68.724,-11.2168,95,4,584,679,245,9,326,571
"Bolivia","Potosí","Alonso de Ibáñez","Caripuyo","ESC. CATARI",-66.557,-18.152,21,0,100,121,10,5,85,95
"Bolivia","Potosí","Alonso de Ibáñez","Caripuyo","ESC. CHAICURIRI",-66.63818,-18.22252,25,1,104,129,19,1,83,102
"Bolivia","Potosí","Alonso de Ibáñez","Caripuyo","ESC. CHALVIRI",-66.51712,-18.19005,37,11,160,197,15,8,126,141
"Bolivia","Potosí","Alonso de Ibáñez","Caripuyo","ESC. CHOJLLA",-66.58522,-18.208,10,2,277,287,13,32,230,243
"Bolivia","Potosí","Alonso de Ibáñez","Caripuyo","ESC. COTANA",-66.57648,-18.09925,113,25,466,579,55,13,373,428
"Bolivia","Potosí","Alonso de Ibáñez","Caripuyo","ESC. EDUARDO AVAROA",-66.47403,-18.2329,187,65,815,1002,109,38,603,712
"Bolivia","Potosí","Alonso de Ibáñez","Caripuyo","ESC. HUANACHACA",-66.53834,-18.10201,15,3,141,156,5,2,131,136
"Bolivia","Potosí","Alonso de Ibáñez","Caripuyo","ESC. HUANACOMA",-66.49527,-18.15723,23,19,376,399,76,20,261,337
"Bolivia","Potosí","Alonso de Ibáñez","Caripuyo","ESC. JANCKO JANCKO",-66.59177,-18.17574,66,4,311,377,50,29,228,278
"Bolivia","Potosí","Alonso de Ibáñez","Caripuyo","ESC. JUNTAVI",-66.50504,-18.23312,53,7,401,454,11,11,372,383
"Bolivia","Potosí","Alonso de Ibáñez","Sacaca (Villa de Sacaca)","COL. JOSE ALONZO DE IBAÑEZ",-66.38387,-18.06966,512,52,1970,2482,779,146,993,1772
"Bolivia","Potosí","Alonso de Ibáñez","Sacaca (Villa de Sacaca)","ESC. CARCOMA",-66.31796,-17.98507,92,0,491,583,16,1,474,490
"Bolivia","Potosí","Alonso de Ibáñez","Sacaca (Villa de Sacaca)","ESC. CHARCA",-66.309,-18.29,22,3,230,252,121,6,100,221
"Bolivia","Potosí","Alonso de Ibáñez","Sacaca (Villa de Sacaca)","ESC. COLLOMA",-66.34437,-18.3256,15,3,105,120,32,5,65,97
"Bolivia","Potosí","Alonso de Ibáñez","Sacaca (Villa de Sacaca)","ESC. DE OVEJERIA",-66.23547,-18.14605,46,5,701,747,88,27,581,669
"Bolivia","Potosí","Alonso de Ibáñez","Sacaca (Villa de Sacaca)","ESC. ITURATA",-66.2449,-18.01211,27,3,260,287,18,10,229,247
"Bolivia","Potosí","Alonso de Ibáñez","Sacaca (Villa de Sacaca)","ESC. JARUMA",-66.49641,-18.05654,14,8,309,323,125,18,158,283
"Bolivia","Potosí","Alonso de Ibáñez","Sacaca (Villa de Sacaca)","ESC. LAYTOCO",-66.30727,-18.14706,21,0,276,297,4,8,264,268
"Bolivia","Potosí","Alonso de Ibáñez","Sacaca (Villa de Sacaca)","ESC. LAYUPAMPA",-66.40737,-17.99987,41,25,439,480,52,23,339,391
"Bolivia","Potosí","Alonso de Ibáñez","Sacaca (Villa de Sacaca)","ESC. SILLU SILLU",-66.46011,-18.09924,3,4,440,443,22,9,405,427
"Bolivia","Potosí","Alonso de Ibáñez","Sacaca (Villa de Sacaca)","ESC. VILA SIRCA",-66.32172,-18.34239,28,4,115,143,36,6,69,105
"Bolivia","Potosí","Alonso de Ibáñez","Sacaca (Villa de Sacaca)","ESC. VILA VILA",-66.34768,-18.15004,27,3,623,650,28,26,566,594
"Bolivia","Potosí","Alonso de Ibáñez","Sacaca (Villa de Sacaca)","SACANI",-66.18929,-18.09043,10,0,373,383,19,7,347,366
"Bolivia","Potosí","Alonso de Ibáñez","Sacaca (Villa de Sacaca)","TARHUA CHAPI",-66.40738,-18.19324,65,24,565,630,54,27,460,514
"Bolivia","Potosí","Alonso de Ibáñez","Sacaca (Villa de Sacaca)","U.E. BOLIVIA",-66.41556,-18.09067,5,2,174,179,1,9,162,163
"Bolivia","Potosí","Alonso de Ibáñez","Sacaca (Villa de Sacaca)","U.E. CAMACACHI",-66.3724,-18.11655,0,1,90,90,0,0,89,89
"Bolivia","Potosí","Alonso de Ibáñez","Sacaca (Villa de Sacaca)","U.E. JAYU JAYU",-66.37892,-18.16083,2,10,155,157,4,5,136,140
"Bolivia","Potosí","Alonso de Ibáñez","Sacaca (Villa de Sacaca)","U.E. LLAPA LLAPA",-66.3597,-18.09612,2,2,82,84,6,1,73,79
"Bolivia","Potosí","Antonio Quijarro","Porco","ESC. AGUA CASTILLA",-65.99281,-19.76802,148,16,1148,1296,844,43,245,1089
"Bolivia","Potosí","Antonio Quijarro","Porco","U.E. ANTONIO QUIJARRO DE CARMA",-65.83518,-19.78734,27,1,128,155,109,6,12,121
"Bolivia","Potosí","Antonio Quijarro","Porco","U.E. CONCEPCION DE CHAQUILLA",-66.17165,-19.915,5,0,89,94,44,1,44,88
"Bolivia","Potosí","Antonio Quijarro","Porco","U.E. GUALBERTO VILLARROEL DE CHICHUYO",-65.97169,-19.90254,22,1,113,135,62,5,45,107
"Bolivia","Potosí","Antonio Quijarro","Porco","U.E. JOSE MARIA LINARES",-65.98714,-19.79856,161,13,1042,1203,729,31,269,998
"Bolivia","Potosí","Antonio Quijarro","Porco","U.E. SAN ANTONIO DE TORCUYO",-65.79976,-19.77843,3,2,100,103,72,4,22,94
"Bolivia","Potosí","Antonio Quijarro","Porco","U.E. SAN GABRIEL DE CONDORIRI",-65.92919,-19.74775,33,1,117,150,92,1,23,115
"Bolivia","Potosí","Antonio Quijarro","Porco","U.E. SAN JOSE DE TOPALA",-65.90455,-19.80483,17,0,117,134,76,6,35,111
"Bolivia","Potosí","Antonio Quijarro","Porco","U.E. SANTA MARIA DE CHURCUITA",-65.81611,-19.84111,24,2,119,143,82,3,32,114
"Bolivia","Potosí","Antonio Quijarro","Porco","U.E. SANTA ROSA",-65.98714,-19.79856,199,23,1244,1443,841,46,334,1175
"Bolivia","Potosí","Antonio Quijarro","Tomave","COL. ELIZARDO PEREZ A",-66.31324,-20.14378,65,19,573,638,221,23,310,531
"Bolivia","Potosí","Antonio Quijarro","Tomave","COL. SIMON RODRIGUEZ CARREÑO",-66.13405,-20.04367,35,2,184,219,96,6,80,176
"Bolivia","Potosí","Antonio Quijarro","Tomave","COL. TOMAS FRIAS",-66.53149,-20.0643,129,33,438,567,224,21,160,384
"Bolivia","Potosí","Antonio Quijarro","Tomave","ESC. MARISCAL SUCRE",-66.7066,-19.74305,75,14,394,469,179,21,180,359
"Bolivia","Potosí","Antonio Quijarro","Tomave","U.E. 10 DE NOVIEMBRE",-66.5676,-20.21303,20,1,115,135,46,3,65,111
"Bolivia","Potosí","Antonio Quijarro","Tomave","U.E. 1RO. DE MAYO",-66.39316,-20.35149,27,3,142,169,60,8,71,131
"Bolivia","Potosí","Antonio Quijarro","Tomave","U.E. 31 DE OCTUBRE",-66.34953,-19.78253,14,1,128,142,77,5,45,122
"Bolivia","Potosí","Antonio Quijarro","Tomave","U.E. DANIEL CAMPOS",-66.2225,-20.26551,37,8,144,181,55,6,75,130
"Bolivia","Potosí","Antonio Quijarro","Tomave","U.E. EDUARDO ABAROA",-66.17575,-19.98652,14,3,133,147,58,5,67,125
"Bolivia","Potosí","Antonio Quijarro","Tomave","U.E. ELIZARDO PEREZ",-66.19482,-20.41101,12,1,98,110,40,4,53,93
"Bolivia","Potosí","Antonio Quijarro","Tomave","U.E. FRANZ TAMAYO",-66.16724,-20.0438,89,5,498,587,222,14,257,479
"Bolivia","Potosí","Antonio Quijarro","Tomave","U.E. FRANZ TAMAYO",-66.38166,-20.09554,89,5,498,587,222,14,257,479
"Bolivia","Potosí","Antonio Quijarro","Tomave","U.E. FRANZ TAMAYO",-66.26527,-19.82753,89,5,498,587,222,14,257,479
"Bolivia","Potosí","Antonio Quijarro","Tomave","U.E. GERMAN BUSCH",-66.04766,-20.07577,39,1,267,306,71,13,182,253
"Bolivia","Potosí","Antonio Quijarro","Tomave","U.E. GERMAN BUSCH",-66.26482,-19.89234,39,1,267,306,71,13,182,253
"Bolivia","Potosí","Antonio Quijarro","Tomave","U.E. JUANA AZURDUY DE PADILLA",-66.36832,-20.50186,7,1,35,42,14,2,18,32
"Bolivia","Potosí","Antonio Quijarro","Tomave","U.E. JULIO LAREDO",-66.17559,-20.12856,23,3,125,148,19,2,101,120
"Bolivia","Potosí","Antonio Quijarro","Tomave","U.E. MARISCAL DE AYACUCHO",-66.56905,-19.69648,43,6,115,158,63,6,40,103
"Bolivia","Potosí","Antonio Quijarro","Tomave","U.E. MARISCAL JOSE DE SUCRE",-66.12498,-20.07338,129,18,499,628,242,14,225,467
"Bolivia","Potosí","Antonio Quijarro","Tomave","U.E. RAFAEL PABON",-66.09256,-20.00132,22,4,86,108,25,5,52,77
"Bolivia","Potosí","Antonio Quijarro","Tomave","U.E. RICARDO CRUZ",-65.92126,-20.07895,67,3,164,231,47,11,103,150
"Bolivia","Potosí","Antonio Quijarro","Tomave","U.E. SIMON BOLIVAR",-66.24822,-19.90882,11,3,266,277,36,26,201,237
"Bolivia","Potosí","Antonio Quijarro","Tomave","U.E. SIMON BOLIVAR",-66.22723,-19.87498,11,3,266,277,36,26,201,237
"Bolivia","Potosí","Antonio Quijarro","Tomave","U.E. TOMAS FRIAS",-66.30714,-19.96937,27,15,191,218,78,4,94,172
"Bolivia","Potosí","Antonio Quijarro","Uyuni (Thola Pampa)","SUB SEDE UNIV. ECONOMIA",-66.82623,-20.46294,301,33,1661,1962,712,68,848,1560
"Bolivia","Potosí","Antonio Quijarro","Uyuni (Thola Pampa)","U.E.ALTO ALIANZA",-66.43998,-19.54232,4,0,36,40,23,4,9,32
"Bolivia","Potosí","Antonio Quijarro","Uyuni (Thola Pampa)","U.E. ANTONIO QUIJARRO",-66.82595,-20.45747,654,41,3074,3728,1678,139,1216,2894
"Bolivia","Potosí","Antonio Quijarro","Uyuni (Thola Pampa)","U.E. EDUARDO AVAROA",-66.85102,-20.36443,21,3,241,262,149,12,77,226
"Bolivia","Potosí","Antonio Quijarro","Uyuni (Thola Pampa)","U.E. FRANZ TAMAYO",-66.92651,-20.11757,23,4,160,183,94,11,51,145
"Bolivia","Potosí","Antonio Quijarro","Uyuni (Thola Pampa)","U.E. GERMAN BUSCH",-66.93522,-20.30083,48,4,339,387,183,13,139,322
"Bolivia","Potosí","Antonio Quijarro","Uyuni (Thola Pampa)","U.E. GUALBERTO VILLARROEL",-67.06178,-19.53462,61,10,312,373,161,28,113,274
"Bolivia","Potosí","Antonio Quijarro","Uyuni (Thola Pampa)","U.E. JAIME DE ZUDAÑES",-66.82595,-20.45747,736,45,3224,3960,1718,113,1348,3066
"Bolivia","Potosí","Antonio Quijarro","Uyuni (Thola Pampa)","U.E. JUANA AZURDUY DE PADILLA",-67.0053,-19.61859,9,1,94,103,50,2,41,91
"Bolivia","Potosí","Antonio Quijarro","Uyuni (Thola Pampa)","U.E. JUAN SANJINEZ",-67.16636,-19.68052,63,42,490,553,250,15,183,433
"Bolivia","Potosí","Antonio Quijarro","Uyuni (Thola Pampa)","U.E. KATARINA KRSUL",-66.81326,-19.52889,120,26,718,838,476,27,189,665
"Bolivia","Potosí","Antonio Quijarro","Uyuni (Thola Pampa)","U.E. MARISCAL BRAUN",-66.68245,-19.51538,31,5,316,347,137,20,154,291
"Bolivia","Potosí","Antonio Quijarro","Uyuni (Thola Pampa)","U.E. MARISCAL DE AYACUCHO",-66.3906,-20.81844,36,8,177,213,57,9,103,160
"Bolivia","Potosí","Antonio Quijarro","Uyuni (Thola Pampa)","U.E. POTOSI",-66.82595,-20.45747,233,24,1350,1583,706,71,549,1255
"Bolivia","Potosí","Antonio Quijarro","Uyuni (Thola Pampa)","U.E. PULACAYO A",-66.70123,-20.39232,34,7,219,253,105,11,96,201
"Bolivia","Potosí","Antonio Quijarro","Uyuni (Thola Pampa)","U.E. RICARDO RODRIGUEZ",-66.89848,-19.89956,52,11,279,331,126,13,129,255
"Bolivia","Potosí","Antonio Quijarro","Uyuni (Thola Pampa)","U.E. RIO MULATO",-66.77838,-19.69697,71,20,437,508,213,16,188,401
"Bolivia","Potosí","Antonio Quijarro","Uyuni (Thola Pampa)","U.E. UYUNI A",-66.81758,-20.45736,321,27,1851,2172,1044,65,715,1759
"Bolivia","Potosí","Charcas","San Pedro de Buena Vista","COLEG. NAL. CHARCAS",-65.981,-18.26995,855,167,2189,3044,517,100,1405,1922
"Bolivia","Potosí","Charcas","San Pedro de Buena Vista","ESC. ARAKANI",-65.94547,-18.44892,1,2,156,157,0,2,152,152
"Bolivia","Potosí","Charcas","San Pedro de Buena Vista","ESC. CHIRO CKASA",-66.18792,-18.26068,267,58,1164,1431,257,92,757,1014
"Bolivia","Potosí","Charcas","San Pedro de Buena Vista","ESC. IPOTE",-65.76811,-18.33076,1,0,73,74,0,1,72,72
"Bolivia","Potosí","Charcas","San Pedro de Buena Vista","ESC. MARTIN CALA",-65.68661,-18.55701,9,0,194,203,2,1,191,193
"Bolivia","Potosí","Charcas","San Pedro de Buena Vista","ESC. MOSCARI",-66.00932,-18.36224,218,11,526,744,13,4,498,511
"Bolivia","Potosí","Charcas","San Pedro de Buena Vista","ESC. ÑEQUETA",-66.21066,-18.28477,153,60,516,669,76,20,360,436
"Bolivia","Potosí","Charcas","San Pedro de Buena Vista","ESC. QUINAMARA",-65.843,-18.236,160,3,269,429,11,23,232,243
"Bolivia","Potosí","Charcas","San Pedro de Buena Vista","ESC. SAN MARCOS",-65.71427,-18.49057,105,0,617,722,5,0,612,617
"Bolivia","Potosí","Charcas","San Pedro de Buena Vista","ESC. SAPACARI",-66.24672,-18.3837,62,10,163,225,40,7,106,146
"Bolivia","Potosí","Charcas","San Pedro de Buena Vista","ESC. SECCIONAL ESKENCACHI",-66.164,-18.427,95,40,424,519,65,18,301,366
"Bolivia","Potosí","Charcas","San Pedro de Buena Vista","ESC. SORA SORA",-66.272,-18.19449,3,1,62,65,12,1,48,60
"Bolivia","Potosí","Charcas","San Pedro de Buena Vista","ESC. TORACARI",-66.13522,-18.13033,246,30,559,805,158,29,342,500
"Bolivia","Potosí","Charcas","San Pedro de Buena Vista","ESCUELA SECCIONAL COTA COTA",-66.21744,-18.34191,23,2,268,291,20,5,241,261
"Bolivia","Potosí","Charcas","San Pedro de Buena Vista","NUCLEO EDUCATIVO BANDURIRI",-66.0399,-18.15632,7,4,358,365,11,7,336,347
"Bolivia","Potosí","Charcas","San Pedro de Buena Vista","NUCLEO ESCOLAR MICANI",-65.83389,-18.3693,114,12,917,1031,13,3,889,902
"Bolivia","Potosí","Charcas","Toro Toro","ESC. PALLA PALLA",-65.52338,-18.32186,55,3,412,467,16,6,387,403
"Bolivia","Potosí","Charcas","Toro Toro","ESC. SECCIONAL",-65.77195,-18.19173,36,2,390,426,13,4,371,384
"Bolivia","Potosí","Charcas","Toro Toro","ESC. SECCIONAL AÑAHUANI",-65.64471,-18.23354,64,9,350,414,17,7,317,334
"Bolivia","Potosí","Charcas","Toro Toro","ESC. SECCIONAL CARASI",-65.68874,-18.31779,142,7,453,595,39,12,395,434
"Bolivia","Potosí","Charcas","Toro Toro","ESC. TORO TORO",-65.79198,-18.02429,451,37,1814,2265,347,77,1353,1700
"Bolivia","Potosí","Charcas","Toro Toro","ESC. TORO TORO",-65.76296,-18.13375,451,37,1814,2265,347,77,1353,1700
"Bolivia","Potosí","Charcas","Toro Toro","ESC. YAMBATA",-65.91856,-18.05247,61,3,282,343,25,8,246,271
"Bolivia","Potosí","Charcas","Toro Toro","NUCLEO POCO SUCO",-65.73625,-18.25639,49,4,257,306,11,6,236,247
"Bolivia","Potosí","Chayanta","Colquechaca","COLEG. TOMAS CATARI",-66.0375,-18.8177,642,157,1752,2394,211,131,1253,1464
"Bolivia","Potosí","Chayanta","Colquechaca","ESC. AYOMA",-66.14678,-18.86896,185,45,452,637,69,28,310,379
"Bolivia","Potosí","Chayanta","Colquechaca","ESC. CENTRAL ULUCHI",-66.14444,-18.95846,166,47,864,1030,150,65,602,752
"Bolivia","Potosí","Chayanta","Colquechaca","ESC. GUADALUPE",-65.79741,-18.69036,143,4,555,698,21,2,528,549
"Bolivia","Potosí","Chayanta","Colquechaca","ESC. GUALBERTO VILLARROEL TITIRI",-65.97601,-18.97547,31,3,145,176,7,6,129,136
"Bolivia","Potosí","Chayanta","Colquechaca","ESC. JACINTO PINTO DE PHUTINA",-66.21133,-18.83524,207,13,637,844,88,19,517,605
"Bolivia","Potosí","Chayanta","Colquechaca","ESC. JAIME MENDOZA",-66.20398,-18.9043,69,8,674,743,66,95,505,571
"Bolivia","Potosí","Chayanta","Colquechaca","ESC. JAMANCHIRI",-65.8834,-18.70837,29,3,141,170,5,13,120,125
"Bolivia","Potosí","Chayanta","Colquechaca","ESC. JUNIN",-66.00296,-18.69715,269,44,893,1162,355,84,410,765
"Bolivia","Potosí","Chayanta","Colquechaca","ESC. MARCELO QUIRVES",-66.05211,-18.97724,110,50,338,448,69,39,180,249
"Bolivia","Potosí","Chayanta","Colquechaca","ESC. MEJILLONES DE CAYARANI",-65.94516,-18.74131,32,2,279,311,17,47,213,230
"Bolivia","Potosí","Chayanta","Colquechaca","ESC. ROSARIO",-65.97795,-18.77202,59,26,418,477,41,17,334,375
"Bolivia","Potosí","Chayanta","Colquechaca","ESC. SALINAS",-66.11065,-19.01487,69,28,711,780,101,33,549,650
"Bolivia","Potosí","Chayanta","Colquechaca","ESC. S.BOLIVAR CHOQUECAYARA",-66.23908,-18.92873,35,19,208,243,46,22,121,167
"Bolivia","Potosí","Chayanta","Colquechaca","ESC. SECCIONAL SALINAS DE MACHA",-66.11683,-18.9747,41,0,150,191,22,11,117,139
"Bolivia","Potosí","Chayanta","Colquechaca","OFIC. CORREGIMIENTO",-65.84781,-18.56566,231,17,484,715,37,11,419,456
"Bolivia","Potosí","Chayanta","Colquechaca","TOMAYCURI",-65.90958,-18.85932,153,26,508,661,118,26,338,456
"Bolivia","Potosí","Chayanta","Colquechaca","U.E. AYACUCHO DE SICUTA",-65.80147,-18.59073,19,6,238,257,4,6,222,226
"Bolivia","Potosí","Chayanta","Colquechaca","U.E. MILLURI",-66.15628,-18.90602,4,1,100,104,14,10,75,89
"Bolivia","Potosí","Chayanta","Colquechaca","U.E. ROBERTO ALVARADO",-66.0021,-18.70359,235,50,881,1116,414,68,349,763
"Bolivia","Potosí","Chayanta","Ocurí","COLEGIO DANIEL SALAMANCA",-65.79628,-18.8428,338,62,843,1181,256,60,465,721
"Bolivia","Potosí","Chayanta","Ocurí","COL. NAC. MARCELO QUIROGA SANTA CRUZ",-65.79628,-18.8428,364,40,850,1214,226,91,493,719
"Bolivia","Potosí","Chayanta","Ocurí","ESC. KARA KARA",-65.70093,-18.81138,102,33,337,439,84,21,199,283
"Bolivia","Potosí","Chayanta","Ocurí","ESC. MARAGUA",-65.77851,-18.95468,268,32,515,783,171,59,253,424
"Bolivia","Potosí","Chayanta","Ocurí","ESC ROCO ROCO",-65.84806,-18.79057,17,2,84,101,8,4,70,78
"Bolivia","Potosí","Chayanta","Ocurí","ESC. SECCIONAL MARCOMA",-65.65381,-18.95084,87,22,326,413,90,19,195,285
"Bolivia","Potosí","Chayanta","Ocurí","ESC. SIMON BOLIVAR DE PEANA",-65.785,-18.719,54,6,366,420,31,16,313,344
"Bolivia","Potosí","Chayanta","Ocurí","ESC. YURIMATA",-65.69332,-18.93946,63,18,237,300,55,13,151,206
"Bolivia","Potosí","Chayanta","Ocurí","U.E. CHAUPI LOMA",-65.77997,-19.00577,3,2,65,68,15,11,37,52
"Bolivia","Potosí","Chayanta","Ocurí","U.E. COLLPA",-65.82913,-18.99837,10,13,158,168,25,7,113,138
"Bolivia","Potosí","Chayanta","Pocoata","ESC. ACHACANA",-66.15985,-18.5925,100,2,465,565,12,18,433,445
"Bolivia","Potosí","Chayanta","Pocoata","ESC. CACHUYO",-66.04868,-18.71111,39,17,260,299,39,14,190,229
"Bolivia","Potosí","Chayanta","Pocoata","ESC. CAMPAYA",-66.30963,-18.75883,68,12,1019,1087,84,12,911,995
"Bolivia","Potosí","Chayanta","Pocoata","ESC. CENTRAL JACHATAJO",-66.07078,-18.51748,67,17,231,298,11,8,195,206
"Bolivia","Potosí","Chayanta","Pocoata","ESC. CENTRAL VILLA ALCARAPI",-66.28011,-18.8248,19,0,329,348,16,12,301,317
"Bolivia","Potosí","Chayanta","Pocoata","ESC. CHAYALA",-66.04488,-18.53314,164,6,291,455,22,5,258,280
"Bolivia","Potosí","Chayanta","Pocoata","ESC. COLLANA TUICA",-66.20734,-18.60429,29,12,373,402,17,7,337,354
"Bolivia","Potosí","Chayanta","Pocoata","ESC. COLLPA CKASA",-66.118,-18.49396,36,4,235,271,40,7,184,224
"Bolivia","Potosí","Chayanta","Pocoata","ESC. HUANCARANI",-66.13522,-18.73722,146,56,638,784,133,34,415,548
"Bolivia","Potosí","Chayanta","Pocoata","ESC. JARANA",-66.12551,-18.6998,65,27,342,407,54,20,241,295
"Bolivia","Potosí","Chayanta","Pocoata","ESC. KAPARANCHO",-66.06309,-18.63861,19,7,126,145,19,7,93,112
"Bolivia","Potosí","Chayanta","Pocoata","ESC.PACOTANCA",-66.25257,-18.74593,33,2,97,130,6,0,89,95
"Bolivia","Potosí","Chayanta","Pocoata","ESC. PEDRO GUTIERREZ",-66.1626,-18.69938,484,118,1818,2302,559,146,995,1554
"Bolivia","Potosí","Chayanta","Pocoata","ESC. SAN MIGUEL DE KARI",-66.26031,-18.59378,3,3,385,388,42,14,326,368
"Bolivia","Potosí","Chayanta","Pocoata","ESC. SAYI",-66.22854,-18.75826,4,0,174,178,5,12,157,162
"Bolivia","Potosí","Chayanta","Pocoata","ESC. SECCIONAL SENAJO",-66.14663,-18.49398,16,5,77,93,30,4,38,68
"Bolivia","Potosí","Chayanta","Pocoata","ESC. SECCIONAL TURBERIA",-66.07927,-18.6298,118,18,531,649,47,59,407,454
"Bolivia","Potosí","Chayanta","Pocoata","ESC SECCIONAL YAHUACO",-66.02201,-18.5216,14,5,83,97,13,10,55,68
"Bolivia","Potosí","Chayanta","Pocoata","ESC. TOMOYO",-66.134,-18.463,41,1,187,228,34,5,147,181
"Bolivia","Potosí","Chayanta","Pocoata","ESC. VILA VILA",-66.27483,-18.82087,10,3,323,333,26,6,288,314
"Bolivia","Potosí","Chayanta","Pocoata","NUCLEO ESCOLAR JUAN DE ARROZ PATA",-66.17729,-18.4751,8,5,104,112,25,7,67,92
"Bolivia","Potosí","Chayanta","Pocoata","NUCLEO ESCOLAR KESIMPUCU",-66.05427,-18.56416,13,27,399,412,73,33,266,339
"Bolivia","Potosí","Chayanta","Ravelo","COL. JOSE ALONSO DE IBAÑEZ",-65.60184,-18.87419,28,27,252,280,21,9,195,216
"Bolivia","Potosí","Chayanta","Ravelo","ESC. ANTORA",-65.64693,-18.75318,72,21,278,350,52,30,175,227
"Bolivia","Potosí","Chayanta","Ravelo","ESC. CENTRAL 1º DE MAYO",-65.67611,-18.87961,78,9,235,313,36,19,171,207
"Bolivia","Potosí","Chayanta","Ravelo","ESC. CENTRAL RODEO HUAYLLAS",-65.59853,-18.7994,107,36,358,465,67,14,241,308
"Bolivia","Potosí","Chayanta","Ravelo","ESC. CENTRAL SAUCY MAYU",-65.55036,-18.78822,65,20,359,424,59,17,263,322
"Bolivia","Potosí","Chayanta","Ravelo","ESC. CHALLUMA",-65.54932,-18.85223,9,8,119,128,12,6,93,105
"Bolivia","Potosí","Chayanta","Ravelo","ESC. CHIPIRINA",-65.4499,-18.80882,23,1,101,124,19,10,71,90
"Bolivia","Potosí","Chayanta","Ravelo","ESC. HUAYCOMA",-65.48942,-18.58409,75,23,189,264,34,19,113,147
"Bolivia","Potosí","Chayanta","Ravelo","ESC. LACAYANI",-65.57085,-18.71785,52,30,271,323,37,14,190,227
"Bolivia","Potosí","Chayanta","Ravelo","ESC. LAMPHASUNI",-65.43322,-18.60605,18,1,116,134,7,9,99,106
"Bolivia","Potosí","Chayanta","Ravelo","ESC. M. ASCENCIO PADILLA",-65.50803,-18.80719,378,54,1383,1761,459,96,774,1233
"Bolivia","Potosí","Chayanta","Ravelo","ESC. MOROTO",-65.51731,-18.72289,13,9,77,90,2,4,62,64
"Bolivia","Potosí","Chayanta","Ravelo","ESC. PITANTORA",-65.6319,-18.70022,99,5,266,365,14,20,227,241
"Bolivia","Potosí","Chayanta","Ravelo","ESC. SASANTA",-65.48589,-18.85652,35,3,243,278,52,13,175,227
"Bolivia","Potosí","Chayanta","Ravelo","ESC. SECCIONAL MOKO KOTANI",-65.55286,-18.6043,65,14,132,197,7,5,106,113
"Bolivia","Potosí","Chayanta","Ravelo","ESC. SECCIONAL MOLLE MOLLE",-65.5581,-18.99458,68,52,444,512,55,19,318,373
"Bolivia","Potosí","Chayanta","Ravelo","ESC. SECC. LUQUI PAMPA",-65.71329,-18.71529,44,5,98,142,19,17,57,76
"Bolivia","Potosí","Chayanta","Ravelo","ESC. SECC TEJA MOLINO",-65.56034,-18.51546,71,1,151,222,21,11,118,139
"Bolivia","Potosí","Chayanta","Ravelo","ESC. S. YURUBAMBA",-65.45452,-18.86363,56,20,340,396,71,17,232,303
"Bolivia","Potosí","Chayanta","Ravelo","ESC. TOMOYO",-65.58306,-18.92324,76,38,316,392,50,27,201,251
"Bolivia","Potosí","Chayanta","Ravelo","TOROCA",-65.49248,-18.66342,22,2,146,168,6,7,131,137
"Bolivia","Potosí","Chayanta","Ravelo","U.E. JANINA",-65.67776,-18.77756,20,4,199,219,75,14,106,181
"Bolivia","Potosí","Cornelio Saavedra","Betanzos","CENTRAL ELIZARDO PEREZ",-66.42453,-18.54064,89,16,368,457,74,19,259,333
"Bolivia","Potosí","Cornelio Saavedra","Betanzos","COLEG. R. BOHORQUEZ",-65.44724,-19.55169,334,54,1686,2020,865,95,672,1537
"Bolivia","Potosí","Cornelio Saavedra","Betanzos","ESC. ALONZO DE IBAÑEZ",-65.45937,-19.3632,65,11,395,460,90,12,282,372
"Bolivia","Potosí","Cornelio Saavedra","Betanzos","ESC. ANCO MAYU",-65.26953,-19.413,16,0,70,86,3,1,66,69
"Bolivia","Potosí","Cornelio Saavedra","Betanzos","ESC. BLAS S. DE PEDRO",-65.27425,-19.36944,35,1,110,145,25,9,75,100
"Bolivia","Potosí","Cornelio Saavedra","Betanzos","ESC. BUEY TAMBO",-65.33926,-19.56878,74,7,312,386,93,22,190,283
"Bolivia","Potosí","Cornelio Saavedra","Betanzos","ESC. CAMALI",-65.00764,-19.49642,84,17,443,527,54,15,357,411
"Bolivia","Potosí","Cornelio Saavedra","Betanzos","ESC. CENTRAL OTUYO",-65.23023,-19.48659,82,13,295,377,49,8,225,274
"Bolivia","Potosí","Cornelio Saavedra","Betanzos","ESC. CENTRAL TECOYA",-65.4239,-19.50207,302,112,1167,1469,243,57,755,998
"Bolivia","Potosí","Cornelio Saavedra","Betanzos","ESC. CENTRAL VILA VILA",-65.33044,-19.34779,94,6,376,470,70,37,263,333
"Bolivia","Potosí","Cornelio Saavedra","Betanzos","ESC. DE HUANO HUANO",-64.985,-19.61366,48,10,125,173,27,8,80,107
"Bolivia","Potosí","Cornelio Saavedra","Betanzos","ESC. DE MAMAHOTA",-65.48484,-19.48434,36,12,238,274,27,6,193,220
"Bolivia","Potosí","Cornelio Saavedra","Betanzos","ESC. DE MARIACA",-65.35322,-19.41788,67,12,240,307,19,8,201,220
"Bolivia","Potosí","Cornelio Saavedra","Betanzos","ESC. ELIZARDO PEREZ",-65.3391,-19.44707,38,15,182,220,37,7,123,160
"Bolivia","Potosí","Cornelio Saavedra","Betanzos","ESC. GERMAN BUSH",-65.54766,-19.82024,47,8,340,387,151,26,155,306
"Bolivia","Potosí","Cornelio Saavedra","Betanzos","ESC. MEDIA LUNA",-64.77518,-19.76643,16,0,70,86,4,2,64,68
"Bolivia","Potosí","Cornelio Saavedra","Betanzos","ESC. MODESTO OMISTE",-65.44724,-19.55169,347,41,1391,1738,664,70,616,1280
"Bolivia","Potosí","Cornelio Saavedra","Betanzos","ESC. POCO POCO",-65.01298,-19.36994,139,8,527,666,109,20,390,499
"Bolivia","Potosí","Cornelio Saavedra","Betanzos","ESC. POTOBAMBA",-65.3583,-19.2998,58,0,241,299,21,2,218,239
"Bolivia","Potosí","Cornelio Saavedra","Betanzos","ESC. POTONGO ALTO",-65.24026,-19.39199,9,0,65,74,0,2,63,63
"Bolivia","Potosí","Cornelio Saavedra","Betanzos","ESC. SECCIONAL DE SAN PEDRO DE COLILA",-65.12701,-19.44642,21,1,132,153,8,2,121,129
"Bolivia","Potosí","Cornelio Saavedra","Betanzos","ESC. TARIJA CUCHU",-65.33474,-19.49068,66,17,317,383,67,21,212,279
"Bolivia","Potosí","Cornelio Saavedra","Betanzos","ESC. TAURI CANCHA",-65.31977,-19.59806,203,60,1079,1282,541,55,423,964
"Bolivia","Potosí","Cornelio Saavedra","Betanzos","ESC. TIRISPAYA",-65.40837,-19.27494,45,2,229,274,2,12,213,215
"Bolivia","Potosí","Cornelio Saavedra","Betanzos","ESC. TRAPICHE ALTA",-65.5425,-19.42349,20,1,144,164,66,3,74,140
"Bolivia","Potosí","Cornelio Saavedra","Betanzos","ESC. TROJA PAMPA",-64.96799,-19.44878,21,8,189,210,11,6,164,175
"Bolivia","Potosí","Cornelio Saavedra","Betanzos","ESC. UNZAGA DE LA VEGA",-65.18517,-19.4238,71,7,515,586,128,22,358,486
"Bolivia","Potosí","Cornelio Saavedra","Betanzos","ESC. URIFAYA",-64.92088,-19.48255,4,1,235,239,12,2,220,232
"Bolivia","Potosí","Cornelio Saavedra","Betanzos","ESC. VILLA IMPERIAL",-65.37331,-19.54539,84,49,314,398,56,13,196,252
"Bolivia","Potosí","Cornelio Saavedra","Betanzos","ESC. VIÑA QUEMADA",-64.85901,-19.42301,15,9,102,117,26,6,61,87
"Bolivia","Potosí","Cornelio Saavedra","Betanzos","KINDER VILLA IMPERIAL",-65.44724,-19.55169,162,42,949,1111,381,65,461,842
"Bolivia","Potosí","Cornelio Saavedra","Chaquí","COL. VILLA IMPERIAL",-65.57073,-19.62471,140,30,512,652,232,72,178,410
"Bolivia","Potosí","Cornelio Saavedra","Chaquí","ESC. ANDRES DE SANTA CRUZ",-65.56108,-19.58838,306,52,1152,1458,563,97,440,1003
"Bolivia","Potosí","Cornelio Saavedra","Chaquí","ESC. C. CHIUTALUYO",-65.51266,-19.63994,135,37,351,486,137,63,114,251
"Bolivia","Potosí","Cornelio Saavedra","Chaquí","ESC. CENTRAL EL PALOMAR",-65.41072,-19.65163,57,5,169,226,28,6,130,158
"Bolivia","Potosí","Cornelio Saavedra","Chaquí","ESC. CHARCA FLORIDA",-65.41967,-19.71643,34,1,103,137,26,4,72,98
"Bolivia","Potosí","Cornelio Saavedra","Chaquí","ESC. CHICO CHICO",-65.53385,-19.67762,130,41,320,450,72,23,184,256
"Bolivia","Potosí","Cornelio Saavedra","Chaquí","ESC. DON DIEGO",-65.60049,-19.50195,66,13,469,535,311,29,116,427
"Bolivia","Potosí","Cornelio Saavedra","Chaquí","ESC. RODERO",-65.51254,-19.56043,34,11,166,200,70,14,71,141
"Bolivia","Potosí","Cornelio Saavedra","Chaquí","ESC. SAN ANTONIO",-65.44303,-19.60513,90,13,228,318,95,16,104,199
"Bolivia","Potosí","Cornelio Saavedra","Tacobamba","COL. GUALBERTO VILLARROEL",-65.54424,-19.31846,46,8,213,259,133,17,55,188
"Bolivia","Potosí","Cornelio Saavedra","Tacobamba","ESC. ANCOMA",-65.63528,-19.13348,58,2,258,316,20,0,236,256
"Bolivia","Potosí","Cornelio Saavedra","Tacobamba","ESC. CAJAS ALTA",-65.63494,-19.29129,60,0,163,223,74,14,75,149
"Bolivia","Potosí","Cornelio Saavedra","Tacobamba","ESC. CENTRAL MACHACAMARCA",-65.54421,-19.37108,10,0,55,65,32,4,19,51
"Bolivia","Potosí","Cornelio Saavedra","Tacobamba","ESC. CHALLVIRI",-65.63294,-19.32677,47,5,210,257,116,14,75,191
"Bolivia","Potosí","Cornelio Saavedra","Tacobamba","ESC. C. MIGMA",-65.65115,-19.21268,95,13,197,292,84,16,84,168
"Bolivia","Potosí","Cornelio Saavedra","Tacobamba","ESC. GENOVEVA RIOS",-65.54977,-19.32013,57,16,221,278,90,5,110,200
"Bolivia","Potosí","Cornelio Saavedra","Tacobamba","ESC. HUAJCHI BAJO",-65.58374,-19.20394,38,1,67,105,17,3,46,63
"Bolivia","Potosí","Cornelio Saavedra","Tacobamba","ESC. JURUNA",-65.426,-19.219,50,5,284,334,21,10,248,269
"Bolivia","Potosí","Cornelio Saavedra","Tacobamba","ESC. RODEO",-65.58909,-19.07606,70,2,182,252,16,12,152,168
"Bolivia","Potosí","Cornelio Saavedra","Tacobamba","ESC. SECCIONAL TRAPICHE BAJO",-65.53699,-19.41847,12,1,69,81,26,4,38,64
"Bolivia","Potosí","Cornelio Saavedra","Tacobamba","ESC. SIMON BOLIVAR",-65.54227,-19.34671,22,2,44,66,21,3,18,39
"Bolivia","Potosí","Cornelio Saavedra","Tacobamba","ESC. TACOBAMBA",-65.55141,-19.20102,264,64,550,814,131,32,323,454
"Bolivia","Potosí","Cornelio Saavedra","Tacobamba","ESC. YAGUACARI",-65.60043,-19.04875,20,2,86,106,20,3,61,81
"Bolivia","Potosí","Cornelio Saavedra","Tacobamba","UNID. EDU. FRANZ TAMAYO",-65.44989,-19.16096,37,2,266,303,16,6,242,258
"Bolivia","Potosí","Daniel Campos","Llica","U.E. BERNABE LEDEZMA",-68.29847,-19.99556,13,0,66,79,8,1,57,65
"Bolivia","Potosí","Daniel Campos","Llica","U.E. CANQUELLA",-68.2532,-20.08167,14,0,65,79,19,0,46,65
"Bolivia","Potosí","Daniel Campos","Llica","U.E. ELIZARDO PEREZ",-68.10056,-19.62237,4,1,54,58,6,2,45,51
"Bolivia","Potosí","Daniel Campos","Llica","U.E. FRANZ TAMAYO",-68.2407,-19.86069,240,14,1053,1293,326,24,689,1015
"Bolivia","Potosí","Daniel Campos","Llica","U.E. HUANAQUE",-68.33338,-20.01662,24,4,89,113,13,0,72,85
"Bolivia","Potosí","Daniel Campos","Llica","U.E. MANUAL ANTONIO AGUIRRE",-68.30267,-20.11507,23,1,70,93,10,1,58,68
"Bolivia","Potosí","Daniel Campos","Llica","U.E. PALAYA",-68.13572,-19.80343,15,3,95,110,16,1,75,91
"Bolivia","Potosí","Daniel Campos","Llica","U.E. PEDRO GARCIA IGNACIO",-68.48859,-19.71477,16,3,62,78,19,0,40,59
"Bolivia","Potosí","Daniel Campos","Llica","U.E. VILLQUE",-68.10628,-19.66033,3,1,33,36,4,0,28,32
"Bolivia","Potosí","Daniel Campos","Tahua","ESC. JARUMA",-67.945,-19.77135,9,0,24,33,1,0,23,24
"Bolivia","Potosí","Daniel Campos","Tahua","ESC. TAMANCASA",-68.00201,-19.72284,5,0,27,32,5,2,20,25
"Bolivia","Potosí","Daniel Campos","Tahua","U.E. ANICETO ARCE",-67.9101,-19.7663,2,0,20,22,3,0,17,20
"Bolivia","Potosí","Daniel Campos","Tahua","U.E. BERNABE LEDEZMA",-67.80781,-19.82589,7,4,60,67,6,0,50,56
"Bolivia","Potosí","Daniel Campos","Tahua","U.E. CAQUENA",-67.76733,-19.84044,17,1,78,95,34,3,40,74
"Bolivia","Potosí","Daniel Campos","Tahua","U.E. FRANZ TAMAYO",-68.02673,-20.63319,1,2,120,121,37,1,80,117
"Bolivia","Potosí","Daniel Campos","Tahua","U.E. GERMAN BUSCH",-67.66147,-19.91329,4,0,35,39,10,1,24,34
"Bolivia","Potosí","Daniel Campos","Tahua","U.E. JOHN F. KENNEDY",-67.69619,-19.891,30,5,178,208,35,5,133,168
"Bolivia","Potosí","Enrique Baldivieso","San Agustín","ESC. SAN AGUSTIN",-67.6795,-21.1566,67,6,223,290,70,6,141,211
"Bolivia","Potosí","Enrique Baldivieso","San Agustín","ESC. VICTOR PAZ ESTENSORO",-67.35812,-21.51948,10,0,132,142,40,3,89,129
"Bolivia","Potosí","Enrique Baldivieso","San Agustín","U.E. 1RO DE MAYO",-67.23789,-21.70214,4,0,89,93,8,0,81,89
"Bolivia","Potosí","Enrique Baldivieso","San Agustín","U.E. ELIZARDO PEREZ",-67.18568,-21.72287,10,1,78,88,15,1,61,76
"Bolivia","Potosí","Enrique Baldivieso","San Agustín","U.E. LITORAL",-67.59641,-21.40281,36,4,223,259,109,5,105,214
"Bolivia","Potosí","General Bernardino B","Acacio","ESC. CHURITACA",-65.98965,-18.1063,78,7,417,495,12,9,389,401
"Bolivia","Potosí","General Bernardino B","Acacio","ESC. JOSE RIVERO",-66.05407,-18.02672,206,21,746,952,223,27,475,698
"Bolivia","Potosí","General Bernardino B","Acacio","ESC. PIRIQUINA",-66.01617,-18.0789,49,9,233,282,15,4,205,220
"Bolivia","Potosí","General Bernardino B","Acacio","ESC. TACONI DE CAINE",-66.00538,-17.94402,14,2,81,95,9,0,70,79
"Bolivia","Potosí","General Bernardino B","Acacio","ESC. TACONI YAMBATA",-65.94917,-18.04741,72,5,165,237,1,2,157,158
"Bolivia","Potosí","General Bernardino B","Acacio","ESC. TUQUIZA",-66.00704,-18.02213,41,11,208,249,15,5,177,192
"Bolivia","Potosí","General Bernardino B","Arampampa","ESC. ARAMPAMPA",-66.08163,-17.87692,50,14,225,275,54,27,130,184
"Bolivia","Potosí","General Bernardino B","Arampampa","ESC. CALACHUA",-66.12383,-17.98363,17,0,121,138,2,2,117,119
"Bolivia","Potosí","General Bernardino B","Arampampa","ESC. CATACORA",-66.15216,-17.94774,43,1,94,137,5,0,88,93
"Bolivia","Potosí","General Bernardino B","Arampampa","ESC. CHARCA MARCAVI",-66.04567,-17.92901,7,0,51,58,0,2,49,49
"Bolivia","Potosí","General Bernardino B","Arampampa","ESC. HUAYCURI",-66.10529,-17.85553,7,0,28,35,3,0,25,28
"Bolivia","Potosí","General Bernardino B","Arampampa","ESC. HUMAVIZA",-66.03617,-17.88659,4,1,16,20,4,2,9,13
"Bolivia","Potosí","General Bernardino B","Arampampa","ESC. MOLLEVILQUE",-66.10755,-17.84728,7,0,42,49,3,1,38,41
"Bolivia","Potosí","General Bernardino B","Arampampa","ESC. PARARANI",-66.105,-17.919,8,0,58,66,0,0,58,58
"Bolivia","Potosí","General Bernardino B","Arampampa","ESC. QOARACA",-66.17999,-18.0151,1,0,95,96,2,3,90,92
"Bolivia","Potosí","General Bernardino B","Arampampa","ESC. SANTIAGO",-66.19445,-17.99237,88,5,366,454,23,8,330,353
"Bolivia","Potosí","General Bernardino B","Arampampa","ESC. SARCURI",-66.08449,-17.94726,37,2,201,238,0,1,198,198
"Bolivia","Potosí","José María Linares","Caiza","COL. FRANZ TAMAYO",-65.69497,-19.88101,64,17,502,566,318,23,144,462
"Bolivia","Potosí","José María Linares","Caiza","ESC.DE KALTAPI",-65.55387,-20.01271,20,2,123,143,60,3,58,118
"Bolivia","Potosí","José María Linares","Caiza","ESC.DE PANOCOCHI",-65.6757,-20.1773,47,3,145,192,15,9,118,133
"Bolivia","Potosí","José María Linares","Caiza","ESC.HORNOS",-65.48529,-19.90132,92,5,253,345,67,14,167,234
"Bolivia","Potosí","José María Linares","Caiza","ESC. LA FRAGUA",-65.61447,-20.2052,29,4,154,183,18,9,123,141
"Bolivia","Potosí","José María Linares","Caiza","ESC.LA LAVA",-65.64637,-19.8947,79,15,372,451,134,21,202,336
"Bolivia","Potosí","José María Linares","Caiza","ESC. PALCA CANCHA",-65.56768,-19.94123,31,0,74,105,29,2,43,72
"Bolivia","Potosí","José María Linares","Caiza","ESC. SECCIONAL CHILLMA",-65.72665,-19.93593,58,15,309,367,156,23,115,271
"Bolivia","Potosí","José María Linares","Caiza","ESC. TRES CRUCES",-65.5471,-19.87114,253,40,801,1054,299,44,418,717
"Bolivia","Potosí","José María Linares","Caiza","ESC.TUCTAPARI",-65.53459,-20.04247,34,10,210,244,116,10,74,190
"Bolivia","Potosí","José María Linares","Caiza","NORMAL RURAL CAIZA D",-65.65247,-20.00772,212,28,953,1165,475,31,419,894
"Bolivia","Potosí","José María Linares","Ckochas","ESC. ALEJANDRO CORONADO",-65.14595,-19.67983,21,0,167,188,43,19,105,148
"Bolivia","Potosí","José María Linares","Ckochas","ESC. CENTRAL EUSEBIO B. FLORES",-64.83906,-19.61541,47,18,238,285,32,9,179,211
"Bolivia","Potosí","José María Linares","Ckochas","ESC.CKOCHAS",-65.2905,-19.63276,152,26,698,850,265,39,368,633
"Bolivia","Potosí","José María Linares","Ckochas","ESC.DE CALAPAYA",-65.206,-19.756,74,22,182,256,54,6,100,154
"Bolivia","Potosí","José María Linares","Ckochas","ESC.DE MELENA ALTA",-65.14054,-19.64427,37,4,221,258,55,7,155,210
"Bolivia","Potosí","José María Linares","Ckochas","ESC.DE MOJON CKASA",-64.9791,-19.75853,115,7,349,464,60,11,271,331
"Bolivia","Potosí","José María Linares","Ckochas","ESC.DE QUELUYO",-65.1904,-19.8398,128,8,297,425,61,24,204,265
"Bolivia","Potosí","José María Linares","Ckochas","ESC.DURAZNOS",-64.98342,-19.66648,56,4,240,296,54,12,170,224
"Bolivia","Potosí","José María Linares","Ckochas","ESC.ESQUIRI",-65.219,-19.64303,15,1,72,87,37,4,30,67
"Bolivia","Potosí","José María Linares","Ckochas","ESC.JOSE MA.LINARES",-64.94132,-19.81973,46,2,140,186,41,7,90,131
"Bolivia","Potosí","José María Linares","Ckochas","ESC. LAJAS",-64.91263,-19.58851,16,0,152,168,2,0,150,152
"Bolivia","Potosí","José María Linares","Ckochas","ESC. MEDIA LUNA",-64.77805,-19.76315,20,4,255,275,7,4,240,247
"Bolivia","Potosí","José María Linares","Ckochas","ESC. RODEO PAMPA",-64.81729,-19.81045,1,1,75,76,5,0,69,74
"Bolivia","Potosí","José María Linares","Ckochas","ESC. SAN PEDRO DE ESQUIRI",-65.19585,-19.5817,14,1,63,77,22,0,40,62
"Bolivia","Potosí","José María Linares","Ckochas","ESC.SECCIONAL",-64.83231,-19.83634,215,9,538,753,29,19,481,510
"Bolivia","Potosí","José María Linares","Ckochas","ESC. SECCIONAL CAPILLANI",-65.16954,-19.93791,35,3,104,139,33,7,61,94
"Bolivia","Potosí","José María Linares","Ckochas","ESC. SECCIONAL HUAYLLAJARA",-64.92155,-19.6202,35,3,141,176,21,3,114,135
"Bolivia","Potosí","José María Linares","Ckochas","ESC. SECCIONAL UYUNI",-65.12721,-19.85135,58,2,132,190,25,3,102,127
"Bolivia","Potosí","José María Linares","Ckochas","ESC. SEUCOCHI",-64.86348,-19.90878,111,13,339,450,32,14,280,312
"Bolivia","Potosí","José María Linares","Ckochas","ESC. SUCHINA",-65.24477,-19.72506,29,1,83,112,15,2,65,80
"Bolivia","Potosí","José María Linares","Ckochas","SECC. CARPA HUATA",-65.086,-19.586,19,1,59,78,12,2,44,56
"Bolivia","Potosí","José María Linares","Puna (Villa Talavera)","COLEG.LITORAL",-65.50571,-19.79494,223,50,819,1042,396,55,318,714
"Bolivia","Potosí","José María Linares","Puna (Villa Talavera)","ESC.BELEN",-65.54243,-19.86561,88,26,307,395,118,19,144,262
"Bolivia","Potosí","José María Linares","Puna (Villa Talavera)","ESC.CENTRAL",-65.52189,-19.49838,49,2,195,244,84,14,95,179
"Bolivia","Potosí","José María Linares","Puna (Villa Talavera)","ESC. CENTRAL JOSE MARIA LINARES",-65.30202,-19.6668,43,4,340,383,119,13,204,323
"Bolivia","Potosí","José María Linares","Puna (Villa Talavera)","ESC.DE ALCATUYO",-65.564,-19.86951,106,7,324,430,180,15,122,302
"Bolivia","Potosí","José María Linares","Puna (Villa Talavera)","ESC.DE HUAYCAYA",-65.61684,-19.8672,52,9,193,245,127,3,54,181
"Bolivia","Potosí","José María Linares","Puna (Villa Talavera)","ESC.DE KEPALLO",-65.31073,-19.90731,172,8,418,590,127,14,269,396
"Bolivia","Potosí","José María Linares","Puna (Villa Talavera)","ESC.DE LA ESMERALDA",-65.30669,-19.68868,77,30,307,384,125,13,139,264
"Bolivia","Potosí","José María Linares","Puna (Villa Talavera)","ESC.DE NUQUI",-65.30702,-19.97297,87,3,221,308,77,5,136,213
"Bolivia","Potosí","José María Linares","Puna (Villa Talavera)","ESC.DE SUQUICHA",-65.28864,-19.82753,117,7,266,383,111,16,132,243
"Bolivia","Potosí","José María Linares","Puna (Villa Talavera)","ESC. G.MALDINI CHACABUCO",-65.34591,-19.65162,49,6,301,350,124,16,155,279
"Bolivia","Potosí","José María Linares","Puna (Villa Talavera)","ESC.INCHASI",-65.47024,-19.7256,31,5,68,99,17,8,38,55
"Bolivia","Potosí","José María Linares","Puna (Villa Talavera)","ESC.JOSE MA. LINARES",-65.37317,-19.75613,123,4,315,438,89,16,206,295
"Bolivia","Potosí","José María Linares","Puna (Villa Talavera)","ESC.JOSE MARIA LINARES",-65.50571,-19.79494,195,53,871,1066,435,71,312,747
"Bolivia","Potosí","José María Linares","Puna (Villa Talavera)","ESC.MARAZA",-65.35992,-19.68579,43,22,174,217,60,7,85,145
"Bolivia","Potosí","José María Linares","Puna (Villa Talavera)","ESC. MOJONA",-65.33739,-20.07207,72,7,233,305,44,8,174,218
"Bolivia","Potosí","José María Linares","Puna (Villa Talavera)","ESC. SAN LORENZO",-65.32391,-19.80195,78,24,202,280,77,10,91,168
"Bolivia","Potosí","José María Linares","Puna (Villa Talavera)","ESC. SECCIONAL PAMPA TAMBO",-65.35207,-19.97996,54,4,125,179,43,5,73,116
"Bolivia","Potosí","José María Linares","Puna (Villa Talavera)","ESC.SEPULTURAS",-65.59354,-19.86297,82,25,300,382,118,18,139,257
"Bolivia","Potosí","José María Linares","Puna (Villa Talavera)","ESC.SIMON BOLIVAR",-65.33378,-20.05038,213,15,568,781,153,19,381,534
"Bolivia","Potosí","José María Linares","Puna (Villa Talavera)","ESC. TOMAS FRIAS",-65.51495,-19.7167,189,42,458,647,89,41,286,375
"Bolivia","Potosí","José María Linares","Puna (Villa Talavera)","ESC. TURQUIÑA",-65.26543,-19.7833,55,11,113,168,57,5,40,97
"Bolivia","Potosí","José María Linares","Puna (Villa Talavera)","ESC.VILACAYA",-65.48064,-19.99248,108,5,285,393,122,22,136,258
"Bolivia","Potosí","José María Linares","Puna (Villa Talavera)","ESC.YASPACI",-65.44774,-19.89478,66,2,174,240,59,6,107,166
"Bolivia","Potosí","José María Linares","Puna (Villa Talavera)","UNID. VILAMANI",-65.40481,-19.95643,38,4,142,180,40,6,92,132
"Bolivia","Potosí","Modesto Omiste","Villazón","COLEG. FRANZ TAMAYO",-65.81631,-21.80585,64,5,226,290,43,6,172,215
"Bolivia","Potosí","Modesto Omiste","Villazón","COLEGIO 9 DE ABRIL",-65.59546,-22.09029,712,61,2350,3062,1008,98,1183,2191
"Bolivia","Potosí","Modesto Omiste","Villazón","COL MARISCAL ANDRES DE SANTA CRUZ",-65.48156,-21.95128,17,5,130,147,28,5,92,120
"Bolivia","Potosí","Modesto Omiste","Villazón","COL.MODESTO OMISTE",-65.5955,-22.09031,587,24,1715,2302,859,63,769,1628
"Bolivia","Potosí","Modesto Omiste","Villazón","ESC. BERQUE",-65.78044,-21.94482,56,5,155,211,11,9,130,141
"Bolivia","Potosí","Modesto Omiste","Villazón","ESC. CORNELIO SAAVEDRA",-65.59546,-22.09029,818,44,2770,3588,1274,117,1335,2609
"Bolivia","Potosí","Modesto Omiste","Villazón","ESC. DANIEL CAMPOS",-65.59546,-22.09029,611,77,2640,3251,841,173,1549,2390
"Bolivia","Potosí","Modesto Omiste","Villazón","ESC. LIZARDO PEREZ",-65.51073,-21.91479,32,9,178,210,46,10,113,159
"Bolivia","Potosí","Modesto Omiste","Villazón","ESC. MAX FERNANDEZ",-65.59546,-22.09029,543,53,1897,2440,690,118,1036,1726
"Bolivia","Potosí","Modesto Omiste","Villazón","ESC. MORAYA",-65.54895,-21.74982,37,2,146,183,23,9,112,135
"Bolivia","Potosí","Modesto Omiste","Villazón","ESC. SALITRE",-65.34576,-22.02467,33,1,136,169,22,15,98,120
"Bolivia","Potosí","Modesto Omiste","Villazón","ESC. SAN PEDRO DE SOCOCHA",-65.45055,-21.93332,66,2,168,234,21,5,140,161
"Bolivia","Potosí","Modesto Omiste","Villazón","ESC. SARCARI",-66.02132,-21.91025,37,3,70,107,11,3,53,64
"Bolivia","Potosí","Modesto Omiste","Villazón","ESC. SARGENTO M. PAREDES",-65.87511,-21.95138,56,1,187,243,16,4,166,182
"Bolivia","Potosí","Modesto Omiste","Villazón","ESC. SECCIONAL CHAGUA",-65.80781,-21.88188,71,1,191,262,34,9,147,181
"Bolivia","Potosí","Modesto Omiste","Villazón","ESC. SECCIONAL SELOCHA",-65.48174,-21.80499,30,2,96,126,8,2,84,92
"Bolivia","Potosí","Modesto Omiste","Villazón","ESC. SECCIONAL SOCOCHA",-65.48177,-22.00244,93,14,166,259,19,10,123,142
"Bolivia","Potosí","Modesto Omiste","Villazón","ESC. YURUMA",-65.57485,-21.69375,38,2,209,247,62,10,135,197
"Bolivia","Potosí","Modesto Omiste","Villazón","NUCLEO DE MOJO",-65.55168,-21.83154,40,2,153,193,38,8,105,143
"Bolivia","Potosí","Modesto Omiste","Villazón","U.E. CALDERILLA",-65.58203,-21.71236,0,2,74,74,6,1,65,71
"Bolivia","Potosí","Modesto Omiste","Villazón","U.E.CUARTOS",-65.56418,-21.99242,1,0,27,28,6,1,20,26
"Bolivia","Potosí","Modesto Omiste","Villazón","U.E. MANTACILLAS",-65.59058,-22.06434,10,16,249,259,67,19,147,214
"Bolivia","Potosí","Modesto Omiste","Villazón","U.E. MONSEÑOR FELIX GAINZA",-65.56264,-21.73403,4,0,81,85,15,4,62,77
"Bolivia","Potosí","Modesto Omiste","Villazón","U.E. OJO DE AGUA",-65.61392,-22.08941,0,2,53,53,5,2,44,49
"Bolivia","Potosí","Modesto Omiste","Villazón","UN. ED. 1RO DE MAYO",-65.59546,-22.09029,999,107,4246,5245,1384,208,2547,3931
"Bolivia","Potosí","Modesto Omiste","Villazón","UN. ED. ALONSO DE IBAÑEZ",-65.59546,-22.09029,1085,73,2868,3953,950,184,1661,2611
"Bolivia","Potosí","Nor Chichas","Cotagaita","COLEG. CARLOS MEDINACELI",-65.66064,-20.8168,230,38,1159,1389,468,41,612,1080
"Bolivia","Potosí","Nor Chichas","Cotagaita","U.E. 2 DE ABRIL",-65.61977,-20.49149,31,4,145,176,50,2,89,139
"Bolivia","Potosí","Nor Chichas","Cotagaita","U.E. 6 DE JUNIO",-65.55482,-20.86805,27,2,236,263,30,5,199,229
"Bolivia","Potosí","Nor Chichas","Cotagaita","U.E. ASCANTY",-65.69196,-20.93444,24,11,234,258,19,4,200,219
"Bolivia","Potosí","Nor Chichas","Cotagaita","U.E. CARLOS MEDINACELI DE TASNA ROSARIO",-66.17947,-20.67462,182,16,841,1023,236,44,545,781
"Bolivia","Potosí","Nor Chichas","Cotagaita","U.E. CERRO COLORADO",-65.41893,-20.59675,9,0,49,58,2,0,47,49
"Bolivia","Potosí","Nor Chichas","Cotagaita","U.E. CHATI",-65.63601,-20.4317,39,1,123,162,27,10,85,112
"Bolivia","Potosí","Nor Chichas","Cotagaita","U.E. CHUI CHUI",-65.4746,-20.73512,29,0,59,88,3,2,54,57
"Bolivia","Potosí","Nor Chichas","Cotagaita","U.E. COLLPA UNO",-65.56855,-20.92512,22,3,231,253,65,1,162,227
"Bolivia","Potosí","Nor Chichas","Cotagaita","U.E. CORNACA",-65.57293,-21.06026,33,1,192,225,39,4,148,187
"Bolivia","Potosí","Nor Chichas","Cotagaita","U.E. COTAGAITILLA",-65.76016,-20.80183,49,7,252,301,34,15,196,230
"Bolivia","Potosí","Nor Chichas","Cotagaita","U.E. ELIZARDO PEREZ DE SAN JORGE",-65.72311,-20.26165,39,1,74,113,7,7,59,66
"Bolivia","Potosí","Nor Chichas","Cotagaita","U.E. EL MANZANAL",-65.5703,-21.10514,15,4,75,90,12,1,58,70
"Bolivia","Potosí","Nor Chichas","Cotagaita","U.E. EL PORVENIR A DE TOTORA I",-65.7318,-20.95282,194,22,614,808,148,18,426,574
"Bolivia","Potosí","Nor Chichas","Cotagaita","U.E. EL RANCHO",-65.43662,-20.66881,10,1,66,76,9,0,56,65
"Bolivia","Potosí","Nor Chichas","Cotagaita","U.E. JOSE ALONZO DE IBAÑEZ",-66.20502,-20.73754,63,6,354,417,117,19,212,329
"Bolivia","Potosí","Nor Chichas","Cotagaita","U.E. LAYTAPI",-65.61054,-20.99541,5,4,140,145,6,3,127,133
"Bolivia","Potosí","Nor Chichas","Cotagaita","U.E. MANUEL JOSE CORTEZ",-65.66064,-20.8168,220,21,1009,1229,404,45,539,943
"Bolivia","Potosí","Nor Chichas","Cotagaita","U.E. MARISCAL SUCRE",-65.69301,-20.41956,147,10,324,471,71,4,239,310
"Bolivia","Potosí","Nor Chichas","Cotagaita","U.E. MARTIN PRIMERO DE URUPALCA",-65.85529,-20.18545,47,0,84,131,27,1,56,83
"Bolivia","Potosí","Nor Chichas","Cotagaita","U.E. MOCKO PATA",-65.833,-20.729,15,0,169,184,10,5,154,164
"Bolivia","Potosí","Nor Chichas","Cotagaita","U.E. PAMPA GRANDE I",-65.39799,-20.70718,20,2,108,128,17,0,89,106
"Bolivia","Potosí","Nor Chichas","Cotagaita","U.E. PEDRO DOMINGO MURILLO DE SAGRARIO",-66.01643,-20.90559,53,8,326,379,65,14,239,304
"Bolivia","Potosí","Nor Chichas","Cotagaita","U.E. QUECHISLA",-66.11058,-20.87414,13,1,33,46,7,2,23,30
"Bolivia","Potosí","Nor Chichas","Cotagaita","U.E. RAMADAS",-65.63293,-21.08755,21,11,147,168,30,1,105,135
"Bolivia","Potosí","Nor Chichas","Cotagaita","U.E. SAN LORENZO",-65.40493,-20.75586,20,0,83,103,6,0,77,83
"Bolivia","Potosí","Nor Chichas","Cotagaita","U.E. SAN PEDRO DE CHECOCHI",-65.83663,-20.22395,43,1,102,145,31,4,66,97
"Bolivia","Potosí","Nor Chichas","Cotagaita","U.E. SANTIAGO WRIGHT",-65.70607,-20.62816,64,10,359,423,65,29,255,320
"Bolivia","Potosí","Nor Chichas","Cotagaita","U.E. SIMON BOLIVAR A DE TOROPALCA",-65.728,-20.329,228,28,555,783,119,16,392,511
"Bolivia","Potosí","Nor Chichas","Cotagaita","U.E. TAPCHIQUIRA",-65.79283,-20.41512,27,2,98,125,15,7,74,89
"Bolivia","Potosí","Nor Chichas","Cotagaita","U.E. TUPAC KATARI",-65.67236,-20.91708,87,6,194,281,20,3,165,185
"Bolivia","Potosí","Nor Chichas","Cotagaita","U.E. VILLA CONCEPCION",-65.567,-20.968,64,0,119,183,5,2,112,117
"Bolivia","Potosí","Nor Chichas","Cotagaita","U.E. VILLA IMPERIAL DE VICHACLA",-65.59898,-20.63377,40,9,208,248,34,15,150,184
"Bolivia","Potosí","Nor Chichas","Cotagaita","U.E. VILLA SAN LORENZO",-65.81915,-21.01485,46,1,195,241,8,2,184,192
"Bolivia","Potosí","Nor Chichas","Vitichi","U.E. ARA",-65.49908,-20.52345,84,10,223,307,70,10,133,203
"Bolivia","Potosí","Nor Chichas","Vitichi","U.E. AYOMA BAJA",-65.34461,-20.14421,65,7,180,245,17,4,152,169
"Bolivia","Potosí","Nor Chichas","Vitichi","U.E. CALCHA",-65.4649,-20.36904,180,45,415,595,119,25,226,345
"Bolivia","Potosí","Nor Chichas","Vitichi","U.E. ESTUMILLA",-65.40064,-20.5226,29,3,158,187,23,3,129,152
"Bolivia","Potosí","Nor Chichas","Vitichi","U.E. FRAY ANGELLO STELLINI DE CALVI",-65.35645,-20.34421,105,19,278,383,34,6,219,253
"Bolivia","Potosí","Nor Chichas","Vitichi","U.E. JUAN PELLEGRINI",-65.38126,-20.24069,177,38,508,685,86,7,377,463
"Bolivia","Potosí","Nor Chichas","Vitichi","U.E. MANUEL MORA DE PECKAJSI",-65.388,-20.354,85,0,256,341,20,11,225,245
"Bolivia","Potosí","Nor Chichas","Vitichi","U.E. PRIMO MARTINEZ",-65.49222,-20.55351,19,2,117,136,52,3,60,112
"Bolivia","Potosí","Nor Chichas","Vitichi","U.E. PULAXI",-65.51803,-20.55417,14,2,32,46,13,2,15,28
"Bolivia","Potosí","Nor Chichas","Vitichi","U.E. SAN MIGUEL DE TUSQUIÑA",-65.32579,-20.28519,72,9,483,555,95,7,372,467
"Bolivia","Potosí","Nor Chichas","Vitichi","U.E. TOMAS FRIAS",-65.49218,-20.20666,343,60,904,1247,348,34,462,810
"Bolivia","Potosí","Nor Lípez","Colcha K (Villa Martín)","ESC. ANTOFAGASTA",-67.76271,-20.89953,44,6,213,257,108,5,94,202
"Bolivia","Potosí","Nor Lípez","Colcha K (Villa Martín)","ESC. SANTIAGO",-67.1608,-21.64687,27,6,121,148,64,8,43,107
"Bolivia","Potosí","Nor Lípez","Colcha K (Villa Martín)","ESC. TOMAS FRIAS",-67.68085,-20.58681,3,0,93,96,40,0,53,93
"Bolivia","Potosí","Nor Lípez","Colcha K (Villa Martín)","U.E. 2 DE AGOSTO",-67.9187,-21.21596,27,6,195,222,84,7,98,182
"Bolivia","Potosí","Nor Lípez","Colcha K (Villa Martín)","U.E. ALFONZO IBAÑES",-67.70047,-20.62012,10,0,56,66,13,1,42,55
"Bolivia","Potosí","Nor Lípez","Colcha K (Villa Martín)","U.E. ANTOFAGASTA",-67.34248,-21.83394,35,2,241,276,107,5,127,234
"Bolivia","Potosí","Nor Lípez","Colcha K (Villa Martín)","U.E. BUENAS NUEVAS DE VINTO K",-67.02643,-20.68222,24,5,218,242,62,5,146,208
"Bolivia","Potosí","Nor Lípez","Colcha K (Villa Martín)","U.E. EDUARDO ABAROA",-67.66145,-20.73985,271,10,797,1068,329,25,433,762
"Bolivia","Potosí","Nor Lípez","Colcha K (Villa Martín)","U.E. EDUARDO ABAROA",-67.22194,-21.25105,271,10,797,1068,329,25,433,762
"Bolivia","Potosí","Nor Lípez","Colcha K (Villa Martín)","U.E. EDUARDO ABAROA DE VILLA MAR",-67.48146,-21.75496,42,12,182,224,64,4,102,166
"Bolivia","Potosí","Nor Lípez","Colcha K (Villa Martín)","U.E. HENRY LAREDO",-67.56828,-20.91416,11,0,38,49,17,0,21,38
"Bolivia","Potosí","Nor Lípez","Colcha K (Villa Martín)","U.E. JOSE BALLIVIAN",-66.3466,-18.14842,20,2,213,233,59,1,151,210
"Bolivia","Potosí","Nor Lípez","Colcha K (Villa Martín)","U.E. JUANA AZURDUY",-67.6095,-20.59178,2,3,33,35,15,1,14,29
"Bolivia","Potosí","Nor Lípez","Colcha K (Villa Martín)","U.E. LADISLAO CABRERA",-66.54451,-21.06077,30,2,122,152,25,8,87,112
"Bolivia","Potosí","Nor Lípez","Colcha K (Villa Martín)","U.E. LITORAL",-67.53351,-21.04118,38,0,96,134,33,2,61,94
"Bolivia","Potosí","Nor Lípez","Colcha K (Villa Martín)","U.E. LUIS ESPINAL",-67.63012,-20.57336,0,0,57,57,7,1,49,56
"Bolivia","Potosí","Nor Lípez","Colcha K (Villa Martín)","U.E. NUEVO AMANECER",-67.29654,-20.82078,88,6,354,442,141,6,201,342
"Bolivia","Potosí","Nor Lípez","Colcha K (Villa Martín)","U.E. RICARDO RODRIGUEZ",-67.17109,-21.16474,223,23,1485,1708,468,50,944,1412
"Bolivia","Potosí","Nor Lípez","Colcha K (Villa Martín)","U.E. SIMON BOLIVAR",-66.56165,-21.23029,50,4,208,258,58,13,133,191
"Bolivia","Potosí","Nor Lípez","Colcha K (Villa Martín)","U.E. TOMAS FRIAS",-66.79474,-21.20591,36,2,196,232,55,10,129,184
"Bolivia","Potosí","Nor Lípez","San Pedro de Quemes","U.E. CECILIO VELIZ",-68.04866,-20.74629,55,2,227,282,93,1,131,224
"Bolivia","Potosí","Nor Lípez","San Pedro de Quemes","U.E. CORNELIO SAAVEDRA",-68.03695,-20.94468,20,1,42,62,8,0,33,41
"Bolivia","Potosí","Nor Lípez","San Pedro de Quemes","U.E. EDUARDO ABAROA",-68.21673,-21.19829,1,0,12,13,3,0,9,12
"Bolivia","Potosí","Nor Lípez","San Pedro de Quemes","U.E.LADISLAO CABRERA",-68.34213,-21.01003,5,0,25,30,20,0,5,25
"Bolivia","Potosí","Rafael Bustillo","Chayanta","ESC. COCAFAYA",-66.37881,-18.50657,34,5,344,378,62,10,267,329
"Bolivia","Potosí","Rafael Bustillo","Chayanta","ESC. COPANA",-66.35302,-18.23664,16,27,352,368,34,13,278,312
"Bolivia","Potosí","Rafael Bustillo","Chayanta","ESC. MANCO CAPAC",-66.30493,-18.52878,23,22,329,352,40,9,258,298
"Bolivia","Potosí","Rafael Bustillo","Chayanta","ESC. MCAL. SANTA CRUZ",-66.44352,-18.46028,263,67,1688,1951,664,77,880,1544
"Bolivia","Potosí","Rafael Bustillo","Chayanta","ESC. OCTAVIO MURILLO",-66.38741,-18.48727,53,36,750,803,282,36,396,678
"Bolivia","Potosí","Rafael Bustillo","Chayanta","ESC. PHUSUTA PAMPA",-66.23933,-18.47786,13,7,120,133,13,11,89,102
"Bolivia","Potosí","Rafael Bustillo","Chayanta","ESC. PICHATA",-66.39987,-18.40766,30,0,284,314,24,7,253,277
"Bolivia","Potosí","Rafael Bustillo","Chayanta","ESC. QUINTA PAMPA",-66.32737,-18.23514,55,8,327,382,15,13,291,306
"Bolivia","Potosí","Rafael Bustillo","Chayanta","ESC. RAFAEL PABON",-66.46142,-18.44868,68,20,486,554,169,34,263,432
"Bolivia","Potosí","Rafael Bustillo","Chayanta","NUCLEO ESCOLAR",-66.28407,-18.42465,61,28,231,292,92,14,97,189
"Bolivia","Potosí","Rafael Bustillo","Chayanta","NUCLEO ESCOLAR IRUPATA",-66.37756,-18.29441,166,66,924,1090,117,43,698,815
"Bolivia","Potosí","Rafael Bustillo","Chayanta","NUCLEO ESCOLAR NUEVA COLCHA",-66.26283,-18.54489,43,0,277,320,13,12,252,265
"Bolivia","Potosí","Rafael Bustillo","Chayanta","NUCLEO ESCOLAR RIO VERDE (QUILA QUILA)",-66.30909,-18.37211,19,8,187,206,70,4,105,175
"Bolivia","Potosí","Rafael Bustillo","Chuquihuta","COL. PABLO ZARATE VILLCA",-66.36883,-18.59564,286,101,1568,1854,526,127,814,1340
"Bolivia","Potosí","Rafael Bustillo","Chuquihuta","ESC. LULUNI",-66.41494,-18.66807,41,59,284,325,40,17,168,208
"Bolivia","Potosí","Rafael Bustillo","Chuquihuta","ESC. TACOPALCA",-66.33701,-18.641,222,52,923,1145,240,103,528,768
"Bolivia","Potosí","Rafael Bustillo","Llallagua","COLEG. 1RO. DE MAYO",-66.58627,-18.42284,553,104,3722,4275,1973,182,1463,3436
"Bolivia","Potosí","Rafael Bustillo","Llallagua","COLEG. JUNIN",-66.58627,-18.42284,342,69,2250,2592,986,166,1029,2015
"Bolivia","Potosí","Rafael Bustillo","Llallagua","COLEG. SIGLO XX-AMERICA",-66.58627,-18.42284,562,67,3368,3930,1690,164,1447,3137
"Bolivia","Potosí","Rafael Bustillo","Llallagua","ESC. 6 DE JUNIO",-66.58627,-18.42284,227,47,1161,1388,537,83,494,1031
"Bolivia","Potosí","Rafael Bustillo","Llallagua","ESC. BARTOLINA SISA",-66.66508,-18.34604,50,34,503,553,130,37,302,432
"Bolivia","Potosí","Rafael Bustillo","Llallagua","ESC. CAPUNITA",-66.48626,-18.40959,47,6,279,326,67,16,190,257
"Bolivia","Potosí","Rafael Bustillo","Llallagua","ESC. CARLOS MEDINACELI",-66.58627,-18.42284,279,53,2121,2400,1133,106,829,1962
"Bolivia","Potosí","Rafael Bustillo","Llallagua","ESC. CHIRU CHIRU",-66.43234,-18.28475,14,3,207,221,21,9,174,195
"Bolivia","Potosí","Rafael Bustillo","Llallagua","ESC. JAIME MENDOZA",-66.58627,-18.42284,401,65,3191,3592,1809,148,1169,2978
"Bolivia","Potosí","Rafael Bustillo","Llallagua","ESC. UYUNI",-66.82401,-20.45792,24,0,318,342,16,37,265,281
"Bolivia","Potosí","Rafael Bustillo","Llallagua","HUMANISTICO LLALLAGUA",-66.58627,-18.42284,422,73,2559,2981,1343,152,991,2334
"Bolivia","Potosí","Rafael Bustillo","Llallagua","MARTIN CARDENAS",-66.58627,-18.42284,358,96,2566,2924,1036,215,1219,2255
"Bolivia","Potosí","Rafael Bustillo","Llallagua","NUCLEO JISK'ANQUI",-66.55359,-18.32512,20,21,253,273,106,11,115,221
"Bolivia","Potosí","Rafael Bustillo","Uncía","CÁRCEL SAN MIGUEL DE UNCÍA",-66.56538,-18.46565,7,1,29,36,15,0,13,28
"Bolivia","Potosí","Rafael Bustillo","Uncía","CHILCA PALCA",-66.48528,-18.62824,82,33,384,466,93,49,209,302
"Bolivia","Potosí","Rafael Bustillo","Uncía","COLEG. RAFAEL BUSTILLO",-66.56538,-18.46565,466,77,2251,2717,1085,97,992,2077
"Bolivia","Potosí","Rafael Bustillo","Uncía","COL. INTERMEDIO INDEPENDENCIA",-66.56538,-18.46565,276,72,1938,2214,1068,136,662,1730
"Bolivia","Potosí","Rafael Bustillo","Uncía","ESC. CHOCO CHICO",-66.56693,-18.66152,17,7,91,108,57,5,22,79
"Bolivia","Potosí","Rafael Bustillo","Uncía","ESC. HUACUTA A",-66.57107,-18.59737,20,10,123,143,62,5,46,108
"Bolivia","Potosí","Rafael Bustillo","Uncía","ESC. JUANA AZURDUY DE PADILLA",-66.56538,-18.46565,272,60,1759,2031,826,94,779,1605
"Bolivia","Potosí","Rafael Bustillo","Uncía","ESC. MODESTO OMISTE",-66.56538,-18.46565,162,35,1160,1322,707,45,373,1080
"Bolivia","Potosí","Rafael Bustillo","Uncía","ESC. MOROCOMARCA",-66.529,-18.674,116,29,334,450,80,28,197,277
"Bolivia","Potosí","Rafael Bustillo","Uncía","ESC. SUBCENTRAL LAGUNILLAS",-66.41483,-18.5441,46,18,337,383,57,19,243,300
"Bolivia","Potosí","Rafael Bustillo","Uncía","NUCLEO ESCOLAR CALA CALA",-66.48356,-18.52519,109,35,991,1100,173,48,735,908
"Bolivia","Potosí","Sur Chichas","Atocha","COL. CHOROLQUE",-66.0516,-20.92446,145,28,1092,1237,316,50,698,1014
"Bolivia","Potosí","Sur Chichas","Atocha","COLEG. GREGORIO PACHECO",-66.22056,-20.93593,181,20,751,932,293,33,405,698
"Bolivia","Potosí","Sur Chichas","Atocha","ESC. CHOCAYA",-66.3306,-20.97412,14,1,72,86,10,4,57,67
"Bolivia","Potosí","Sur Chichas","Atocha","ESC. CHOROLQUE VIEJO",-66.06475,-21.01707,4,0,12,16,2,0,10,12
"Bolivia","Potosí","Sur Chichas","Atocha","ESC. DE ANIMAS",-66.30733,-20.96173,83,20,677,760,312,15,330,642
"Bolivia","Potosí","Sur Chichas","Atocha","ESC. DE SIETE SUYOS",-66.29662,-20.9496,91,16,527,618,176,23,312,488
"Bolivia","Potosí","Sur Chichas","Atocha","ESC. DE TACMARI",-66.06282,-21.08223,0,0,21,21,3,1,17,20
"Bolivia","Potosí","Sur Chichas","Atocha","ESC. EDUARDO AVAROA",-66.22056,-20.93593,123,20,606,729,213,35,338,551
"Bolivia","Potosí","Sur Chichas","Atocha","ESC. GUADALUPE",-65.79517,-18.69062,17,0,46,63,9,3,34,43
"Bolivia","Potosí","Sur Chichas","Atocha","ESC. JULIO URQUIETA",-66.31551,-21.26756,94,12,473,567,137,26,298,435
"Bolivia","Potosí","Sur Chichas","Atocha","ESC. PORTUGALETE",-66.14603,-21.16817,50,8,310,360,74,13,215,289
"Bolivia","Potosí","Sur Chichas","Atocha","UNIDAD EDUCATIVA TELAMAYU",-66.22509,-20.94718,84,5,369,453,122,13,229,351
"Bolivia","Potosí","Sur Chichas","Tupiza","CÁRCEL TUPIZA",-65.72643,-21.4452,1,0,27,28,11,0,16,27
"Bolivia","Potosí","Sur Chichas","Tupiza","COLEGIO ANTOFAGASTA",-65.72643,-21.4452,364,38,1879,2243,788,83,970,1758
"Bolivia","Potosí","Sur Chichas","Tupiza","COL. NAL. MIXTO CHICHAS",-65.6029,-21.18405,22,6,107,129,9,5,87,96
"Bolivia","Potosí","Sur Chichas","Tupiza","EL MOLINO",-65.49464,-21.74079,13,0,58,71,11,1,46,57
"Bolivia","Potosí","Sur Chichas","Tupiza","ESC. CHACO PAMPA",-65.77544,-21.51714,69,7,283,352,46,10,220,266
"Bolivia","Potosí","Sur Chichas","Tupiza","ESC. CHIFLOCA",-65.79998,-21.48615,13,3,95,108,36,5,51,87
"Bolivia","Potosí","Sur Chichas","Tupiza","ESC. CHILLCO",-66.10437,-21.40515,28,4,104,132,29,8,63,92
"Bolivia","Potosí","Sur Chichas","Tupiza","ESC. CHUQUI",-66.17671,-21.72463,12,1,42,54,3,2,36,39
"Bolivia","Potosí","Sur Chichas","Tupiza","ESC. CHUQUIAGO",-65.64294,-21.56561,60,9,225,285,37,9,170,207
"Bolivia","Potosí","Sur Chichas","Tupiza","ESC. CONCEPCION",-66.12894,-21.69586,2,0,12,14,1,0,11,12
"Bolivia","Potosí","Sur Chichas","Tupiza","ESC. DE ALMONA",-65.78484,-21.17253,23,10,118,141,21,2,85,106
"Bolivia","Potosí","Sur Chichas","Tupiza","ESC. DE MOCHARA",-65.59682,-21.27156,25,5,218,243,14,5,194,208
"Bolivia","Potosí","Sur Chichas","Tupiza","ESC. DE OPLOCA",-65.80829,-21.33162,68,17,365,433,94,32,222,316
"Bolivia","Potosí","Sur Chichas","Tupiza","ESC. DE RIO BLANCO",-65.59937,-21.14781,33,0,125,158,10,6,109,119
"Bolivia","Potosí","Sur Chichas","Tupiza","ESC. DE SALO",-65.78109,-21.24509,32,7,183,215,28,4,144,172
"Bolivia","Potosí","Sur Chichas","Tupiza","ESC. DE SAN MIGUEL",-65.75484,-21.3053,28,1,121,149,21,7,92,113
"Bolivia","Potosí","Sur Chichas","Tupiza","ESC. ESMORACA",-66.22615,-21.6957,20,6,202,222,64,5,127,191
"Bolivia","Potosí","Sur Chichas","Tupiza","ESC. ESPICAYA",-65.79379,-21.58842,32,2,165,197,32,7,124,156
"Bolivia","Potosí","Sur Chichas","Tupiza","ESC. ESTARCA",-65.95553,-21.66106,22,0,138,160,21,1,116,137
"Bolivia","Potosí","Sur Chichas","Tupiza","ESC. HUARIRACA",-65.98829,-21.71672,5,1,33,38,5,0,27,32
"Bolivia","Potosí","Sur Chichas","Tupiza","ESC. KUCHU",-66.01013,-21.51916,11,1,54,65,11,1,41,52
"Bolivia","Potosí","Sur Chichas","Tupiza","ESC. MIXTA 7 DE NOVIEMBRE",-65.72643,-21.4452,415,23,2101,2516,1080,80,918,1998
"Bolivia","Potosí","Sur Chichas","Tupiza","ESC. NAZARENO",-65.58674,-21.60765,50,15,251,301,40,11,185,225
"Bolivia","Potosí","Sur Chichas","Tupiza","ESC. ORO INGENIO",-65.96437,-21.31153,13,1,44,57,7,5,31,38
"Bolivia","Potosí","Sur Chichas","Tupiza","ESC. REYNECILLA",-65.2538,-21.58071,45,0,113,158,19,4,90,109
"Bolivia","Potosí","Sur Chichas","Tupiza","ESC. SAN JOSE PAMPA GRANDE",-65.81684,-21.67879,52,15,178,230,14,7,142,156
"Bolivia","Potosí","Sur Chichas","Tupiza","ESC. SANTO DOMINCO",-66.10701,-21.56706,8,0,19,27,2,0,17,19
"Bolivia","Potosí","Sur Chichas","Tupiza","ESC. SECCIONAL",-65.30436,-21.69688,31,1,128,159,18,8,101,119
"Bolivia","Potosí","Sur Chichas","Tupiza","ESC. SUIPACHA",-65.60592,-21.57154,178,29,560,738,155,37,339,494
"Bolivia","Potosí","Sur Chichas","Tupiza","ESC. SUPIRA",-65.52016,-21.59575,31,6,148,179,40,15,87,127
"Bolivia","Potosí","Sur Chichas","Tupiza","ESC. TALINA",-65.82471,-21.74855,47,8,129,176,10,2,109,119
"Bolivia","Potosí","Sur Chichas","Tupiza","ESC. TAPAXA",-65.9848,-21.61774,15,4,96,111,13,5,74,87
"Bolivia","Potosí","Sur Chichas","Tupiza","ESC. TITIHOYO",-65.75745,-21.5398,8,1,78,86,10,6,61,71
"Bolivia","Potosí","Sur Chichas","Tupiza","ESC. TOCLOCA",-65.68027,-21.51474,74,11,285,359,57,10,207,264
"Bolivia","Potosí","Sur Chichas","Tupiza","ESC. VILLA FATIMA ANDRES DE SANTA CRUZ",-65.72643,-21.4452,330,63,1990,2320,775,115,1037,1812
"Bolivia","Potosí","Sur Chichas","Tupiza","ESC. ZAPATERA",-66.18834,-21.62791,5,0,33,38,9,0,24,33
"Bolivia","Potosí","Sur Chichas","Tupiza","INSTITUTO SAN JUAN",-65.72643,-21.4452,468,37,2402,2870,1277,102,986,2263
"Bolivia","Potosí","Sur Chichas","Tupiza","KINDER REMEDIOS",-65.72643,-21.4452,738,87,3803,4541,1206,200,2310,3516
"Bolivia","Potosí","Sur Chichas","Tupiza","NUCLEO ESCOLAR QUIRIZA",-65.79105,-21.61311,45,10,223,268,28,2,183,211
"Bolivia","Potosí","Sur Chichas","Tupiza","U.E. G. BERRIOS",-65.72643,-21.4452,22,5,137,159,39,5,88,127
"Bolivia","Potosí","Sur Chichas","Tupiza","U.E. NACIONAL 6 DE JUNIO",-65.58966,-21.57787,19,13,280,299,70,33,164,234
"Bolivia","Potosí","Sur Chichas","Tupiza","U.E. P. HARRIS",-65.72643,-21.4452,16,7,157,173,37,15,98,135
"Bolivia","Potosí","Sur Chichas","Tupiza","U.E. TOMATAS",-65.63572,-21.54967,11,4,115,126,20,13,78,98
"Bolivia","Potosí","Sur Chichas","Tupiza","UNIDAD EDUCATIVA RITA ROMANO",-65.72643,-21.4452,296,40,1575,1871,586,98,851,1437
"Bolivia","Potosí","Sur Chichas","Tupiza","UNIDAD EDUCATIVA TUPIZA B",-65.72643,-21.4452,337,30,1464,1801,493,78,863,1356
"Bolivia","Potosí","Sur Chichas","Tupiza","VETERINARIA SUB SEDE UATF",-65.72643,-21.4452,199,29,1070,1269,460,53,528,988
"Bolivia","Potosí","Sur Lípez","Mojinete","ESC. BONETE PALCA",-66.394,-21.788,0,0,13,13,1,0,12,13
"Bolivia","Potosí","Sur Lípez","Mojinete","ESC. CASA GRANDE",-66.27042,-21.93487,14,4,64,78,3,3,54,57
"Bolivia","Potosí","Sur Lípez","Mojinete","ESC. LA CIENEGA",-66.33878,-21.79782,7,0,24,31,2,1,21,23
"Bolivia","Potosí","Sur Lípez","Mojinete","ESC. PUEBLO VIEJO",-66.28301,-21.84269,2,0,20,22,1,0,19,20
"Bolivia","Potosí","Sur Lípez","Mojinete","H. ALCALDIA MUNICIPAL",-66.23934,-21.76464,24,2,97,121,12,2,81,93
"Bolivia","Potosí","Sur Lípez","San Antonio de Esmoruco","ESC. 10 DE NOVIEMBRE",-66.51337,-21.84954,20,0,73,93,12,0,61,73
"Bolivia","Potosí","Sur Lípez","San Antonio de Esmoruco","ESC. ANTOFAGASTA",-66.41882,-22.10488,34,6,112,146,31,3,72,103
"Bolivia","Potosí","Sur Lípez","San Antonio de Esmoruco","ESC. CENTRAL CALAMA",-66.51688,-21.9479,55,7,252,307,56,9,180,236
"Bolivia","Potosí","Sur Lípez","San Antonio de Esmoruco","ESC. DE RIO SECO",-66.33189,-21.99798,4,1,76,80,14,2,59,73
"Bolivia","Potosí","Sur Lípez","San Antonio de Esmoruco","ESC. OCKE ORCKO",-66.31582,-21.96951,7,2,48,55,6,0,40,46
"Bolivia","Potosí","Sur Lípez","San Antonio de Esmoruco","ESC. RANCHO CHILENO",-66.79728,-22.40032,9,0,29,38,8,0,21,29
"Bolivia","Potosí","Sur Lípez","San Pablo de Lípez","ESC. EDUARDO AVAROA",-67.35746,-22.22936,3,8,53,56,28,5,12,40
"Bolivia","Potosí","Sur Lípez","San Pablo de Lípez","ESC. KOLLPANI",-66.91783,-22.03759,6,0,51,57,7,3,41,48
"Bolivia","Potosí","Sur Lípez","San Pablo de Lípez","ESC. QUETENA CHICO",-67.34043,-22.1941,18,4,223,241,104,3,112,216
"Bolivia","Potosí","Sur Lípez","San Pablo de Lípez","ESC. RELAVE",-66.79867,-21.76142,15,1,45,60,16,4,24,40
"Bolivia","Potosí","Sur Lípez","San Pablo de Lípez","ESC. SANTA ISABEL",-66.45042,-21.64084,19,0,30,49,1,0,29,30
"Bolivia","Potosí","Sur Lípez","San Pablo de Lípez","ESC. SECCIONAL RIO SAN PABLO",-66.76449,-21.60779,12,3,89,101,23,2,61,84
"Bolivia","Potosí","Sur Lípez","San Pablo de Lípez","ESC. SECCIONAL VILUYO",-66.35195,-21.53281,16,0,83,99,5,3,75,80
"Bolivia","Potosí","Sur Lípez","San Pablo de Lípez","ESC. VILLA PORVENIR",-66.88214,-21.87592,23,3,111,134,37,9,62,99
"Bolivia","Potosí","Sur Lípez","San Pablo de Lípez","SALON DE COMUNIDAD",-66.48465,-21.41609,3,3,91,94,26,3,59,85
"Bolivia","Potosí","Sur Lípez","San Pablo de Lípez","SALON DE PLAZA",-66.67158,-21.50187,27,4,126,153,38,13,71,109
"Bolivia","Potosí","Sur Lípez","San Pablo de Lípez","U.E. COLORADOS DE BOLIVIA",-66.61893,-21.68718,12,0,70,82,23,7,40,63
"Bolivia","Potosí","Tomás Frías","Potosí","(CÁRCEL) PENAL DE CANTUMARCA",-65.78258,-19.59936,39,1,106,145,70,4,31,101
"Bolivia","Potosí","Tomás Frías","Potosí","CENTRO ED. FRAY VICENTE BERNEDO",-65.749,-19.58,551,40,4272,4823,3555,124,553,4108
"Bolivia","Potosí","Tomás Frías","Potosí","COL. 31 DE OCTUBRE",-65.7597,-19.58211,181,3,1186,1367,1006,30,147,1153
"Bolivia","Potosí","Tomás Frías","Potosí","COL. ANICETO ARCE",-65.75697,-19.58251,113,4,841,954,719,21,97,816
"Bolivia","Potosí","Tomás Frías","Potosí","COL. CARLOS MEDINACELI",-65.75753,-19.58196,96,3,731,827,641,9,78,719
"Bolivia","Potosí","Tomás Frías","Potosí","COL. DIVINO MAESTRO",-65.77073,-19.56213,348,7,2512,2860,2122,54,329,2451
"Bolivia","Potosí","Tomás Frías","Potosí","COLEG. ANTOFAGASTA",-65.74934,-19.59519,368,17,2803,3171,2396,54,336,2732
"Bolivia","Potosí","Tomás Frías","Potosí","COLEG. BANCARIO",-65.7532,-19.5843,131,3,1009,1140,910,9,87,997
"Bolivia","Potosí","Tomás Frías","Potosí","COLEG. CRISTO MAESTRO",-65.753,-19.583,63,1,548,611,497,4,46,543
"Bolivia","Potosí","Tomás Frías","Potosí","COLEG. DAVID BERRIOS",-65.76199,-19.58034,223,4,1576,1799,1323,42,207,1530
"Bolivia","Potosí","Tomás Frías","Potosí","COLEG. DON BOSCO",-65.75298,-19.58537,129,0,985,1114,887,10,88,975
"Bolivia","Potosí","Tomás Frías","Potosí","COLEGIO FRANCISCANO",-65.75263,-19.59103,94,2,927,1021,851,6,68,919
"Bolivia","Potosí","Tomás Frías","Potosí","COLEG. LUIS ESPINAL",-65.74538,-19.59578,525,34,3280,3805,2729,106,411,3140
"Bolivia","Potosí","Tomás Frías","Potosí","COLEG. SAN RAFAEL",-65.59398,-19.45205,99,17,822,921,503,89,213,716
"Bolivia","Potosí","Tomás Frías","Potosí","ESC. 12 DE ABRIL",-65.7491,-19.59479,119,5,898,1017,739,33,121,860
"Bolivia","Potosí","Tomás Frías","Potosí","ESC. 1RO DE ABRIL",-65.75495,-19.58885,61,2,526,587,456,9,59,515
"Bolivia","Potosí","Tomás Frías","Potosí","ESC. 6 DE JUNIO",-65.77945,-19.58491,182,25,1695,1877,1122,88,460,1582
"Bolivia","Potosí","Tomás Frías","Potosí","ESC. ANTONIO QUIJARRO",-65.75183,-19.59038,73,0,552,625,505,6,41,546
"Bolivia","Potosí","Tomás Frías","Potosí","ESC. BENICIO MONTERO MALLO",-65.74702,-19.59106,221,7,1868,2089,1631,42,188,1819
"Bolivia","Potosí","Tomás Frías","Potosí","ESC. BOLIVIANO ALEMÁN",-65.771,-19.583,155,20,1233,1388,1012,37,164,1176
"Bolivia","Potosí","Tomás Frías","Potosí","ESC. CLETO LOAYZA",-65.75833,-19.59216,352,27,2543,2895,2186,56,274,2460
"Bolivia","Potosí","Tomás Frías","Potosí","ESC. COBIJA",-65.75887,-19.57669,465,17,3334,3799,2826,73,418,3244
"Bolivia","Potosí","Tomás Frías","Potosí","ESC. COPACABANA",-65.75468,-19.59232,282,10,2160,2442,1905,52,193,2098
"Bolivia","Potosí","Tomás Frías","Potosí","ESC. DANIEL CAMPOS",-65.75119,-19.57934,792,30,4956,5748,4150,132,644,4794
"Bolivia","Potosí","Tomás Frías","Potosí","ESC. ENRIQUE VIANA",-65.75941,-19.57416,487,23,3819,4306,3238,81,477,3715
"Bolivia","Potosí","Tomás Frías","Potosí","ESC. GERMAN BUSCH",-65.76686,-19.59209,332,27,2128,2460,1676,100,325,2001
"Bolivia","Potosí","Tomás Frías","Potosí","ESC. GREGORIO BARRIGA",-65.75343,-19.58554,58,1,383,441,344,3,35,379
"Bolivia","Potosí","Tomás Frías","Potosí","ESC. GUALBERTO VILLARROEL",-65.75404,-19.59555,282,19,2176,2458,1756,77,324,2080
"Bolivia","Potosí","Tomás Frías","Potosí","ESC. JAIME MENDOZA",-65.744,-19.60323,201,21,1240,1441,981,41,197,1178
"Bolivia","Potosí","Tomás Frías","Potosí","ESC. JESUS DE NAZARET",-65.77232,-19.56954,321,28,2478,2799,1917,83,450,2367
"Bolivia","Potosí","Tomás Frías","Potosí","ESC. JOSE A.ZAMPA",-65.75164,-19.58199,175,9,725,900,613,18,85,698
"Bolivia","Potosí","Tomás Frías","Potosí","ESC. JOSE MARIA LINARES",-65.74564,-19.59069,225,10,1835,2060,1593,46,186,1779
"Bolivia","Potosí","Tomás Frías","Potosí","ESC. KARACHIPAMPA",-65.72121,-19.55614,98,6,576,674,402,46,122,524
"Bolivia","Potosí","Tomás Frías","Potosí","ESC. KENNY PRIETO MELGAREJO",-65.756,-19.561,443,43,3315,3758,2636,101,535,3171
"Bolivia","Potosí","Tomás Frías","Potosí","ESC. LITORAL",-65.75475,-19.58171,329,5,2262,2591,1948,37,272,2220
"Bolivia","Potosí","Tomás Frías","Potosí","ESC.L.SUBIETA SAGARNAGA",-65.74593,-19.59545,287,16,1934,2221,1405,81,432,1837
"Bolivia","Potosí","Tomás Frías","Potosí","ESC. MANQUIRI",-65.713,-19.422,42,6,191,233,126,21,38,164
"Bolivia","Potosí","Tomás Frías","Potosí","ESC. MARTIN CRUZ",-65.63708,-19.4641,47,18,411,458,227,13,153,380
"Bolivia","Potosí","Tomás Frías","Potosí","ESC. MODESTO OMISTE",-65.75407,-19.5905,80,1,498,578,428,9,60,488
"Bolivia","Potosí","Tomás Frías","Potosí","ESC. OCKORURO",-65.68793,-19.34093,39,14,148,187,84,12,38,122
"Bolivia","Potosí","Tomás Frías","Potosí","ESC. PARANTACA",-65.67346,-19.41582,14,2,126,140,91,2,31,122
"Bolivia","Potosí","Tomás Frías","Potosí","ESC. PARANTURI",-65.84405,-19.38804,8,5,86,94,55,8,18,73
"Bolivia","Potosí","Tomás Frías","Potosí","ESC. SALVADOR REVILLA",-65.75059,-19.58397,99,3,1074,1173,953,16,102,1055
"Bolivia","Potosí","Tomás Frías","Potosí","ESC. SAN JOSE",-65.75632,-19.58005,167,2,1693,1860,1478,35,178,1656
"Bolivia","Potosí","Tomás Frías","Potosí","ESC. SIMON RODRIGUEZ",-65.75714,-19.58396,172,5,1428,1600,1227,28,168,1395
"Bolivia","Potosí","Tomás Frías","Potosí","ESC. TARAPAYA",-65.79939,-19.47568,23,2,220,243,144,29,45,189
"Bolivia","Potosí","Tomás Frías","Potosí","ESC. TOMAS FRIAS",-65.78917,-19.42753,2,0,105,107,82,0,23,105
"Bolivia","Potosí","Tomás Frías","Potosí","ESC. TOPATER",-65.76611,-19.57706,524,19,3624,4148,3119,89,397,3516
"Bolivia","Potosí","Tomás Frías","Potosí","ESCUELA JOSÉ ALONSO DE IBÁÑEZ",-65.75143,-19.58758,191,4,1307,1498,1167,22,114,1281
"Bolivia","Potosí","Tomás Frías","Potosí","FE Y ALEGRIA Y SAN CLEMENTE",-65.76543,-19.57224,481,21,4159,4640,3662,81,395,4057
"Bolivia","Potosí","Tomás Frías","Potosí","INSTITUTO I.S.E.C.",-65.76514,-19.57146,109,3,1199,1308,1062,19,115,1177
"Bolivia","Potosí","Tomás Frías","Potosí","INSTITUTO SAN JUAN",-65.75861,-19.59069,116,7,1018,1134,866,30,115,981
"Bolivia","Potosí","Tomás Frías","Potosí","KINDER CONCEPCION",-65.747,-19.59719,207,14,1372,1579,1117,43,198,1315
"Bolivia","Potosí","Tomás Frías","Potosí","KINDER ISMAEL MONTES",-65.74657,-19.58614,448,37,3719,4167,3177,82,423,3600
"Bolivia","Potosí","Tomás Frías","Potosí","LIC. SUCRE",-65.7513,-19.58862,226,9,1737,1963,1560,19,149,1709
"Bolivia","Potosí","Tomás Frías","Potosí","MARISCAL SANTA CRUZ",-65.75602,-19.57199,599,43,4278,4877,3492,139,604,4096
"Bolivia","Potosí","Tomás Frías","Potosí","UE 31 DE OCTUBRE",-65.76176,-19.58175,458,27,3685,4143,3094,76,488,3582
"Bolivia","Potosí","Tomás Frías","Potosí","U.E. ANTONIO JOSE DE SUCRE",-65.75098,-19.57251,500,36,3678,4178,2914,151,577,3491
"Bolivia","Potosí","Tomás Frías","Potosí","U.E. CECILIO GUZMAN ROJAS",-65.75775,-19.56903,22,2,192,214,155,8,27,182
"Bolivia","Potosí","Tomás Frías","Potosí","U.E. DON BOSCO B",-65.76209,-19.59194,27,6,257,284,200,7,44,244
"Bolivia","Potosí","Tomás Frías","Potosí","U.E. DR. GONZALO CALDERON RIOS",-65.73939,-19.58194,21,8,312,333,219,17,68,287
"Bolivia","Potosí","Tomás Frías","Potosí","U.E. HUMBERTO IPORRE SALINAS",-65.748,-19.576,368,35,2350,2718,1653,127,535,2188
"Bolivia","Potosí","Tomás Frías","Potosí","UNIDAD EDUCATIVA JUAN PABLO II",-65.77334,-19.57676,490,50,4248,4738,3330,175,693,4023
"Bolivia","Potosí","Tomás Frías","Potosí","UNIDAD EDUCATIVA MEJILLONES",-65.74363,-19.58617,544,58,3993,4537,3174,181,580,3754
"Bolivia","Potosí","Tomás Frías","Potosí","UNIDAD EDUCATIVA SANTA ROSA",-65.75475,-19.58914,182,3,1341,1523,1180,35,123,1303
"Bolivia","Potosí","Tomás Frías","Potosí","UNIDAD EDUCATIVA VILLA COLON",-65.7385,-19.59098,531,60,3875,4406,2921,197,697,3618
"Bolivia","Potosí","Tomás Frías","Potosí","UNID. EDUCATIVA OSCAR ALFARO",-65.74941,-19.58645,130,4,1045,1175,928,18,95,1023
"Bolivia","Potosí","Tomás Frías","Tinguipaya","ESC. ACTARA",-65.95901,-19.07407,227,26,575,802,212,110,227,439
"Bolivia","Potosí","Tomás Frías","Tinguipaya","ESC. CALASAYA",-65.94428,-19.09865,88,1,192,280,3,10,178,181
"Bolivia","Potosí","Tomás Frías","Tinguipaya","ESC. CENTRAL ANTHURA",-65.96957,-19.12422,146,56,983,1129,145,112,670,815
"Bolivia","Potosí","Tomás Frías","Tinguipaya","ESC. CENTRAL JAHUACAYA",-65.88607,-19.19718,187,103,720,907,183,57,377,560
"Bolivia","Potosí","Tomás Frías","Tinguipaya","ESC. CENTRAL UTACALLA",-65.82983,-19.32134,111,18,327,438,124,20,165,289
"Bolivia","Potosí","Tomás Frías","Tinguipaya","ESC. EJE CAQUENA",-65.93787,-19.10439,75,30,320,395,122,15,153,275
"Bolivia","Potosí","Tomás Frías","Tinguipaya","ESC. FOROCTIRI",-65.71165,-19.14012,108,2,354,462,38,14,300,338
"Bolivia","Potosí","Tomás Frías","Tinguipaya","ESC. ISLA",-65.79921,-19.34833,15,2,69,84,47,5,15,62
"Bolivia","Potosí","Tomás Frías","Tinguipaya","ESC. ITHINOCA",-65.74291,-19.17638,53,4,370,423,50,18,298,348
"Bolivia","Potosí","Tomás Frías","Tinguipaya","ESC. LEÑAS",-66.08008,-19.24488,52,23,262,314,102,26,111,213
"Bolivia","Potosí","Tomás Frías","Tinguipaya","ESC. MARISCAL SUCRE",-65.86382,-19.09476,349,99,1428,1777,403,82,844,1247
"Bolivia","Potosí","Tomás Frías","Tinguipaya","ESC. MARISCAL SUCRE",-65.823,-19.22001,349,99,1428,1777,403,82,844,1247
"Bolivia","Potosí","Tomás Frías","Tinguipaya","ESC. MATANSUYO",-65.89815,-19.03701,83,20,208,291,83,15,90,173
"Bolivia","Potosí","Tomás Frías","Tinguipaya","ESC. MCAL. A. JOSE DE SUCRE",-65.72488,-19.24366,151,7,326,477,82,18,219,301
"Bolivia","Potosí","Tomás Frías","Tinguipaya","ESC. PUCA PUNTA",-65.68548,-19.11989,62,5,209,271,20,10,174,194
"Bolivia","Potosí","Tomás Frías","Tinguipaya","ESC. TACOHUARA",-65.7727,-19.13595,45,5,194,239,13,3,173,186
"Bolivia","Potosí","Tomás Frías","Tinguipaya","ESCUELA SAYACA",-66.0471,-19.11271,3,6,91,94,26,6,53,79
"Bolivia","Potosí","Tomás Frías","Tinguipaya","U.E. CIENEGOMA",-65.84728,-19.06967,0,1,256,256,52,19,184,236
"Bolivia","Potosí","Tomás Frías","Tinguipaya","U.E. MACHAC MARCA",-65.92706,-19.16479,12,24,195,207,131,10,30,161
"Bolivia","Potosí","Tomás Frías","Urmiri (Belén de Andamarca)","ESC. CAHUAYO",-66.17896,-19.27176,6,2,87,93,14,3,68,82
"Bolivia","Potosí","Tomás Frías","Urmiri (Belén de Andamarca)","ESC. JUAN JOSE PEREZ",-66.06399,-19.38641,27,2,267,294,85,12,168,253
"Bolivia","Potosí","Tomás Frías","Urmiri (Belén de Andamarca)","ESC. PUITUCO",-66.093,-19.315,19,3,112,131,47,2,60,107
"Bolivia","Potosí","Tomás Frías","Urmiri (Belén de Andamarca)","ESC. SECC. VACUYO",-66.10999,-19.45775,24,7,164,188,111,5,41,152
"Bolivia","Potosí","Tomás Frías","Yocalla","COLEG. ELIZARDO PEREZ",-65.97868,-19.41173,35,8,259,294,83,5,163,246
"Bolivia","Potosí","Tomás Frías","Yocalla","ESC. ALONSO DE IBANEZ",-65.81144,-19.51297,24,9,243,267,178,5,51,229
"Bolivia","Potosí","Tomás Frías","Yocalla","ESC. CAYARA",-65.88385,-19.55053,70,16,403,473,262,13,112,374
"Bolivia","Potosí","Tomás Frías","Yocalla","ESC. CHIRACORO",-65.9007,-19.60283,32,8,298,330,146,28,116,262
"Bolivia","Potosí","Tomás Frías","Yocalla","ESC. EDUARDO AVAROA",-65.90892,-19.38971,136,39,634,770,339,35,221,560
"Bolivia","Potosí","Tomás Frías","Yocalla","ESC. JOSE ANTONIO ZAMPA",-65.8355,-19.45168,63,29,503,566,281,26,167,448
"Bolivia","Potosí","Tomás Frías","Yocalla","ESC. JUAN XXIII",-66.019,-19.356,58,8,360,418,99,9,244,343
"Bolivia","Potosí","Tomás Frías","Yocalla","ESC. SAN ANTONIO",-65.79968,-19.58194,59,7,397,456,293,17,80,373
"Bolivia","Potosí","Tomás Frías","Yocalla","ESC. SANTA LUCIA",-65.84718,-19.55035,35,12,372,407,291,4,65,356
"Bolivia","Santa Cruz","Andrés Ibáñez","Cotoca","COLEGIO NAL. BENEMERITOS DE LA PATRIA",-62.99899,-17.75773,546,58,3675,4221,2367,95,1155,3522
"Bolivia","Santa Cruz","Andrés Ibáñez","Cotoca","ESC. GREMIAL CORTEZ",-63.01388,-17.82349,60,8,454,514,194,17,235,429
"Bolivia","Santa Cruz","Andrés Ibáñez","Cotoca","ESC. MARISCAL ANTONIO JOSE DE SUCRE",-63.05227,-17.74769,135,14,821,956,497,26,284,781
"Bolivia","Santa Cruz","Andrés Ibáñez","Cotoca","ESCUELA.COLEGIO LORENZO CORTEZ RIVERA",-62.9951,-17.75099,642,69,3952,4594,2513,117,1253,3766
"Bolivia","Santa Cruz","Andrés Ibáñez","Cotoca","ESCUELA.COLEGIO MANUEL ANGEL CORTEZ",-63.0035,-17.75491,443,33,2682,3125,1574,77,998,2572
"Bolivia","Santa Cruz","Andrés Ibáñez","Cotoca","ESCUELA.COL. SAN MARCOS",-62.98962,-17.75545,629,27,3675,4304,2039,131,1478,3517
"Bolivia","Santa Cruz","Andrés Ibáñez","Cotoca","ESCUELA DEMETRIO AÑEZ",-62.79085,-17.66665,462,16,2146,2608,1158,33,939,2097
"Bolivia","Santa Cruz","Andrés Ibáñez","Cotoca","ESCUELA GERMAN BUSCH",-62.93764,-17.73404,141,9,1072,1213,316,70,677,993
"Bolivia","Santa Cruz","Andrés Ibáñez","Cotoca","ESCUELA JESUS GOMEZ",-62.99224,-17.75945,187,14,991,1178,558,16,403,961
"Bolivia","Santa Cruz","Andrés Ibáñez","Cotoca","ESCUELA REP. DE MEXICO",-62.95778,-17.7372,279,27,1621,1900,356,137,1101,1457
"Bolivia","Santa Cruz","Andrés Ibáñez","Cotoca","ESCUELA.U.E. CALLEJAS",-62.9951,-17.75099,203,8,978,1181,666,14,290,956
"Bolivia","Santa Cruz","Andrés Ibáñez","Cotoca","ESCUELA U.E CLUB SOCIAL 24 DE SEPTIEMBRE",-63.0174,-17.69314,258,14,1674,1932,891,70,699,1590
"Bolivia","Santa Cruz","Andrés Ibáñez","Cotoca","ESCUELA UNIDADEDUCATIVA OSCAR ALFARO",-63.01909,-17.79542,202,26,1730,1932,356,66,1282,1638
"Bolivia","Santa Cruz","Andrés Ibáñez","Cotoca","U.E. PATUJU",-63.05326,-17.77304,12,4,236,248,146,8,78,224
"Bolivia","Santa Cruz","Andrés Ibáñez","Cotoca","U.E. SAN ANTONIO",-62.98827,-17.75096,7,1,62,69,39,1,21,60
"Bolivia","Santa Cruz","Andrés Ibáñez","Cotoca","UNIDAD EDUCATIVA FIDEL SAUCEDO",-62.99212,-17.69003,110,23,1116,1226,609,32,452,1061
"Bolivia","Santa Cruz","Andrés Ibáñez","El Torno","ESC.  29 DE JUNIO",-63.42663,-18.05655,314,62,2328,2642,1063,112,1091,2154
"Bolivia","Santa Cruz","Andrés Ibáñez","El Torno","ESC. ALBERTO RIBERA TAPIA",-63.50418,-18.15956,150,24,994,1144,371,105,494,865
"Bolivia","Santa Cruz","Andrés Ibáñez","El Torno","ESC. CAÑADA DOS",-63.32237,-18.06299,31,15,261,292,34,6,206,240
"Bolivia","Santa Cruz","Andrés Ibáñez","El Torno","ESC. CENTRAL MONTEVERDE",-63.50122,-17.92225,20,5,154,174,23,5,121,144
"Bolivia","Santa Cruz","Andrés Ibáñez","El Torno","ESC. ELENA VACA ANTELO",-63.3835,-17.99134,864,64,5819,6683,2753,271,2731,5484
"Bolivia","Santa Cruz","Andrés Ibáñez","El Torno","ESC. FE Y ALEGRIA",-63.45194,-17.981,42,6,369,411,114,11,238,352
"Bolivia","Santa Cruz","Andrés Ibáñez","El Torno","ESC. LA ELVIRA",-63.44523,-18.05682,0,2,24,24,13,0,9,22
"Bolivia","Santa Cruz","Andrés Ibáñez","El Torno","ESC. NACIONES UNIDAS",-63.38043,-17.9931,921,129,6202,7123,2304,309,3460,5764
"Bolivia","Santa Cruz","Andrés Ibáñez","El Torno","ESC, NUCLEO SAN LUIS",-63.48095,-18.1413,216,30,1305,1521,675,57,543,1218
"Bolivia","Santa Cruz","Andrés Ibáñez","El Torno","ESC. QUEBRADA LEON",-63.47776,-17.96212,17,3,140,157,39,4,94,133
"Bolivia","Santa Cruz","Andrés Ibáñez","El Torno","ESC. SECCIONAL SANTA RITA",-63.37109,-17.97818,207,32,1700,1907,740,72,856,1596
"Bolivia","Santa Cruz","Andrés Ibáñez","El Torno","ESCUELA 23 DE MARZO",-63.34325,-18.09747,61,3,374,435,57,16,298,355
"Bolivia","Santa Cruz","Andrés Ibáñez","El Torno","ESCUELA ANDRES IBAÑEZ",-63.40279,-18.02817,178,35,1785,1963,749,106,895,1644
"Bolivia","Santa Cruz","Andrés Ibáñez","El Torno","ESCUELA PUERTO RICO",-63.39142,-18.00683,357,48,2672,3029,1015,131,1478,2493
"Bolivia","Santa Cruz","Andrés Ibáñez","El Torno","ESCUELA SANTA MARTHA",-63.36341,-17.96476,157,13,1125,1282,334,110,668,1002
"Bolivia","Santa Cruz","Andrés Ibáñez","El Torno","ESCUELA TIQUIPAYA",-63.45114,-18.08387,134,43,1060,1194,224,42,751,975
"Bolivia","Santa Cruz","Andrés Ibáñez","El Torno","ESC. VILLA BARRIENTOS",-63.35257,-18.01478,14,3,90,104,16,3,68,84
"Bolivia","Santa Cruz","Andrés Ibáñez","El Torno","NUCLEO CENTRAL TARUMA",-63.46047,-18.11805,66,19,532,598,229,36,248,477
"Bolivia","Santa Cruz","Andrés Ibáñez","El Torno","SECCIONAL PARABANOCITO",-63.46001,-18.22056,14,6,135,149,53,3,73,126
"Bolivia","Santa Cruz","Andrés Ibáñez","El Torno","U.E. BICENTENARIO",-63.38105,-17.98782,21,4,178,199,71,2,101,172
"Bolivia","Santa Cruz","Andrés Ibáñez","El Torno","U.E. BICENTENARIO II",-63.38103,-17.98801,1,0,9,10,6,0,3,9
"Bolivia","Santa Cruz","Andrés Ibáñez","El Torno","U.E. LIC. ZACHARY MACY",-63.38482,-17.99942,25,2,199,224,72,4,121,193
"Bolivia","Santa Cruz","Andrés Ibáñez","El Torno","U.E. LIC. ZACHARY MACY",-63.38501,-17.9992,25,2,199,224,72,4,121,193
"Bolivia","Santa Cruz","Andrés Ibáñez","La Guardia","CAMBAO",-63.23442,-17.87344,79,6,822,901,397,22,397,794
"Bolivia","Santa Cruz","Andrés Ibáñez","La Guardia","ESC. CENTRAL ANGEL FOIANINI",-63.2851,-17.8802,572,78,4598,5170,2218,245,2057,4275
"Bolivia","Santa Cruz","Andrés Ibáñez","La Guardia","ESC. CENTRAL BASILIO",-63.19316,-18.12562,232,44,1398,1630,516,71,767,1283
"Bolivia","Santa Cruz","Andrés Ibáñez","La Guardia","ESC. JOSE MIGUEL DE VELASCO",-63.21535,-17.9662,35,5,282,317,172,5,100,272
"Bolivia","Santa Cruz","Andrés Ibáñez","La Guardia","ESC. JOSE VICENTE SOLIZ Y RAMOS",-63.32945,-17.89064,554,77,3290,3844,1744,169,1300,3044
"Bolivia","Santa Cruz","Andrés Ibáñez","La Guardia","ESC. JUANA AZURDUY DE PADILLA",-63.26641,-17.87674,350,17,2453,2803,1373,98,965,2338
"Bolivia","Santa Cruz","Andrés Ibáñez","La Guardia","ESC. LA PEÑA- BRECHA-3",-63.05506,-17.98781,67,17,470,537,213,13,227,440
"Bolivia","Santa Cruz","Andrés Ibáñez","La Guardia","ESC. NATANIEL VERDUGEZ",-63.25018,-17.85087,1438,62,9085,10523,4641,248,4134,8775
"Bolivia","Santa Cruz","Andrés Ibáñez","La Guardia","ESC. RUBEN DARIO SOLIZ",-63.35154,-17.93966,357,51,2252,2609,1051,76,1074,2125
"Bolivia","Santa Cruz","Andrés Ibáñez","La Guardia","ESC. TOMAS JOSE MORALES",-63.33047,-17.89173,650,39,4522,5172,2617,193,1673,4290
"Bolivia","Santa Cruz","Andrés Ibáñez","La Guardia","ESC. U. EDUC. ALFREDO IBAÑEZ FRANCO",-63.24312,-17.85056,637,105,4629,5266,2224,296,2004,4228
"Bolivia","Santa Cruz","Andrés Ibáñez","La Guardia","ESCUELA JOSE GIL SORUCO",-63.2532,-17.95629,141,15,850,991,457,61,317,774
"Bolivia","Santa Cruz","Andrés Ibáñez","La Guardia","ESCUELA MAESTRO PITAGORAS",-63.29059,-17.89535,625,47,4633,5258,1776,151,2659,4435
"Bolivia","Santa Cruz","Andrés Ibáñez","La Guardia","ESCUELA NUEVA ESPERANZA",-63.26702,-17.86146,440,17,2777,3217,1817,65,878,2695
"Bolivia","Santa Cruz","Andrés Ibáñez","La Guardia","MADRE TERESA DE CALCUTA",-63.23131,-17.87858,42,3,536,578,228,31,274,502
"Bolivia","Santa Cruz","Andrés Ibáñez","La Guardia","NUCLEO SAN CARLOS",-63.33423,-18.13221,22,4,142,164,78,4,56,134
"Bolivia","Santa Cruz","Andrés Ibáñez","La Guardia","U.E. ANGEL FOIANINI BANZER II",-63.2851,-17.8802,20,2,253,273,130,10,111,241
"Bolivia","Santa Cruz","Andrés Ibáñez","La Guardia","U.E. AYACUCHO",-63.21905,-17.86675,21,3,359,380,135,7,214,349
"Bolivia","Santa Cruz","Andrés Ibáñez","La Guardia","U.E. BARRIO LINDO",-63.26904,-17.89636,42,3,588,630,249,28,308,557
"Bolivia","Santa Cruz","Andrés Ibáñez","La Guardia","U.E. BICENTENARIO ARCO IRIS",-63.2214,-17.86212,22,1,180,202,112,5,62,174
"Bolivia","Santa Cruz","Andrés Ibáñez","La Guardia","U.E. CORDECRUZ",-63.24748,-17.84745,124,3,858,982,477,30,348,825
"Bolivia","Santa Cruz","Andrés Ibáñez","La Guardia","U.E. HERNANDO ZANABRIA",-63.28431,-17.89734,17,3,251,268,95,10,143,238
"Bolivia","Santa Cruz","Andrés Ibáñez","La Guardia","U.E. INTEGRACION DE LAS AMERICAS",-63.27132,-17.88183,42,6,608,650,88,10,504,592
"Bolivia","Santa Cruz","Andrés Ibáñez","La Guardia","U.E. JOSE MARIANO SERRANO",-63.25946,-17.83774,48,2,639,687,318,19,300,618
"Bolivia","Santa Cruz","Andrés Ibáñez","La Guardia","U.E. LUZ DE ESPERANZA",-63.27512,-17.85011,10,1,168,178,106,1,60,166
"Bolivia","Santa Cruz","Andrés Ibáñez","La Guardia","U.E. NACIONAL LA GUARDIA",-63.32025,-17.89236,31,6,451,482,215,18,212,427
"Bolivia","Santa Cruz","Andrés Ibáñez","La Guardia","U.E. NATANIEL GARCIA CHAVEZ",-63.23131,-17.87858,69,0,485,554,295,15,175,470
"Bolivia","Santa Cruz","Andrés Ibáñez","La Guardia","U.E. QUEBRADA SECA",-63.34096,-17.9067,0,1,41,41,26,1,13,39
"Bolivia","Santa Cruz","Andrés Ibáñez","La Guardia","U.E. TOMAS MORALES PADILLA",-63.22071,-17.89719,21,4,374,395,95,94,181,276
"Bolivia","Santa Cruz","Andrés Ibáñez","Porongo (Ayacucho)","ESC. FRAY SANTIAGO DE RIVERO",-63.30791,-17.85656,312,34,2277,2589,1348,50,845,2193
"Bolivia","Santa Cruz","Andrés Ibáñez","Porongo (Ayacucho)","ESC. JOSE PARADA LAGUINDEY",-63.38077,-17.72245,141,12,570,711,379,7,172,551
"Bolivia","Santa Cruz","Andrés Ibáñez","Porongo (Ayacucho)","ESC. NUCLEO CENTRAL SANTA FE",-63.45945,-17.70892,52,7,329,381,63,4,255,318
"Bolivia","Santa Cruz","Andrés Ibáñez","Porongo (Ayacucho)","ESCUELA 6 DE AGOSTO",-63.21883,-17.72828,26,4,694,720,568,75,47,615
"Bolivia","Santa Cruz","Andrés Ibáñez","Porongo (Ayacucho)","ESCUELA CENTRAL ANICETO PARADA ROCA",-63.44804,-17.6197,61,4,252,313,205,5,38,243
"Bolivia","Santa Cruz","Andrés Ibáñez","Porongo (Ayacucho)","ESCUELA CENTRAL SOMBRERITO",-63.36818,-17.88821,55,6,203,258,93,11,93,186
"Bolivia","Santa Cruz","Andrés Ibáñez","Porongo (Ayacucho)","ESCUELA IRENIA MONTERO",-63.4469,-17.87279,46,1,107,153,27,9,70,97
"Bolivia","Santa Cruz","Andrés Ibáñez","Porongo (Ayacucho)","ESCUELA PUERTO ICHILO",-63.23566,-17.74908,51,5,266,317,183,12,66,249
"Bolivia","Santa Cruz","Andrés Ibáñez","Porongo (Ayacucho)","ESCUELA SAN LORENZO",-63.24335,-17.76947,211,13,1196,1407,842,30,311,1153
"Bolivia","Santa Cruz","Andrés Ibáñez","Porongo (Ayacucho)","ESCUELA TARUMATU",-63.24299,-17.65729,71,2,360,431,263,12,83,346
"Bolivia","Santa Cruz","Andrés Ibáñez","Porongo (Ayacucho)","U.E. LAS CRUCES",-63.35539,-17.76963,8,0,72,80,48,4,20,68
"Bolivia","Santa Cruz","Andrés Ibáñez","Porongo (Ayacucho)","U.E. SAN PEDRO",-63.43151,-17.72083,0,0,50,50,23,0,27,50
"Bolivia","Santa Cruz","Andrés Ibáñez","Porongo (Ayacucho)","U.E. TACUAREMBO",-63.39894,-17.93078,1,0,6,7,0,0,6,6
"Bolivia","Santa Cruz","Andrés Ibáñez","Porongo (Ayacucho)","URUBO OPEN MALL",-63.21519,-17.7493,60,1,510,570,463,7,39,502
"Bolivia","Santa Cruz","Andrés Ibáñez","Santa Cruz de la Sierra","16 DE FEBRERO",-63.09864,-17.74821,0,1,139,139,82,14,42,124
"Bolivia","Santa Cruz","Andrés Ibáñez","Santa Cruz de la Sierra","16 DE JULIO",-63.11146,-17.75544,72,8,775,847,460,54,253,713
"Bolivia","Santa Cruz","Andrés Ibáñez","Santa Cruz de la Sierra","ANGELINA RIVERA",-63.17871,-17.85304,21,0,214,235,126,2,86,212
"Bolivia","Santa Cruz","Andrés Ibáñez","Santa Cruz de la Sierra","CAMPUS UNIVERSITARIO",-63.1925,-17.77396,566,6,2742,3308,2256,35,445,2701
"Bolivia","Santa Cruz","Andrés Ibáñez","Santa Cruz de la Sierra","COL. 12 DE DICIEMBRE",-63.13068,-17.821,1193,53,6567,7760,3871,178,2465,6336
"Bolivia","Santa Cruz","Andrés Ibáñez","Santa Cruz de la Sierra","COL. 18 DE MARZO",-63.12068,-17.78999,855,52,5021,5876,3225,153,1591,4816
"Bolivia","Santa Cruz","Andrés Ibáñez","Santa Cruz de la Sierra","COL. 27 DE MAYO",-63.1305,-17.80221,655,18,3291,3946,1750,112,1411,3161
"Bolivia","Santa Cruz","Andrés Ibáñez","Santa Cruz de la Sierra","COL. 30 DE MARZO",-63.14708,-17.80647,532,11,3569,4101,2721,91,746,3467
"Bolivia","Santa Cruz","Andrés Ibáñez","Santa Cruz de la Sierra","COL. 7 DE SEPTIEMBRE",-63.17094,-17.72965,552,10,3062,3614,2429,83,540,2969
"Bolivia","Santa Cruz","Andrés Ibáñez","Santa Cruz de la Sierra","COL.ADVENTISTA SANTA CRUZ",-63.16123,-17.73494,575,13,3616,4191,2831,147,625,3456
"Bolivia","Santa Cruz","Andrés Ibáñez","Santa Cruz de la Sierra","COL. ALAN FARAH",-63.0952,-17.79962,566,18,3107,3673,1992,150,947,2939
"Bolivia","Santa Cruz","Andrés Ibáñez","Santa Cruz de la Sierra","COL. ALFA Y OMEGA",-63.18944,-17.80245,212,7,1587,1799,1123,72,385,1508
"Bolivia","Santa Cruz","Andrés Ibáñez","Santa Cruz de la Sierra","COL. AMERICAN SCHOOL COOP.",-63.19998,-17.80871,315,4,1992,2307,1772,56,160,1932
"Bolivia","Santa Cruz","Andrés Ibáñez","Santa Cruz de la Sierra","COL. ANGELA PINCKERT",-63.12423,-17.80643,889,30,5378,6267,2843,179,2326,5169
"Bolivia","Santa Cruz","Andrés Ibáñez","Santa Cruz de la Sierra","COL. ANGLO AMERICANO",-63.17102,-17.75651,45,29,643,688,557,8,49,606
"Bolivia","Santa Cruz","Andrés Ibáñez","Santa Cruz de la Sierra","COL.  ANITA SUAREZ DE LEYGUE",-63.24062,-17.82561,262,17,2119,2381,1164,42,896,2060
"Bolivia","Santa Cruz","Andrés Ibáñez","Santa Cruz de la Sierra","COL.ANTONIO VICENTE SEOANE",-63.19352,-17.80136,281,9,2239,2520,1749,88,393,2142
"Bolivia","Santa Cruz","Andrés Ibáñez","Santa Cruz de la Sierra","COL. ARTURO MEDEIROS",-63.1909,-17.72338,192,8,1349,1541,855,41,445,1300
"Bolivia","Santa Cruz","Andrés Ibáñez","Santa Cruz de la Sierra","COL. ARZ. DANIEL RIVERO",-63.18145,-17.78975,25,0,137,162,108,1,28,136
"Bolivia","Santa Cruz","Andrés Ibáñez","Santa Cruz de la Sierra","COL. BAILON MERCADO ORTIZ",-63.16036,-17.75771,376,11,2633,3009,2098,62,462,2560
"Bolivia","Santa Cruz","Andrés Ibáñez","Santa Cruz de la Sierra","COL. BASILIO DE CUELLAR",-63.1786,-17.7843,145,1,778,923,709,15,53,762
"Bolivia","Santa Cruz","Andrés Ibáñez","Santa Cruz de la Sierra","COL. BATALLON TREN",-63.12371,-17.79344,243,9,1562,1805,1055,77,421,1476
"Bolivia","Santa Cruz","Andrés Ibáñez","Santa Cruz de la Sierra","COL. BERTHA CUELLAR",-63.13752,-17.78985,1101,25,5105,6206,3293,345,1442,4735
"Bolivia","Santa Cruz","Andrés Ibáñez","Santa Cruz de la Sierra","COL. BOSTON COLLEGE",-63.17429,-17.77369,188,3,1410,1598,1246,22,139,1385
"Bolivia","Santa Cruz","Andrés Ibáñez","Santa Cruz de la Sierra","COL. BRITANICO",-63.17352,-17.7643,381,4,2798,3179,2581,31,182,2763
"Bolivia","Santa Cruz","Andrés Ibáñez","Santa Cruz de la Sierra","COL. BUENAS NUEVAS",-63.13937,-17.8226,978,116,6445,7423,3805,205,2319,6124
"Bolivia","Santa Cruz","Andrés Ibáñez","Santa Cruz de la Sierra","COL. CAÑADA EL CARMEN",-63.15352,-17.81458,450,8,3510,3960,2813,87,602,3415
"Bolivia","Santa Cruz","Andrés Ibáñez","Santa Cruz de la Sierra","COL. CAÑADA PAILITAS",-63.14665,-17.81992,401,11,2507,2908,1766,63,667,2433
"Bolivia","Santa Cruz","Andrés Ibáñez","Santa Cruz de la Sierra","COL.CARCEL PUBLICA",-63.17891,-17.87441,400,3,530,930,265,9,253,518
"Bolivia","Santa Cruz","Andrés Ibáñez","Santa Cruz de la Sierra","COL.CARDENAL CUSHING JESUS MARIA",-63.18533,-17.79161,318,11,1929,2247,1566,41,311,1877
"Bolivia","Santa Cruz","Andrés Ibáñez","Santa Cruz de la Sierra","COL. CASTILLA LA MANCHA",-63.06415,-17.85068,1619,151,9549,11168,5034,419,3945,8979
"Bolivia","Santa Cruz","Andrés Ibáñez","Santa Cruz de la Sierra","COL. CENTRAL OBRERA DEPARTAMENTAL",-63.10396,-17.80835,771,69,4763,5534,2602,171,1921,4523
"Bolivia","Santa Cruz","Andrés Ibáñez","Santa Cruz de la Sierra","COL.CENTRO APRONDY",-63.15873,-17.77472,251,34,2255,2506,1823,114,284,2107
"Bolivia","Santa Cruz","Andrés Ibáñez","Santa Cruz de la Sierra","COL. CENTRO EDUCATIVO CARITAS",-63.18559,-17.83982,520,11,4777,5297,3648,162,956,4604
"Bolivia","Santa Cruz","Andrés Ibáñez","Santa Cruz de la Sierra","COL. CENTRO INTERNO BOL. ALEMAN",-63.11688,-17.82509,1431,53,6686,8117,3081,196,3356,6437
"Bolivia","Santa Cruz","Andrés Ibáñez","Santa Cruz de la Sierra","COL. CIUDAD NIÑO JESUS",-63.18233,-17.82738,643,18,4033,4676,2573,199,1243,3816
"Bolivia","Santa Cruz","Andrés Ibáñez","Santa Cruz de la Sierra","COL.CLUB DE LEONES",-63.17753,-17.7902,245,6,1758,2003,1297,32,423,1720
"Bolivia","Santa Cruz","Andrés Ibáñez","Santa Cruz de la Sierra","COL.CLUB DE LEONES #10",-63.17753,-17.7902,148,32,1130,1278,930,34,134,1064
"Bolivia","Santa Cruz","Andrés Ibáñez","Santa Cruz de la Sierra","COL. CLUB DE LEONES #6",-63.18416,-17.7943,118,3,670,788,450,45,172,622
"Bolivia","Santa Cruz","Andrés Ibáñez","Santa Cruz de la Sierra","COL. COMPLEJO EDUCATIVO JAPON",-63.18984,-17.80635,777,27,4684,5461,2821,182,1654,4475
"Bolivia","Santa Cruz","Andrés Ibáñez","Santa Cruz de la Sierra","COL. COVIPAL",-63.23657,-17.83965,151,14,933,1084,341,31,547,888
"Bolivia","Santa Cruz","Andrés Ibáñez","Santa Cruz de la Sierra","COL. CUPESI TERRADO",-63.09699,-17.81237,764,46,4206,4970,1806,173,2181,3987
"Bolivia","Santa Cruz","Andrés Ibáñez","Santa Cruz de la Sierra","COL. DIOS ES AMOR",-63.16571,-17.78535,174,8,1294,1468,1097,20,169,1266
"Bolivia","Santa Cruz","Andrés Ibáñez","Santa Cruz de la Sierra","COL.DOMINGO LEIGUE (BOLIVIANO CANADIENSE",-63.16274,-17.77073,265,5,1803,2068,1519,31,248,1767
"Bolivia","Santa Cruz","Andrés Ibáñez","Santa Cruz de la Sierra","COL. EDUCATIVO COTOCA",-63.11758,-17.74604,506,85,3026,3532,1654,128,1159,2813
"Bolivia","Santa Cruz","Andrés Ibáñez","Santa Cruz de la Sierra","COL. EDUCATIVO SAN ISIDRO",-63.13194,-17.80816,850,54,5300,6150,3113,144,1989,5102
"Bolivia","Santa Cruz","Andrés Ibáñez","Santa Cruz de la Sierra","COLEGIO  23 DE ABRIL",-63.14577,-17.74856,444,9,2730,3174,1761,123,837,2598
"Bolivia","Santa Cruz","Andrés Ibáñez","Santa Cruz de la Sierra","COLEGIO  6 DE JUNIO",-63.16083,-17.75763,600,7,2213,2813,1755,93,358,2113
"Bolivia","Santa Cruz","Andrés Ibáñez","Santa Cruz de la Sierra","COLEGIO ADELA ZAMUDIO",-63.17396,-17.8329,935,25,5934,6869,3515,228,2166,5681
"Bolivia","Santa Cruz","Andrés Ibáñez","Santa Cruz de la Sierra","COLEGIO BERTHA CUELLAR",-63.1344,-17.77751,187,5,856,1043,652,12,187,839
"Bolivia","Santa Cruz","Andrés Ibáñez","Santa Cruz de la Sierra","COLEGIO CASTULO CHAVEZ",-63.18775,-17.77663,395,14,2078,2473,1772,24,268,2040
"Bolivia","Santa Cruz","Andrés Ibáñez","Santa Cruz de la Sierra","COLEGIO CUPESO DE LOS REYES",-63.10786,-17.82436,609,21,3885,4494,1653,152,2059,3712
"Bolivia","Santa Cruz","Andrés Ibáñez","Santa Cruz de la Sierra","COLEGIO DOMINGO SAVIO - DON BOSCO",-63.19939,-17.83571,1167,39,7171,8338,4296,250,2586,6882
"Bolivia","Santa Cruz","Andrés Ibáñez","Santa Cruz de la Sierra","COLEGIO DON BOSCO",-63.17539,-17.79467,346,5,2023,2369,1752,37,229,1981
"Bolivia","Santa Cruz","Andrés Ibáñez","Santa Cruz de la Sierra","COLEGIO EL PROGRESO",-63.20576,-17.82713,926,33,5004,5930,2443,242,2286,4729
"Bolivia","Santa Cruz","Andrés Ibáñez","Santa Cruz de la Sierra","COLEGIO ELVIRA PARADA",-63.12992,-17.75476,646,16,3534,4180,2305,104,1109,3414
"Bolivia","Santa Cruz","Andrés Ibáñez","Santa Cruz de la Sierra","COLEGIO FUENTE DEL SABER",-63.16189,-17.87296,100,7,766,866,296,23,440,736
"Bolivia","Santa Cruz","Andrés Ibáñez","Santa Cruz de la Sierra","COLEGIO IGNACIO WARNES",-63.15627,-17.86588,614,20,3784,4398,1638,145,1981,3619
"Bolivia","Santa Cruz","Andrés Ibáñez","Santa Cruz de la Sierra","COLEGIO JOSEFINA BALSAMO( LOS TUSEQUIS)",-63.1523,-17.78086,539,50,3818,4357,2803,157,808,3611
"Bolivia","Santa Cruz","Andrés Ibáñez","Santa Cruz de la Sierra","COLEGIO JUSTO LEIGUE",-63.16701,-17.79873,132,4,1430,1562,1189,65,172,1361
"Bolivia","Santa Cruz","Andrés Ibáñez","Santa Cruz de la Sierra","COLEGIO LUZ Y VERDAD",-63.18724,-17.876,472,18,2520,2992,1136,76,1290,2426
"Bolivia","Santa Cruz","Andrés Ibáñez","Santa Cruz de la Sierra","COLEGIO MARCELINO CHAMPAGNAT",-63.18896,-17.85419,315,15,2690,3005,1976,107,592,2568
"Bolivia","Santa Cruz","Andrés Ibáñez","Santa Cruz de la Sierra","COLEGIO MARISTA",-63.17305,-17.78898,250,6,1698,1948,1523,21,148,1671
"Bolivia","Santa Cruz","Andrés Ibáñez","Santa Cruz de la Sierra","COLEGIO MARTIN SAPP",-63.17467,-17.82512,828,25,5678,6506,3614,179,1860,5474
"Bolivia","Santa Cruz","Andrés Ibáñez","Santa Cruz de la Sierra","COLEGIO NESTOR SUAREZ",-63.17374,-17.81688,548,12,3694,4242,2568,146,968,3536
"Bolivia","Santa Cruz","Andrés Ibáñez","Santa Cruz de la Sierra","COLEGIO PLAN 4000",-63.17594,-17.88471,685,37,4624,5309,1666,153,2768,4434
"Bolivia","Santa Cruz","Andrés Ibáñez","Santa Cruz de la Sierra","COLEGIO RAQUEL SOSSA",-63.19794,-17.77104,94,1,888,982,789,15,83,872
"Bolivia","Santa Cruz","Andrés Ibáñez","Santa Cruz de la Sierra","COLEGIO SAN FELIPE",-63.123,-17.76667,1279,166,7396,8675,3972,234,3024,6996
"Bolivia","Santa Cruz","Andrés Ibáñez","Santa Cruz de la Sierra","COLEGIO SAN FRANCISCO DE ASIS",-63.14429,-17.85693,46,5,434,480,220,6,203,423
"Bolivia","Santa Cruz","Andrés Ibáñez","Santa Cruz de la Sierra","COLEGIO SAN JORGE",-63.1956,-17.87261,466,49,2424,2890,1129,98,1148,2277
"Bolivia","Santa Cruz","Andrés Ibáñez","Santa Cruz de la Sierra","COLEGIO SIMON BOLIVAR",-63.1228,-17.82358,745,64,4324,5069,1870,135,2255,4125
"Bolivia","Santa Cruz","Andrés Ibáñez","Santa Cruz de la Sierra","COLEGIO TOKIO",-63.18006,-17.77509,273,2,1112,1385,708,25,377,1085
"Bolivia","Santa Cruz","Andrés Ibáñez","Santa Cruz de la Sierra","COLEGIO VILLA GLADYS THEVENETH",-63.11954,-17.82021,709,42,4643,5352,1923,222,2456,4379
"Bolivia","Santa Cruz","Andrés Ibáñez","Santa Cruz de la Sierra","COL. EL BUEN SAMARITANO",-63.08056,-17.81198,231,16,1724,1955,830,68,810,1640
"Bolivia","Santa Cruz","Andrés Ibáñez","Santa Cruz de la Sierra","COL. EL CARMEN 16 DE JULIO",-63.19295,-17.80798,301,12,2046,2347,1548,58,428,1976
"Bolivia","Santa Cruz","Andrés Ibáñez","Santa Cruz de la Sierra","COL.  ELFI RIVERA DE BARBERY",-63.15907,-17.73966,1594,50,8265,9859,4971,298,2946,7917
"Bolivia","Santa Cruz","Andrés Ibáñez","Santa Cruz de la Sierra","COL. EL PAJONAL",-63.16722,-17.81264,284,11,1633,1917,1353,29,240,1593
"Bolivia","Santa Cruz","Andrés Ibáñez","Santa Cruz de la Sierra","COL. ESC. 29 DE DICIEMBRE",-63.21157,-17.80971,337,8,1915,2252,1112,58,737,1849
"Bolivia","Santa Cruz","Andrés Ibáñez","Santa Cruz de la Sierra","COL.ESC.  AMSTERDAN",-63.14972,-17.85901,408,8,2357,2765,922,70,1357,2279
"Bolivia","Santa Cruz","Andrés Ibáñez","Santa Cruz de la Sierra","COL. ESC. CORONEL IGNACIO WARNES",-63.1825,-17.78679,150,2,585,735,466,21,96,562
"Bolivia","Santa Cruz","Andrés Ibáñez","Santa Cruz de la Sierra","COL.ESC. GRAL. ISMAEL MONTES GAMBOA",-63.10978,-17.74466,733,84,5227,5960,2676,238,2229,4905
"Bolivia","Santa Cruz","Andrés Ibáñez","Santa Cruz de la Sierra","COL. ESC. HILANDERIA",-63.21956,-17.80578,503,17,3062,3565,2090,98,857,2947
"Bolivia","Santa Cruz","Andrés Ibáñez","Santa Cruz de la Sierra","COL. ESC. HOLANDA",-63.19473,-17.88406,211,14,1625,1836,662,82,867,1529
"Bolivia","Santa Cruz","Andrés Ibáñez","Santa Cruz de la Sierra","COL. ESC. HONORATO MEJIA",-63.21367,-17.86145,335,52,2678,3013,1407,107,1112,2519
"Bolivia","Santa Cruz","Andrés Ibáñez","Santa Cruz de la Sierra","COL.ESC. INOCENCIO ROMAN",-63.06305,-17.85023,947,89,4783,5730,1783,171,2740,4523
"Bolivia","Santa Cruz","Andrés Ibáñez","Santa Cruz de la Sierra","COL. ESC.JUANA AZURDUY DE PADILLA",-63.10905,-17.84618,1216,186,7968,9184,3786,336,3660,7446
"Bolivia","Santa Cruz","Andrés Ibáñez","Santa Cruz de la Sierra","COL. ESC. LA BASE",-63.21367,-17.83001,351,14,2562,2913,1613,49,886,2499
"Bolivia","Santa Cruz","Andrés Ibáñez","Santa Cruz de la Sierra","COL. ESC. MAGISTERIO SUR",-63.18134,-17.86983,397,20,2581,2978,1301,103,1157,2458
"Bolivia","Santa Cruz","Andrés Ibáñez","Santa Cruz de la Sierra","COL. ESC. MANUEL IGNACIO SALVATIERRA",-63.17845,-17.78334,103,1,537,640,458,9,69,527
"Bolivia","Santa Cruz","Andrés Ibáñez","Santa Cruz de la Sierra","COL. ESC. MARIA ALICIA PAZ B.",-63.19432,-17.85304,810,32,5206,6016,3276,164,1734,5010
"Bolivia","Santa Cruz","Andrés Ibáñez","Santa Cruz de la Sierra","COL. ESC. MAX FERNANDEZ ROJAS B",-63.16543,-17.87381,524,28,3050,3574,1335,156,1531,2866
"Bolivia","Santa Cruz","Andrés Ibáñez","Santa Cruz de la Sierra","COL. ESC. NAUN FERNANDEZ",-63.17404,-17.83272,308,11,2526,2834,1607,101,807,2414
"Bolivia","Santa Cruz","Andrés Ibáñez","Santa Cruz de la Sierra","COL. ESC.PEREGRINA DAVALOS",-63.16763,-17.87231,589,17,3259,3848,1456,92,1694,3150
"Bolivia","Santa Cruz","Andrés Ibáñez","Santa Cruz de la Sierra","COL.ESC. ROCA CORONADO",-63.15992,-17.83748,872,36,5345,6217,2591,129,2589,5180
"Bolivia","Santa Cruz","Andrés Ibáñez","Santa Cruz de la Sierra","COL.ESC. TIERRAS NUEVAS EL CARMEN",-63.21467,-17.84509,1769,213,9544,11313,4380,453,4498,8878
"Bolivia","Santa Cruz","Andrés Ibáñez","Santa Cruz de la Sierra","COL. ESCUELA 2 DE AGOSTO",-63.15519,-17.75298,390,9,2532,2922,2063,32,428,2491
"Bolivia","Santa Cruz","Andrés Ibáñez","Santa Cruz de la Sierra","COL. ESCUELA AMBROCIO VILLARROEL",-63.2262,-17.79013,294,53,1659,1953,859,44,703,1562
"Bolivia","Santa Cruz","Andrés Ibáñez","Santa Cruz de la Sierra","COL.ESCUELA BOLIVIA HOLANDA",-63.14489,-17.86903,595,21,3656,4251,1247,190,2198,3445
"Bolivia","Santa Cruz","Andrés Ibáñez","Santa Cruz de la Sierra","COL.ESCUELA DELCY MARTINEZ SALINAS",-63.15478,-17.84095,300,8,1829,2129,890,186,745,1635
"Bolivia","Santa Cruz","Andrés Ibáñez","Santa Cruz de la Sierra","COL.ESCUELA EL FUERTE",-63.14807,-17.84582,999,75,5729,6728,2589,398,2667,5256
"Bolivia","Santa Cruz","Andrés Ibáñez","Santa Cruz de la Sierra","COL. ESCUELA JORGE URENDA TRIGO",-63.23063,-17.81518,505,17,3198,3703,2256,120,805,3061
"Bolivia","Santa Cruz","Andrés Ibáñez","Santa Cruz de la Sierra","COL. ESCUELA MAGISTERIO",-63.15523,-17.76229,390,43,3336,3726,2735,67,491,3226
"Bolivia","Santa Cruz","Andrés Ibáñez","Santa Cruz de la Sierra","COL.ESCUELA NUEVA ESPERANZA",-63.07431,-17.83275,291,18,1282,1573,511,36,717,1228
"Bolivia","Santa Cruz","Andrés Ibáñez","Santa Cruz de la Sierra","COL.ESCUELA POLY VILLARROEL",-63.1315,-17.8723,206,6,1541,1747,1034,81,420,1454
"Bolivia","Santa Cruz","Andrés Ibáñez","Santa Cruz de la Sierra","COL. ESCUELA SARA PORRAS DE PINTO",-63.22218,-17.79663,377,8,2465,2842,1720,127,610,2330
"Bolivia","Santa Cruz","Andrés Ibáñez","Santa Cruz de la Sierra","COL. ESC. UNZAGA DE LA VEGA",-63.22689,-17.82803,1549,91,9194,10743,5199,370,3534,8733
"Bolivia","Santa Cruz","Andrés Ibáñez","Santa Cruz de la Sierra","COL.ESC. VIRGEN DE URKUPINA",-63.10241,-17.74881,1331,65,7212,8543,2693,318,4136,6829
"Bolivia","Santa Cruz","Andrés Ibáñez","Santa Cruz de la Sierra","COL. FAUSTO MEDRANO",-63.12659,-17.78748,451,22,2839,3290,1664,130,1023,2687
"Bolivia","Santa Cruz","Andrés Ibáñez","Santa Cruz de la Sierra","COL. FELIX BASCOPE",-63.14538,-17.79648,433,11,3613,4046,2789,79,734,3523
"Bolivia","Santa Cruz","Andrés Ibáñez","Santa Cruz de la Sierra","COL. FELIX BASCOPE SANANDITA",-63.15129,-17.78336,309,8,2073,2382,1667,74,324,1991
"Bolivia","Santa Cruz","Andrés Ibáñez","Santa Cruz de la Sierra","COL. FE Y ALEGRIA",-63.13117,-17.79493,814,26,4302,5116,2823,74,1379,4202
"Bolivia","Santa Cruz","Andrés Ibáñez","Santa Cruz de la Sierra","COL. FE Y ALEGRIA - ANICETO ARZE",-63.15612,-17.7986,684,28,5033,5717,3934,218,853,4787
"Bolivia","Santa Cruz","Andrés Ibáñez","Santa Cruz de la Sierra","COL. FE Y ALEGRIA LA MERCED",-63.19189,-17.78853,575,20,4235,4810,3105,268,842,3947
"Bolivia","Santa Cruz","Andrés Ibáñez","Santa Cruz de la Sierra","COL. FE Y ALEGRIA NUEVA AMERICA",-63.13412,-17.82978,1332,62,7094,8426,3674,208,3150,6824
"Bolivia","Santa Cruz","Andrés Ibáñez","Santa Cruz de la Sierra","COL. GABRIEL RENE MORENO",-63.18595,-17.78357,230,2,1393,1623,1170,25,196,1366
"Bolivia","Santa Cruz","Andrés Ibáñez","Santa Cruz de la Sierra","COL.GASTON GUILLAUX",-63.17099,-17.77877,728,6,2912,3640,2454,57,395,2849
"Bolivia","Santa Cruz","Andrés Ibáñez","Santa Cruz de la Sierra","COL. GILBERTO MENACHO",-63.12507,-17.79899,871,62,5200,6071,3129,216,1793,4922
"Bolivia","Santa Cruz","Andrés Ibáñez","Santa Cruz de la Sierra","COL. GUALBERTO VILLARROEL",-63.16062,-17.77363,402,10,2624,3026,2179,45,390,2569
"Bolivia","Santa Cruz","Andrés Ibáñez","Santa Cruz de la Sierra","COL. GUAPILO JUNIN",-63.10236,-17.79171,769,31,4730,5499,3204,127,1368,4572
"Bolivia","Santa Cruz","Andrés Ibáñez","Santa Cruz de la Sierra","COL. HENRRY PRINCE",-63.20725,-17.81194,243,11,1409,1652,1048,27,323,1371
"Bolivia","Santa Cruz","Andrés Ibáñez","Santa Cruz de la Sierra","COL. HERMANOS CAVANIS",-63.22014,-17.81549,703,20,5427,6130,4031,164,1212,5243
"Bolivia","Santa Cruz","Andrés Ibáñez","Santa Cruz de la Sierra","COL. HERNANDO SILES",-63.17575,-17.86155,1926,71,10283,12209,5075,366,4771,9846
"Bolivia","Santa Cruz","Andrés Ibáñez","Santa Cruz de la Sierra","COL. HEROES DEL CHACO",-63.14454,-17.80119,730,21,4927,5657,3419,210,1277,4696
"Bolivia","Santa Cruz","Andrés Ibáñez","Santa Cruz de la Sierra","COL. HISPANO AMERICANO",-63.13283,-17.79934,319,12,1765,2084,1102,27,624,1726
"Bolivia","Santa Cruz","Andrés Ibáñez","Santa Cruz de la Sierra","COL. HNAS. ARREDONDO(COL.JESUS PEREDO)",-63.20106,-17.78474,533,39,3512,4045,2482,141,850,3332
"Bolivia","Santa Cruz","Andrés Ibáñez","Santa Cruz de la Sierra","COL. HUMBERTO EGUEZ",-63.11185,-17.79594,405,29,2887,3292,1660,168,1030,2690
"Bolivia","Santa Cruz","Andrés Ibáñez","Santa Cruz de la Sierra","COL.INST. DOMINGO SAVIO",-63.17353,-17.75908,178,1,870,1048,738,20,111,849
"Bolivia","Santa Cruz","Andrés Ibáñez","Santa Cruz de la Sierra","COL. INSTITUTO AMERICANO JUAN WESLEY",-63.16511,-17.78164,395,8,2843,3238,2379,93,363,2742
"Bolivia","Santa Cruz","Andrés Ibáñez","Santa Cruz de la Sierra","COL. INTERNACIONAL (BETHESDA)",-63.22035,-17.8294,344,14,2344,2688,1489,99,742,2231
"Bolivia","Santa Cruz","Andrés Ibáñez","Santa Cruz de la Sierra","COL. JHON KENNEDY",-63.19871,-17.78818,988,55,5951,6939,4339,182,1375,5714
"Bolivia","Santa Cruz","Andrés Ibáñez","Santa Cruz de la Sierra","COL. JOSEFINA GOYTIA",-63.17068,-17.79632,144,2,989,1133,860,20,107,967
"Bolivia","Santa Cruz","Andrés Ibáñez","Santa Cruz de la Sierra","COL. JOSE MALKY JESUS MARIA",-63.18144,-17.80808,895,13,4268,5163,3254,109,892,4146
"Bolivia","Santa Cruz","Andrés Ibáñez","Santa Cruz de la Sierra","COL. JUAN LA BORDE MOREL",-63.16035,-17.72277,282,3,2193,2475,1706,40,444,2150
"Bolivia","Santa Cruz","Andrés Ibáñez","Santa Cruz de la Sierra","COL. JUAN PABLO II",-63.17759,-17.7325,397,9,3247,3644,2813,126,299,3112
"Bolivia","Santa Cruz","Andrés Ibáñez","Santa Cruz de la Sierra","COL. JULIO A. GUTIERREZ",-63.18236,-17.79789,341,5,1524,1865,1214,30,275,1489
"Bolivia","Santa Cruz","Andrés Ibáñez","Santa Cruz de la Sierra","COL.KINDER FANNY ANTELO",-63.15987,-17.75532,107,3,704,811,537,13,151,688
"Bolivia","Santa Cruz","Andrés Ibáñez","Santa Cruz de la Sierra","COL. LA MADRE",-63.20914,-17.78125,598,17,3800,4398,2524,79,1180,3704
"Bolivia","Santa Cruz","Andrés Ibáñez","Santa Cruz de la Sierra","COL. LAS AMERICAS II",-63.19033,-17.86217,595,38,4929,5524,2664,348,1879,4543
"Bolivia","Santa Cruz","Andrés Ibáñez","Santa Cruz de la Sierra","COL.LA SANTA CRUZ",-63.17908,-17.76664,280,4,1998,2278,1757,54,183,1940
"Bolivia","Santa Cruz","Andrés Ibáñez","Santa Cruz de la Sierra","COL.LICEO MARIA VACADIEZ",-63.16927,-17.76587,164,1,1623,1787,1381,89,152,1533
"Bolivia","Santa Cruz","Andrés Ibáñez","Santa Cruz de la Sierra","COL. LUIS BARRANCO ALVAREZ",-63.12068,-17.84258,1072,48,5995,7067,2744,137,3066,5810
"Bolivia","Santa Cruz","Andrés Ibáñez","Santa Cruz de la Sierra","COL. LUIS ESPINAL CAMPOS",-63.16032,-17.86751,876,29,4883,5759,2253,222,2379,4632
"Bolivia","Santa Cruz","Andrés Ibáñez","Santa Cruz de la Sierra","COL. LUZ DEL ORIENTE",-63.13755,-17.79396,592,18,2849,3441,1917,78,836,2753
"Bolivia","Santa Cruz","Andrés Ibáñez","Santa Cruz de la Sierra","COL. LUZ Y SABER II",-63.14804,-17.73533,590,14,3343,3933,2463,113,753,3216
"Bolivia","Santa Cruz","Andrés Ibáñez","Santa Cruz de la Sierra","COL. MADRE CLARA RICCI (JESUS ROMAN VACA",-63.14016,-17.79584,208,2,1639,1847,1102,52,483,1585
"Bolivia","Santa Cruz","Andrés Ibáñez","Santa Cruz de la Sierra","COL. MAGDALENA POSTEL",-63.17854,-17.82687,569,19,3862,4431,2894,147,802,3696
"Bolivia","Santa Cruz","Andrés Ibáñez","Santa Cruz de la Sierra","COL. MARIA TERESA PULIDO",-63.1305,-17.8336,850,109,5129,5979,2601,250,2169,4770
"Bolivia","Santa Cruz","Andrés Ibáñez","Santa Cruz de la Sierra","COL. MARISCAL SUCRE",-63.15338,-17.77866,352,11,2646,2998,2240,45,350,2590
"Bolivia","Santa Cruz","Andrés Ibáñez","Santa Cruz de la Sierra","COL. MATEO KULJIS SECUNDARIO",-63.22539,-17.8377,463,43,4733,5196,2542,333,1815,4357
"Bolivia","Santa Cruz","Andrés Ibáñez","Santa Cruz de la Sierra","COL. MIRETTE SCIARONI",-63.18918,-17.76269,351,6,2162,2513,1833,48,275,2108
"Bolivia","Santa Cruz","Andrés Ibáñez","Santa Cruz de la Sierra","COL. M. NELLY VDA. DE BERTERO",-63.11536,-17.81427,271,13,1544,1815,770,44,717,1487
"Bolivia","Santa Cruz","Andrés Ibáñez","Santa Cruz de la Sierra","COL.MODULO # 5 ELVA ANTELO JORDAN",-63.16745,-17.86005,564,36,3171,3735,1558,63,1514,3072
"Bolivia","Santa Cruz","Andrés Ibáñez","Santa Cruz de la Sierra","COL. MODULO FLAMINGO",-63.21369,-17.82285,368,8,2480,2848,1922,45,505,2427
"Bolivia","Santa Cruz","Andrés Ibáñez","Santa Cruz de la Sierra","COL. MONSEÑOR LUIS RODRIGUEZ P.",-63.19559,-17.81594,916,24,5119,6035,3131,124,1840,4971
"Bolivia","Santa Cruz","Andrés Ibáñez","Santa Cruz de la Sierra","COL. NACIONAL 9 DE OCTUBRE",-63.15674,-17.84428,526,50,4490,5016,2931,218,1291,4222
"Bolivia","Santa Cruz","Andrés Ibáñez","Santa Cruz de la Sierra","COL. NACIONAL FLORIDA",-63.18027,-17.79039,150,4,1339,1489,1123,89,123,1246
"Bolivia","Santa Cruz","Andrés Ibáñez","Santa Cruz de la Sierra","COL. NACIONAL SALESIANO",-63.16814,-17.78925,276,6,1510,1786,1204,34,266,1470
"Bolivia","Santa Cruz","Andrés Ibáñez","Santa Cruz de la Sierra","COL. NIMIA CENTELLA",-63.11775,-17.78436,637,31,4115,4752,2457,170,1457,3914
"Bolivia","Santa Cruz","Andrés Ibáñez","Santa Cruz de la Sierra","COL. NORMANDIA JOSEFINA BALSAMO",-63.06764,-17.84974,559,35,3871,4430,1769,114,1953,3722
"Bolivia","Santa Cruz","Andrés Ibáñez","Santa Cruz de la Sierra","COL. NUCLEO ESCOLAR RAMAFA",-63.1834,-17.80372,238,7,1704,1942,1458,26,213,1671
"Bolivia","Santa Cruz","Andrés Ibáñez","Santa Cruz de la Sierra","COL. NUEVA AMERICA",-63.15847,-17.76582,330,8,1992,2322,1579,40,365,1944
"Bolivia","Santa Cruz","Andrés Ibáñez","Santa Cruz de la Sierra","COL. NUEVA ESPERANZA",-63.14962,-17.74375,384,10,1860,2244,1446,42,362,1808
"Bolivia","Santa Cruz","Andrés Ibáñez","Santa Cruz de la Sierra","COL. OBISPO SANTISTEVAN",-63.1792,-17.78578,113,2,731,844,653,16,60,713
"Bolivia","Santa Cruz","Andrés Ibáñez","Santa Cruz de la Sierra","COL. OSCAR ARNULFO",-63.23433,-17.82932,590,47,3909,4499,2207,272,1383,3590
"Bolivia","Santa Cruz","Andrés Ibáñez","Santa Cruz de la Sierra","COL. OVIDIO SANTISTEVAN",-63.19029,-17.74906,841,12,4602,5443,3526,130,934,4460
"Bolivia","Santa Cruz","Andrés Ibáñez","Santa Cruz de la Sierra","COL. PABLO SEXTO",-63.16424,-17.76425,256,3,1888,2144,1481,35,369,1850
"Bolivia","Santa Cruz","Andrés Ibáñez","Santa Cruz de la Sierra","COL. PAMPA DE LA CRUZ",-63.12878,-17.79276,436,15,2714,3150,1905,82,712,2617
"Bolivia","Santa Cruz","Andrés Ibáñez","Santa Cruz de la Sierra","COL. PAMPA DE LA ISLA",-63.12679,-17.77277,483,15,2007,2490,1340,39,613,1953
"Bolivia","Santa Cruz","Andrés Ibáñez","Santa Cruz de la Sierra","COL. PART. ALFRED B. NOBEL",-63.19432,-17.85304,275,8,1762,2037,1287,42,425,1712
"Bolivia","Santa Cruz","Andrés Ibáñez","Santa Cruz de la Sierra","COL.  PEDRO AÑEZ",-63.11894,-17.76698,815,27,4613,5428,2861,161,1564,4425
"Bolivia","Santa Cruz","Andrés Ibáñez","Santa Cruz de la Sierra","COL. PEDRO GUTIERREZ",-63.16812,-17.7553,264,7,2337,2601,2046,87,197,2243
"Bolivia","Santa Cruz","Andrés Ibáñez","Santa Cruz de la Sierra","COL  PLACIDO MOLILNA",-63.19062,-17.79406,506,21,2269,2775,1364,83,801,2165
"Bolivia","Santa Cruz","Andrés Ibáñez","Santa Cruz de la Sierra","COL.POLIFUNCIONAL CALAMA",-63.21886,-17.83718,533,26,3216,3749,1588,88,1514,3102
"Bolivia","Santa Cruz","Andrés Ibáñez","Santa Cruz de la Sierra","COL. PRIMAVERA",-63.1032,-17.81673,900,61,5207,6107,2346,200,2600,4946
"Bolivia","Santa Cruz","Andrés Ibáñez","Santa Cruz de la Sierra","COL. RAFAEL BUSTILLOS",-63.12329,-17.81418,625,21,3368,3993,1706,84,1557,3263
"Bolivia","Santa Cruz","Andrés Ibáñez","Santa Cruz de la Sierra","COL. RAMON DARIO GUTIERREZ",-63.164,-17.80529,196,0,1418,1614,1210,36,172,1382
"Bolivia","Santa Cruz","Andrés Ibáñez","Santa Cruz de la Sierra","COL.REPUBLICA DEL URUGUAY",-63.17242,-17.77493,459,9,2705,3164,2296,35,365,2661
"Bolivia","Santa Cruz","Andrés Ibáñez","Santa Cruz de la Sierra","COL. RODOLFO JOEM",-63.16545,-17.82204,1478,51,8097,9575,4736,285,3025,7761
"Bolivia","Santa Cruz","Andrés Ibáñez","Santa Cruz de la Sierra","COL.ROMULO HERRERA",-63.17609,-17.78023,217,5,1177,1394,840,29,303,1143
"Bolivia","Santa Cruz","Andrés Ibáñez","Santa Cruz de la Sierra","COL. SAGRADO CORAZON",-63.17153,-17.81605,139,5,937,1076,667,23,242,909
"Bolivia","Santa Cruz","Andrés Ibáñez","Santa Cruz de la Sierra","COL. SAN CARLOS",-63.15134,-17.79229,229,7,2142,2371,1689,94,352,2041
"Bolivia","Santa Cruz","Andrés Ibáñez","Santa Cruz de la Sierra","COL. SAN FRANCISCO DE SALES DON BOSCO",-63.0923,-17.76109,1196,51,7315,8511,5448,217,1599,7047
"Bolivia","Santa Cruz","Andrés Ibáñez","Santa Cruz de la Sierra","COL. SAN FRANCISCO SUR",-63.16087,-17.85275,562,26,3415,3977,1453,94,1842,3295
"Bolivia","Santa Cruz","Andrés Ibáñez","Santa Cruz de la Sierra","COL. SAN MARTIN DE PORRES",-63.2021,-17.77761,1088,30,7593,8681,4828,450,2285,7113
"Bolivia","Santa Cruz","Andrés Ibáñez","Santa Cruz de la Sierra","COL. SAN MARTIN NORTE",-63.14275,-17.7284,580,23,3799,4379,2529,217,1030,3559
"Bolivia","Santa Cruz","Andrés Ibáñez","Santa Cruz de la Sierra","COL. SAN PABLO",-63.18967,-17.83693,232,1,2029,2261,1671,29,328,1999
"Bolivia","Santa Cruz","Andrés Ibáñez","Santa Cruz de la Sierra","COL. SAN SILVESTRE",-63.11408,-17.81204,713,30,4262,4975,2053,119,2060,4113
"Bolivia","Santa Cruz","Andrés Ibáñez","Santa Cruz de la Sierra","COL. SANTA RAFAELA",-63.14124,-17.81471,378,44,2450,2828,1644,66,696,2340
"Bolivia","Santa Cruz","Andrés Ibáñez","Santa Cruz de la Sierra","COL. SECCIONAL MONSEÑOR SANTIESTEVAN",-63.18117,-17.77959,326,9,1516,1842,1195,25,287,1482
"Bolivia","Santa Cruz","Andrés Ibáñez","Santa Cruz de la Sierra","COL. SEFERINO NAMUCARA DON BOSCO",-63.17717,-17.77525,88,1,570,658,532,3,34,566
"Bolivia","Santa Cruz","Andrés Ibáñez","Santa Cruz de la Sierra","COL. SOCIEDAD DE INGENIEROS",-63.19918,-17.79882,427,8,3497,3924,2745,160,584,3329
"Bolivia","Santa Cruz","Andrés Ibáñez","Santa Cruz de la Sierra","COL. SOR MARIA CRISTINA PEREZ",-63.14532,-17.78059,1026,27,7718,8744,6347,174,1170,7517
"Bolivia","Santa Cruz","Andrés Ibáñez","Santa Cruz de la Sierra","COL.TECNOLOGICO SANTA CRUZ",-63.15675,-17.76927,192,8,1437,1629,1227,17,185,1412
"Bolivia","Santa Cruz","Andrés Ibáñez","Santa Cruz de la Sierra","COL. TRISTAN ROCA",-63.16394,-17.78412,376,11,2502,2878,1972,52,467,2439
"Bolivia","Santa Cruz","Andrés Ibáñez","Santa Cruz de la Sierra","COL.U.E.23 DE DICIEMBRE(J.  CARLOS TRUJI",-63.11529,-17.76983,847,40,4357,5204,3046,95,1176,4222
"Bolivia","Santa Cruz","Andrés Ibáñez","Santa Cruz de la Sierra","COL.U.E. 26 DE SEPTIEMBRE",-63.10361,-17.72374,994,45,5166,6160,2338,118,2665,5003
"Bolivia","Santa Cruz","Andrés Ibáñez","Santa Cruz de la Sierra","COL.U.E. ALFREDO BARBERY CHAVEZ",-63.11797,-17.75344,1039,47,6218,7257,3563,368,2240,5803
"Bolivia","Santa Cruz","Andrés Ibáñez","Santa Cruz de la Sierra","COL.U. E. CARLOS LA TORRE",-63.12363,-17.77396,515,47,3281,3796,2362,146,726,3088
"Bolivia","Santa Cruz","Andrés Ibáñez","Santa Cruz de la Sierra","COL.U.  E. EL DORADO NORTE",-63.09708,-17.73737,1662,45,8177,9839,4100,353,3679,7779
"Bolivia","Santa Cruz","Andrés Ibáñez","Santa Cruz de la Sierra","COL.U. E. EL RETOÑO",-63.07298,-17.73956,1068,34,5500,6568,3218,183,2065,5283
"Bolivia","Santa Cruz","Andrés Ibáñez","Santa Cruz de la Sierra","COL.U. E. ESCUELA ÑUFLO DE CHAVEZ",-63.15858,-17.74715,284,6,2043,2327,1766,43,228,1994
"Bolivia","Santa Cruz","Andrés Ibáñez","Santa Cruz de la Sierra","COL. U.E. LA RESURECCION -ESC.CONVIF",-63.17194,-17.7436,189,4,1609,1798,1478,10,117,1595
"Bolivia","Santa Cruz","Andrés Ibáñez","Santa Cruz de la Sierra","COL.U.E. NUEVO HORIZONTE",-63.10971,-17.73058,541,15,3152,3693,1403,265,1469,2872
"Bolivia","Santa Cruz","Andrés Ibáñez","Santa Cruz de la Sierra","COL.UNIDAD EDUCATIVA ESPAÑA",-63.11751,-17.77592,401,41,3081,3482,1827,141,1072,2899
"Bolivia","Santa Cruz","Andrés Ibáñez","Santa Cruz de la Sierra","COL. UNIDAD EDUCATIVA LA COLINA",-63.20247,-17.81842,705,25,4472,5177,2993,165,1289,4282
"Bolivia","Santa Cruz","Andrés Ibáñez","Santa Cruz de la Sierra","COL.UNIDAD EDUCATIVA LORENZO CABALLERO",-63.18774,-17.80008,241,8,1776,2017,1354,74,340,1694
"Bolivia","Santa Cruz","Andrés Ibáñez","Santa Cruz de la Sierra","COL.UNIDAD EDUCATIVA SAN JORGE",-63.10691,-17.83507,853,25,5194,6047,1655,299,3215,4870
"Bolivia","Santa Cruz","Andrés Ibáñez","Santa Cruz de la Sierra","COL. UV. LA MADRE",-63.21101,-17.78952,739,24,5166,5905,3851,183,1108,4959
"Bolivia","Santa Cruz","Andrés Ibáñez","Santa Cruz de la Sierra","COL.VENANCIO AQUINO VILLEGAS",-63.15873,-17.77472,176,1,1415,1591,1231,21,162,1393
"Bolivia","Santa Cruz","Andrés Ibáñez","Santa Cruz de la Sierra","COL. VICTOR PAZ ESTENSORO",-63.18661,-17.81709,729,26,4631,5360,2955,167,1483,4438
"Bolivia","Santa Cruz","Andrés Ibáñez","Santa Cruz de la Sierra","COL. VILLA ALEGRE",-63.17024,-17.87461,345,11,2083,2428,659,99,1314,1973
"Bolivia","Santa Cruz","Andrés Ibáñez","Santa Cruz de la Sierra","COL. VILLA BOLIVIA",-63.19029,-17.74906,746,17,3594,4340,2670,144,763,3433
"Bolivia","Santa Cruz","Andrés Ibáñez","Santa Cruz de la Sierra","COL. VILLA FATIMA",-63.20216,-17.81076,719,27,4231,4950,2904,118,1182,4086
"Bolivia","Santa Cruz","Andrés Ibáñez","Santa Cruz de la Sierra","COL. VILLA ROSARIO",-63.2086,-17.79646,787,24,3893,4680,2047,122,1700,3747
"Bolivia","Santa Cruz","Andrés Ibáñez","Santa Cruz de la Sierra","COL. VIRGEN DE COTOCA",-63.1789,-17.74445,463,14,3401,3864,2656,37,694,3350
"Bolivia","Santa Cruz","Andrés Ibáñez","Santa Cruz de la Sierra","COL.WENSESLAO MONTERO",-63.15583,-17.76315,370,12,2532,2902,2121,53,346,2467
"Bolivia","Santa Cruz","Andrés Ibáñez","Santa Cruz de la Sierra","ESC. APONTE TINEO(ESC.GREGORIO MORENO)",-63.18357,-17.76609,245,3,1632,1877,1412,54,163,1575
"Bolivia","Santa Cruz","Andrés Ibáñez","Santa Cruz de la Sierra","ESC.BERNARDO CADARIO(COL.KURT RICHTER)",-63.19029,-17.74906,537,11,2828,3365,2099,70,648,2747
"Bolivia","Santa Cruz","Andrés Ibáñez","Santa Cruz de la Sierra","ESC. CLARACUTA",-63.15587,-17.73351,342,10,2088,2430,1626,49,403,2029
"Bolivia","Santa Cruz","Andrés Ibáñez","Santa Cruz de la Sierra","ESC. GABRIEL JOSE MORENO",-62.94179,-17.88486,170,32,1584,1754,1141,42,369,1510
"Bolivia","Santa Cruz","Andrés Ibáñez","Santa Cruz de la Sierra","ESC. GERMAN BUSCH",-63.1716,-17.73681,401,6,2476,2877,1995,55,420,2415
"Bolivia","Santa Cruz","Andrés Ibáñez","Santa Cruz de la Sierra","ESC.HUGO BANZER SUAREZ",-63.1536,-17.88131,164,10,1245,1409,597,29,609,1206
"Bolivia","Santa Cruz","Andrés Ibáñez","Santa Cruz de la Sierra","ESC. JOSE MARIANO SERRANO",-63.16407,-17.72271,212,3,1279,1491,1103,12,161,1264
"Bolivia","Santa Cruz","Andrés Ibáñez","Santa Cruz de la Sierra","ESC. LA PEÑA",-62.96586,-17.96183,138,12,741,879,95,28,606,701
"Bolivia","Santa Cruz","Andrés Ibáñez","Santa Cruz de la Sierra","ESC LOS SAUCES I",-63.17955,-17.72833,408,10,2328,2736,1633,63,622,2255
"Bolivia","Santa Cruz","Andrés Ibáñez","Santa Cruz de la Sierra","ESC.MAMERTO CUELLAR COSTA",-63.16402,-17.69388,246,9,1758,2004,1254,46,449,1703
"Bolivia","Santa Cruz","Andrés Ibáñez","Santa Cruz de la Sierra","ESC. NORMAL ENRIQUET  FINOT",-63.19629,-17.76357,709,2,3948,4657,3621,20,305,3926
"Bolivia","Santa Cruz","Andrés Ibáñez","Santa Cruz de la Sierra","ESC. REAL AMERICA(ESC.F.FLORIDA)",-63.14962,-17.74375,237,4,1785,2022,1336,27,418,1754
"Bolivia","Santa Cruz","Andrés Ibáñez","Santa Cruz de la Sierra","ESC. RENE BARRIENTOS",-63.19794,-17.77104,590,10,3093,3683,2349,44,690,3039
"Bolivia","Santa Cruz","Andrés Ibáñez","Santa Cruz de la Sierra","ESC. SECCIONAL VILLA FLOR",-63.12761,-17.91508,92,11,643,735,324,20,288,612
"Bolivia","Santa Cruz","Andrés Ibáñez","Santa Cruz de la Sierra","ESC.SOLIDARIDAD 55",-63.09384,-17.88467,644,32,4023,4667,1800,199,1992,3792
"Bolivia","Santa Cruz","Andrés Ibáñez","Santa Cruz de la Sierra","ESCUELA 1RO DE MAYO",-63.12766,-17.79881,226,7,1399,1625,1031,62,299,1330
"Bolivia","Santa Cruz","Andrés Ibáñez","Santa Cruz de la Sierra","ESCUELA 23 DE MARZO",-63.14704,-17.71829,544,17,2990,3534,1885,104,984,2869
"Bolivia","Santa Cruz","Andrés Ibáñez","Santa Cruz de la Sierra","ESCUELA ADOLFO ROMAN HIJO",-62.82351,-17.6432,180,9,1323,1503,805,61,448,1253
"Bolivia","Santa Cruz","Andrés Ibáñez","Santa Cruz de la Sierra","ESCUELA CANOTO",-63.19444,-17.78442,162,3,1077,1239,867,14,193,1060
"Bolivia","Santa Cruz","Andrés Ibáñez","Santa Cruz de la Sierra","ESCUELA KM 9",-63.15509,-17.6916,574,11,3766,4340,2661,110,984,3645
"Bolivia","Santa Cruz","Andrés Ibáñez","Santa Cruz de la Sierra","ESCUELA NUEVA AURORA",-62.8249,-17.57719,40,0,63,103,48,3,12,60
"Bolivia","Santa Cruz","Andrés Ibáñez","Santa Cruz de la Sierra","ESCUELA PRIMAVERA",-63.1032,-17.81673,121,7,508,629,337,11,153,490
"Bolivia","Santa Cruz","Andrés Ibáñez","Santa Cruz de la Sierra","ESCUELA SAN CARLOS",-63.18186,-17.7572,467,7,2738,3205,2256,39,436,2692
"Bolivia","Santa Cruz","Andrés Ibáñez","Santa Cruz de la Sierra","ESCUELA SAN JOAQUIN",-63.13668,-17.72238,354,15,2179,2533,1317,129,718,2035
"Bolivia","Santa Cruz","Andrés Ibáñez","Santa Cruz de la Sierra","ESCUELA SECCIONAL GUAPILO",-63.08126,-17.74644,401,16,2227,2628,1374,81,756,2130
"Bolivia","Santa Cruz","Andrés Ibáñez","Santa Cruz de la Sierra","ESCUELA SECCIONAL ZAFRANILLA",-63.00508,-17.62794,43,2,314,357,199,9,104,303
"Bolivia","Santa Cruz","Andrés Ibáñez","Santa Cruz de la Sierra","ESC. USURI APONTE",-63.05743,-17.92564,60,2,218,278,132,7,77,209
"Bolivia","Santa Cruz","Andrés Ibáñez","Santa Cruz de la Sierra","ESC VILLA NORTE",-63.18038,-17.74704,265,5,1467,1732,1193,13,256,1449
"Bolivia","Santa Cruz","Andrés Ibáñez","Santa Cruz de la Sierra","ESC..ZENOVIA APONTE",-63.10257,-17.87117,277,11,1687,1964,782,39,855,1637
"Bolivia","Santa Cruz","Andrés Ibáñez","Santa Cruz de la Sierra","FACULTAD DE CIENCIAS AGRICOLAS UAGRM",-63.14874,-17.69814,22,2,303,325,207,8,86,293
"Bolivia","Santa Cruz","Andrés Ibáñez","Santa Cruz de la Sierra","FRED NUÑEZ GONZALES",-63.06961,-17.71776,88,9,1011,1099,453,26,523,976
"Bolivia","Santa Cruz","Andrés Ibáñez","Santa Cruz de la Sierra","GLADYS RIVERO DE JIMENEZ",-63.20806,-17.77348,469,14,3062,3531,2000,229,819,2819
"Bolivia","Santa Cruz","Andrés Ibáñez","Santa Cruz de la Sierra","KINDER CARIÑOSITO",-63.21444,-17.8494,1,0,3,4,2,0,1,3
"Bolivia","Santa Cruz","Andrés Ibáñez","Santa Cruz de la Sierra","KINDER FERROVIARIO",-63.145,-17.781,2,0,19,21,12,0,7,19
"Bolivia","Santa Cruz","Andrés Ibáñez","Santa Cruz de la Sierra","KINDER GUARDERIA EL CARMEN",-63.20383,-17.77054,1,1,48,49,39,2,6,45
"Bolivia","Santa Cruz","Andrés Ibáñez","Santa Cruz de la Sierra","KINDER LIBERTAD",-63.12066,-17.80011,0,0,9,9,7,1,1,8
"Bolivia","Santa Cruz","Andrés Ibáñez","Santa Cruz de la Sierra","KINDER LUISA SAUCEDO",-63.18323,-17.77909,103,0,758,861,677,5,76,753
"Bolivia","Santa Cruz","Andrés Ibáñez","Santa Cruz de la Sierra","KINDER NIMIA CENTELLA",-63.11775,-17.78436,0,0,45,45,31,10,4,35
"Bolivia","Santa Cruz","Andrés Ibáñez","Santa Cruz de la Sierra","LUZ DEL MUNDO C",-63.1118,-17.77199,10,0,142,152,98,0,44,142
"Bolivia","Santa Cruz","Andrés Ibáñez","Santa Cruz de la Sierra","MISIONES DE JESUS",-63.21696,-17.84764,0,1,285,285,130,53,101,231
"Bolivia","Santa Cruz","Andrés Ibáñez","Santa Cruz de la Sierra","MODULO EDUCATIVO 24 DE SEPTIEMBRE",-63.20504,-17.81955,28,1,110,138,73,4,32,105
"Bolivia","Santa Cruz","Andrés Ibáñez","Santa Cruz de la Sierra","MODULO EDUCATIVO 3 LAGUNAS",-63.1305,-17.80221,286,14,1915,2201,1082,40,779,1861
"Bolivia","Santa Cruz","Andrés Ibáñez","Santa Cruz de la Sierra","MODULO EDUCATIVO CENETROP",-63.17531,-17.86828,6,0,53,59,32,1,20,52
"Bolivia","Santa Cruz","Andrés Ibáñez","Santa Cruz de la Sierra","MODULO EDUCATIVO GERMAN BUSCH",-63.17423,-17.73516,13,2,151,164,126,2,21,147
"Bolivia","Santa Cruz","Andrés Ibáñez","Santa Cruz de la Sierra","MODULO EDUCATIVO JARDIN LATINO",-63.22685,-17.81104,0,0,65,65,52,3,10,62
"Bolivia","Santa Cruz","Andrés Ibáñez","Santa Cruz de la Sierra","MODULO EDUCATIVO JOSE MIGUEL DE VELASCO",-63.18459,-17.75368,703,54,4506,5209,3568,115,769,4337
"Bolivia","Santa Cruz","Andrés Ibáñez","Santa Cruz de la Sierra","MODULO EDUCATIVO MARIA DE MATTIAS",-63.19329,-17.84451,5,0,79,84,57,1,21,78
"Bolivia","Santa Cruz","Andrés Ibáñez","Santa Cruz de la Sierra","MODULO EDUCATIVO REPUBLICA DE COLOMBIA",-63.20602,-17.86002,18,4,196,214,84,0,108,192
"Bolivia","Santa Cruz","Andrés Ibáñez","Santa Cruz de la Sierra","MODULO RANCHO NUEVO",-63.12128,-17.74573,256,9,1188,1444,735,28,416,1151
"Bolivia","Santa Cruz","Andrés Ibáñez","Santa Cruz de la Sierra","MOTACUSAL",-63.10342,-17.68219,0,1,176,176,14,46,115,129
"Bolivia","Santa Cruz","Andrés Ibáñez","Santa Cruz de la Sierra","NACIONES UNIDAS",-63.17759,-17.7325,532,11,3355,3887,2418,150,776,3194
"Bolivia","Santa Cruz","Andrés Ibáñez","Santa Cruz de la Sierra","PEDRO DIEZ",-63.18398,-17.85394,31,0,133,164,83,2,48,131
"Bolivia","Santa Cruz","Andrés Ibáñez","Santa Cruz de la Sierra","PROGRESO",-63.13077,-17.72208,27,1,147,174,99,4,43,142
"Bolivia","Santa Cruz","Andrés Ibáñez","Santa Cruz de la Sierra","SAHARA GUARDIA",-63.20287,-17.85209,35,7,616,651,413,32,164,577
"Bolivia","Santa Cruz","Andrés Ibáñez","Santa Cruz de la Sierra","U.E. 18 DE JULIO",-63.0932,-17.7454,149,7,1028,1177,520,59,442,962
"Bolivia","Santa Cruz","Andrés Ibáñez","Santa Cruz de la Sierra","U.E 19 DE MARZO",-63.08685,-17.86819,16,1,294,310,91,1,201,292
"Bolivia","Santa Cruz","Andrés Ibáñez","Santa Cruz de la Sierra","U.E. 24 DE MARZO",-63.10131,-17.72942,16,1,153,169,51,6,95,146
"Bolivia","Santa Cruz","Andrés Ibáñez","Santa Cruz de la Sierra","U.E. 25 DE OCTUBRE",-63.0919,-17.81277,29,1,294,323,117,38,138,255
"Bolivia","Santa Cruz","Andrés Ibáñez","Santa Cruz de la Sierra","U.E. 26 DE JUNIO",-63.10215,-17.84533,37,2,245,282,100,9,134,234
"Bolivia","Santa Cruz","Andrés Ibáñez","Santa Cruz de la Sierra","U.E. 26 DE NOVIEMBRE",-63.13193,-17.73059,9,0,91,100,62,1,28,90
"Bolivia","Santa Cruz","Andrés Ibáñez","Santa Cruz de la Sierra","U.E. 2 DE ABRIL",-63.14366,-17.81759,17,1,111,128,86,3,21,107
"Bolivia","Santa Cruz","Andrés Ibáñez","Santa Cruz de la Sierra","UE 3 DE MAYO",-63.12704,-17.82614,95,7,635,730,284,19,325,609
"Bolivia","Santa Cruz","Andrés Ibáñez","Santa Cruz de la Sierra","U.E. APONTE DE JORORI",-63.02875,-17.88749,122,15,709,831,249,40,405,654
"Bolivia","Santa Cruz","Andrés Ibáñez","Santa Cruz de la Sierra","U.E. ARBOLEDA DE FATIMA",-63.09396,-17.77194,60,7,638,698,386,63,182,568
"Bolivia","Santa Cruz","Andrés Ibáñez","Santa Cruz de la Sierra","U.E. ARCA DE NOE",-63.0994,-17.74709,0,39,1073,1073,561,123,350,911
"Bolivia","Santa Cruz","Andrés Ibáñez","Santa Cruz de la Sierra","U.E. BIBOSI",-63.10976,-17.72477,16,1,109,125,53,2,53,106
"Bolivia","Santa Cruz","Andrés Ibáñez","Santa Cruz de la Sierra","U.E. CIELITO LINDO",-63.10667,-17.77039,97,39,1192,1289,746,61,346,1092
"Bolivia","Santa Cruz","Andrés Ibáñez","Santa Cruz de la Sierra","U.E. CLARA SERRANO",-63.06764,-17.69809,10,2,136,146,66,0,68,134
"Bolivia","Santa Cruz","Andrés Ibáñez","Santa Cruz de la Sierra","UE DOMINGO FAUSTINO",-63.1547,-17.78424,203,11,1367,1570,1142,21,193,1335
"Bolivia","Santa Cruz","Andrés Ibáñez","Santa Cruz de la Sierra","U.E. EL ARENAL C",-63.12381,-17.76286,0,3,29,29,10,0,16,26
"Bolivia","Santa Cruz","Andrés Ibáñez","Santa Cruz de la Sierra","U.E. HACIA LA CUMBRE",-63.13114,-17.79115,15,0,67,82,52,0,15,67
"Bolivia","Santa Cruz","Andrés Ibáñez","Santa Cruz de la Sierra","U.E. ISUTO",-63.19371,-17.74409,77,1,524,601,385,16,122,507
"Bolivia","Santa Cruz","Andrés Ibáñez","Santa Cruz de la Sierra","U.E. JOSEFINA BALSAMO CORDECRUZ",-63.13193,-17.73059,2,0,25,27,20,2,3,23
"Bolivia","Santa Cruz","Andrés Ibáñez","Santa Cruz de la Sierra","U.E. JOSEFINA BALSAMO LOS PINOS",-63.13827,-17.73302,10,3,107,117,67,0,37,104
"Bolivia","Santa Cruz","Andrés Ibáñez","Santa Cruz de la Sierra","U.E. LOS CUSIS",-63.07648,-17.73135,106,9,849,955,516,58,266,782
"Bolivia","Santa Cruz","Andrés Ibáñez","Santa Cruz de la Sierra","U.E. LUIS ANTONIO AÑEZ CAMPOS",-63.12105,-17.83816,18,0,117,135,49,4,64,113
"Bolivia","Santa Cruz","Andrés Ibáñez","Santa Cruz de la Sierra","U.E. MANANTIAL DE VIDA",-63.07259,-17.85223,64,8,804,868,307,17,472,779
"Bolivia","Santa Cruz","Andrés Ibáñez","Santa Cruz de la Sierra","U.E. MANOS UNIDAS",-63.12869,-17.83705,6,0,30,36,13,1,16,29
"Bolivia","Santa Cruz","Andrés Ibáñez","Santa Cruz de la Sierra","U.E. MARIA DE LAS CANDELARIAS",-63.11254,-17.78087,0,0,3,3,3,0,0,3
"Bolivia","Santa Cruz","Andrés Ibáñez","Santa Cruz de la Sierra","U.E. MATEO KULJIS LLIC II",-63.22541,-17.83761,19,2,65,84,35,3,25,60
"Bolivia","Santa Cruz","Andrés Ibáñez","Santa Cruz de la Sierra","U.E. MIGUEL APONTE",-63.02794,-17.93152,1,0,3,4,3,0,0,3
"Bolivia","Santa Cruz","Andrés Ibáñez","Santa Cruz de la Sierra","U.E. NESTOR PAZ ZAMORA",-63.16751,-17.82976,35,5,249,284,157,2,85,242
"Bolivia","Santa Cruz","Andrés Ibáñez","Santa Cruz de la Sierra","U.E. PALMAR DEL ORIENTE",-63.16326,-17.84556,0,0,38,38,23,4,11,34
"Bolivia","Santa Cruz","Andrés Ibáñez","Santa Cruz de la Sierra","U.E. PASTORCITO DE FÁTIMA (DON BOSCO)",-63.19865,-17.77891,5,0,32,37,27,0,5,32
"Bolivia","Santa Cruz","Andrés Ibáñez","Santa Cruz de la Sierra","U.E. REP. DEL PARAGUAY",-63.19029,-17.74906,9,0,74,83,38,6,30,68
"Bolivia","Santa Cruz","Andrés Ibáñez","Santa Cruz de la Sierra","U.E. SAN CAYETANO",-63.08637,-17.73178,122,9,946,1068,529,14,394,923
"Bolivia","Santa Cruz","Andrés Ibáñez","Santa Cruz de la Sierra","U.E. SAN DIEGO DE SAMARIA",-63.07624,-17.84651,39,0,237,276,99,3,135,234
"Bolivia","Santa Cruz","Andrés Ibáñez","Santa Cruz de la Sierra","U.E. SAN JUAN BAUTISTA",-63.084,-17.82422,27,2,323,350,143,9,169,312
"Bolivia","Santa Cruz","Andrés Ibáñez","Santa Cruz de la Sierra","U.E. SAN JUAN DEL ESTE",-63.05619,-17.85738,15,1,80,95,36,2,41,77
"Bolivia","Santa Cruz","Andrés Ibáñez","Santa Cruz de la Sierra","U.E. SAN MIGUEL APONTE",-63.02491,-17.91358,4,6,133,137,73,2,52,125
"Bolivia","Santa Cruz","Andrés Ibáñez","Santa Cruz de la Sierra","U.E. SANTA ANA C",-63.22587,-17.82052,19,0,118,137,66,2,50,116
"Bolivia","Santa Cruz","Andrés Ibáñez","Santa Cruz de la Sierra","U.E. SANTA CRUZ DE LA SIERRA",-63.15969,-17.70646,415,6,3367,3782,2847,58,456,3303
"Bolivia","Santa Cruz","Andrés Ibáñez","Santa Cruz de la Sierra","U.E. SEÑOR DE LOS MILAGROS",-63.11103,-17.73937,0,0,124,124,69,12,43,112
"Bolivia","Santa Cruz","Andrés Ibáñez","Santa Cruz de la Sierra","U.E. SIXTO SUAREZ NAVARRO",-63.08702,-17.83393,23,7,321,344,119,8,187,306
"Bolivia","Santa Cruz","Andrés Ibáñez","Santa Cruz de la Sierra","U.E. SIXTO SUAREZ NAVARRO",-63.08702,-17.83391,23,7,321,344,119,8,187,306
"Bolivia","Santa Cruz","Andrés Ibáñez","Santa Cruz de la Sierra","U.E. THEVENET DE VIANA",-63.05536,-17.87156,17,7,275,292,122,5,141,263
"Bolivia","Santa Cruz","Andrés Ibáñez","Santa Cruz de la Sierra","UE UNION Y PROGRESO",-63.20576,-17.82713,633,27,3331,3964,1659,127,1518,3177
"Bolivia","Santa Cruz","Andrés Ibáñez","Santa Cruz de la Sierra","U.E. VICTORIA",-63.10123,-17.8158,35,1,113,148,55,1,56,111
"Bolivia","Santa Cruz","Andrés Ibáñez","Santa Cruz de la Sierra","U.E. VICTORIA DIEZ",-63.19228,-17.87336,2,0,37,39,21,5,11,32
"Bolivia","Santa Cruz","Andrés Ibáñez","Santa Cruz de la Sierra","U.E. VILLA ALBA",-63.11149,-17.76056,4,1,12,16,7,0,4,11
"Bolivia","Santa Cruz","Andrés Ibáñez","Santa Cruz de la Sierra","U.E. VILLA MODERNA",-63.08892,-17.84801,59,10,444,503,158,7,269,427
"Bolivia","Santa Cruz","Andrés Ibáñez","Santa Cruz de la Sierra","U.E. ZARAGOZA",-63.0803,-17.73039,71,5,839,910,460,27,347,807
"Bolivia","Santa Cruz","Andrés Ibáñez","Santa Cruz de la Sierra","UNIDAD EDUCATIVA POMPEYA SANTISIMO REDENTOR",-63.13646,-17.73572,1180,25,6120,7300,3745,175,2175,5920
"Bolivia","Santa Cruz","Andrés Ibáñez","Santa Cruz de la Sierra","UNIDAD EDUCATIVA SAN JORGE NORTE",-63.18151,-17.74152,366,6,2032,2398,1567,47,412,1979
"Bolivia","Santa Cruz","Andrés Ibáñez","Santa Cruz de la Sierra","UNIDAD EDUCATIVA SAN JUAN",-63.15163,-17.71595,101,5,661,762,458,19,179,637
"Bolivia","Santa Cruz","Andrés Ibáñez","Santa Cruz de la Sierra","UNIVERSITARIO SUR",-63.20155,-17.84228,11,2,203,214,138,10,53,191
"Bolivia","Santa Cruz","Andrés Ibáñez","Santa Cruz de la Sierra","URKUPIÑA",-63.10837,-17.74188,39,51,579,618,278,20,230,508
"Bolivia","Santa Cruz","Andrés Ibáñez","Santa Cruz de la Sierra","VIRGEN DE GUADALUPE",-63.12177,-17.72815,178,21,1962,2140,1155,89,697,1852
"Bolivia","Santa Cruz","Ángel Sandoval","San Matías","ESC. BENJAMIN CATACORA",-59.44956,-16.31998,104,6,544,648,294,40,204,498
"Bolivia","Santa Cruz","Ángel Sandoval","San Matías","ESC. LAS PETAS",-58.39948,-16.36022,94,4,318,412,206,3,105,311
"Bolivia","Santa Cruz","Ángel Sandoval","San Matías","ESC. SAN FERNANDO",-58.50947,-17.16588,29,0,41,70,32,0,9,41
"Bolivia","Santa Cruz","Ángel Sandoval","San Matías","ESC. SANTA ISABEL",-58.64299,-16.41756,15,0,96,111,24,1,71,95
"Bolivia","Santa Cruz","Ángel Sandoval","San Matías","ESC. SANTO CORAZON",-58.80663,-17.97362,65,1,218,283,144,3,70,214
"Bolivia","Santa Cruz","Ángel Sandoval","San Matías","ESC. SECCIONAL CANDELARIA",-58.98688,-18.62612,92,1,259,351,132,5,121,253
"Bolivia","Santa Cruz","Ángel Sandoval","San Matías","ESC. U.E. EMILIA RODAT",-58.40152,-16.35967,635,77,2354,2989,1139,27,1111,2250
"Bolivia","Santa Cruz","Ángel Sandoval","San Matías","ESC. U.E.TECNICA VOCACIONAL",-58.40529,-16.36109,559,83,1882,2441,855,36,908,1763
"Bolivia","Santa Cruz","Chiquitos","Pailón","ESC. 25 DE MAYO (CHIQUITOS)",-62.72187,-17.665,7,2,97,104,18,4,73,91
"Bolivia","Santa Cruz","Chiquitos","Pailón","ESC. 3 DE MAYO",-62.71723,-17.65756,240,24,1005,1245,435,32,514,949
"Bolivia","Santa Cruz","Chiquitos","Pailón","ESC. EL TINTO",-61.51249,-17.66647,41,1,104,145,58,2,43,101
"Bolivia","Santa Cruz","Chiquitos","Pailón","ESC. EMILIO SUNCER SALINAS",-61.98844,-17.60188,99,4,358,457,159,6,189,348
"Bolivia","Santa Cruz","Chiquitos","Pailón","ESC. FE ALEGRIA",-62.72065,-17.65843,1615,81,7072,8687,4100,231,2660,6760
"Bolivia","Santa Cruz","Chiquitos","Pailón","ESC. MUNICIPAL ROSAL CENTRO",-62.68006,-17.93407,80,3,517,597,281,14,219,500
"Bolivia","Santa Cruz","Chiquitos","Pailón","ESC. POZA VERDE",-62.70517,-17.71927,18,0,93,111,17,3,73,90
"Bolivia","Santa Cruz","Chiquitos","Pailón","ESC. PUESTO PAZ",-62.44294,-17.48613,0,2,75,75,20,15,38,58
"Bolivia","Santa Cruz","Chiquitos","Pailón","ESC. SECCIONAL CAÑADA LARGA",-62.49146,-17.64193,57,2,278,335,167,2,107,274
"Bolivia","Santa Cruz","Chiquitos","Pailón","ESCUELA TUNAS NUEVO",-61.71287,-17.63908,195,9,605,800,105,8,483,588
"Bolivia","Santa Cruz","Chiquitos","Pailón","U.E. 12 DE OCTUBRE",-61.51058,-17.54329,0,1,39,39,26,0,12,38
"Bolivia","Santa Cruz","Chiquitos","Pailón","U.E. ING. JORGE MAURICIO ROJAS P.",-62.76874,-17.66311,9,3,129,138,85,4,37,122
"Bolivia","Santa Cruz","Chiquitos","Roboré","ESC. DON BOSCO",-59.75139,-18.33508,506,10,1459,1965,962,17,470,1432
"Bolivia","Santa Cruz","Chiquitos","Roboré","ESC. GUIDO OSWALDO SUANZO",-59.75161,-18.33875,343,17,1223,1566,824,15,367,1191
"Bolivia","Santa Cruz","Chiquitos","Roboré","ESC. LOS SOTOS",-59.8557,-18.24889,19,0,90,109,38,1,51,89
"Bolivia","Santa Cruz","Chiquitos","Roboré","ESC. MARISTA",-59.75665,-18.34039,455,11,1400,1855,909,18,462,1371
"Bolivia","Santa Cruz","Chiquitos","Roboré","ESC. NAPOLEON MONTERO MONTERO",-59.59888,-18.33945,176,7,616,792,463,5,141,604
"Bolivia","Santa Cruz","Chiquitos","Roboré","ESC. SAGRADA FAMILIA",-59.75781,-18.33087,484,17,1757,2241,1185,43,512,1697
"Bolivia","Santa Cruz","Chiquitos","Roboré","ESC. SAN ANTONIO DEL POTRERO",-59.74802,-18.342,8,1,45,53,13,1,30,43
"Bolivia","Santa Cruz","Chiquitos","Roboré","ESC. SECCIONAL AGUAS CALIENTES",-59.50294,-18.45304,55,5,346,401,108,12,221,329
"Bolivia","Santa Cruz","Chiquitos","Roboré","ESC.SECCIONAL CHOCHIS",-60.03102,-18.14897,94,3,453,547,350,8,92,442
"Bolivia","Santa Cruz","Chiquitos","San José de Chiquitos","ESC. EDUCACIONAL TAPERAS",-62.70883,-17.65825,113,6,445,558,267,8,164,431
"Bolivia","Santa Cruz","Chiquitos","San José de Chiquitos","ESC. GERMAN BUSCH",-60.74323,-17.84692,794,15,2574,3368,1633,53,873,2506
"Bolivia","Santa Cruz","Chiquitos","San José de Chiquitos","ESC. LEONOR RIVERA",-60.7432,-17.83881,673,19,2279,2952,1367,33,860,2227
"Bolivia","Santa Cruz","Chiquitos","San José de Chiquitos","ESC.MUNICIPAL",-61.17406,-17.70868,29,1,233,262,140,4,88,228
"Bolivia","Santa Cruz","Chiquitos","San José de Chiquitos","ESC. NUEVO HORIZONTE",-60.73072,-17.43794,0,15,75,75,40,0,20,60
"Bolivia","Santa Cruz","Chiquitos","San José de Chiquitos","ESC. SAN JUAN",-59.93511,-17.77805,129,6,304,433,169,1,128,297
"Bolivia","Santa Cruz","Chiquitos","San José de Chiquitos","ESC. SANTA TERESITA",-60.49098,-17.94919,0,0,13,13,0,0,13,13
"Bolivia","Santa Cruz","Chiquitos","San José de Chiquitos","ESC. UNZAGA DE LA VEGA",-60.73931,-17.84642,603,63,2603,3206,1663,52,825,2488
"Bolivia","Santa Cruz","Chiquitos","San José de Chiquitos","U.E. BUENA VISTA",-59.97245,-17.82214,12,2,166,178,98,3,63,161
"Bolivia","Santa Cruz","Chiquitos","San José de Chiquitos","U.E. RAMADA",-60.05825,-18.00214,2,1,41,43,22,1,17,39
"Bolivia","Santa Cruz","Cordillera","Boyuibe","ESC. CENTRAL RAFAEL PABON",-63.28176,-20.43133,615,20,1770,2385,806,55,889,1695
"Bolivia","Santa Cruz","Cordillera","Boyuibe","ESC. SECC. CHOROQUETAL LA ELE",-62.71613,-20.43031,11,0,13,24,8,0,5,13
"Bolivia","Santa Cruz","Cordillera","Boyuibe","ESC. SECC. POZO DE MONTE",-63.21899,-20.28442,0,1,85,85,25,13,46,71
"Bolivia","Santa Cruz","Cordillera","Cabezas","ESC. 12 DE ABRIL",-63.21368,-18.45699,296,37,1584,1880,796,61,690,1486
"Bolivia","Santa Cruz","Cordillera","Cabezas","ESC. COTOCA (CORDILLERA)",-63.19016,-18.28279,10,1,82,92,65,1,15,80
"Bolivia","Santa Cruz","Cordillera","Cabezas","ESC. EDUARDO ABAROA",-63.42406,-18.29929,20,2,178,198,77,25,74,151
"Bolivia","Santa Cruz","Cordillera","Cabezas","ESC. PAMPA DEL COSCAL",-63.31197,-18.78212,48,2,226,274,68,10,146,214
"Bolivia","Santa Cruz","Cordillera","Cabezas","ESC. PTO. CAMACHO",-63.39868,-18.90593,301,26,1630,1931,899,68,637,1536
"Bolivia","Santa Cruz","Cordillera","Cabezas","ESC. RIO SECO FLORIDA",-63.24144,-18.67221,93,3,413,506,207,28,175,382
"Bolivia","Santa Cruz","Cordillera","Cabezas","ESC. SANTA ROSA",-63.00379,-18.31618,30,3,145,175,74,1,67,141
"Bolivia","Santa Cruz","Cordillera","Cabezas","ESC. SECC. EL CURICHI",-63.18411,-18.36359,15,0,105,120,68,6,31,99
"Bolivia","Santa Cruz","Cordillera","Cabezas","ESC. SECCIONAL EL FILO",-63.31801,-18.78696,0,1,22,22,20,0,1,21
"Bolivia","Santa Cruz","Cordillera","Cabezas","ESC. SECCIONAL PUEBLO VIEJO",-63.32113,-18.79173,66,8,221,287,116,2,95,211
"Bolivia","Santa Cruz","Cordillera","Cabezas","ESC. SECC SAN FRANCISCO DE ASIS",-62.9499,-18.13124,75,8,297,372,97,11,181,278
"Bolivia","Santa Cruz","Cordillera","Cabezas","ESC. SERAFIN RODRIGUEZ",-63.31145,-18.78667,419,19,1402,1821,760,94,529,1289
"Bolivia","Santa Cruz","Cordillera","Cabezas","ESC. YATIRENDA",-63.22488,-18.60128,11,3,196,207,147,4,42,189
"Bolivia","Santa Cruz","Cordillera","Cabezas","ESC. ZANJA HONDA",-63.30159,-18.78745,219,23,1238,1457,611,41,563,1174
"Bolivia","Santa Cruz","Cordillera","Camiri","AULAS U.A.G.R.M.",-63.52124,-20.03783,635,37,2928,3563,1600,107,1184,2784
"Bolivia","Santa Cruz","Cordillera","Camiri","COL. HUGO ARTEAGA",-63.51498,-20.03587,214,14,968,1182,600,25,329,929
"Bolivia","Santa Cruz","Cordillera","Camiri","ESC. 12 DE JULIO",-63.53097,-20.04149,431,27,2244,2675,1228,122,867,2095
"Bolivia","Santa Cruz","Cordillera","Camiri","ESC. 16 DE MARZO",-63.52925,-20.04896,254,22,1233,1487,640,50,521,1161
"Bolivia","Santa Cruz","Cordillera","Camiri","ESC. 24 DE SEPTIEMBRE",-63.5203,-20.04004,370,17,1891,2261,1173,60,641,1814
"Bolivia","Santa Cruz","Cordillera","Camiri","ESC. ABEL ITURRALDE",-63.52305,-20.04487,309,11,1455,1764,906,35,503,1409
"Bolivia","Santa Cruz","Cordillera","Camiri","ESC. APONTE J. MANUEL O.H. DEL CHACO",-63.52154,-20.04499,240,15,1528,1768,949,36,528,1477
"Bolivia","Santa Cruz","Cordillera","Camiri","ESC. CENTRAL DE ITANAMBIKUA",-63.51152,-20.01815,70,15,484,554,109,26,334,443
"Bolivia","Santa Cruz","Cordillera","Camiri","ESC. CENTRAL URBANA",-63.53619,-20.01045,231,14,718,949,327,20,357,684
"Bolivia","Santa Cruz","Cordillera","Camiri","ESC. CRISTIANA EVANGELICA",-63.52061,-20.04179,153,7,889,1042,590,17,275,865
"Bolivia","Santa Cruz","Cordillera","Camiri","ESC. GABRIEL RENE MORENO",-63.52212,-20.03892,393,15,1646,2039,957,42,632,1589
"Bolivia","Santa Cruz","Cordillera","Camiri","ESC. JOSE CASTRILLO",-63.52077,-20.03724,301,18,1404,1705,708,42,636,1344
"Bolivia","Santa Cruz","Cordillera","Camiri","ESC. NIÑO JESUS",-63.51853,-20.04194,165,7,916,1081,635,21,253,888
"Bolivia","Santa Cruz","Cordillera","Camiri","ESC. SECC. CURUNDAITY",-63.52541,-19.96275,39,5,284,323,44,4,231,275
"Bolivia","Santa Cruz","Cordillera","Camiri","ESC. SECC. GUIRARAPO",-63.48684,-20.09914,18,2,120,138,41,5,72,113
"Bolivia","Santa Cruz","Cordillera","Camiri","ESC. SECC. IMBOCHI",-63.51324,-20.06726,19,9,114,133,36,3,66,102
"Bolivia","Santa Cruz","Cordillera","Camiri","ESC. SECCIONAL EL RODEO",-63.41266,-19.96312,31,9,205,236,31,13,152,183
"Bolivia","Santa Cruz","Cordillera","Camiri","ESC. SECCIONAL PIPI",-63.42315,-20.08308,37,2,147,184,22,2,121,143
"Bolivia","Santa Cruz","Cordillera","Camiri","ESC. SECC. PUENTE VIEJO",-63.54469,-20.01106,36,9,185,221,49,5,122,171
"Bolivia","Santa Cruz","Cordillera","Charagua","ESC. 25 DE MAYO",-62.11812,-18.4546,47,0,79,126,12,1,66,78
"Bolivia","Santa Cruz","Cordillera","Charagua","ESC. CENTRAL IYOBI",-63.14491,-19.7853,129,14,596,725,249,13,320,569
"Bolivia","Santa Cruz","Cordillera","Charagua","ESC. COOPERE BRECHA",-62.7429,-19.42522,146,6,419,565,105,14,294,399
"Bolivia","Santa Cruz","Cordillera","Charagua","ESC. ENRIQUE QUINTELA",-63.18414,-20.00909,116,10,549,665,228,14,297,525
"Bolivia","Santa Cruz","Cordillera","Charagua","ESC. ESTACION CHARAGUA",-63.1487,-19.78266,181,15,819,1000,392,22,390,782
"Bolivia","Santa Cruz","Cordillera","Charagua","ESC. NUCLEO ESCOLAR LA BRECHA",-62.7429,-19.42522,150,8,547,697,188,10,341,529
"Bolivia","Santa Cruz","Cordillera","Charagua","ESC. NUEVA ESPERANZA",-63.20002,-19.79183,53,0,84,137,19,1,64,83
"Bolivia","Santa Cruz","Cordillera","Charagua","ESC. OKITA",-63.2003,-19.79011,16,2,72,88,10,0,60,70
"Bolivia","Santa Cruz","Cordillera","Charagua","ESC. PUEBLO NUEVO PARAPETI",-63.13974,-19.98935,31,3,163,194,63,8,89,152
"Bolivia","Santa Cruz","Cordillera","Charagua","ESC. SECC. CENTRAL MASAVI",-63.19563,-19.79061,63,14,348,411,84,9,241,325
"Bolivia","Santa Cruz","Cordillera","Charagua","ESC. SECC. DE KAIPEPE",-63.19104,-19.79076,29,5,264,293,72,7,180,252
"Bolivia","Santa Cruz","Cordillera","Charagua","ESC. SECC. EL ESPINO",-63.32734,-19.21872,47,8,394,441,54,8,324,378
"Bolivia","Santa Cruz","Cordillera","Charagua","ESC. SECC. HUARIRENDA NUEVA",-63.19857,-19.78299,120,7,310,430,104,6,193,297
"Bolivia","Santa Cruz","Cordillera","Charagua","ESC. SECCIONAL ISIPORENDA",-62.5005,-19.24791,49,0,112,161,28,2,82,110
"Bolivia","Santa Cruz","Cordillera","Charagua","ESC. SECCIONAL ITATIQUE",-63.17703,-19.99888,11,0,82,93,8,1,73,81
"Bolivia","Santa Cruz","Cordillera","Charagua","ESC. SECCIONAL SAN F. DE PARAPETI",-63.17523,-19.99946,36,7,144,180,43,2,92,135
"Bolivia","Santa Cruz","Cordillera","Charagua","ESC. SECCIONAL SAN LORENZO",-63.12445,-19.649,19,0,87,106,36,4,47,83
"Bolivia","Santa Cruz","Cordillera","Charagua","ESC. SECC. RANCHO NUEVO",-63.1832,-20.01321,117,18,387,504,160,11,198,358
"Bolivia","Santa Cruz","Cordillera","Charagua","ESC. SECC. TACOBO",-63.19634,-19.78686,26,7,216,242,50,9,150,200
"Bolivia","Santa Cruz","Cordillera","Charagua","ESC. SECC. TAPUTA",-63.22105,-19.5902,0,33,272,272,13,9,217,230
"Bolivia","Santa Cruz","Cordillera","Charagua","ESCUELA CENTRAL FE Y ALEGRIA",-63.19686,-19.79076,461,28,2212,2673,1281,67,836,2117
"Bolivia","Santa Cruz","Cordillera","Charagua","ESCUELA SECCIONAL SAIPURU",-63.14339,-19.78258,0,2,132,132,56,27,47,103
"Bolivia","Santa Cruz","Cordillera","Charagua","U.E. 24 DE SEPTIEMBRE",-63.19831,-19.75614,1,4,65,66,16,5,40,56
"Bolivia","Santa Cruz","Cordillera","Charagua","U.E. JOSERAVI",-62.29416,-18.33184,19,0,62,81,36,1,25,61
"Bolivia","Santa Cruz","Cordillera","Charagua","U.E. JUAN LUIS OTIN",-63.08943,-19.97976,2,2,90,92,37,6,45,82
"Bolivia","Santa Cruz","Cordillera","Charagua","U.E. MACHIPO",-63.17883,-19.83895,6,8,100,106,36,4,52,88
"Bolivia","Santa Cruz","Cordillera","Charagua","U.E. PEDRO RAMOS",-63.21563,-19.63187,3,2,121,124,49,2,68,117
"Bolivia","Santa Cruz","Cordillera","Charagua","U.E. YAPIROA",-62.57546,-19.60771,5,1,185,190,112,5,67,179
"Bolivia","Santa Cruz","Cordillera","Cuevo","ESC. SECC. EL ARENAL",-63.51422,-20.40347,0,0,8,8,1,0,7,8
"Bolivia","Santa Cruz","Cordillera","Cuevo","ESC. SECC. ITAKUATIA",-63.51872,-20.45691,10,2,64,74,42,3,17,59
"Bolivia","Santa Cruz","Cordillera","Cuevo","ESC. UB. ANGEL SANDOVAL",-63.46928,-20.39243,502,20,1218,1720,706,26,466,1172
"Bolivia","Santa Cruz","Cordillera","Cuevo","ESC. UNIDAD EDUCATIVA IVICUATI",-63.41391,-20.37102,42,3,144,186,95,0,46,141
"Bolivia","Santa Cruz","Cordillera","Cuevo","ESC. UNIDAD SECCIONAL HUARACA",-63.51622,-20.4536,29,2,116,145,83,3,28,111
"Bolivia","Santa Cruz","Cordillera","Cuevo","U.E. EL ARENAL",-63.51412,-20.40366,9,2,98,107,5,3,88,93
"Bolivia","Santa Cruz","Cordillera","Cuevo","U.E. SALINAS",-63.46267,-20.226,16,1,93,109,19,2,71,90
"Bolivia","Santa Cruz","Cordillera","Gutiérrez","ESC. CENTRAL IPATIMIRI",-63.48169,-19.76727,85,7,515,600,167,30,311,478
"Bolivia","Santa Cruz","Cordillera","Gutiérrez","ESC. EMILIO FINOT",-63.52944,-19.42346,196,10,749,945,446,15,278,724
"Bolivia","Santa Cruz","Cordillera","Gutiérrez","ESC. IBAMIRAPINTA",-63.53056,-19.4212,90,18,552,642,185,17,332,517
"Bolivia","Santa Cruz","Cordillera","Gutiérrez","ESC. KURUGUAKUA",-63.52905,-19.42271,20,1,107,127,22,1,83,105
"Bolivia","Santa Cruz","Cordillera","Gutiérrez","ESC. MARCELINO REVOLLO",-63.39302,-19.72541,92,19,566,658,229,16,302,531
"Bolivia","Santa Cruz","Cordillera","Gutiérrez","ESC. MARISCAL SUCRE",-63.50597,-19.35422,67,15,298,365,181,4,98,279
"Bolivia","Santa Cruz","Cordillera","Gutiérrez","ESC. MIGUEL LANDIVAR",-63.50658,-19.34445,59,8,348,407,111,21,208,319
"Bolivia","Santa Cruz","Cordillera","Gutiérrez","ESC. PALMARITO",-63.46463,-19.50546,69,2,267,336,21,11,233,254
"Bolivia","Santa Cruz","Cordillera","Gutiérrez","ESC. SECC. GUASANTI",-63.42537,-19.78613,32,4,243,275,57,7,175,232
"Bolivia","Santa Cruz","Cordillera","Gutiérrez","ESC. SECCIONAL CAIPIPENDI",-63.3559,-19.78204,0,5,54,54,11,0,38,49
"Bolivia","Santa Cruz","Cordillera","Gutiérrez","ESC. SECCIONAL CAPIRENDA",-63.37655,-19.6701,36,5,225,261,45,10,165,210
"Bolivia","Santa Cruz","Cordillera","Gutiérrez","ESC. SECCIONAL ITEMBEGUAZU",-63.36713,-19.36706,33,7,181,214,80,4,90,170
"Bolivia","Santa Cruz","Cordillera","Gutiérrez","ESC. SECCIONAL S. MIGUEL POCITO",-63.45378,-19.68275,16,5,126,142,78,3,40,118
"Bolivia","Santa Cruz","Cordillera","Gutiérrez","ESC. TATARENDA VIEJA",-63.53038,-19.42489,62,8,339,401,94,18,219,313
"Bolivia","Santa Cruz","Cordillera","Lagunillas","ESC. LAGUNILLAS",-63.67723,-19.65222,334,18,1086,1420,478,26,564,1042
"Bolivia","Santa Cruz","Cordillera","Lagunillas","ESC. PROF. DELFIN ARTEAGA IPATI",-63.56137,-19.76491,99,17,666,765,316,21,312,628
"Bolivia","Santa Cruz","Cordillera","Lagunillas","ESC. SECCIONAL AGUADA GRANDE",-63.67469,-19.64971,40,5,191,231,76,7,103,179
"Bolivia","Santa Cruz","Cordillera","Lagunillas","ESC. SECCIONAL ALTO PARAPETI",-63.67161,-19.65821,15,2,67,82,11,5,49,60
"Bolivia","Santa Cruz","Cordillera","Lagunillas","ESC. TASETE",-63.65621,-19.65524,3,0,40,43,7,3,30,37
"Bolivia","Santa Cruz","Cordillera","Lagunillas","ESCUELA SECCIONAL AQUIO",-63.68824,-19.70833,6,1,69,75,49,2,17,66
"Bolivia","Santa Cruz","Cordillera","Lagunillas","U.E. CARPARICITO",-63.66229,-19.80228,41,5,145,186,44,10,86,130
"Bolivia","Santa Cruz","Cordillera","Lagunillas","U.E. PAMPA REDONDA",-63.66234,-19.60102,5,4,73,78,26,4,39,65
"Bolivia","Santa Cruz","Cordillera","Lagunillas","U. E. TENTA PIAU",-63.66815,-19.55789,12,0,73,85,32,5,36,68
"Bolivia","Santa Cruz","Cordillera","Lagunillas","U.E. YAITY",-63.63815,-20.06437,9,2,80,89,15,3,60,75
"Bolivia","Santa Cruz","Florida","Mairana","ESC. ANANIAS MELENDRES",-64.03188,-17.97899,99,18,599,698,203,31,347,550
"Bolivia","Santa Cruz","Florida","Mairana","ESC. ANGEL SAAVEDRA CHAVEZ",-63.96286,-18.12236,19,5,139,158,74,8,52,126
"Bolivia","Santa Cruz","Florida","Mairana","ESC. RENE BARRIENTOS ORTUÑO",-63.95997,-18.11939,690,134,4900,5590,2049,323,2394,4443
"Bolivia","Santa Cruz","Florida","Pampa Grande","ESC. NUCLEO SANTA ROSA",-64.24594,-17.86679,18,2,172,190,68,4,98,166
"Bolivia","Santa Cruz","Florida","Pampa Grande","ESC. PALMASOLA (EL CARMEN)",-64.2088,-17.89188,23,6,156,179,47,4,99,146
"Bolivia","Santa Cruz","Florida","Pampa Grande","ESC. PEDRO ARISTIDES",-64.11092,-18.08937,98,21,602,700,372,15,194,566
"Bolivia","Santa Cruz","Florida","Pampa Grande","ESC. SAN IGNACIO DE LOYOLA",-64.11346,-18.0916,83,12,457,540,294,18,133,427
"Bolivia","Santa Cruz","Florida","Pampa Grande","ESC. U.E. EDUARDO AVAROA",-64.12405,-18.05703,457,72,2948,3405,980,151,1745,2725
"Bolivia","Santa Cruz","Florida","Quirusillas","ESC. NESTOR PAZ ZAMORA",-63.96211,-18.37715,208,27,865,1073,465,56,317,782
"Bolivia","Santa Cruz","Florida","Samaipata","ESC. CENTRAL BELLA VICTORIA",-63.94548,-18.23438,74,23,893,967,436,49,385,821
"Bolivia","Santa Cruz","Florida","Samaipata","ESC. GRAL. AGUSTIN SAAVEDRA",-63.87621,-18.1794,270,15,1483,1753,850,94,524,1374
"Bolivia","Santa Cruz","Florida","Samaipata","ESC. NAPOLEON GOMEZ",-63.87625,-18.17913,229,45,1779,2008,1079,74,581,1660
"Bolivia","Santa Cruz","Florida","Samaipata","ESC. NUCLEO SAN JUAN DEL ROSARIO",-63.8751,-18.17855,63,2,193,256,108,6,77,185
"Bolivia","Santa Cruz","Florida","Samaipata","ESC. SANTIAGO DEL VALLE",-63.91644,-18.22129,62,7,327,389,224,7,89,313
"Bolivia","Santa Cruz","Florida","Samaipata","ESC. TIMOTEO RONDALES",-63.63435,-18.13063,64,12,341,405,206,23,100,306
"Bolivia","Santa Cruz","Florida","Samaipata","ESC. UNIDAD EDUCATIVA 27 DE MAYO",-63.79241,-18.17142,18,3,110,128,39,2,66,105
"Bolivia","Santa Cruz","Germán Busch","El Carmen Rivero Tórrez","ESC. CANDELARIA (CHIQUITOS)",-58.98688,-18.62612,11,1,59,70,26,2,30,56
"Bolivia","Santa Cruz","Germán Busch","El Carmen Rivero Tórrez","ESC. DANIEL ZAMBRANA",-58.62548,-18.82769,546,24,1737,2283,910,29,774,1684
"Bolivia","Santa Cruz","Germán Busch","El Carmen Rivero Tórrez","ESC. EVANGELICA RINCON DEL TIGRE",-58.16805,-18.21079,90,4,199,289,104,8,83,187
"Bolivia","Santa Cruz","Germán Busch","El Carmen Rivero Tórrez","ESC. PALMERAS",-58.20692,-18.22021,39,2,87,126,41,4,40,81
"Bolivia","Santa Cruz","Germán Busch","El Carmen Rivero Tórrez","ESC. SANTA ANA",-58.78492,-18.70716,59,0,181,240,87,4,90,177
"Bolivia","Santa Cruz","Germán Busch","El Carmen Rivero Tórrez","U.E. PALMITO",-58.40663,-18.91338,19,0,34,53,21,0,13,34
"Bolivia","Santa Cruz","Germán Busch","Puerto Quijarro","ESC. GISELA BRUN SCIARONI",-57.7165,-19.00469,238,24,2908,3146,1610,453,821,2431
"Bolivia","Santa Cruz","Germán Busch","Puerto Quijarro","ESC. MIXTA LA FRONTERA",-57.70963,-19.02897,1229,24,2836,4065,1399,111,1302,2701
"Bolivia","Santa Cruz","Germán Busch","Puerto Quijarro","ESC. SAMUEL LOPEZ MENDOZA",-57.7174,-19.00237,971,14,2691,3662,1543,66,1068,2611
"Bolivia","Santa Cruz","Germán Busch","Puerto Quijarro","U.E. SAN SALVADOR",-57.74367,-18.91407,0,0,13,13,1,0,12,13
"Bolivia","Santa Cruz","Germán Busch","Puerto Suárez","ESC. ANGELICA RIVERO",-57.79461,-18.96881,171,7,812,983,542,10,253,795
"Bolivia","Santa Cruz","Germán Busch","Puerto Suárez","ESC. COLONIA WARNES",-57.94844,-19.21188,0,0,62,62,12,9,41,53
"Bolivia","Santa Cruz","Germán Busch","Puerto Suárez","ESC. COOP EDUCACIONAL PUERTO SUAREZ",-57.80175,-18.96629,674,24,2287,2961,1408,33,822,2230
"Bolivia","Santa Cruz","Germán Busch","Puerto Suárez","ESC. ELIODORO PAZ",-57.79655,-18.96109,357,6,946,1303,644,18,278,922
"Bolivia","Santa Cruz","Germán Busch","Puerto Suárez","ESC. GERMAN BUSCH YACUSES",-58.23871,-18.97605,80,10,382,462,167,11,194,361
"Bolivia","Santa Cruz","Germán Busch","Puerto Suárez","ESC. JOSEFINA GOYTIA",-57.80096,-18.96123,351,10,1330,1681,944,20,356,1300
"Bolivia","Santa Cruz","Germán Busch","Puerto Suárez","ESC. MIGUEL SUAREZ ARANA",-57.79474,-18.96855,533,19,2294,2827,1447,108,720,2167
"Bolivia","Santa Cruz","Germán Busch","Puerto Suárez","U.E. EL SALAO",-57.80831,-18.97087,3,0,4,7,3,0,1,4
"Bolivia","Santa Cruz","Germán Busch","Puerto Suárez","U.E. MOTACUCITO",-57.86888,-18.9975,2,1,19,21,6,0,12,18
"Bolivia","Santa Cruz","Guarayos","Ascención de Guarayos","COL. JOSE BARRERA",-63.19069,-15.89573,67,4,371,438,230,7,130,360
"Bolivia","Santa Cruz","Guarayos","Ascención de Guarayos","ESC. 17 DE FEBRERO",-63.46325,-15.73225,45,0,218,263,29,4,185,214
"Bolivia","Santa Cruz","Guarayos","Ascención de Guarayos","ESC. 6 DE ABRIL",-63.45643,-15.72873,16,0,86,102,29,2,55,84
"Bolivia","Santa Cruz","Guarayos","Ascención de Guarayos","ESC. ASCENCION CENTRAL",-63.18915,-15.89754,1057,37,3873,4930,2022,94,1720,3742
"Bolivia","Santa Cruz","Guarayos","Ascención de Guarayos","ESC. COLONIA 5 DE MARZO",-63.79241,-15.32275,39,3,163,202,65,4,91,156
"Bolivia","Santa Cruz","Guarayos","Ascención de Guarayos","ESC. ESTEBAN GEBARD",-63.187,-15.90327,1040,40,4564,5604,2575,136,1813,4388
"Bolivia","Santa Cruz","Guarayos","Ascención de Guarayos","ESC. SAN PABLO",-63.30412,-15.89327,82,14,476,558,174,17,271,445
"Bolivia","Santa Cruz","Guarayos","Ascención de Guarayos","ESC. SANTA MARIA",-63.45824,-15.73023,48,11,345,393,103,9,222,325
"Bolivia","Santa Cruz","Guarayos","Ascención de Guarayos","KINDER MI DULCE HOGAR",-63.19152,-15.89707,68,1,480,548,214,13,252,466
"Bolivia","Santa Cruz","Guarayos","El Puente","ESC. 10 DE NOVIEMBRE",-63.10825,-16.43058,95,13,493,588,137,13,330,467
"Bolivia","Santa Cruz","Guarayos","El Puente","ESC. ALFREDO SMITH",-62.90907,-16.32987,442,29,1732,2174,1003,42,658,1661
"Bolivia","Santa Cruz","Guarayos","El Puente","ESC. CACHUELA",-63.11323,-16.20543,10,1,65,75,11,2,51,62
"Bolivia","Santa Cruz","Guarayos","El Puente","ESC. CORRALON",-63.21976,-16.36582,83,0,220,303,32,2,186,218
"Bolivia","Santa Cruz","Guarayos","El Puente","ESC. EL COMBATE",-64.34967,-15.96244,5,0,34,39,10,0,24,34
"Bolivia","Santa Cruz","Guarayos","El Puente","ESC. LOS CHACOS",-63.53627,-15.93622,19,0,51,70,46,1,4,50
"Bolivia","Santa Cruz","Guarayos","El Puente","ESC. PUEBLOS UNIDOS",-64.45015,-15.95046,154,1,222,376,30,8,183,213
"Bolivia","Santa Cruz","Guarayos","El Puente","ESC. SAN JOSE DE YOTAU",-63.02123,-16.17607,257,20,1041,1298,322,29,670,992
"Bolivia","Santa Cruz","Guarayos","El Puente","ESC. SECCIONAL EL CARMEN",-63.38649,-16.17395,75,5,346,421,128,15,198,326
"Bolivia","Santa Cruz","Guarayos","El Puente","ESC. SECCIONAL LIMONCITO",-63.38322,-15.91767,15,0,33,48,21,1,11,32
"Bolivia","Santa Cruz","Guarayos","El Puente","ESC. U.E. BOLIVAR",-63.2851,-16.27928,35,13,255,290,70,13,159,229
"Bolivia","Santa Cruz","Guarayos","El Puente","MONTE SINAI",-63.28524,-16.28186,32,2,224,256,32,7,183,215
"Bolivia","Santa Cruz","Guarayos","El Puente","U.E EL CORRALON",-63.44645,-16.40989,0,4,104,104,12,9,79,91
"Bolivia","Santa Cruz","Guarayos","Urubichá","ESC, MARIA DE LOS ANGELES",-63.08243,-15.62326,404,27,1715,2119,720,44,924,1644
"Bolivia","Santa Cruz","Guarayos","Urubichá","ESC. NUCLEO ESCOLAR YAGUARU",-63.22532,-15.60033,180,14,860,1040,538,28,280,818
"Bolivia","Santa Cruz","Guarayos","Urubichá","ESC. SANTA TERESITA (CURURU)",-63.19052,-15.89766,15,2,57,72,45,0,10,55
"Bolivia","Santa Cruz","Guarayos","Urubichá","ESC. SECC.MON.SALVATIERRA",-63.01738,-15.50296,29,1,78,107,32,0,45,77
"Bolivia","Santa Cruz","Ichilo","Buena Vista","ESC. ADHEMAR ORTIZ",-63.5253,-17.61063,31,1,213,244,81,1,130,211
"Bolivia","Santa Cruz","Ichilo","Buena Vista","ESC. EDUARDO ABAROA",-63.6379,-17.55737,109,14,762,871,218,30,500,718
"Bolivia","Santa Cruz","Ichilo","Buena Vista","ESC. MARIANO SAUCEDO SEVILLA",-63.66378,-17.45934,380,13,1750,2130,1047,43,647,1694
"Bolivia","Santa Cruz","Ichilo","Buena Vista","ESC. OVIDIO SUAREZ",-63.66139,-17.45913,473,25,1661,2134,850,75,711,1561
"Bolivia","Santa Cruz","Ichilo","Buena Vista","ESC. U.E. CARANDA",-63.53439,-17.52241,117,15,643,760,262,21,345,607
"Bolivia","Santa Cruz","Ichilo","Buena Vista","ESC. U.E. LUCIO  PEREZ",-63.5322,-17.4093,34,3,182,216,140,5,34,174
"Bolivia","Santa Cruz","Ichilo","Buena Vista","ESC. U.E. PEDRO DOMINGO MURILLO",-63.57303,-17.63503,75,8,459,534,57,10,384,441
"Bolivia","Santa Cruz","Ichilo","Buena Vista","ESC. U.E. SAN ISIDRO",-63.53614,-17.44589,44,1,199,243,175,0,23,198
"Bolivia","Santa Cruz","Ichilo","Buena Vista","ESC. U.E. SAN JAVIER",-63.56753,-17.36419,0,0,48,48,36,3,9,45
"Bolivia","Santa Cruz","Ichilo","Buena Vista","ESC. U.E. SANTO ESPOSORIO",-63.60875,-17.35815,40,0,158,198,130,2,26,156
"Bolivia","Santa Cruz","Ichilo","Buena Vista","U.E. 5 DE SEPTIEMBRE",-63.69266,-17.53192,3,2,89,92,5,0,82,87
"Bolivia","Santa Cruz","Ichilo","Buena Vista","U.E. 6 DE AGOSTO",-63.60951,-17.40799,6,6,265,271,214,5,40,254
"Bolivia","Santa Cruz","Ichilo","San Carlos","ESC. CENTRAL SAN CARLOS",-63.72837,-17.40302,456,40,2762,3218,1740,104,878,2618
"Bolivia","Santa Cruz","Ichilo","San Carlos","ESC. FISCAL DE NINOS SANTA FE",-63.82872,-17.39861,865,58,4764,5629,1936,215,2555,4491
"Bolivia","Santa Cruz","Ichilo","San Carlos","ESC. NUCLEO CENTRAL",-63.76135,-17.16378,95,14,740,835,148,14,564,712
"Bolivia","Santa Cruz","Ichilo","San Carlos","ESC. U.E. POPULAR DON BOSCO",-63.76614,-17.09247,66,11,934,1000,533,123,267,800
"Bolivia","Santa Cruz","Ichilo","San Juan","ESC. POPULAR DON BOSCO",-63.85132,-17.29254,435,75,2475,2910,1395,47,958,2353
"Bolivia","Santa Cruz","Ichilo","San Juan","NUCLEO CENTRAL LA ENCONADA",-63.89576,-17.05627,105,17,652,757,203,21,411,614
"Bolivia","Santa Cruz","Ichilo","San Juan","UN. ED. AYACUCHO",-63.90579,-17.00542,54,6,288,342,90,2,190,280
"Bolivia","Santa Cruz","Ichilo","San Juan","UN. ED.  NUCLEO CENTRAL",-63.99822,-16.91391,34,1,126,160,31,2,92,123
"Bolivia","Santa Cruz","Ichilo","San Juan","UN. ED. RAUL MENACHO",-64.04461,-16.70449,44,1,225,269,61,7,156,217
"Bolivia","Santa Cruz","Ichilo","Yapacaní","ESC. CESAR BANZER ALIAGA",-63.88105,-17.40066,1311,94,7132,8443,2413,387,4238,6651
"Bolivia","Santa Cruz","Ichilo","Yapacaní","ESC. DON BOSCO FE Y ALEGRIA",-64.09068,-17.35061,419,24,2019,2438,432,50,1513,1945
"Bolivia","Santa Cruz","Ichilo","Yapacaní","ESC. EL PALLAR",-64.81531,-16.76252,77,6,197,274,57,4,130,187
"Bolivia","Santa Cruz","Ichilo","Yapacaní","ESC. GERMAN BUSCH",-63.88563,-17.40492,683,66,4440,5123,1652,151,2571,4223
"Bolivia","Santa Cruz","Ichilo","Yapacaní","ESC. MARISCAL SUCRE",-63.96143,-17.38778,129,16,997,1126,226,24,731,957
"Bolivia","Santa Cruz","Ichilo","Yapacaní","ESC. NACIONAL BOLIVIA",-63.88673,-17.40517,69,3,372,441,99,37,233,332
"Bolivia","Santa Cruz","Ichilo","Yapacaní","ESC. NOEL KENP MERCADO",-64.29475,-17.08242,217,16,1115,1332,156,22,921,1077
"Bolivia","Santa Cruz","Ichilo","Yapacaní","ESC. NUEVO SIMON BOLLIVAR",-63.88425,-17.4061,847,37,4136,4983,1514,94,2491,4005
"Bolivia","Santa Cruz","Ichilo","Yapacaní","ESC. U.E. CASCABEL",-64.25111,-17.05944,124,8,494,618,84,11,391,475
"Bolivia","Santa Cruz","Ichilo","Yapacaní","ESC. U.E. GERMAN BUSCH (P. GRETHER)",-64.3512,-17.18946,68,7,299,367,99,14,179,278
"Bolivia","Santa Cruz","Ichilo","Yapacaní","ESCUELA CORTE HONDO",-64.77988,-16.74353,0,0,69,69,7,1,61,68
"Bolivia","Santa Cruz","Ichilo","Yapacaní","ESC. U.E. NUCLEO CENTRAL",-64.03771,-17.36884,85,5,625,710,145,15,460,605
"Bolivia","Santa Cruz","Ichilo","Yapacaní","ESC. U.E. NUCLEO CENTRAL EL CONDOR",-64.12843,-17.42864,44,6,251,295,49,5,191,240
"Bolivia","Santa Cruz","Ichilo","Yapacaní","ESC. U.E. NUCLEO CENTRAL LOS POZOS",-64.07143,-17.0136,31,5,228,259,64,9,150,214
"Bolivia","Santa Cruz","Ichilo","Yapacaní","ESC. U.E. PUERTO AVAROA",-64.22526,-17.25569,58,6,402,460,113,8,275,388
"Bolivia","Santa Cruz","Ichilo","Yapacaní","U.E. JUANA AZURDUY",-63.90387,-17.41217,7,0,58,65,21,5,32,53
"Bolivia","Santa Cruz","Ichilo","Yapacaní","U.E. NUEVO HORIZONTE",-64.1521,-17.31313,25,12,394,419,57,13,312,369
"Bolivia","Santa Cruz","Ichilo","Yapacaní","U.E. SAN RAFAEL",-63.92513,-17.45016,5,0,121,126,14,3,104,118
"Bolivia","Santa Cruz","Manuel M. Caballero","Comarapa","ESC.  EL JAGUE",-64.32232,-18.02102,10,0,48,58,26,0,22,48
"Bolivia","Santa Cruz","Manuel M. Caballero","Comarapa","ESC. ESCUELA SAN MATEO",-64.66756,-17.75924,19,4,205,224,24,4,173,197
"Bolivia","Santa Cruz","Manuel M. Caballero","Comarapa","ESC. GABRIEL RENE MORENO",-64.52667,-17.91351,532,73,3949,4481,1439,227,2210,3649
"Bolivia","Santa Cruz","Manuel M. Caballero","Comarapa","ESC. HABRA DE CAPILLA",-64.73131,-17.87328,9,2,116,125,17,6,91,108
"Bolivia","Santa Cruz","Manuel M. Caballero","Comarapa","ESC. MANZANAL",-64.77901,-17.84591,12,0,98,110,8,3,87,95
"Bolivia","Santa Cruz","Manuel M. Caballero","Comarapa","ESC. MARCELINO CHAIPANA",-64.43036,-18.10087,48,4,372,420,158,19,191,349
"Bolivia","Santa Cruz","Manuel M. Caballero","Comarapa","ESC. SAN ISIDRO",-64.43211,-18.04461,162,14,909,1071,427,43,425,852
"Bolivia","Santa Cruz","Manuel M. Caballero","Comarapa","ESC. SAN JOSE DE LA CAPILLA",-64.4388,-18.0994,56,8,365,421,160,23,174,334
"Bolivia","Santa Cruz","Manuel M. Caballero","Comarapa","ESC. SAN JUAN DEL POTRERO",-64.29284,-17.96157,53,13,331,384,164,12,142,306
"Bolivia","Santa Cruz","Manuel M. Caballero","Comarapa","ESC. SIBERIA",-64.75382,-17.82761,10,0,120,130,30,3,87,117
"Bolivia","Santa Cruz","Manuel M. Caballero","Comarapa","ESC. TORRECILLAS",-64.61208,-17.86851,67,28,740,807,112,60,540,652
"Bolivia","Santa Cruz","Manuel M. Caballero","Comarapa","ESC. U.E. LA PALIZADA",-64.43266,-18.06145,45,13,328,373,126,12,177,303
"Bolivia","Santa Cruz","Manuel M. Caballero","Saipina","ESC. EMILIA CABALLERO",-64.63905,-17.96113,1,0,33,34,6,1,26,32
"Bolivia","Santa Cruz","Manuel M. Caballero","Saipina","ESC. HUMBERTO VILLARROEL",-64.58239,-18.09421,322,35,2105,2427,718,73,1279,1997
"Bolivia","Santa Cruz","Manuel M. Caballero","Saipina","ESC. OCONI",-64.68318,-17.98282,21,3,103,124,6,2,92,98
"Bolivia","Santa Cruz","Manuel M. Caballero","Saipina","ESC. SAN RAFAEL",-64.56412,-18.1077,16,1,207,223,54,6,146,200
"Bolivia","Santa Cruz","Manuel M. Caballero","Saipina","ESC. U.E. SANTA CATALINA CHILON",-64.63826,-18.00198,65,8,397,462,99,15,275,374
"Bolivia","Santa Cruz","Ñuflo De Chávez","Concepción","ESC. CENT. JULIO FLORES FRANCO",-62.01875,-16.44536,26,7,207,233,112,3,85,197
"Bolivia","Santa Cruz","Ñuflo De Chávez","Concepción","ESC. CENTRAL SAN PEDRO",-62.2496,-16.67241,28,0,143,171,94,3,46,140
"Bolivia","Santa Cruz","Ñuflo De Chávez","Concepción","ESC. EDUCATIVA MAKANATE",-62.29666,-15.48511,15,2,109,124,4,3,100,104
"Bolivia","Santa Cruz","Ñuflo De Chávez","Concepción","ESC. GUADALUPE FE Y ALEGRIA",-62.02316,-16.13626,1293,115,7052,8345,3589,185,3163,6752
"Bolivia","Santa Cruz","Ñuflo De Chávez","Concepción","ESC. PALESTINA",-62.25437,-15.5535,0,0,73,73,3,12,58,61
"Bolivia","Santa Cruz","Ñuflo De Chávez","Concepción","ESC. SECCIONAL CALENDARIA",-62.12077,-16.2456,13,5,188,201,64,7,112,176
"Bolivia","Santa Cruz","Ñuflo De Chávez","Concepción","ESC. SECCIONAL PALMARITO",-61.58675,-15.68015,29,2,211,240,155,3,51,206
"Bolivia","Santa Cruz","Ñuflo De Chávez","Concepción","ESC. TIERRA HERMOZA",-61.96533,-16.47223,116,6,486,602,42,11,427,469
"Bolivia","Santa Cruz","Ñuflo De Chávez","Concepción","ESC. U.E. ALTAMIRA",-62.02086,-16.13548,74,10,374,448,166,18,180,346
"Bolivia","Santa Cruz","Ñuflo De Chávez","Concepción","ESC. U.E. GUAYABA",-62.00958,-16.11202,9,4,130,139,16,2,108,124
"Bolivia","Santa Cruz","Ñuflo De Chávez","Concepción","ESC. U.E. LAS MERCEDES",-62.15521,-16.63746,13,1,38,51,18,0,19,37
"Bolivia","Santa Cruz","Ñuflo De Chávez","Concepción","ESC. U.E. SAN SILVESTRE",-61.8651,-15.87338,14,1,123,137,45,8,69,114
"Bolivia","Santa Cruz","Ñuflo De Chávez","Concepción","ESC. U.E. SANTA MONICA",-62.19145,-15.97295,13,1,91,104,6,0,84,90
"Bolivia","Santa Cruz","Ñuflo De Chávez","Concepción","ESC. U.E. ZAPOCO",-61.64749,-16.49761,7,0,14,21,9,0,5,14
"Bolivia","Santa Cruz","Ñuflo De Chávez","Concepción","MEDIO MONTE",-62.07742,-16.52462,6,0,108,114,10,1,97,107
"Bolivia","Santa Cruz","Ñuflo De Chávez","Concepción","U.E. JOSE ORTIZ SENAR",-61.9508,-16.22951,9,0,63,72,6,0,57,63
"Bolivia","Santa Cruz","Ñuflo De Chávez","Concepción","U.E. NUBIASIX",-62.1369,-16.33951,4,2,59,63,16,2,39,55
"Bolivia","Santa Cruz","Ñuflo De Chávez","Concepción","U.E. SAN FRANCISCO DE ASIS",-62.06047,-16.13365,3,2,80,83,13,4,61,74
"Bolivia","Santa Cruz","Ñuflo De Chávez","Cuatro Cañadas","COL. NACIONAL CUATRO CAÑANDAS",-62.55971,-17.27547,21,5,147,168,40,4,98,138
"Bolivia","Santa Cruz","Ñuflo De Chávez","Cuatro Cañadas","ESC. 26 DE AGOSTO",-62.60896,-17.44349,89,14,703,792,226,29,434,660
"Bolivia","Santa Cruz","Ñuflo De Chávez","Cuatro Cañadas","ESC. JOSE LUIS CASTRO",-62.55427,-17.34488,180,17,1297,1477,418,39,823,1241
"Bolivia","Santa Cruz","Ñuflo De Chávez","Cuatro Cañadas","ESC. JUAN PABLO SEGUNDO",-62.55701,-17.26752,996,72,5934,6930,2113,310,3439,5552
"Bolivia","Santa Cruz","Ñuflo De Chávez","Cuatro Cañadas","ESC. LOS TRONCOS",-62.63882,-17.06814,25,3,182,207,96,3,80,176
"Bolivia","Santa Cruz","Ñuflo De Chávez","Cuatro Cañadas","ESC. MONTE RICO",-62.48614,-17.37492,34,2,206,240,24,1,179,203
"Bolivia","Santa Cruz","Ñuflo De Chávez","Cuatro Cañadas","U.E. HAZIEL",-62.152,-17.22365,13,2,235,248,181,7,45,226
"Bolivia","Santa Cruz","Ñuflo De Chávez","San Antonio de Lomerio","ESC. CENTRAL EL PUQUIO",-61.9117,-16.73251,54,3,400,454,4,3,390,394
"Bolivia","Santa Cruz","Ñuflo De Chávez","San Antonio de Lomerio","ESC. HOLANDA",-61.79376,-16.88703,0,0,7,7,0,2,5,5
"Bolivia","Santa Cruz","Ñuflo De Chávez","San Antonio de Lomerio","ESC. PADRE MATIAS LENS",-61.81025,-16.76787,209,11,1149,1358,496,36,606,1102
"Bolivia","Santa Cruz","Ñuflo De Chávez","San Antonio de Lomerio","ESC.SAN LORENZO",-61.87291,-16.70838,31,7,265,296,5,1,252,257
"Bolivia","Santa Cruz","Ñuflo De Chávez","San Antonio de Lomerio","ESC. SECCIONAL SALINAS",-61.85703,-16.98182,43,8,188,231,72,5,103,175
"Bolivia","Santa Cruz","Ñuflo De Chávez","San Antonio de Lomerio","ESC. U.E. LAS TRANCAS",-61.86698,-16.5975,9,0,109,118,6,2,101,107
"Bolivia","Santa Cruz","Ñuflo De Chávez","San Antonio de Lomerio","ESC. U.E. MONTERITO",-61.96834,-16.70661,8,1,173,181,0,0,172,172
"Bolivia","Santa Cruz","Ñuflo De Chávez","San Antonio de Lomerio","ESC. U.E. PADRE PIO",-61.8397,-16.68229,16,1,147,163,10,2,134,144
"Bolivia","Santa Cruz","Ñuflo De Chávez","San Antonio de Lomerio","PEDRO PABLO PEÑA GARCIA",-61.93461,-16.75292,2,0,60,62,0,0,60,60
"Bolivia","Santa Cruz","Ñuflo De Chávez","San Javier","ESC. SECCIONAL CORONACION",-62.63953,-16.50191,59,6,424,483,132,9,277,409
"Bolivia","Santa Cruz","Ñuflo De Chávez","San Javier","ESCUELA ADOLFO BURTON",-62.50405,-16.27246,877,109,4625,5502,2881,73,1562,4443
"Bolivia","Santa Cruz","Ñuflo De Chávez","San Javier","ESC. U.E. LAS ABRAS",-62.62867,-16.31566,37,2,195,232,16,2,175,191
"Bolivia","Santa Cruz","Ñuflo De Chávez","San Javier","ESC. U.E. SAN PABLO",-62.59928,-16.16368,12,0,104,116,4,0,100,104
"Bolivia","Santa Cruz","Ñuflo De Chávez","San Javier","ESC. U.E. SANTA RITA",-62.41707,-16.19858,10,0,59,69,21,0,38,59
"Bolivia","Santa Cruz","Ñuflo De Chávez","San Javier","ESC. U.E. TURUX NAPEZ",-62.54155,-16.06091,13,2,86,99,1,1,82,83
"Bolivia","Santa Cruz","Ñuflo De Chávez","San Julián","ESC. 26 DE OCT. FE Y ALEGRIA",-62.75789,-16.80131,48,4,501,549,43,6,448,491
"Bolivia","Santa Cruz","Ñuflo De Chávez","San Julián","ESC. CENTRAL FRANZ TAMAYO",-62.84544,-16.9986,153,26,865,1018,190,43,606,796
"Bolivia","Santa Cruz","Ñuflo De Chávez","San Julián","ESC. COL  CIRO MEALLA",-62.61414,-16.90736,1235,165,9306,10541,2619,651,5871,8490
"Bolivia","Santa Cruz","Ñuflo De Chávez","San Julián","ESC. EL PROGRESO",-62.62124,-16.91284,74,4,498,572,116,38,340,456
"Bolivia","Santa Cruz","Ñuflo De Chávez","San Julián","ESC. FE Y ALEGRIA",-62.68461,-17.09639,153,16,786,939,385,26,359,744
"Bolivia","Santa Cruz","Ñuflo De Chávez","San Julián","ESC. GRAL SAN MARTIN",-62.85691,-16.70174,81,9,499,580,90,17,383,473
"Bolivia","Santa Cruz","Ñuflo De Chávez","San Julián","ESC. LA ASUNTA SAN BERNARDO",-62.57837,-16.76817,171,17,1201,1372,445,34,705,1150
"Bolivia","Santa Cruz","Ñuflo De Chávez","San Julián","ESC.LIMONCITO",-63.06672,-16.76165,51,6,223,274,60,6,151,211
"Bolivia","Santa Cruz","Ñuflo De Chávez","San Julián","ESC. MAX FERNANDEZ ROJAS",-62.54577,-16.97607,44,11,477,521,101,13,352,453
"Bolivia","Santa Cruz","Ñuflo De Chávez","San Julián","ESC. NUCLEO 66 2 DE AGOSTO",-62.78839,-16.6398,55,8,417,472,128,9,272,400
"Bolivia","Santa Cruz","Ñuflo De Chávez","San Julián","ESC. PATUJU",-62.61599,-16.9081,65,2,497,562,133,19,343,476
"Bolivia","Santa Cruz","Ñuflo De Chávez","San Julián","ESC. SAN ANTONIO",-62.72305,-16.83416,7,1,125,132,24,1,99,123
"Bolivia","Santa Cruz","Ñuflo De Chávez","San Julián","ESC. SAN SALVADOR NUCLEO 38",-63.01813,-16.53014,94,7,480,574,50,23,400,450
"Bolivia","Santa Cruz","Ñuflo De Chávez","San Julián","ESC. SEBASTIAN PAGADOR",-62.62574,-16.91129,9,0,104,113,6,0,98,104
"Bolivia","Santa Cruz","Ñuflo De Chávez","San Julián","ESC. U.E. 16 DE MARZO",-62.46996,-16.93457,42,5,276,318,23,25,223,246
"Bolivia","Santa Cruz","Ñuflo De Chávez","San Julián","ESC. U.E. EL LIMONAL",-62.94872,-16.60476,41,5,263,304,34,8,216,250
"Bolivia","Santa Cruz","Ñuflo De Chávez","San Julián","ESCUELA EDUARDO AVAROA",-62.93443,-17.02607,143,17,1026,1169,287,40,682,969
"Bolivia","Santa Cruz","Ñuflo De Chávez","San Julián","ESCUELA LUZ Y VERDAD",-62.91896,-16.63566,35,10,282,317,75,11,186,261
"Bolivia","Santa Cruz","Ñuflo De Chávez","San Julián","ESC. U.E. SEGUNDA MILLA",-62.91419,-16.50614,12,1,123,135,89,6,27,116
"Bolivia","Santa Cruz","Ñuflo De Chávez","San Julián","U.E. 27 DE ABRIL",-62.61187,-16.86376,3,0,28,31,10,2,16,26
"Bolivia","Santa Cruz","Ñuflo De Chávez","San Julián","U.E. GUILLERMO JORDAN",-62.62149,-16.91677,350,19,2052,2402,535,122,1376,1911
"Bolivia","Santa Cruz","Ñuflo De Chávez","San Julián","U.E. JOSE DAVID BERRIOS",-62.63219,-16.90126,0,0,20,20,6,2,12,18
"Bolivia","Santa Cruz","Ñuflo De Chávez","San Julián","U.E. SAN JULIAN DE BERLIN",-62.63087,-17.0567,3,1,31,34,6,3,21,27
"Bolivia","Santa Cruz","Ñuflo De Chávez","San Julián","U.E. SANTA ANA",-63.06822,-16.33947,3,2,98,101,8,2,86,94
"Bolivia","Santa Cruz","Ñuflo De Chávez","San Ramón","ESC. CENTRAL SAN RAMON",-62.49786,-16.61663,737,58,3465,4202,1874,146,1387,3261
"Bolivia","Santa Cruz","Ñuflo De Chávez","San Ramón","ESC. SANTA ROSA DE LA MINA",-62.46406,-16.54375,19,1,156,175,89,9,57,146
"Bolivia","Santa Cruz","Obispo Santisteban","Fernández Alonso","ESC. AGUAICES",-63.31085,-16.89686,33,3,274,307,88,14,169,257
"Bolivia","Santa Cruz","Obispo Santisteban","Fernández Alonso","ESC. EDUARDO AVAROA",-63.23214,-16.96287,63,12,499,562,156,15,316,472
"Bolivia","Santa Cruz","Obispo Santisteban","Fernández Alonso","ESC. NUCLEO MARISCAL SUCRE",-63.2194,-16.96726,276,20,1815,2091,575,67,1153,1728
"Bolivia","Santa Cruz","Obispo Santisteban","Fernández Alonso","ESC. SECCIONAL",-63.31478,-17.03029,4,0,20,24,2,1,17,19
"Bolivia","Santa Cruz","Obispo Santisteban","Fernández Alonso","ESC. SECCIONAL FAJA BOLIVAR",-63.22898,-16.97343,0,1,10,10,0,0,9,9
"Bolivia","Santa Cruz","Obispo Santisteban","Fernández Alonso","ESC. U.E. BETANIA",-63.20389,-16.86883,5,3,106,111,30,2,71,101
"Bolivia","Santa Cruz","Obispo Santisteban","Fernández Alonso","ESC. U.E. VICTOR HUGO OTALORA",-63.22835,-17.00979,494,52,3096,3590,1080,138,1826,2906
"Bolivia","Santa Cruz","Obispo Santisteban","General Agustín Saavedra","COL. PRINCIPE DE PAZ",-63.21263,-17.22497,523,39,3217,3740,1900,134,1144,3044
"Bolivia","Santa Cruz","Obispo Santisteban","General Agustín Saavedra","ESC. 1 DE SEPTIEMBRE",-63.08397,-17.09076,78,7,379,457,140,7,225,365
"Bolivia","Santa Cruz","Obispo Santisteban","General Agustín Saavedra","ESC. NUCLEO CENTRAL NUEVA ESPERANZA",-63.21746,-17.16079,129,9,823,952,363,22,429,792
"Bolivia","Santa Cruz","Obispo Santisteban","General Agustín Saavedra","ESC. NUCLEO  MARISCAL SUCRE",-63.12855,-17.10982,149,17,857,1006,283,34,523,806
"Bolivia","Santa Cruz","Obispo Santisteban","General Agustín Saavedra","ESC. U.E. CHANE BEDOYA",-63.07076,-17.02967,68,3,313,381,109,8,193,302
"Bolivia","Santa Cruz","Obispo Santisteban","General Agustín Saavedra","ESC. U.E. GUALBERTO VILLARROEL",-63.13241,-17.22034,96,12,458,554,129,25,292,421
"Bolivia","Santa Cruz","Obispo Santisteban","General Agustín Saavedra","ESC. U.E. SANTIAGO CORNEN",-63.07765,-17.07392,53,1,352,405,171,13,167,338
"Bolivia","Santa Cruz","Obispo Santisteban","General Agustín Saavedra","U.E. ARMINDA MERCADO P.",-63.27879,-17.22003,4,4,81,85,57,2,18,75
"Bolivia","Santa Cruz","Obispo Santisteban","General Agustín Saavedra","U.E. MARCELO QUIROGA SANTA CRUZ",-63.23772,-17.25334,1,6,81,82,17,1,57,74
"Bolivia","Santa Cruz","Obispo Santisteban","General Agustín Saavedra","U.E. SAN FELIX",-63.16826,-17.22752,6,3,45,51,15,2,25,40
"Bolivia","Santa Cruz","Obispo Santisteban","Mineros","ESC. LA PATRIA",-63.33168,-17.13894,48,6,220,268,99,10,105,204
"Bolivia","Santa Cruz","Obispo Santisteban","Mineros","ESC. LAS PALMAS",-63.27835,-17.07745,46,5,326,372,115,11,195,310
"Bolivia","Santa Cruz","Obispo Santisteban","Mineros","ESC. NUCLEO CENTRAL MINERO",-63.23399,-17.11312,1568,165,9457,11025,5140,371,3781,8921
"Bolivia","Santa Cruz","Obispo Santisteban","Mineros","ESC. SUB. CENTRAL LA PORFIA",-63.15114,-17.05671,98,5,388,486,144,6,233,377
"Bolivia","Santa Cruz","Obispo Santisteban","Mineros","ESC. U.E. SAN JUAN DEL CARMEN",-63.18584,-17.07821,6,1,58,64,21,3,33,54
"Bolivia","Santa Cruz","Obispo Santisteban","Mineros","U.E. 24 DE JUNIO",-63.37979,-17.01744,0,0,88,88,14,7,67,81
"Bolivia","Santa Cruz","Obispo Santisteban","Mineros","U.E. ALIANZA EL PROGRESO",-63.2196,-17.05495,0,19,183,183,42,5,117,159
"Bolivia","Santa Cruz","Obispo Santisteban","Mineros","U.E. ALICE ALVAREZ DE AREDONDO I",-63.23064,-17.11864,81,9,560,641,305,11,235,540
"Bolivia","Santa Cruz","Obispo Santisteban","Mineros","U.E. BENJAMIN BANEGAS VACA",-63.22878,-17.1259,37,5,252,289,131,4,112,243
"Bolivia","Santa Cruz","Obispo Santisteban","Montero","CARCEL PUBLICA DE MONTERO",-63.20849,-17.31119,84,0,26,110,15,4,7,22
"Bolivia","Santa Cruz","Obispo Santisteban","Montero","COL. ANGEL LIMPIAS",-63.23486,-17.34456,384,28,2254,2638,929,72,1225,2154
"Bolivia","Santa Cruz","Obispo Santisteban","Montero","COL. DANIEL RIVERO",-63.24461,-17.34128,1029,58,5460,6489,2066,169,3167,5233
"Bolivia","Santa Cruz","Obispo Santisteban","Montero","COL. EDUARDO ABAROA",-63.23902,-17.32316,331,15,2193,2524,1362,54,762,2124
"Bolivia","Santa Cruz","Obispo Santisteban","Montero","COL. FE Y ALEGRIA",-63.22857,-17.34315,222,13,1807,2029,1483,28,283,1766
"Bolivia","Santa Cruz","Obispo Santisteban","Montero","COL. FRANZ TAMAYO",-63.23262,-17.34123,343,21,2293,2636,1066,76,1130,2196
"Bolivia","Santa Cruz","Obispo Santisteban","Montero","COL. GUILLERMO KRUEGLER",-63.26248,-17.34654,475,19,2960,3435,2154,119,668,2822
"Bolivia","Santa Cruz","Obispo Santisteban","Montero","COL. JOSE CRONEMBOL",-63.25688,-17.35259,404,15,2141,2545,1565,78,483,2048
"Bolivia","Santa Cruz","Obispo Santisteban","Montero","COL. JUAN ZABALA",-63.27181,-17.31366,770,35,4491,5261,2796,132,1528,4324
"Bolivia","Santa Cruz","Obispo Santisteban","Montero","COL. MARCELIANO MONTERO",-63.25363,-17.34717,325,42,2464,2789,1844,86,492,2336
"Bolivia","Santa Cruz","Obispo Santisteban","Montero","COL. MARCOS CHAVEZ",-63.24632,-17.35353,348,23,2349,2697,1490,51,785,2275
"Bolivia","Santa Cruz","Obispo Santisteban","Montero","COL. NACIONAL GUABIRA",-63.26613,-17.30766,346,11,2427,2773,1400,126,890,2290
"Bolivia","Santa Cruz","Obispo Santisteban","Montero","COL. OBISPO SANTISTEBAN",-63.25393,-17.34288,253,4,1683,1936,1226,41,412,1638
"Bolivia","Santa Cruz","Obispo Santisteban","Montero","COL. RAFAEL TERRAZAS",-63.25919,-17.3407,325,8,1954,2279,1572,46,328,1900
"Bolivia","Santa Cruz","Obispo Santisteban","Montero","COL. RENE MORENO",-63.25811,-17.33856,199,9,2754,2953,2172,155,418,2590
"Bolivia","Santa Cruz","Obispo Santisteban","Montero","COL. SAN JOSE OBRERO",-63.24022,-17.34599,621,38,3672,4293,1383,137,2114,3497
"Bolivia","Santa Cruz","Obispo Santisteban","Montero","COL. SIMON BOLIVAR",-63.25801,-17.34814,173,8,1404,1577,983,110,303,1286
"Bolivia","Santa Cruz","Obispo Santisteban","Montero","COL. U.E. ELVIRA FRIAS",-63.25016,-17.33013,929,77,5774,6703,1833,287,3577,5410
"Bolivia","Santa Cruz","Obispo Santisteban","Montero","COL. U.E. MONTECRISTO",-63.26806,-17.34976,359,13,1873,2232,738,310,812,1550
"Bolivia","Santa Cruz","Obispo Santisteban","Montero","COL. UNIDAD EDUCATIVA LA ESPERANZA",-63.23973,-17.35262,304,10,2210,2514,1188,81,931,2119
"Bolivia","Santa Cruz","Obispo Santisteban","Montero","COL. UNIDAD EDUCATIVA VILLA VIRGINIA",-63.23734,-17.33811,358,24,1977,2335,563,86,1304,1867
"Bolivia","Santa Cruz","Obispo Santisteban","Montero","COL. VICTOR SALVATIERRA",-63.25366,-17.34156,266,8,1851,2117,1398,42,403,1801
"Bolivia","Santa Cruz","Obispo Santisteban","Montero","ESC. U.E. MARILUZ ESTREMADOIRO",-63.22701,-17.32729,27,4,158,185,74,8,72,146
"Bolivia","Santa Cruz","Obispo Santisteban","Montero","U.E. 12 DE ABRIL",-63.25831,-17.33828,23,3,331,354,148,19,161,309
"Bolivia","Santa Cruz","Obispo Santisteban","Montero","U.E. JUANCITO PINTO",-63.14261,-17.58141,44,15,922,966,189,31,687,876
"Bolivia","Santa Cruz","Obispo Santisteban","Montero","U.E. MARCELIANO MONTERO",-63.25181,-17.34623,251,14,1663,1914,1287,33,329,1616
"Bolivia","Santa Cruz","Obispo Santisteban","Montero","UE MAXIMILIANO KOLBE",-63.26643,-17.3404,613,29,4199,4812,2592,165,1413,4005
"Bolivia","Santa Cruz","Obispo Santisteban","Montero","U.E. NUEVO MILENIO",-63.24696,-17.32077,31,2,170,201,62,5,101,163
"Bolivia","Santa Cruz","Obispo Santisteban","Montero","U.E. SAN RAMON DE LA VIBORA",-63.26657,-17.33263,15,0,154,169,41,4,109,150
"Bolivia","Santa Cruz","Obispo Santisteban","Montero","U.E. SAN SILVESTRE",-63.26012,-17.3525,33,3,234,267,96,9,126,222
"Bolivia","Santa Cruz","Obispo Santisteban","Montero","U.E. SANTA ROSITA",-63.2749,-17.30831,0,0,4,4,3,0,1,4
"Bolivia","Santa Cruz","Obispo Santisteban","San Pedro","ESC. 9 DE ABRIL",-63.66607,-16.60111,106,9,588,694,180,12,387,567
"Bolivia","Santa Cruz","Obispo Santisteban","San Pedro","ESC. CANANDOA",-63.71227,-16.52267,80,6,343,423,68,13,256,324
"Bolivia","Santa Cruz","Obispo Santisteban","San Pedro","ESC. FE Y ALEGRIA",-63.48004,-16.82541,301,38,1758,2059,789,34,897,1686
"Bolivia","Santa Cruz","Obispo Santisteban","San Pedro","ESC. FE Y ALEGRIA TITO BOLTAN",-63.42871,-16.84723,113,7,864,977,420,12,425,845
"Bolivia","Santa Cruz","Obispo Santisteban","San Pedro","ESC. NUCLEO CENTRAL MURILLO",-63.55027,-16.75557,15,4,178,193,62,4,108,170
"Bolivia","Santa Cruz","Obispo Santisteban","San Pedro","ESC. OBISPO SANTISTEBAN",-63.38285,-16.84942,77,6,601,678,162,34,399,561
"Bolivia","Santa Cruz","Obispo Santisteban","San Pedro","ESC. PADRE REMO PRANDINI VIOTTI",-63.6132,-16.67545,195,29,1059,1254,380,22,628,1008
"Bolivia","Santa Cruz","Obispo Santisteban","San Pedro","ESC. SAN SILVESTRE",-63.3363,-16.87776,16,0,113,129,34,1,78,112
"Bolivia","Santa Cruz","Obispo Santisteban","San Pedro","ESC. SECCIONAL LITORAL",-63.57311,-16.72976,28,2,270,298,75,1,192,267
"Bolivia","Santa Cruz","Obispo Santisteban","San Pedro","ESC. U.E. PETA GRANDE",-63.68477,-16.44438,25,1,112,137,24,8,79,103
"Bolivia","Santa Cruz","Obispo Santisteban","San Pedro","ESC. VILLA ROSARIO",-63.42629,-16.93978,74,5,291,365,47,8,231,278
"Bolivia","Santa Cruz","Sara","Colpa Bélgica","ESC. LOLA TERRAZAS DE GASSER",-63.23116,-17.5691,440,15,2358,2798,1357,39,947,2304
"Bolivia","Santa Cruz","Sara","Colpa Bélgica","ESC, REPUBLICA DEL BRASIL",-63.2303,-17.56968,109,8,689,798,478,20,183,661
"Bolivia","Santa Cruz","Sara","Portachuelo","ESC. ANGEL MARIA LIMPIAS",-63.39923,-17.35743,236,11,1770,2006,1310,24,425,1735
"Bolivia","Santa Cruz","Sara","Portachuelo","ESC. JULIO LANDIVAR",-63.39304,-17.35695,176,6,1373,1549,1085,23,259,1344
"Bolivia","Santa Cruz","Sara","Portachuelo","ESC. LA APLICACION",-63.39476,-17.35477,368,54,3185,3553,2389,107,635,3024
"Bolivia","Santa Cruz","Sara","Portachuelo","ESC. MARTINA DORADO",-63.39271,-17.35174,365,60,2771,3136,1964,71,676,2640
"Bolivia","Santa Cruz","Sara","Portachuelo","ESC. NUCLEO CENTRAL",-63.51644,-17.58445,88,9,595,683,403,4,179,582
"Bolivia","Santa Cruz","Sara","Portachuelo","ESC. PEROTO",-63.41801,-17.47633,0,0,53,53,38,2,13,51
"Bolivia","Santa Cruz","Sara","Portachuelo","ESC. SAN IGNACIO",-63.57069,-17.2788,59,3,363,422,225,7,128,353
"Bolivia","Santa Cruz","Sara","Santa Rosa del Sara","ESC. 4 DE MARZO",-63.89693,-16.93718,35,5,293,328,31,10,247,278
"Bolivia","Santa Cruz","Sara","Santa Rosa del Sara","ESC.  ALFREDO VACA FLOR",-63.86467,-16.67098,100,8,454,554,58,13,375,433
"Bolivia","Santa Cruz","Sara","Santa Rosa del Sara","ESC  ALFREDO VASQUEZ",-63.18314,-17.78275,65,7,575,640,438,33,97,535
"Bolivia","Santa Cruz","Sara","Santa Rosa del Sara","ESC. EL COLORADO",-63.42475,-17.17983,18,2,97,115,40,3,52,92
"Bolivia","Santa Cruz","Sara","Santa Rosa del Sara","ESC.GALILEA",-63.67821,-16.95352,63,2,404,467,71,4,327,398
"Bolivia","Santa Cruz","Sara","Santa Rosa del Sara","ESC. LA CONQUISTA",-63.95355,-16.73366,72,6,363,435,53,17,287,340
"Bolivia","Santa Cruz","Sara","Santa Rosa del Sara","ESC.  MIXTO LOS ANDES",-63.83144,-16.88512,206,20,1067,1273,175,44,828,1003
"Bolivia","Santa Cruz","Sara","Santa Rosa del Sara","ESC. PALOMETAS",-63.52637,-17.03255,16,0,83,99,46,0,37,83
"Bolivia","Santa Cruz","Sara","Santa Rosa del Sara","ESC. PASTO MERCADO QUIROGA",-63.43382,-17.12932,64,6,318,382,145,12,155,300
"Bolivia","Santa Cruz","Sara","Santa Rosa del Sara","ESC. RINCON DE PALOMETA",-63.18314,-17.78275,67,7,405,472,263,2,133,396
"Bolivia","Santa Cruz","Sara","Santa Rosa del Sara","ESC. SAN LUIS",-63.78288,-16.94883,63,4,295,358,39,11,241,280
"Bolivia","Santa Cruz","Sara","Santa Rosa del Sara","ESC. SANTA ROSA",-63.59691,-17.11006,565,37,2833,3398,1803,52,941,2744
"Bolivia","Santa Cruz","Valle Grande","Moro Moro","ESC. ASTILLERO",-64.3554,-18.40132,4,9,119,123,26,5,79,105
"Bolivia","Santa Cruz","Valle Grande","Moro Moro","ESC.LA LAJA",-64.29583,-18.25416,14,8,175,189,96,9,62,158
"Bolivia","Santa Cruz","Valle Grande","Moro Moro","ESC. MOROMORO",-64.3226,-18.36664,94,11,646,740,393,30,212,605
"Bolivia","Santa Cruz","Valle Grande","Moro Moro","ESC.NUCLEO AÑAPACO",-64.28843,-18.44178,0,0,25,25,15,1,9,24
"Bolivia","Santa Cruz","Valle Grande","Moro Moro","ESC. NUCLEO ARIRUMA",-64.32661,-18.43659,23,1,155,178,65,8,81,146
"Bolivia","Santa Cruz","Valle Grande","Moro Moro","ESC. NUCLEO CENTRAL",-64.29378,-18.52514,6,0,61,67,17,2,42,59
"Bolivia","Santa Cruz","Valle Grande","Moro Moro","ESC. U.E. EL VELADERO",-64.26523,-18.35126,39,8,245,284,114,14,109,223
"Bolivia","Santa Cruz","Valle Grande","Postrer Valle","ESC. NUCLEO POSTERVALLE",-63.83601,-18.49309,143,19,603,746,398,23,163,561
"Bolivia","Santa Cruz","Valle Grande","Postrer Valle","ESC.SAN PABLO DE LA LADERA",-63.92479,-18.43073,7,0,36,43,18,1,17,35
"Bolivia","Santa Cruz","Valle Grande","Postrer Valle","ESC.TIERRAS NUEVAS",-63.90362,-18.48421,16,0,105,121,87,3,15,102
"Bolivia","Santa Cruz","Valle Grande","Postrer Valle","ESC. UNIDAD EDUCATIVA MOSQUERA",-63.75977,-18.62887,31,5,92,123,68,3,16,84
"Bolivia","Santa Cruz","Valle Grande","Pucará","ESC. EDEY CORBAN SEHALLER",-64.18601,-18.71765,99,9,593,692,262,18,304,566
"Bolivia","Santa Cruz","Valle Grande","Pucará","ESC. LA HIGUERA",-64.18205,-18.71724,54,8,322,376,195,10,109,304
"Bolivia","Santa Cruz","Valle Grande","Trigal","ESC. LA AGUADA",-64.05747,-18.29873,0,1,53,53,29,7,16,45
"Bolivia","Santa Cruz","Valle Grande","Trigal","ESC.LAGUNILLAS",-64.15909,-18.26369,39,4,276,315,113,60,99,212
"Bolivia","Santa Cruz","Valle Grande","Trigal","ESC.SAN JOSE AGUIRRE ACHA",-64.15065,-18.30182,136,10,533,669,266,15,242,508
"Bolivia","Santa Cruz","Valle Grande","Trigal","ESC.TTE.ROMAN ALDERETTE",-64.15926,-18.35822,29,2,156,185,88,7,59,147
"Bolivia","Santa Cruz","Valle Grande","Vallegrande","ESC. ALTO SECO",-64.07446,-18.87057,53,5,285,338,151,12,117,268
"Bolivia","Santa Cruz","Valle Grande","Vallegrande","ESC. CASAMONTES",-64.02926,-18.70448,44,4,138,182,90,3,41,131
"Bolivia","Santa Cruz","Valle Grande","Vallegrande","ESC. CENTRAL GUADALUPE",-64.08943,-18.55554,39,12,378,417,196,9,161,357
"Bolivia","Santa Cruz","Valle Grande","Vallegrande","ESC. DE CHACOPATA",-64.22842,-18.35763,11,8,153,164,77,21,47,124
"Bolivia","Santa Cruz","Valle Grande","Vallegrande","ESC.DE MANKAILLPA",-64.21599,-18.39356,0,0,61,61,44,7,10,54
"Bolivia","Santa Cruz","Valle Grande","Vallegrande","ESC. IGNACIO TERAN",-64.10592,-18.48932,362,42,2095,2457,1261,109,683,1944
"Bolivia","Santa Cruz","Valle Grande","Vallegrande","ESC. JUANA CARMEN ROMAN",-64.10367,-18.4858,300,25,1457,1757,857,71,504,1361
"Bolivia","Santa Cruz","Valle Grande","Vallegrande","ESC.LOMA LARGA",-63.90175,-18.76361,13,1,88,101,67,1,19,86
"Bolivia","Santa Cruz","Valle Grande","Vallegrande","ESC. LOS SITANOS",-63.95913,-18.86104,31,4,151,182,116,3,28,144
"Bolivia","Santa Cruz","Valle Grande","Vallegrande","ESC.MASICURI",-63.7827,-18.83035,30,3,166,196,109,7,47,156
"Bolivia","Santa Cruz","Valle Grande","Vallegrande","ESC.NARANJO",-64.25002,-18.42377,9,1,69,78,55,0,13,68
"Bolivia","Santa Cruz","Valle Grande","Vallegrande","ESC. NUCLEO EL BELLO",-64.1921,-18.4416,8,4,90,98,76,0,10,86
"Bolivia","Santa Cruz","Valle Grande","Vallegrande","ESC. NUCLEO SAN JUAN",-64.20347,-18.3373,15,5,158,173,101,3,49,150
"Bolivia","Santa Cruz","Valle Grande","Vallegrande","ESC. NUCLEO TUCUMANCILLO",-64.14893,-18.37689,4,1,54,58,37,0,16,53
"Bolivia","Santa Cruz","Valle Grande","Vallegrande","ESC. OBISPO MANUEL JOSE PEÑA",-64.10788,-18.48844,343,26,1917,2260,1149,100,642,1791
"Bolivia","Santa Cruz","Valle Grande","Vallegrande","ESC. PIRAIMIRI",-63.96607,-18.63742,13,5,83,96,46,7,25,71
"Bolivia","Santa Cruz","Valle Grande","Vallegrande","ESC.SANTA ANA",-64.14568,-18.59265,11,1,108,119,52,5,50,102
"Bolivia","Santa Cruz","Valle Grande","Vallegrande","ESC. SANTA ROSITA",-64.08921,-18.52326,22,3,132,154,85,3,41,126
"Bolivia","Santa Cruz","Valle Grande","Vallegrande","ESC. TEMPORAL",-64.07647,-18.63612,6,0,29,35,21,1,7,28
"Bolivia","Santa Cruz","Valle Grande","Vallegrande","ESC. UNIDAD EDUCATIVA ARENALES",-63.72049,-18.95825,28,0,113,141,87,4,22,109
"Bolivia","Santa Cruz","Valle Grande","Vallegrande","KINDER SANTA MARIA",-64.1016,-18.48618,239,26,1628,1867,968,80,554,1522
"Bolivia","Santa Cruz","Velasco","San Ignacio (San Ignacio de Velasco)","15 DE AGOSTO",-61.22021,-16.04663,28,5,192,220,13,6,168,181
"Bolivia","Santa Cruz","Velasco","San Ignacio (San Ignacio de Velasco)","ESC.ALBERTO NATUSCH BUSCH",-61.19359,-14.61075,6,0,36,42,11,0,25,36
"Bolivia","Santa Cruz","Velasco","San Ignacio (San Ignacio de Velasco)","ESC. CAMPAMENTO",-61.01795,-15.1786,121,10,391,512,206,16,159,365
"Bolivia","Santa Cruz","Velasco","San Ignacio (San Ignacio de Velasco)","ESC. CARLOS MAYSER",-60.96424,-16.37827,751,52,3206,3957,2263,74,817,3080
"Bolivia","Santa Cruz","Velasco","San Ignacio (San Ignacio de Velasco)","ESC.CENTRAL EL PORVENIR",-59.49656,-16.28357,89,2,119,208,46,1,70,116
"Bolivia","Santa Cruz","Velasco","San Ignacio (San Ignacio de Velasco)","ESC.CENTRAL PISO FIRME",-61.73743,-13.63076,32,4,143,175,49,6,84,133
"Bolivia","Santa Cruz","Velasco","San Ignacio (San Ignacio de Velasco)","ESC. DON BOSCO",-60.9684,-16.38181,500,65,2505,3005,1494,60,886,2380
"Bolivia","Santa Cruz","Velasco","San Ignacio (San Ignacio de Velasco)","ESC.EL CARMEN DE RUIZ",-61.09895,-16.04755,92,6,488,580,359,13,110,469
"Bolivia","Santa Cruz","Velasco","San Ignacio (San Ignacio de Velasco)","ESC. LIC. SENORITAS MONSENOR DANIEL RIVE",-60.95947,-16.38194,1047,45,4525,5572,3400,116,964,4364
"Bolivia","Santa Cruz","Velasco","San Ignacio (San Ignacio de Velasco)","ESC. MARISCAL SUCRE",-60.97673,-16.37599,890,47,3456,4346,2594,78,737,3331
"Bolivia","Santa Cruz","Velasco","San Ignacio (San Ignacio de Velasco)","ESC.MIRAFLORES",-60.39898,-15.7093,9,0,31,40,25,0,6,31
"Bolivia","Santa Cruz","Velasco","San Ignacio (San Ignacio de Velasco)","ESC.NUCLEO CENTRAL ESPIRITU",-60.52824,-16.18724,116,5,244,360,164,3,72,236
"Bolivia","Santa Cruz","Velasco","San Ignacio (San Ignacio de Velasco)","ESC. PAILITA",-60.71217,-16.55711,12,1,54,66,22,0,31,53
"Bolivia","Santa Cruz","Velasco","San Ignacio (San Ignacio de Velasco)","ESC. RECREO",-61.05543,-16.42583,17,1,108,125,38,1,68,106
"Bolivia","Santa Cruz","Velasco","San Ignacio (San Ignacio de Velasco)","ESC. SAN JOSEMA",-61.0378,-16.26388,6,5,97,103,27,4,61,88
"Bolivia","Santa Cruz","Velasco","San Ignacio (San Ignacio de Velasco)","ESC. SAN JUAN DEL MACOÑO",-60.1824,-16.04592,8,0,56,64,37,3,16,53
"Bolivia","Santa Cruz","Velasco","San Ignacio (San Ignacio de Velasco)","ESC. SAN MARTIN",-61.48943,-15.39137,193,14,705,898,97,29,565,662
"Bolivia","Santa Cruz","Velasco","San Ignacio (San Ignacio de Velasco)","ESC.SANTA ANA",-60.68709,-16.58516,107,2,363,470,274,4,83,357
"Bolivia","Santa Cruz","Velasco","San Ignacio (San Ignacio de Velasco)","ESC.SANTA ROSA ROCA",-61.43752,-15.9136,394,22,1053,1447,549,45,437,986
"Bolivia","Santa Cruz","Velasco","San Ignacio (San Ignacio de Velasco)","ESC.SAN VICENTE",-60.07525,-16.27286,61,5,229,290,122,10,92,214
"Bolivia","Santa Cruz","Velasco","San Ignacio (San Ignacio de Velasco)","ESC. U.E. 25 DE JULIO",-60.34592,-15.55293,18,1,67,85,41,5,20,61
"Bolivia","Santa Cruz","Velasco","San Ignacio (San Ignacio de Velasco)","ESC. U.E. LA ESTRELLA",-61.51268,-15.57549,44,5,337,381,106,13,213,319
"Bolivia","Santa Cruz","Velasco","San Ignacio (San Ignacio de Velasco)","ESC. U.E. SIMON BOLIVAR",-60.42154,-15.33675,14,0,118,132,55,6,57,112
"Bolivia","Santa Cruz","Velasco","San Ignacio (San Ignacio de Velasco)","U.E. 15 DE AGOSTO",-61.221,-16.0462,5,0,105,110,16,2,87,103
"Bolivia","Santa Cruz","Velasco","San Ignacio (San Ignacio de Velasco)","U.E. 19 DE MARZO",-61.04763,-16.33254,8,0,0,8,0,0,0,0
"Bolivia","Santa Cruz","Velasco","San Ignacio (San Ignacio de Velasco)","U.E. BERNARDO MONTEAGUDO",-61.43381,-15.22893,11,1,94,105,6,2,85,91
"Bolivia","Santa Cruz","Velasco","San Ignacio (San Ignacio de Velasco)","U.E. CELEDONIO CORTEZON",-61.15897,-16.03947,4,0,0,4,0,0,0,0
"Bolivia","Santa Cruz","Velasco","San Ignacio (San Ignacio de Velasco)","U.E. JOSE CHAVEZ",-61.42244,-15.99493,1,0,75,76,41,1,33,74
"Bolivia","Santa Cruz","Velasco","San Ignacio (San Ignacio de Velasco)","U.E. JOSE FERREIRA",-60.96625,-15.38916,3,0,41,44,25,0,16,41
"Bolivia","Santa Cruz","Velasco","San Ignacio (San Ignacio de Velasco)","U.E. JOSE PESSOA",-60.89307,-15.46235,0,2,42,42,23,2,15,38
"Bolivia","Santa Cruz","Velasco","San Ignacio (San Ignacio de Velasco)","U.E. MERCEDES DE LAS MINAS",-60.87927,-16.38784,3,2,50,53,27,0,21,48
"Bolivia","Santa Cruz","Velasco","San Ignacio (San Ignacio de Velasco)","U.E. SAN BARTOLO DE LA FRONTERA",-59.89635,-16.29955,22,1,109,131,57,5,46,103
"Bolivia","Santa Cruz","Velasco","San Ignacio (San Ignacio de Velasco)","U.E. SAN JAVIERITO",-61.00164,-16.16473,12,3,247,259,155,21,68,223
"Bolivia","Santa Cruz","Velasco","San Ignacio (San Ignacio de Velasco)","U.E. SAN LORENCITO DE LA FRONTERA",-60.32001,-15.62855,12,1,107,119,68,2,36,104
"Bolivia","Santa Cruz","Velasco","San Ignacio (San Ignacio de Velasco)","U.E. SAN RAFAELITO DE SUPONEMA",-60.73782,-16.51591,4,1,107,111,86,1,19,105
"Bolivia","Santa Cruz","Velasco","San Ignacio (San Ignacio de Velasco)","U.E. SANTA ANITA DE LA FRONTERA",-60.46891,-16.16416,5,1,64,69,9,1,53,62
"Bolivia","Santa Cruz","Velasco","San Ignacio (San Ignacio de Velasco)","U.E. TARCILA JUSTINIANO",-61.3272,-15.92669,4,1,68,72,30,3,34,64
"Bolivia","Santa Cruz","Velasco","San Ignacio (San Ignacio de Velasco)","U.E. TIERRA FIRME",-61.38297,-15.43932,13,1,123,136,7,4,111,118
"Bolivia","Santa Cruz","Velasco","San Miguel (San Miguel de Velasco)","ESC. BELISARIO SANTISTEBAN",-60.96719,-16.70072,369,14,1819,2188,784,34,987,1771
"Bolivia","Santa Cruz","Velasco","San Miguel (San Miguel de Velasco)","ESC. JOSE J.DORADO",-60.96856,-16.69866,431,61,2409,2840,1178,44,1126,2304
"Bolivia","Santa Cruz","Velasco","San Miguel (San Miguel de Velasco)","ESC. MONSEÑOR BONIFACIO",-61.49168,-17.07628,59,9,378,437,203,7,159,362
"Bolivia","Santa Cruz","Velasco","San Miguel (San Miguel de Velasco)","ESC. U.E. CRUZ DEL TOCOIGO",-61.14905,-16.62491,14,3,112,126,27,1,81,108
"Bolivia","Santa Cruz","Velasco","San Miguel (San Miguel de Velasco)","ESC. U.E. SAN LUISITO DE LIMA",-61.22618,-16.79143,2,0,20,22,1,2,17,18
"Bolivia","Santa Cruz","Velasco","San Miguel (San Miguel de Velasco)","ESC. U.E. SAN PEDRO DEL CERRITO",-61.1039,-16.61456,6,0,49,55,17,2,30,47
"Bolivia","Santa Cruz","Velasco","San Miguel (San Miguel de Velasco)","U.E. ALTAMIRA",-61.0463,-16.71514,6,2,49,55,6,1,40,46
"Bolivia","Santa Cruz","Velasco","San Miguel (San Miguel de Velasco)","U.E. SAPOCO",-60.99136,-16.61194,0,3,85,85,11,1,70,81
"Bolivia","Santa Cruz","Velasco","San Rafael","ESC. EL TUNA",-59.6983,-16.62828,32,0,138,170,106,3,29,135
"Bolivia","Santa Cruz","Velasco","San Rafael","ESC. GODOFREDO TRENKER",-60.67352,-16.78576,458,24,1673,2131,1119,39,491,1610
"Bolivia","Santa Cruz","Velasco","San Rafael","ESC. MIRAFLORES II",-60.58031,-17.12125,64,0,228,292,56,5,167,223
"Bolivia","Santa Cruz","Velasco","San Rafael","ESC. VILLA FATIMA",-60.60354,-16.9649,17,1,52,69,34,3,14,48
"Bolivia","Santa Cruz","Warnes","Okinawa Uno","ESC. NUEVA AURORA",-62.80148,-17.49827,7,0,48,55,39,0,9,48
"Bolivia","Santa Cruz","Warnes","Okinawa Uno","ESCUELA. COLEGIO EVANGELICO METODISTA",-62.88918,-17.21915,486,66,3233,3719,2007,172,988,2995
"Bolivia","Santa Cruz","Warnes","Okinawa Uno","ESCUELA UNID. EDU.NUEVO HORIZONTE",-62.80159,-17.32424,135,14,934,1069,639,9,272,911
"Bolivia","Santa Cruz","Warnes","Okinawa Uno","ESC. UNIDAD EDUCATIVA NUEVA ESPERANZA",-62.7861,-17.24826,30,5,201,231,107,6,83,190
"Bolivia","Santa Cruz","Warnes","Okinawa Uno","ESC. UNID. EDU. SAN MIGUEL",-62.90409,-17.43998,60,3,373,433,217,8,145,362
"Bolivia","Santa Cruz","Warnes","Okinawa Uno","ESC. UNID.EDU. SECCIONAL PUERTO NUEVO",-62.79018,-17.17909,52,5,338,390,251,5,77,328
"Bolivia","Santa Cruz","Warnes","Okinawa Uno","ESC.UNID EDU.  VILLA REYES",-62.82537,-17.39157,19,0,129,148,54,5,70,124
"Bolivia","Santa Cruz","Warnes","Warnes","26 DE MARZO",-63.13284,-17.58807,25,2,152,177,57,28,65,122
"Bolivia","Santa Cruz","Warnes","Warnes","ESC. ADRIAN JUSTINIANO ROCA",-63.01891,-17.59505,73,12,474,547,287,10,165,452
"Bolivia","Santa Cruz","Warnes","Warnes","ESC. CIUDAD SATELITE NORTE",-63.14571,-17.60657,1688,57,8634,10322,3703,302,4572,8275
"Bolivia","Santa Cruz","Warnes","Warnes","ESC. COL. CONSTANTINO CUELLAR",-63.16426,-17.50641,477,89,3386,3863,2007,85,1205,3212
"Bolivia","Santa Cruz","Warnes","Warnes","ESC. COLEGIO JULIA SAID",-63.16407,-17.51213,1125,51,6745,7870,3208,253,3233,6441
"Bolivia","Santa Cruz","Warnes","Warnes","ESC. EL JIPA",-63.14586,-17.50428,34,5,450,484,197,17,231,428
"Bolivia","Santa Cruz","Warnes","Warnes","ESC. FISCAL POTRERO LARGO",-63.11728,-17.56155,448,24,2508,2956,1064,103,1317,2381
"Bolivia","Santa Cruz","Warnes","Warnes","ESC. JUANA AZURDUY DE PADILLA",-63.0628,-17.51302,633,32,4061,4694,1485,187,2357,3842
"Bolivia","Santa Cruz","Warnes","Warnes","ESC. TERRACOR",-63.18655,-17.65559,324,24,2002,2326,1188,49,741,1929
"Bolivia","Santa Cruz","Warnes","Warnes","ESC. UE ANGELMIRA MONTE. DE DALENCE",-62.96617,-17.45183,46,6,429,475,269,9,145,414
"Bolivia","Santa Cruz","Warnes","Warnes","ESC. UE LAS BARRERAS",-63.18001,-17.44845,189,29,1575,1764,761,101,684,1445
"Bolivia","Santa Cruz","Warnes","Warnes","ESC. UE MARIANO VACA MONTERO",-63.05692,-17.42761,163,10,849,1012,458,49,332,790
"Bolivia","Santa Cruz","Warnes","Warnes","ESC. UE. NUCLEO CENTRAL CLARA CHUCHIO",-63.10474,-17.6164,84,8,615,699,397,14,196,593
"Bolivia","Santa Cruz","Warnes","Warnes","ESC. UE SECCIONAL AZUZAQUI",-63.15946,-17.43235,33,3,340,373,149,13,175,324
"Bolivia","Santa Cruz","Warnes","Warnes","ESC. UE SECCIONAL LA MARINA",-63.00195,-17.4187,62,9,345,407,123,8,205,328
"Bolivia","Santa Cruz","Warnes","Warnes","ESC. UE TUROBITO",-63.14501,-17.36471,26,5,314,340,193,16,100,293
"Bolivia","Santa Cruz","Warnes","Warnes","ESC. UNID. EDU. 21 DE OCTUBRE",-62.99185,-17.40991,30,5,171,201,27,5,134,161
"Bolivia","Santa Cruz","Warnes","Warnes","ESC. UNID. EDU. DON BOSCO",-63.20383,-17.40809,91,4,566,657,333,17,212,545
"Bolivia","Santa Cruz","Warnes","Warnes","ESC. UNID. EDU. EL TAJIBO",-62.99646,-17.24698,146,14,736,882,434,18,270,704
"Bolivia","Santa Cruz","Warnes","Warnes","ESC.  UNID. EDU. FELIX PAZ VIEIRA",-63.04347,-17.29358,26,17,287,313,127,9,134,261
"Bolivia","Santa Cruz","Warnes","Warnes","ESC. UNID. EDU.  JUAN LATINO",-63.22111,-17.4443,59,5,392,451,188,17,182,370
"Bolivia","Santa Cruz","Warnes","Warnes","ESC. UNID. EDU.  LA REFORMA",-63.07001,-17.26757,87,13,627,714,301,7,306,607
"Bolivia","Santa Cruz","Warnes","Warnes","ESC. UNID. EDU.  LOS CHACOS",-63.01535,-17.29066,54,5,360,414,251,2,102,353
"Bolivia","Santa Cruz","Warnes","Warnes","ESC.UNID.EDU.    MOTACU",-63.11813,-17.55554,30,2,206,236,140,3,61,201
"Bolivia","Santa Cruz","Warnes","Warnes","ESC. UNID. EDU. SECCIONAL EL FUTURO",-63.0559,-17.36139,6,3,73,79,27,2,41,68
"Bolivia","Santa Cruz","Warnes","Warnes","ESC. VALLE SANCHEZ",-63.16564,-17.65603,523,14,2806,3329,1988,78,726,2714
"Bolivia","Santa Cruz","Warnes","Warnes","POLITECNICO PENTAGUAZU",-63.13067,-17.59501,8,0,53,61,23,0,30,53
"Bolivia","Santa Cruz","Warnes","Warnes","U.E. AKUALAND",-63.17204,-17.64403,23,1,330,353,217,5,107,324
"Bolivia","Santa Cruz","Warnes","Warnes","U.E. ANTONIO ANZUATI",-63.17149,-17.53695,12,2,163,175,52,8,101,153
"Bolivia","Santa Cruz","Warnes","Warnes","U.E. BUENA FE",-63.0742,-17.5464,52,5,673,725,181,55,432,613
"Bolivia","Santa Cruz","Warnes","Warnes","U.E. CAMPO ROSSO 4 DE ABRIL",-63.13654,-17.59862,157,9,1048,1205,489,28,522,1011
"Bolivia","Santa Cruz","Warnes","Warnes","U.E. EL MANANTIAL",-63.12106,-17.60827,94,2,738,832,407,14,315,722
"Bolivia","Santa Cruz","Warnes","Warnes","U.E. IGNACIO WARNES",-63.16686,-17.50828,1162,44,7429,8591,4224,228,2933,7157
"Bolivia","Santa Cruz","Warnes","Warnes","U.E. JOSE MANUEL VACA",-63.16396,-17.50945,34,5,235,269,134,4,92,226
"Bolivia","Santa Cruz","Warnes","Warnes","U.E. JUANCITO PINTO",-63.27866,-17.35187,19,1,252,271,78,6,167,245
"Bolivia","Santa Cruz","Warnes","Warnes","U.E. MAXIMO NOVILLO",-63.12106,-17.60827,0,10,975,975,320,107,538,858
"Bolivia","Santa Cruz","Warnes","Warnes","U.E. MONTE CARMELO",-63.11643,-17.59848,26,2,251,277,104,37,108,212
"Bolivia","Santa Cruz","Warnes","Warnes","U.E. NUEVA JERUSALEN-PENTAGUAZU",-63.12896,-17.60241,30,1,377,407,155,8,213,368
"Bolivia","Santa Cruz","Warnes","Warnes","U.E. PAITITI",-63.17518,-17.5598,18,3,232,250,68,5,156,224
"Bolivia","Santa Cruz","Warnes","Warnes","U.E . SAN JUAN",-63.10375,-17.60646,122,3,865,987,414,31,417,831
"Bolivia","Santa Cruz","Warnes","Warnes","U.E. SATELITE NORTE",-63.14511,-17.60841,91,3,565,656,251,25,286,537
"Bolivia","Santa Cruz","Warnes","Warnes","U.E. WAJOJO",-63.18615,-17.54112,12,5,225,237,89,15,116,205
"Bolivia","Tarija","Arce","Bermejo","(CÁRCEL) CARCELETA BERMEJO",-64.34433,-22.73379,1,0,14,15,6,0,8,14
"Bolivia","Tarija","Arce","Bermejo","U.E. 25 DE MAYO",-64.33881,-22.73283,751,34,2989,3740,1773,60,1122,2895
"Bolivia","Tarija","Arce","Bermejo","U.E. 8 DE SEPTIEMBRE",-64.3345,-22.74253,499,33,1867,2366,936,54,844,1780
"Bolivia","Tarija","Arce","Bermejo","U.E. ANTONIO JOSE DE SUCRE",-64.33714,-22.72646,197,5,812,1009,408,22,377,785
"Bolivia","Tarija","Arce","Bermejo","U.E. ARROZALES",-64.28224,-22.71737,45,2,187,232,72,6,107,179
"Bolivia","Tarija","Arce","Bermejo","U.E. AULIO ARAOZ",-64.34415,-22.72519,444,32,1518,1962,708,62,716,1424
"Bolivia","Tarija","Arce","Bermejo","U.E. BARREDERO",-64.25467,-22.60689,59,6,258,317,42,5,205,247
"Bolivia","Tarija","Arce","Bermejo","U.E. CAMPO GRANDE (ARCE)",-64.31056,-22.8059,111,12,300,411,84,30,174,258
"Bolivia","Tarija","Arce","Bermejo","U.E. COLONIA LINARES",-64.27553,-22.67242,127,18,486,613,124,20,324,448
"Bolivia","Tarija","Arce","Bermejo","U.E. EDUARDO AVAROA",-64.34496,-22.72868,920,44,3542,4462,1931,103,1464,3395
"Bolivia","Tarija","Arce","Bermejo","U.E. FLOR DE ORO",-64.42138,-22.64809,47,3,141,188,56,4,78,134
"Bolivia","Tarija","Arce","Bermejo","U.E. GUIDO VILLAGOMEZ",-64.333,-22.73719,648,45,2524,3172,1332,71,1076,2408
"Bolivia","Tarija","Arce","Bermejo","U.E. LA ESPERANZA",-64.31773,-22.72795,16,6,289,305,77,5,201,278
"Bolivia","Tarija","Arce","Bermejo","U.E. MOTO MENDEZ",-64.40874,-22.67791,78,11,209,287,71,8,119,190
"Bolivia","Tarija","Arce","Bermejo","U.E. MSCAL. ANDRES DE SANTA CRUZ",-64.33983,-22.73268,620,20,1911,2531,1155,37,699,1854
"Bolivia","Tarija","Arce","Bermejo","U.E. OCTAVIO CAMPERO ECHAZU (BERMEJO)",-64.33255,-22.73421,795,42,3075,3870,1617,101,1315,2932
"Bolivia","Tarija","Arce","Bermejo","U.E. PORCELANA",-64.2924,-22.77003,40,6,97,137,28,3,60,88
"Bolivia","Tarija","Arce","Padcaya","ESC. SECCIONAL QUEÑAHUAYCO",-64.95709,-21.92935,31,2,259,290,37,9,211,248
"Bolivia","Tarija","Arce","Padcaya","ESC. TACUARA SIMON BOLIVAR",-64.85365,-21.8613,38,2,154,192,30,2,120,150
"Bolivia","Tarija","Arce","Padcaya","NUCLEO 9 DE OCTUBRE",-64.16064,-22.4478,73,5,169,242,30,7,127,157
"Bolivia","Tarija","Arce","Padcaya","NUCLEO  SAN TELMO/PRIMERO DE MAYO",-64.41067,-22.53317,50,8,278,328,124,16,130,254
"Bolivia","Tarija","Arce","Padcaya","U.E. 2 DE AGOSTO",-64.24153,-22.49751,66,3,248,314,30,8,207,237
"Bolivia","Tarija","Arce","Padcaya","U.E. ABRA DE SAN MIGUEL",-64.80976,-21.90239,12,1,213,225,80,1,131,211
"Bolivia","Tarija","Arce","Padcaya","U.E. ANICETO ARCE",-64.71397,-21.88711,317,26,1759,2076,975,41,717,1692
"Bolivia","Tarija","Arce","Padcaya","U.E. ANZELMO ONTIVEROS",-64.53857,-22.26854,73,4,365,438,71,8,282,353
"Bolivia","Tarija","Arce","Padcaya","U.E. BLANCA NAVAJAS",-64.84832,-21.89751,89,6,384,473,105,31,242,347
"Bolivia","Tarija","Arce","Padcaya","U.E. CAMACHO",-64.91243,-21.89222,64,5,367,431,84,9,269,353
"Bolivia","Tarija","Arce","Padcaya","U.E. CANCHAS MAYU",-64.89188,-21.89764,28,2,209,237,42,2,163,205
"Bolivia","Tarija","Arce","Padcaya","U.E. EL CARMEN",-64.84747,-22.04908,25,1,135,160,32,1,101,133
"Bolivia","Tarija","Arce","Padcaya","U.E. ELOY APARICIO",-64.67204,-21.83963,116,8,518,634,188,12,310,498
"Bolivia","Tarija","Arce","Padcaya","U.E. JUAN PABLO II",-64.47629,-22.45985,54,1,127,181,50,3,73,123
"Bolivia","Tarija","Arce","Padcaya","U.E. LA HUERTA",-64.93794,-21.91131,43,7,209,252,27,6,169,196
"Bolivia","Tarija","Arce","Padcaya","U.E. LA MERCED",-64.67546,-22.02656,64,4,338,402,171,11,152,323
"Bolivia","Tarija","Arce","Padcaya","U.E. LIMAL",-64.49821,-22.32937,21,0,107,128,35,3,69,104
"Bolivia","Tarija","Arce","Padcaya","U.E. NARANJO AGRIO",-64.49283,-22.30481,23,1,100,123,17,1,81,98
"Bolivia","Tarija","Arce","Padcaya","U.E. OROZAS ARRIBA",-64.64409,-21.91746,90,15,505,595,137,23,330,467
"Bolivia","Tarija","Arce","Padcaya","U.E. OSCAR HIZA BASTIAS",-64.66535,-22.17904,117,9,466,583,149,19,289,438
"Bolivia","Tarija","Arce","Padcaya","U.E. PAMPA GRANDE",-64.43581,-22.04747,181,23,464,645,110,17,314,424
"Bolivia","Tarija","Arce","Padcaya","U.E. QUEBRADA DE CAÑAS",-64.88522,-21.96515,25,3,135,160,19,6,107,126
"Bolivia","Tarija","Arce","Padcaya","U.E. RIO NEGRO",-64.67294,-22.10281,53,11,305,358,103,11,180,283
"Bolivia","Tarija","Arce","Padcaya","U.E. ROSILLAS II",-64.78128,-21.93346,110,10,525,635,211,11,293,504
"Bolivia","Tarija","Arce","Padcaya","U.E. RUMY CANCHA",-64.67708,-21.94845,45,6,146,191,57,6,77,134
"Bolivia","Tarija","Arce","Padcaya","U.E. SALADO CONCHAS",-64.41152,-22.36673,15,0,122,137,27,2,93,120
"Bolivia","Tarija","Arce","Padcaya","U.E. SAN ANTONIO DE MACOYA",-64.89361,-22.10435,92,6,233,325,164,12,51,215
"Bolivia","Tarija","Arce","Padcaya","U.E. SAN FRANCISCO (ARCE)",-64.81699,-21.99598,22,1,151,173,34,5,111,145
"Bolivia","Tarija","Arce","Padcaya","U.E. SAN JOSE DE MARAÑUELO",-64.8847,-21.02283,20,3,175,195,18,2,152,170
"Bolivia","Tarija","Arce","Padcaya","U.E. SIMON BOLIVAR DE REJARA",-64.98435,-22.00053,49,2,271,320,21,4,244,265
"Bolivia","Tarija","Arce","Padcaya","U.E. VIRGEN DE CHAGUAYA",-64.82275,-21.86792,70,4,296,366,108,11,173,281
"Bolivia","Tarija","Avilés","Uriondo (Concepción)","COL. DELFIN PINO ICHAZU",-64.65437,-21.69452,359,20,1833,2192,1080,75,658,1738
"Bolivia","Tarija","Avilés","Uriondo (Concepción)","ESC. FELIPE ARAOZ",-64.79521,-21.81298,72,8,255,327,107,10,130,237
"Bolivia","Tarija","Avilés","Uriondo (Concepción)","ESC. MULLI CANCHA 27 DE MAYO",-64.75569,-21.66716,15,2,67,82,23,7,35,58
"Bolivia","Tarija","Avilés","Uriondo (Concepción)","ESC. NICOLAS GARECA",-64.73965,-21.68574,18,8,125,143,36,8,73,109
"Bolivia","Tarija","Avilés","Uriondo (Concepción)","ESC. WALTER MADALLENO",-64.87085,-21.83233,79,4,223,302,48,8,163,211
"Bolivia","Tarija","Avilés","Uriondo (Concepción)","U.E. 15 DE OCTUBRE",-64.87048,-21.78415,121,9,347,468,82,12,244,326
"Bolivia","Tarija","Avilés","Uriondo (Concepción)","U.E. 19 DE MARZO",-64.76694,-21.79675,44,4,203,247,73,7,119,192
"Bolivia","Tarija","Avilés","Uriondo (Concepción)","U.E. ANCON CHICO",-64.65513,-21.67163,37,5,295,332,106,4,180,286
"Bolivia","Tarija","Avilés","Uriondo (Concepción)","U.E. ANCON GRANDE",-64.65231,-21.62995,9,0,129,138,82,8,39,121
"Bolivia","Tarija","Avilés","Uriondo (Concepción)","U.E. ANICETO ARCE",-64.73565,-21.75162,181,22,870,1051,431,28,389,820
"Bolivia","Tarija","Avilés","Uriondo (Concepción)","U.E. LA CHOZA",-64.61714,-21.67806,85,13,590,675,323,32,222,545
"Bolivia","Tarija","Avilés","Uriondo (Concepción)","U.E. LA COMPAÑIA",-64.68107,-21.70434,37,7,329,366,106,14,202,308
"Bolivia","Tarija","Avilés","Uriondo (Concepción)","U.E. NUEVO AMANECER",-64.65608,-21.7632,178,17,888,1066,450,19,402,852
"Bolivia","Tarija","Avilés","Uriondo (Concepción)","U.E. ROSARIO JARAMILLO",-64.62204,-21.69797,261,40,1842,2103,823,84,895,1718
"Bolivia","Tarija","Avilés","Uriondo (Concepción)","U.E. VIRGEN DE LADERAS",-64.55874,-21.6606,27,4,166,193,45,9,108,153
"Bolivia","Tarija","Avilés","Yunchará","COL. 6 DE ABRIL",-65.22864,-21.82303,67,1,260,327,61,12,186,247
"Bolivia","Tarija","Avilés","Yunchará","U.E. 13 DE ABRIL",-65.09945,-21.99084,28,1,162,190,10,8,143,153
"Bolivia","Tarija","Avilés","Yunchará","U.E. 15 DE ABRIL",-65.32096,-21.76059,13,3,67,80,8,2,54,62
"Bolivia","Tarija","Avilés","Yunchará","U.E.  25 DE MAYO",-65.13538,-21.55874,39,2,194,233,26,7,159,185
"Bolivia","Tarija","Avilés","Yunchará","U.E. CHORCOYA AVILES",-65.05279,-21.65858,24,4,123,147,43,5,71,114
"Bolivia","Tarija","Avilés","Yunchará","U.E. FELIX RAMOS",-65.28792,-21.84653,23,0,54,77,7,2,45,52
"Bolivia","Tarija","Avilés","Yunchará","U.E. HUGO AMABLE HOYOS",-65.25793,-21.60342,8,1,45,53,3,0,41,44
"Bolivia","Tarija","Avilés","Yunchará","U.E. JOSE BALLIVIAN",-65.09161,-21.8291,90,10,208,298,44,6,148,192
"Bolivia","Tarija","Avilés","Yunchará","U.E. JOSE MARIA AVILES",-65.24372,-21.56001,18,1,99,117,15,7,76,91
"Bolivia","Tarija","Avilés","Yunchará","U.E. NARCISO CAMPERO",-65.32111,-21.81886,36,6,124,160,23,6,89,112
"Bolivia","Tarija","Avilés","Yunchará","U.E. ÑOQUERA",-65.13422,-21.62397,35,5,151,186,53,3,90,143
"Bolivia","Tarija","Avilés","Yunchará","U.E. PASAJES",-65.08871,-21.74598,48,5,272,320,50,10,207,257
"Bolivia","Tarija","Avilés","Yunchará","U.E. QUEBRADA HONDA",-65.15102,-21.95652,36,0,125,161,19,5,101,120
"Bolivia","Tarija","Avilés","Yunchará","U.E. SAN JOSE DE CHURQUIS",-65.23459,-21.72629,22,3,68,90,8,6,51,59
"Bolivia","Tarija","Avilés","Yunchará","U.E. SATURNINO URZAGASTE",-65.30037,-21.69103,18,0,123,141,15,0,108,123
"Bolivia","Tarija","Avilés","Yunchará","U.E. YUTICANCHA",-65.06479,-21.91516,4,2,91,95,13,5,71,84
"Bolivia","Tarija","Burnet O'Connor","Entre Ríos (La Moreta)","CENTRO P.A.N TENTAGUAZU",-63.96276,-21.11408,35,0,116,151,75,4,37,112
"Bolivia","Tarija","Burnet O'Connor","Entre Ríos (La Moreta)","U.E. 12 DE ABRIL",-63.78238,-21.41462,69,5,350,419,235,5,105,340
"Bolivia","Tarija","Burnet O'Connor","Entre Ríos (La Moreta)","U.E. CANALETAS CENTRO",-64.35432,-21.45255,32,2,134,166,33,7,92,125
"Bolivia","Tarija","Burnet O'Connor","Entre Ríos (La Moreta)","U.E. CHIQUIACA CENTRO",-64.12215,-21.86438,64,14,431,495,153,11,253,406
"Bolivia","Tarija","Burnet O'Connor","Entre Ríos (La Moreta)","U.E. CNL. EUSTAQUIO MENDEZ",-64.27944,-21.40812,43,6,346,389,94,14,232,326
"Bolivia","Tarija","Burnet O'Connor","Entre Ríos (La Moreta)","U.E. FRANZ TAMAYO",-64.17131,-21.52566,870,75,4070,4940,2194,116,1685,3879
"Bolivia","Tarija","Burnet O'Connor","Entre Ríos (La Moreta)","U.E. HUAICO ACERRADERO",-64.25552,-21.33019,53,4,244,297,90,12,138,228
"Bolivia","Tarija","Burnet O'Connor","Entre Ríos (La Moreta)","U.E. JUAN SAAVEDRA MEALLA",-64.23573,-21.79252,62,5,262,324,119,11,127,246
"Bolivia","Tarija","Burnet O'Connor","Entre Ríos (La Moreta)","U.E. LAGUNITAS",-63.89547,-21.41483,42,2,101,143,61,5,33,94
"Bolivia","Tarija","Burnet O'Connor","Entre Ríos (La Moreta)","U.E. LUIS VACA GALLARDO",-64.1218,-21.31882,47,5,176,223,98,7,66,164
"Bolivia","Tarija","Burnet O'Connor","Entre Ríos (La Moreta)","U.E. MISTOLAR",-63.78576,-21.17984,80,1,146,226,86,4,55,141
"Bolivia","Tarija","Burnet O'Connor","Entre Ríos (La Moreta)","U.E. ÑAURENDA",-64.05932,-21.1314,58,4,265,323,100,9,152,252
"Bolivia","Tarija","Burnet O'Connor","Entre Ríos (La Moreta)","U.E. PAJONAL",-64.16981,-21.48504,34,4,161,195,74,3,80,154
"Bolivia","Tarija","Burnet O'Connor","Entre Ríos (La Moreta)","U.E. PAMPA REDONDA",-64.17494,-21.997,16,0,118,134,23,3,92,115
"Bolivia","Tarija","Burnet O'Connor","Entre Ríos (La Moreta)","U.E. POTRERILLOS (O CONNOR)",-64.10823,-21.2234,45,13,250,295,105,3,129,234
"Bolivia","Tarija","Burnet O'Connor","Entre Ríos (La Moreta)","U.E. PROF. EMILIANO VILLARRUBIA",-63.98725,-21.52296,44,2,226,270,114,6,104,218
"Bolivia","Tarija","Burnet O'Connor","Entre Ríos (La Moreta)","U.E. PROFESOR RENE AVILA BAYON",-64.23028,-21.20329,141,13,504,645,179,21,291,470
"Bolivia","Tarija","Burnet O'Connor","Entre Ríos (La Moreta)","U.E. PUESTO MARGARITA",-63.79027,-21.1828,27,3,108,135,65,4,36,101
"Bolivia","Tarija","Burnet O'Connor","Entre Ríos (La Moreta)","U.E. REMIGIO VACA",-64.14987,-21.6035,31,2,118,149,60,23,33,93
"Bolivia","Tarija","Burnet O'Connor","Entre Ríos (La Moreta)","U.E. SAN DIEGO CENTRO",-64.18287,-21.42213,69,6,263,332,70,4,183,253
"Bolivia","Tarija","Burnet O'Connor","Entre Ríos (La Moreta)","U.E. SAN SIMON",-64.12061,-21.44145,20,7,123,143,56,1,59,115
"Bolivia","Tarija","Burnet O'Connor","Entre Ríos (La Moreta)","U.E. SECCIONAL BERETY",-64.03776,-21.44295,24,1,127,151,60,3,63,123
"Bolivia","Tarija","Burnet O'Connor","Entre Ríos (La Moreta)","U.E. SECCIONAL CAÑADAS",-63.97494,-21.41901,11,1,25,36,15,0,9,24
"Bolivia","Tarija","Burnet O'Connor","Entre Ríos (La Moreta)","U.E. SIVINGAL",-64.20417,-21.33499,30,3,188,218,23,8,154,177
"Bolivia","Tarija","Burnet O'Connor","Entre Ríos (La Moreta)","U.E. TAQUILLOS",-64.11756,-21.39566,15,3,75,90,18,2,52,70
"Bolivia","Tarija","Burnet O'Connor","Entre Ríos (La Moreta)","U.E. TARUPAYO",-63.95544,-21.32335,52,0,129,181,63,5,61,124
"Bolivia","Tarija","Burnet O'Connor","Entre Ríos (La Moreta)","U.E. TENTAPIAO",-63.91972,-21.15654,27,1,72,99,53,2,16,69
"Bolivia","Tarija","Burnet O'Connor","Entre Ríos (La Moreta)","U.E. TIMBOY",-64.06391,-21.16788,106,7,357,463,203,16,131,334
"Bolivia","Tarija","Burnet O'Connor","Entre Ríos (La Moreta)","U.E. TTE. GUALBERTO VILLARROEL",-64.20447,-21.69906,54,3,223,277,80,10,130,210
"Bolivia","Tarija","Burnet O'Connor","Entre Ríos (La Moreta)","U.E. VALLECITO DE LOS LAPACHOS",-64.05889,-21.7324,25,8,157,182,91,6,52,143
"Bolivia","Tarija","Burnet O'Connor","Entre Ríos (La Moreta)","U.E. YUKIMBIA",-63.97997,-21.04885,21,0,128,149,17,3,108,125
"Bolivia","Tarija","Cercado","Tarija","ALDEAS S.O.S ALTO SENAC",-64.76811,-21.53532,133,11,842,975,603,19,209,812
"Bolivia","Tarija","Cercado","Tarija","(CÁRCEL) PENAL DE MORROS BLANCOS",-64.70137,-21.54816,38,3,153,191,66,5,79,145
"Bolivia","Tarija","Cercado","Tarija","C.E.B.A.",-64.74647,-21.51721,571,37,2861,3432,1716,96,1012,2728
"Bolivia","Tarija","Cercado","Tarija","LOCAL PALO SANTO",-64.74363,-21.53167,342,12,1738,2080,1148,35,543,1691
"Bolivia","Tarija","Cercado","Tarija","SALON CAPACITACION BARRIO CATEDRAL",-64.76089,-21.54589,107,8,696,803,472,9,207,679
"Bolivia","Tarija","Cercado","Tarija","U.A.J.M.S CAMPUS",-64.72205,-21.54214,396,6,2039,2435,1603,47,383,1986
"Bolivia","Tarija","Cercado","Tarija","U.E. 15 DE ABRIL",-64.70269,-21.39775,49,7,209,258,155,5,42,197
"Bolivia","Tarija","Cercado","Tarija","U.E. 6 DE JUNIO",-64.73151,-21.56649,168,11,904,1072,604,25,264,868
"Bolivia","Tarija","Cercado","Tarija","U.E. ALTO DE ESPAÑA NORTE",-64.44588,-21.33693,58,9,212,270,63,34,106,169
"Bolivia","Tarija","Cercado","Tarija","U.E. AUDELIO QUIFRE",-64.53367,-21.61713,53,4,178,231,57,7,110,167
"Bolivia","Tarija","Cercado","Tarija","U.E. AVELINA RAÑA",-64.73672,-21.52712,614,26,3520,4134,2628,50,816,3444
"Bolivia","Tarija","Cercado","Tarija","U.E. BANCARIO",-64.73233,-21.54881,86,4,639,725,518,7,110,628
"Bolivia","Tarija","Cercado","Tarija","U.E. BELGRANO",-64.72131,-21.53838,965,25,5409,6374,4355,105,924,5279
"Bolivia","Tarija","Cercado","Tarija","U.E. BELLA VISTA",-64.84763,-21.65682,124,17,444,568,153,27,247,400
"Bolivia","Tarija","Cercado","Tarija","U.E. BOLIVIA",-64.7492,-21.54095,581,18,4290,4871,3316,114,842,4158
"Bolivia","Tarija","Cercado","Tarija","U.E. CARLAZO CENTRO",-64.48372,-21.48354,34,4,140,174,67,6,63,130
"Bolivia","Tarija","Cercado","Tarija","U.E. CARMEN ECHAZU",-64.72836,-21.53263,223,7,1348,1571,1121,17,203,1324
"Bolivia","Tarija","Cercado","Tarija","U.E. CASTELFORT CASTELLANOS",-64.70528,-21.54581,639,22,4069,4708,3124,110,813,3937
"Bolivia","Tarija","Cercado","Tarija","U.E. CHURQUIS",-64.78795,-21.66093,82,13,263,345,95,19,136,231
"Bolivia","Tarija","Cercado","Tarija","U.E. EL PORTILLO",-64.65661,-21.56547,204,13,1138,1342,681,39,405,1086
"Bolivia","Tarija","Cercado","Tarija","U.E. ESTEBAN MIGLIACI",-64.71228,-21.53156,800,38,5623,6423,4074,138,1373,5447
"Bolivia","Tarija","Cercado","Tarija","U.E. EULOGIO RUIZ",-64.7403,-21.51833,764,39,3787,4551,2177,103,1468,3645
"Bolivia","Tarija","Cercado","Tarija","U.E. FE Y ALEGRIA",-64.73994,-21.52347,933,40,4992,5925,3342,135,1475,4817
"Bolivia","Tarija","Cercado","Tarija","U.E. GAMONEDA",-64.62419,-21.49576,24,5,176,200,69,10,92,161
"Bolivia","Tarija","Cercado","Tarija","U.E. HERMANN GMEINER",-64.73551,-21.50994,1019,72,5020,6039,2440,227,2281,4721
"Bolivia","Tarija","Cercado","Tarija","U.E. IGNACIA NAZARIA MARCH",-64.75533,-21.50238,406,37,3082,3488,1585,128,1332,2917
"Bolivia","Tarija","Cercado","Tarija","U.E. J. NAVAL MONZON",-64.76114,-21.53481,406,33,2559,2965,1560,71,895,2455
"Bolivia","Tarija","Cercado","Tarija","U.E. JOSE MANUEL AVILA",-64.72959,-21.52524,1334,41,7435,8769,5604,189,1601,7205
"Bolivia","Tarija","Cercado","Tarija","U.E. JUANA AZURDUY DE PADILLA",-64.7084,-21.54054,372,5,2667,3039,2048,73,541,2589
"Bolivia","Tarija","Cercado","Tarija","U.E. JUAN PABLO II",-64.7523,-21.53608,542,40,3599,4141,2092,185,1282,3374
"Bolivia","Tarija","Cercado","Tarija","U.E. JUAN XXIII",-64.71565,-21.53829,604,19,3610,4214,2932,81,578,3510
"Bolivia","Tarija","Cercado","Tarija","U.E. JULIO CALVO",-64.72686,-21.51741,1247,70,7131,8378,3926,272,2863,6789
"Bolivia","Tarija","Cercado","Tarija","U.E. JUNACAS SUD",-64.46302,-21.43147,40,9,223,263,71,16,127,198
"Bolivia","Tarija","Cercado","Tarija","U.E. LA PAZ",-64.71841,-21.52833,663,36,3836,4499,2671,143,986,3657
"Bolivia","Tarija","Cercado","Tarija","U.E. LA PINTADA",-64.64189,-21.60837,106,19,823,929,502,18,284,786
"Bolivia","Tarija","Cercado","Tarija","U.E. LICEO CAMPERO",-64.73161,-21.53495,213,4,1162,1375,981,11,166,1147
"Bolivia","Tarija","Cercado","Tarija","U.E. LOS CALLEJONES",-64.73492,-21.54672,151,13,922,1073,666,27,216,882
"Bolivia","Tarija","Cercado","Tarija","U.E. LUIS DE FUENTES",-64.82387,-21.70473,178,6,323,501,173,6,138,311
"Bolivia","Tarija","Cercado","Tarija","U.E. MARIA LAURA JUSTINIANO",-64.72923,-21.53517,334,7,2046,2380,1770,27,242,2012
"Bolivia","Tarija","Cercado","Tarija","U.E. MONS ABEL COSTAS",-64.71011,-21.52861,304,28,2615,2919,1621,107,859,2480
"Bolivia","Tarija","Cercado","Tarija","U.E. MONTE CERCADO",-64.6991,-21.43521,25,3,145,170,109,8,25,134
"Bolivia","Tarija","Cercado","Tarija","U.E. NACIONAL SAN LUIS",-64.73555,-21.53229,326,7,1721,2047,1459,27,228,1687
"Bolivia","Tarija","Cercado","Tarija","U.E. NARCISO CAMPERO",-64.73502,-21.53197,210,4,1059,1269,898,14,143,1041
"Bolivia","Tarija","Cercado","Tarija","U.E. NUESTRA SEÑORA DEL ROSARIO",-64.73557,-21.52024,401,16,1990,2391,1276,72,626,1902
"Bolivia","Tarija","Cercado","Tarija","U.E. OCTAVIO CAMPERO ECHAZU",-64.72095,-21.52139,969,50,5770,6739,3400,197,2123,5523
"Bolivia","Tarija","Cercado","Tarija","U.E. OSCAR ZAMORA",-64.77103,-21.62803,184,12,596,780,237,49,298,535
"Bolivia","Tarija","Cercado","Tarija","U.E. PAPACHACRA",-64.40735,-21.48955,46,7,152,198,39,12,94,133
"Bolivia","Tarija","Cercado","Tarija","U.E. PINOS SUD",-64.87549,-21.73471,110,10,328,438,73,19,226,299
"Bolivia","Tarija","Cercado","Tarija","U.E.ROSA ARCE",-64.73045,-21.53088,344,12,2149,2493,1788,41,308,2096
"Bolivia","Tarija","Cercado","Tarija","U.E. SAN AGUSTIN SUD",-64.5279,-21.55583,56,1,136,192,70,6,59,129
"Bolivia","Tarija","Cercado","Tarija","U.E. SAN ANDRES",-64.81682,-21.62062,273,22,1369,1642,580,61,706,1286
"Bolivia","Tarija","Cercado","Tarija","U.E. SAN BLAS",-64.71835,-21.56428,84,8,466,550,313,8,137,450
"Bolivia","Tarija","Cercado","Tarija","U.E. SAN FRANCISCO DE ASIS",-64.7686,-21.51214,37,7,307,344,190,9,101,291
"Bolivia","Tarija","Cercado","Tarija","U.E. SAN GERONIMO",-64.71439,-21.54964,1257,22,3256,4513,2473,73,688,3161
"Bolivia","Tarija","Cercado","Tarija","U.E. SAN JACINTO SUD",-64.72188,-21.61152,63,8,325,388,138,16,163,301
"Bolivia","Tarija","Cercado","Tarija","U.E. SAN JORGE",-64.69663,-21.55364,693,30,3914,4607,2790,120,974,3764
"Bolivia","Tarija","Cercado","Tarija","U.E. SAN LAZARO DE GUERRA HUAYCO",-64.81322,-21.59201,385,34,1176,1561,414,45,683,1097
"Bolivia","Tarija","Cercado","Tarija","U.E. SAN LUIS",-64.69969,-21.56867,265,18,1518,1783,1013,55,432,1445
"Bolivia","Tarija","Cercado","Tarija","U.E. SAN MATEO",-64.75101,-21.48644,207,20,1239,1446,713,42,464,1177
"Bolivia","Tarija","Cercado","Tarija","U.E. SAN ROQUE",-64.73508,-21.52923,465,6,2503,2968,2108,32,357,2465
"Bolivia","Tarija","Cercado","Tarija","U.E. SANTA ANA LA NUEVA",-64.57794,-21.5435,80,12,467,547,250,5,200,450
"Bolivia","Tarija","Cercado","Tarija","U.E. SELLA QUEBRADA",-64.66478,-21.38699,86,21,257,343,112,18,106,218
"Bolivia","Tarija","Cercado","Tarija","U.E. TARIJA",-64.74217,-21.51051,455,25,2446,2901,1404,85,932,2336
"Bolivia","Tarija","Cercado","Tarija","U.E. TERESA DE CALCUTA",-64.74924,-21.53217,284,25,2053,2337,1317,79,632,1949
"Bolivia","Tarija","Cercado","Tarija","U.E. TOLOMOSITA",-64.75163,-21.6041,41,15,259,300,101,18,125,226
"Bolivia","Tarija","Cercado","Tarija","U.E. TORRECILLAS",-64.67634,-21.55232,205,19,1434,1639,862,61,492,1354
"Bolivia","Tarija","Cercado","Tarija","U.E. YESERA CENTRO",-64.5505,-21.41345,36,6,220,256,102,6,106,208
"Bolivia","Tarija","Cercado","Tarija","U.E. YESERA NORTE",-64.54983,-21.37354,59,11,251,310,111,17,112,223
"Bolivia","Tarija","Cercado","Tarija","U.E. YESERA SUD",-64.56313,-21.46948,55,5,255,310,165,15,70,235
"Bolivia","Tarija","Gran Chaco","Caraparí","POSTA SANITARIA KEREIMBA RENDA (INDIGENA)",-64.10361,-22.10099,0,0,23,23,0,0,23,23
"Bolivia","Tarija","Gran Chaco","Caraparí","U.E. 15 DE ABRIL",-63.76043,-21.74331,25,5,180,205,77,2,96,173
"Bolivia","Tarija","Gran Chaco","Caraparí","U.E. 17 DE AGOSTO",-63.92107,-21.94912,20,1,72,92,16,2,53,69
"Bolivia","Tarija","Gran Chaco","Caraparí","U.E. 2 DE AGOSTO",-63.99053,-22.09679,60,4,224,284,32,5,183,215
"Bolivia","Tarija","Gran Chaco","Caraparí","U.E. 3 DE MAYO",-63.73976,-21.82526,723,46,3404,4127,1593,70,1695,3288
"Bolivia","Tarija","Gran Chaco","Caraparí","U.E. 6 DE AGOSTO",-63.72484,-21.77807,29,8,236,265,80,9,139,219
"Bolivia","Tarija","Gran Chaco","Caraparí","U.E. BERETY CHACO",-63.69269,-21.58313,43,3,221,264,65,5,148,213
"Bolivia","Tarija","Gran Chaco","Caraparí","U.E. BOLIVIA",-63.93956,-21.80327,10,0,168,178,82,2,84,166
"Bolivia","Tarija","Gran Chaco","Caraparí","U.E. BOLIVIA DE CARAPARI",-63.77484,-21.93113,0,8,103,103,46,3,46,92
"Bolivia","Tarija","Gran Chaco","Caraparí","U.E. CAMPO LARGO HITO 22",-63.95479,-22.02285,30,2,132,162,33,2,95,128
"Bolivia","Tarija","Gran Chaco","Caraparí","U.E. CAÑITAS",-63.90673,-21.88649,3,1,74,77,21,1,51,72
"Bolivia","Tarija","Gran Chaco","Caraparí","U.E. CELSO RAFFAELLI",-63.77841,-21.8849,136,6,508,644,246,11,245,491
"Bolivia","Tarija","Gran Chaco","Caraparí","U.E. EUSTAQUIO MENDEZ/FRAY QUEBRACHO",-63.88299,-21.70185,84,8,516,600,240,10,258,498
"Bolivia","Tarija","Gran Chaco","Caraparí","U.E. FRAY QUEBRACHO",-63.72994,-21.69252,109,7,413,522,185,13,208,393
"Bolivia","Tarija","Gran Chaco","Caraparí","U.E. JULIO RAMOS VALDEZ",-63.87885,-21.81146,79,5,361,440,142,10,204,346
"Bolivia","Tarija","Gran Chaco","Caraparí","U.E. LIDIA GALARZA",-63.72426,-21.68103,141,12,631,772,234,25,360,594
"Bolivia","Tarija","Gran Chaco","Caraparí","U.E. SAN ALBERTO",-63.80844,-21.91013,108,13,522,630,210,20,279,489
"Bolivia","Tarija","Gran Chaco","Caraparí","U.E. SAN JUAN",-63.84999,-21.98089,0,0,31,31,11,1,19,30
"Bolivia","Tarija","Gran Chaco","Caraparí","U.E. SAN NICOLAS",-64.10381,-22.10169,2,3,52,54,13,2,34,47
"Bolivia","Tarija","Gran Chaco","Caraparí","U.E. ZAPATERA NORTE",-63.82479,-21.55252,61,5,285,346,111,5,164,275
"Bolivia","Tarija","Gran Chaco","Villamontes","CASA DEL NOTARIO",-62.86723,-21.80463,14,0,30,44,10,0,20,30
"Bolivia","Tarija","Gran Chaco","Villamontes","CENTRO COMUNAL",-63.45503,-21.54227,84,7,297,381,88,10,192,280
"Bolivia","Tarija","Gran Chaco","Villamontes","KINDER COLORADOS DE BOLIVIA",-63.44756,-21.25988,136,7,521,657,246,10,258,504
"Bolivia","Tarija","Gran Chaco","Villamontes","SEDE SOCIAL DE LA COMUNIDAD",-63.15966,-21.41535,15,0,41,56,25,0,16,41
"Bolivia","Tarija","Gran Chaco","Villamontes","U.E. 27 DE MAYO",-63.39827,-21.13041,48,9,345,393,130,3,203,333
"Bolivia","Tarija","Gran Chaco","Villamontes","U.E. 27 DE MAYO",-63.36565,-21.1518,48,9,345,393,130,3,203,333
"Bolivia","Tarija","Gran Chaco","Villamontes","U.E. ADELA HOYOS",-63.46374,-21.26653,568,12,2111,2679,1303,35,761,2064
"Bolivia","Tarija","Gran Chaco","Villamontes","U.E. AGUARAGÜE",-63.57405,-21.22751,44,2,147,191,81,7,57,138
"Bolivia","Tarija","Gran Chaco","Villamontes","U.E. ALGARROBAL",-63.30728,-21.38963,27,1,123,150,14,3,105,119
"Bolivia","Tarija","Gran Chaco","Villamontes","U.E.ANTONIO JOSE DE SUCRE",-63.41752,-21.06529,31,3,170,201,67,10,90,157
"Bolivia","Tarija","Gran Chaco","Villamontes","U.E. ASAMBLEA DE DIOS",-63.46189,-21.27044,742,53,3006,3748,1552,71,1330,2882
"Bolivia","Tarija","Gran Chaco","Villamontes","U.E. CABO JUAN",-63.42142,-21.16265,95,12,497,592,222,10,253,475
"Bolivia","Tarija","Gran Chaco","Villamontes","U.E. CAPIRENDA",-63.00224,-21.09902,14,0,30,44,25,0,5,30
"Bolivia","Tarija","Gran Chaco","Villamontes","U.E. CAPIRENDITA",-63.43694,-21.29784,337,12,589,926,81,72,424,505
"Bolivia","Tarija","Gran Chaco","Villamontes","U.E. CENTRAL CUTAIQUI",-62.83306,-21.892,11,0,49,60,18,0,31,49
"Bolivia","Tarija","Gran Chaco","Villamontes","U.E. CHACO BOREAL",-62.62968,-21.56227,2,1,13,15,3,0,9,12
"Bolivia","Tarija","Gran Chaco","Villamontes","U.E. CHIMEO",-63.44035,-21.18806,19,4,249,268,68,5,172,240
"Bolivia","Tarija","Gran Chaco","Villamontes","U.E. COLORADOS DE BOLIVIA",-63.44739,-21.26013,825,44,3487,4312,1600,147,1696,3296
"Bolivia","Tarija","Gran Chaco","Villamontes","U.E. IBIBOBO",-62.99517,-21.5432,198,2,133,331,62,1,68,130
"Bolivia","Tarija","Gran Chaco","Villamontes","U.E. IBOPEITI",-63.3834,-21.29926,34,2,197,231,43,2,150,193
"Bolivia","Tarija","Gran Chaco","Villamontes","U.E. ISMAEL MONTES",-63.47746,-21.25815,512,24,2204,2716,1419,47,714,2133
"Bolivia","Tarija","Gran Chaco","Villamontes","U.E. JUANA AZURDUY DE PADILLA (V.M.)",-63.46507,-21.25878,558,31,2820,3378,1845,58,886,2731
"Bolivia","Tarija","Gran Chaco","Villamontes","U.E.  JULIO CREVAUX",-63.47588,-21.26414,764,16,2612,3376,1752,60,784,2536
"Bolivia","Tarija","Gran Chaco","Villamontes","U.E. LA ESMERALDA",-62.65346,-22.22636,12,0,25,37,11,0,14,25
"Bolivia","Tarija","Gran Chaco","Villamontes","U.E. NUEVA ESPERANZA",-62.73864,-21.84503,13,0,48,61,16,3,29,45
"Bolivia","Tarija","Gran Chaco","Villamontes","U.E. REBECA AGUIRRE",-63.33084,-21.00389,173,12,610,783,301,16,281,582
"Bolivia","Tarija","Gran Chaco","Villamontes","U.E. RESISTENCIA",-63.113,-21.5044,0,32,154,154,20,4,98,118
"Bolivia","Tarija","Gran Chaco","Villamontes","U.E. SAN ANTONIO (VILLA MONTES)",-63.47097,-21.27801,150,9,776,926,419,15,333,752
"Bolivia","Tarija","Gran Chaco","Villamontes","U.E. SAN ISIDRO LA VICTORIA",-62.75867,-22.14704,23,1,45,68,35,0,9,44
"Bolivia","Tarija","Gran Chaco","Villamontes","U.E. TENIENTE VICTOR ZEBALLOS CLAROS",-63.42403,-21.09695,57,11,345,402,129,11,194,323
"Bolivia","Tarija","Gran Chaco","Yacuiba","(CÁRCEL) CARCELETA PUBLICA",-63.61958,-21.87883,26,0,76,102,29,2,45,74
"Bolivia","Tarija","Gran Chaco","Yacuiba","ESC. 2 DE AGOSTO",-63.6631,-21.98295,291,32,1763,2054,834,72,825,1659
"Bolivia","Tarija","Gran Chaco","Yacuiba","ESCUELA 27 DE MAYO",-63.63179,-21.86089,25,4,217,242,90,9,114,204
"Bolivia","Tarija","Gran Chaco","Yacuiba","U.E. 12 DE AGOSTO",-63.62997,-21.90739,175,13,808,983,318,45,432,750
"Bolivia","Tarija","Gran Chaco","Yacuiba","U.E. 21 DE SEPTIEMBRE",-63.38381,-21.8469,37,3,131,168,76,6,46,122
"Bolivia","Tarija","Gran Chaco","Yacuiba","U.E. 27 DE MAYO",-63.63601,-21.93299,313,13,1107,1420,402,30,662,1064
"Bolivia","Tarija","Gran Chaco","Yacuiba","U.E. 4 DE MAYO",-63.55672,-21.71432,144,28,822,966,246,27,521,767
"Bolivia","Tarija","Gran Chaco","Yacuiba","U.E. ALCIDES D`ORBIGNI",-62.8343,-21.99477,184,11,334,518,45,15,263,308
"Bolivia","Tarija","Gran Chaco","Yacuiba","U.E. CAMPO GRANDE (GRAN CHACO)",-63.6561,-21.95966,324,33,1779,2103,805,57,884,1689
"Bolivia","Tarija","Gran Chaco","Yacuiba","U.E. CAÑON OCULTO",-63.61351,-21.97809,38,7,220,258,71,6,136,207
"Bolivia","Tarija","Gran Chaco","Yacuiba","U.E. CLUB DE LEONES (BÁSICO Y MEDIO)",-63.6776,-22.00842,967,29,4201,5168,2720,104,1348,4068
"Bolivia","Tarija","Gran Chaco","Yacuiba","U.E. CREVAUX SUD",-62.93186,-21.81382,227,7,600,827,116,23,454,570
"Bolivia","Tarija","Gran Chaco","Yacuiba","U.E. FERROVIARIA",-63.6751,-22.01609,451,15,1736,2187,1017,39,665,1682
"Bolivia","Tarija","Gran Chaco","Yacuiba","U.E. GERMAN BUSCH",-63.68483,-22.02006,369,14,1322,1691,789,29,490,1279
"Bolivia","Tarija","Gran Chaco","Yacuiba","U.E. HEROES DE BOQUERON",-63.60726,-21.6859,292,6,502,794,242,25,229,471
"Bolivia","Tarija","Gran Chaco","Yacuiba","U.E. HEROES DEL CHACO",-63.68172,-22.05065,1086,37,2919,4005,1380,60,1442,2822
"Bolivia","Tarija","Gran Chaco","Yacuiba","U.E. JOSE MANUEL BELGRANO (YACUIBA)",-63.6762,-22.01613,713,18,3055,3768,1888,64,1085,2973
"Bolivia","Tarija","Gran Chaco","Yacuiba","U.E. JUANA AZURDUY DE PADILLA (YACUIBA)",-63.67266,-22.00477,864,40,3561,4425,2125,120,1276,3401
"Bolivia","Tarija","Gran Chaco","Yacuiba","U.E. LA PURISIMA",-62.99116,-21.62585,35,0,90,125,17,0,73,90
"Bolivia","Tarija","Gran Chaco","Yacuiba","U.E. LICEO GRAN CHACO",-63.67698,-22.01581,538,19,2359,2897,1600,47,693,2293
"Bolivia","Tarija","Gran Chaco","Yacuiba","U.E. MARISCAL SUCRE",-63.66786,-21.99878,193,9,806,999,434,17,346,780
"Bolivia","Tarija","Gran Chaco","Yacuiba","U.E. MIGUEL ESTENSORO",-63.68021,-22.01661,1277,31,4464,5741,2800,94,1539,4339
"Bolivia","Tarija","Gran Chaco","Yacuiba","U.E. NACIONAL MIXTO EL PALMAR",-63.61583,-21.88011,371,23,1426,1797,756,47,600,1356
"Bolivia","Tarija","Gran Chaco","Yacuiba","U.E. NESTOR PAZ GALARZA",-63.67497,-21.99887,587,19,2316,2903,1276,96,925,2201
"Bolivia","Tarija","Gran Chaco","Yacuiba","U.E. OLIVERIO PELICHELLI",-63.67335,-22.02432,251,15,1090,1341,568,26,481,1049
"Bolivia","Tarija","Gran Chaco","Yacuiba","U.E. PROF. BAUTISTA JURADO",-63.55737,-21.8007,183,23,797,980,323,17,434,757
"Bolivia","Tarija","Gran Chaco","Yacuiba","U.E. SACHAPERA",-63.55339,-21.66175,55,14,607,662,150,24,419,569
"Bolivia","Tarija","Gran Chaco","Yacuiba","U.E. SAN FRANCISCO DE INTI",-63.58647,-21.81835,55,10,394,449,133,12,239,372
"Bolivia","Tarija","Gran Chaco","Yacuiba","U.E. SIMON BOLIVAR",-63.6829,-22.0522,1095,94,3863,4958,1415,130,2224,3639
"Bolivia","Tarija","Gran Chaco","Yacuiba","U.E. SUNCHAL",-63.49324,-21.68086,35,2,95,130,44,1,48,92
"Bolivia","Tarija","Gran Chaco","Yacuiba","U.E. TIERRAS NUEVAS",-63.56289,-21.74935,124,15,653,777,131,35,472,603
"Bolivia","Tarija","Gran Chaco","Yacuiba","U.E. TIMBOY TIGUAZU",-63.57601,-21.55468,32,4,170,202,34,6,126,160
"Bolivia","Tarija","Gran Chaco","Yacuiba","U.E. VILLA EL CARMEN",-63.57232,-21.78605,185,28,1001,1186,310,45,618,928
"Bolivia","Tarija","Gran Chaco","Yacuiba","U.E. YACUIBA",-63.67945,-21.99672,784,52,3662,4446,1964,126,1520,3484
"Bolivia","Tarija","Méndez","Tomayapo (El Puente)","CENTRO COMUNAL",-65.21614,-21.31723,24,3,170,194,83,3,81,164
"Bolivia","Tarija","Méndez","Tomayapo (El Puente)","NUCLEO ANDRES ZAMORA",-65.23907,-21.43847,18,3,120,138,51,2,64,115
"Bolivia","Tarija","Méndez","Tomayapo (El Puente)","SEDE CLUB DE MADRES",-65.24256,-21.46749,15,0,53,68,19,6,28,47
"Bolivia","Tarija","Méndez","Tomayapo (El Puente)","SEDE COMUNAL",-64.96433,-21.23611,58,8,254,312,134,7,105,239
"Bolivia","Tarija","Méndez","Tomayapo (El Puente)","U.E. 1O. DE JULIO",-65.20398,-21.23499,166,13,751,917,347,21,370,717
"Bolivia","Tarija","Méndez","Tomayapo (El Puente)","U.E. CHINCHILLA",-65.14574,-21.19778,10,0,60,70,18,1,41,59
"Bolivia","Tarija","Méndez","Tomayapo (El Puente)","U.E. CHORCOYA MENDEZ",-65.01444,-21.56835,78,10,175,253,30,5,130,160
"Bolivia","Tarija","Méndez","Tomayapo (El Puente)","U.E. CUMBRE DE SAMA",-64.95296,-21.48289,57,12,236,293,62,10,152,214
"Bolivia","Tarija","Méndez","Tomayapo (El Puente)","U.E. EDUARDO ABAROA",-65.11504,-21.35772,3,1,70,73,17,2,50,67
"Bolivia","Tarija","Méndez","Tomayapo (El Puente)","U.E. EL MOLINO",-64.95007,-21.39787,80,8,282,362,70,18,186,256
"Bolivia","Tarija","Méndez","Tomayapo (El Puente)","U.E. FRANZ TAMAYO",-64.96854,-21.48615,285,44,1112,1397,392,78,598,990
"Bolivia","Tarija","Méndez","Tomayapo (El Puente)","U.E. GERALDINO GUERRERO",-64.95905,-21.14464,94,3,280,374,145,11,121,266
"Bolivia","Tarija","Méndez","Tomayapo (El Puente)","U.E. HUARMACHI",-65.06249,-21.44367,22,0,131,153,74,5,52,126
"Bolivia","Tarija","Méndez","Tomayapo (El Puente)","U.E. HUERTA HUAYCO",-64.94923,-21.11442,35,2,87,122,27,6,52,79
"Bolivia","Tarija","Méndez","Tomayapo (El Puente)","U.E. IRCALAYA",-65.20068,-21.19576,14,1,48,62,15,1,31,46
"Bolivia","Tarija","Méndez","Tomayapo (El Puente)","U.E. JESUS ZAMORA",-65.22533,-21.37169,33,4,145,178,83,2,56,139
"Bolivia","Tarija","Méndez","Tomayapo (El Puente)","U.E. LIC. SEGUNDINO UGARTE DURAN",-65.04431,-21.27013,39,2,153,192,98,5,48,146
"Bolivia","Tarija","Méndez","Tomayapo (El Puente)","U.E. MONTE GRANDE",-65.08482,-21.24768,33,2,113,146,76,3,32,108
"Bolivia","Tarija","Méndez","Tomayapo (El Puente)","U.E. OBISPO EL CARMEN",-65.03886,-21.30891,38,2,81,119,48,4,27,75
"Bolivia","Tarija","Méndez","Tomayapo (El Puente)","U.E. PUEBLO NUEVO",-64.98272,-21.53179,115,15,236,351,36,14,171,207
"Bolivia","Tarija","Méndez","Tomayapo (El Puente)","U.E. SAN ANTONIO DE CURQUI",-65.07034,-21.49188,36,4,196,232,99,5,88,187
"Bolivia","Tarija","Méndez","Tomayapo (El Puente)","U.E. SAN ANTONIO (MENDEZ)",-64.965,-21.44068,67,8,235,302,60,29,138,198
"Bolivia","Tarija","Méndez","Tomayapo (El Puente)","U.E. SANTA ROSA",-65.05383,-21.13585,40,1,58,98,1,1,55,56
"Bolivia","Tarija","Méndez","Tomayapo (El Puente)","U.E. VILLA NUEVA",-64.9509,-21.35972,39,1,122,161,43,10,68,111
"Bolivia","Tarija","Méndez","Villa San Lorenzo","PUESTO DE SALUD JARCAS",-64.50289,-21.28495,4,0,66,70,19,3,44,63
"Bolivia","Tarija","Méndez","Villa San Lorenzo","U.E. 15 DE ABRIL ERQUIS",-64.79546,-21.46687,110,15,734,844,409,48,262,671
"Bolivia","Tarija","Méndez","Villa San Lorenzo","U.E. 1O. DE MAYO",-64.57595,-21.03652,59,8,134,193,24,7,95,119
"Bolivia","Tarija","Méndez","Villa San Lorenzo","U.E. ALTO DE CAJAS",-64.47047,-21.30705,29,2,70,99,40,4,24,64
"Bolivia","Tarija","Méndez","Villa San Lorenzo","U.E. ANGEL CALABI PASOLINNI",-64.76366,-21.49823,258,18,1513,1771,907,47,541,1448
"Bolivia","Tarija","Méndez","Villa San Lorenzo","U.E. BORDO EL MOLLAR",-64.76112,-21.42673,66,9,403,469,226,23,145,371
"Bolivia","Tarija","Méndez","Villa San Lorenzo","U.E. CARACHIMAYO CENTRO",-64.72285,-21.35113,153,23,433,586,207,34,169,376
"Bolivia","Tarija","Méndez","Villa San Lorenzo","U.E. CHAUPICANCHA",-64.66171,-21.34586,33,6,56,89,18,3,29,47
"Bolivia","Tarija","Méndez","Villa San Lorenzo","U.E. COCHAS",-64.8509,-21.37324,10,4,71,81,17,3,47,64
"Bolivia","Tarija","Méndez","Villa San Lorenzo","U.E. COLORADO NORTE",-64.78835,-21.17892,62,0,124,186,7,8,109,116
"Bolivia","Tarija","Méndez","Villa San Lorenzo","U.E. EL PAJONAL",-64.52412,-21.20756,23,0,61,84,28,4,29,57
"Bolivia","Tarija","Méndez","Villa San Lorenzo","U.E. EL PUESTO",-64.52888,-21.28559,30,1,57,87,10,6,40,50
"Bolivia","Tarija","Méndez","Villa San Lorenzo","U.E. EUSTAQUIO MENDEZ",-64.75005,-21.41892,943,72,3042,3985,1845,129,996,2841
"Bolivia","Tarija","Méndez","Villa San Lorenzo","U.E. EUSTAQUIO MENDEZ",-64.67755,-21.04951,943,72,3042,3985,1845,129,996,2841
"Bolivia","Tarija","Méndez","Villa San Lorenzo","U.E. EUSTAQUIO MENDEZ",-64.76018,-21.34489,943,72,3042,3985,1845,129,996,2841
"Bolivia","Tarija","Méndez","Villa San Lorenzo","U.E. HUANCOIRO",-64.85504,-21.19721,13,1,68,81,31,4,32,63
"Bolivia","Tarija","Méndez","Villa San Lorenzo","U.E. JUAN MISAEL SARACHO",-64.7941,-21.49765,47,7,407,454,257,17,126,383
"Bolivia","Tarija","Méndez","Villa San Lorenzo","U.E. JULIO SUCRE SELLA MENDEZ",-64.69686,-21.38795,95,9,360,455,248,12,91,339
"Bolivia","Tarija","Méndez","Villa San Lorenzo","U.E. LEON CANCHA",-64.71355,-21.17894,128,13,219,347,62,12,132,194
"Bolivia","Tarija","Méndez","Villa San Lorenzo","U.E. MANDOR GRANDE",-64.74651,-21.06744,29,1,25,54,13,1,10,23
"Bolivia","Tarija","Méndez","Villa San Lorenzo","U.E. NESTOR PAZ ZAMORA",-64.75089,-21.38968,114,24,499,613,269,22,184,453
"Bolivia","Tarija","Méndez","Villa San Lorenzo","U.E. OSVALDO GALVEZ",-64.80488,-21.4087,136,24,514,650,241,15,234,475
"Bolivia","Tarija","Méndez","Villa San Lorenzo","U.E. PEÑADERIA",-64.49856,-21.2275,3,3,67,70,25,7,32,57
"Bolivia","Tarija","Méndez","Villa San Lorenzo","U.E. RANCHO SUD",-64.7542,-21.4619,69,4,455,524,331,9,111,442
"Bolivia","Tarija","Méndez","Villa San Lorenzo","U.E. SAN LORENCITO",-64.47129,-21.25033,14,1,71,85,6,7,57,63
"Bolivia","Tarija","Méndez","Villa San Lorenzo","U.E. SAN PEDRO DE LAS PEÑAS",-64.65049,-21.14055,37,2,49,86,17,1,29,46
"Bolivia","Tarija","Méndez","Villa San Lorenzo","U.E. SERAPIO MARTINEZ",-64.74917,-21.44493,121,11,876,997,602,23,240,842
"Bolivia","Tarija","Méndez","Villa San Lorenzo","U.E. SIMON BOLIVAR",-64.7877,-21.50771,97,14,791,888,565,31,181,746
"Bolivia","Tarija","Méndez","Villa San Lorenzo","U.E. TARIJA CANCHA SUD",-64.76456,-21.41479,88,9,532,620,331,16,176,507
"Bolivia","Tarija","Méndez","Villa San Lorenzo","U.E. TOMATAS GRANDE",-64.78188,-21.3224,101,10,429,530,235,21,163,398
"Bolivia","Tarija","Méndez","Villa San Lorenzo","U.E. TRANCAS",-64.8347,-21.30479,44,3,127,171,65,12,47,112
"Bolivia","Tarija","Méndez","Villa San Lorenzo","U.E. TUCUMILLAS",-64.83385,-21.45885,18,2,104,122,16,3,83,99