"pais","departamento","provincia","municipio","recinto","id_dpa","col_abstencion","col_blancos","col_emitidos","col_inscritos","col_no","col_nulos","col_si","col_validos"
"Bolivia","Beni","Cercado","San Javier","ESCUELA ESPIRITU SANTO",234754,7,0,34,41,13,0,21,34
"Bolivia","Beni","Cercado","San Javier","ESCUELA LAGUNA COLORADA",234755,15,0,33,48,14,0,19,33
"Bolivia","Beni","Cercado","San Javier","ESCUELA NUEVA ISRAEL",234756,110,7,420,530,195,36,182,377
"Bolivia","Beni","Cercado","San Javier","ESCUELA PEDRO IGNACIO MUIBA",234757,23,1,161,184,74,0,86,160
"Bolivia","Beni","Cercado","San Javier","ESCUELA SAN JAVIER",234758,63,4,287,350,141,2,140,281
"Bolivia","Beni","Cercado","San Javier","ESCUELA SAN PEDRO",234759,79,2,319,398,157,10,150,307
"Bolivia","Beni","Cercado","San Javier","UNIDAD EDUCATIVA LA CURVA",234760,41,2,100,141,37,3,58,95
"Bolivia","Beni","Cercado","Trinidad","CARCEL DE MUJERES",235398,9,1,36,45,19,0,16,35
"Bolivia","Beni","Cercado","Trinidad","CARCEL MOCOBI",235399,0,0,178,178,62,50,66,128
"Bolivia","Beni","Cercado","Trinidad","CENTRO INTEGRADO SAN FRANCISCO DE ASIS",235400,85,4,686,771,488,11,183,671
"Bolivia","Beni","Cercado","Trinidad","COLEGIO JOAQUIN HURTADO CHAVEZ",235401,383,17,1922,2305,1225,38,642,1867
"Bolivia","Beni","Cercado","Trinidad","COLEGIO LA SALLE",235402,329,5,1457,1786,1045,38,369,1414
"Bolivia","Beni","Cercado","Trinidad","COLEGIO SAN VICENTE (EX UAB)",235403,631,20,3141,3772,2072,80,969,3041
"Bolivia","Beni","Cercado","Trinidad","ESCUELA 13 DE ABRIL",235422,333,22,2304,2637,1262,129,891,2153
"Bolivia","Beni","Cercado","Trinidad","ESCUELA 4 DE FEBRERO",235404,801,36,3606,4407,2139,91,1340,3479
"Bolivia","Beni","Cercado","Trinidad","ESCUELA CASARABE",235423,112,3,415,527,228,9,175,403
"Bolivia","Beni","Cercado","Trinidad","ESCUELA CORINA HURTADO DE",235405,458,15,2434,2892,1438,50,931,2369
"Bolivia","Beni","Cercado","Trinidad","ESCUELA EMILIO CAMPOS PEDRIEL",235424,388,12,1994,2382,1324,39,619,1943
"Bolivia","Beni","Cercado","Trinidad","ESCUELA IVIATO",235425,40,1,172,212,94,0,77,171
"Bolivia","Beni","Cercado","Trinidad","ESCUELA J. AZURDUY DE PADILLA",235406,271,8,1612,1883,1128,36,440,1568
"Bolivia","Beni","Cercado","Trinidad","ESCUELA J. CHAVEZ SUAREZ",235407,1158,36,5202,6360,3120,112,1934,5054
"Bolivia","Beni","Cercado","Trinidad","ESCUELA J. LORENZO CAMPERO",235408,226,7,1423,1649,982,23,411,1393
"Bolivia","Beni","Cercado","Trinidad","ESCUELA LOMA SUAREZ",235409,202,7,444,646,182,19,236,418
"Bolivia","Beni","Cercado","Trinidad","ESCUELA MANGALITO",235410,371,11,1608,1979,872,32,693,1565
"Bolivia","Beni","Cercado","Trinidad","ESCUELA MARY RIBERA G.",235411,613,20,3832,4445,2571,95,1146,3717
"Bolivia","Beni","Cercado","Trinidad","ESCUELA MAYOR PEDRO VACA DIEZ",235412,100,3,236,336,109,1,123,232
"Bolivia","Beni","Cercado","Trinidad","ESCUELA NICOLAS SUAREZ",235413,444,10,2080,2524,1516,37,517,2033
"Bolivia","Beni","Cercado","Trinidad","ESCUELA NUESTRA SEÑORA DE FATIMA",235414,758,18,3338,4096,2229,82,1009,3238
"Bolivia","Beni","Cercado","Trinidad","ESCUELA NUEVA TRINIDAD",235426,857,28,3145,4002,1882,72,1163,3045
"Bolivia","Beni","Cercado","Trinidad","ESCUELA PEDRO IGNACIO MUIBA",235415,472,25,2346,2818,1413,96,812,2225
"Bolivia","Beni","Cercado","Trinidad","ESCUELA PUERTO BALLIVIAN",235416,20,2,119,139,55,0,62,117
"Bolivia","Beni","Cercado","Trinidad","ESCUELA PUERTO VARADOR",235417,128,13,453,581,242,21,177,419
"Bolivia","Beni","Cercado","Trinidad","ESCUELA RAUL MONJE ROCA",235418,439,7,2240,2679,1414,74,745,2159
"Bolivia","Beni","Cercado","Trinidad","ESCUELA SAN ANTONIO",235419,573,47,3077,3650,2005,42,983,2988
"Bolivia","Beni","Cercado","Trinidad","ESCUELA SAN JOSE",235420,209,9,1272,1481,931,21,311,1242
"Bolivia","Beni","Cercado","Trinidad","ESCUELA SAN JUAN DE AGUAS DULCES",235421,12,0,89,101,67,0,22,89
"Bolivia","Beni","Cercado","Trinidad","ESCUELA URBANIZACION MANA",235427,100,2,512,612,306,5,199,505
"Bolivia","Beni","Cercado","Trinidad","ESCUELA VILLA VECINAL",235428,400,26,2609,3009,1791,40,752,2543
"Bolivia","Beni","Cercado","Trinidad","INFOCAL",235429,231,7,1082,1313,736,19,320,1056
"Bolivia","Beni","Cercado","Trinidad","LICEO MARIO SAIELLY",235430,321,6,1655,1976,1150,17,482,1632
"Bolivia","Beni","Cercado","Trinidad","U.A.B. (CARRERA DE DERECHO)",235431,454,46,2151,2605,1438,31,636,2074
"Bolivia","Beni","Cercado","Trinidad","UNIDAD EDUCATIVA 15 DE AGOSTO",235432,115,11,811,926,454,19,327,781
"Bolivia","Beni","Cercado","Trinidad","UNIDAD EDUCATIVA GONZALO SUAREZ D.",235433,80,5,337,417,214,4,114,328
"Bolivia","Beni","Cercado","Trinidad","UNIDAD EDUCATIVA LUIS ESPINAL CAMS",235434,160,16,1065,1225,577,22,450,1027
"Bolivia","Beni","Cercado","Trinidad","UNIDAD EDUCATIVA ORLANDO MONASTERIO CLAURE",235435,22,7,259,281,151,4,97,248
"Bolivia","Beni","General Jose Ballivián Segurola","Reyes","COLEGIO NACIONAL REYES",234793,370,16,1409,1779,779,27,587,1366
"Bolivia","Beni","General Jose Ballivián Segurola","Reyes","ESCUELA BUEN DESTINO",234794,21,4,102,123,17,2,79,96
"Bolivia","Beni","General Jose Ballivián Segurola","Reyes","ESCUELA CENTRAL BAQUETY",234795,65,0,48,113,4,1,43,47
"Bolivia","Beni","General Jose Ballivián Segurola","Reyes","ESCUELA CENTRAL PUERTO CAVINAS",234796,85,5,133,218,46,1,81,127
"Bolivia","Beni","General Jose Ballivián Segurola","Reyes","ESCUELA CONSTANZA VARGAS",234797,11,0,24,35,13,2,9,22
"Bolivia","Beni","General Jose Ballivián Segurola","Reyes","ESCUELA DE CALIFORNIA",234804,16,0,54,70,22,1,31,53
"Bolivia","Beni","General Jose Ballivián Segurola","Reyes","ESCUELA JESUS ALVAREZ",234798,471,23,1650,2121,912,74,641,1553
"Bolivia","Beni","General Jose Ballivián Segurola","Reyes","ESCUELA PEÑA AMARILLA",234799,61,2,95,156,77,2,14,91
"Bolivia","Beni","General Jose Ballivián Segurola","Reyes","ESCUELA RENE BARRIENTOS ORTUÑO",234800,113,1,310,423,174,9,126,300
"Bolivia","Beni","General Jose Ballivián Segurola","Reyes","ESCUELA SAN JOSE",234801,12,1,89,101,41,5,42,83
"Bolivia","Beni","General Jose Ballivián Segurola","Reyes","ESCUELA SAN MARCOS",234802,3,0,22,25,18,1,3,21
"Bolivia","Beni","General Jose Ballivián Segurola","Reyes","ESCUELA SORAIDA",234803,17,0,24,41,14,0,10,24
"Bolivia","Beni","General Jose Ballivián Segurola","Reyes","UNIDAD EDUCATIVA CARMEN ALTO",234805,6,4,88,94,39,1,44,83
"Bolivia","Beni","General Jose Ballivián Segurola","Rurrenabaque","ESCUELA ASUNCION DEL QUIQUIBEY",232268,29,2,73,102,36,2,33,69
"Bolivia","Beni","General Jose Ballivián Segurola","Rurrenabaque","ESCUELA CENTRAL NUEVOS HORIZONTES",232269,115,9,374,489,122,29,214,336
"Bolivia","Beni","General Jose Ballivián Segurola","Rurrenabaque","ESCUELA CENTRAL PIEDRAS BLANCAS",232270,100,16,586,686,79,15,476,555
"Bolivia","Beni","General Jose Ballivián Segurola","Rurrenabaque","ESCUELA GUALBERTO VILLARRUEL",232271,861,31,2868,3729,1703,52,1082,2785
"Bolivia","Beni","General Jose Ballivián Segurola","Rurrenabaque","ESCUELA PLAYA ANCHA",232272,27,5,164,191,12,9,138,150
"Bolivia","Beni","General Jose Ballivián Segurola","Rurrenabaque","ESCUELA VILLA LOURDES",232273,45,5,152,197,71,3,73,144
"Bolivia","Beni","General Jose Ballivián Segurola","Rurrenabaque","UNIDAD EDUCATIVA LUCIO LENS",232274,953,50,3672,4625,2055,165,1402,3457
"Bolivia","Beni","General Jose Ballivián Segurola","San Borja","COLEGIO ARNULFO MARTINEZ",235524,1010,35,3361,4371,1946,68,1312,3258
"Bolivia","Beni","General Jose Ballivián Segurola","San Borja","COLEGIO INDUSTRIAL INGAVI",235525,666,37,2392,3058,828,69,1458,2286
"Bolivia","Beni","General Jose Ballivián Segurola","San Borja","COLEGIO SAN FRANCISCO DE BORJA",235526,760,29,2731,3491,1804,62,836,2640
"Bolivia","Beni","General Jose Ballivián Segurola","San Borja","ESCUELA DE PUERTO YUCUMO",235527,36,3,276,312,16,6,251,267
"Bolivia","Beni","General Jose Ballivián Segurola","San Borja","ESCUELA EL CHACAL",235528,62,6,300,362,3,3,288,291
"Bolivia","Beni","General Jose Ballivián Segurola","San Borja","ESCUELA EL ORIENTE DEL YACUMA",235540,26,1,79,105,34,0,44,78
"Bolivia","Beni","General Jose Ballivián Segurola","San Borja","ESCUELA EL PALMAR",235529,131,20,688,819,150,19,499,649
"Bolivia","Beni","General Jose Ballivián Segurola","San Borja","ESCUELA GERMAN BUSCH",235530,707,19,2407,3114,1615,47,726,2341
"Bolivia","Beni","General Jose Ballivián Segurola","San Borja","ESCUELA INDIGENA ARENALES",235531,41,8,455,496,13,12,422,435
"Bolivia","Beni","General Jose Ballivián Segurola","San Borja","ESCUELA JUNRRENO",235532,11,1,32,43,15,0,16,31
"Bolivia","Beni","General Jose Ballivián Segurola","San Borja","ESCUELA LA CRUZ",235533,78,14,584,662,38,9,523,561
"Bolivia","Beni","General Jose Ballivián Segurola","San Borja","ESCUELA LA EMBOCADA",235534,85,1,254,339,96,7,150,246
"Bolivia","Beni","General Jose Ballivián Segurola","San Borja","ESCUELA LAS ABRAS",235535,12,4,77,89,6,0,67,73
"Bolivia","Beni","General Jose Ballivián Segurola","San Borja","ESCUELA MISION FATIMA",235536,43,7,352,395,23,3,319,342
"Bolivia","Beni","General Jose Ballivián Segurola","San Borja","ESCUELA SANTA ELENA DEL CARIPO",235537,19,1,102,121,39,0,62,101
"Bolivia","Beni","General Jose Ballivián Segurola","San Borja","ESCUELA S. JUAN DEL REMANZO",235538,8,0,39,47,7,0,32,39
"Bolivia","Beni","General Jose Ballivián Segurola","San Borja","ESCUELA TACUARAL DE MATTOS",235539,39,46,471,510,17,8,400,417
"Bolivia","Beni","General Jose Ballivián Segurola","San Borja","UNIDAD EDUCATIVA MANGUITO",235541,39,10,458,497,56,3,389,445
"Bolivia","Beni","General Jose Ballivián Segurola","San Borja","UNIDAD EDUCATIVA MARCA COROICO",235542,10,4,109,119,14,7,84,98
"Bolivia","Beni","General Jose Ballivián Segurola","San Borja","UNIDAD EDUCATIVA QUIQUIBEY",235543,27,1,174,201,22,1,150,172
"Bolivia","Beni","General Jose Ballivián Segurola","San Borja","UNIDAD EDUCATIVA SAN IGNACIO DEL MANIQUI",235544,101,7,365,466,195,8,155,350
"Bolivia","Beni","General Jose Ballivián Segurola","San Borja","UNIDAD EDUCATIVA VILLA SAN ANTONIO",235545,108,6,463,571,252,13,192,444
"Bolivia","Beni","General Jose Ballivián Segurola","Santa Rosa","COLEGIO NACIONAL SANTA ROSA",235546,263,4,654,917,407,23,220,627
"Bolivia","Beni","General Jose Ballivián Segurola","Santa Rosa","ESCUELA AUSTRALIA",235554,79,2,155,234,75,3,75,150
"Bolivia","Beni","General Jose Ballivián Segurola","Santa Rosa","ESCUELA CENTRAL PALMA FLOR",235547,45,1,71,116,40,9,21,61
"Bolivia","Beni","General Jose Ballivián Segurola","Santa Rosa","ESCUELA EL CANDADO",235548,30,2,80,110,25,1,52,77
"Bolivia","Beni","General Jose Ballivián Segurola","Santa Rosa","ESCUELA EL CERRITO",235549,22,1,82,104,53,1,27,80
"Bolivia","Beni","General Jose Ballivián Segurola","Santa Rosa","ESCUELA EL ROSARIO",235555,14,8,130,144,61,4,57,118
"Bolivia","Beni","General Jose Ballivián Segurola","Santa Rosa","ESCUELA EL TRIUNFO",235550,58,0,223,281,118,1,104,222
"Bolivia","Beni","General Jose Ballivián Segurola","Santa Rosa","ESCUELA GERARDO REYES",235551,509,30,2303,2812,1545,43,685,2230
"Bolivia","Beni","General Jose Ballivián Segurola","Santa Rosa","ESCUELA PUERTO TERESA",235552,18,0,67,85,49,1,17,66
"Bolivia","Beni","General Jose Ballivián Segurola","Santa Rosa","ESCUELA PUERTO YATA",235553,66,5,119,185,81,1,32,113
"Bolivia","Beni","Iténez","Baures","ESCUELA ALTA GRACIA",234343,8,0,51,59,32,0,19,51
"Bolivia","Beni","Iténez","Baures","ESCUELA CAIRO II",234344,7,0,22,29,0,0,22,22
"Bolivia","Beni","Iténez","Baures","ESCUELA CARMELO LOPEZ",234345,305,11,1213,1518,674,7,521,1195
"Bolivia","Beni","Iténez","Baures","ESCUELA EL CAIRO",234346,10,1,95,105,42,3,49,91
"Bolivia","Beni","Iténez","Baures","ESCUELA EL REMANZO",234347,114,4,291,405,126,5,156,282
"Bolivia","Beni","Iténez","Baures","ESCUELA MONTE CRISTO DEL TIQUIN",234348,100,3,121,221,21,3,94,115
"Bolivia","Beni","Iténez","Baures","ESCUELA RURAL JASIAQUIRI",234349,12,0,150,162,70,1,79,149
"Bolivia","Beni","Iténez","Baures","ESCUELA SAN SIMON",234350,54,4,138,192,40,2,92,132
"Bolivia","Beni","Iténez","Baures","ESCUELA SECCIONAL CAFETAL",234351,98,1,122,220,40,0,81,121
"Bolivia","Beni","Iténez","Huacaraje","ESCUELA EL CARMEN",234352,129,2,461,590,275,5,179,454
"Bolivia","Beni","Iténez","Huacaraje","ESCUELA JUAN ALBERTO ORELLANA",234353,313,15,1104,1417,627,17,445,1072
"Bolivia","Beni","Iténez","Huacaraje","NUCLEO ESCOLAR LA EMBROLLA",234354,3,0,58,61,10,6,42,52
"Bolivia","Beni","Iténez","Magdalena","COLEGIO CNEL. CARMELO CUELLAR J.",234333,30,1,219,249,109,2,107,216
"Bolivia","Beni","Iténez","Magdalena","ESCUELA ANGEL CHAVEZ ARZA",234334,10,1,112,122,30,0,81,111
"Bolivia","Beni","Iténez","Magdalena","ESCUELA BUENA VISTA",234335,133,7,236,369,109,4,116,225
"Bolivia","Beni","Iténez","Magdalena","ESCUELA CENTRAL 1RO. DE MAYO",234336,2,0,36,38,3,0,33,36
"Bolivia","Beni","Iténez","Magdalena","ESCUELA GIL COIMBRA",234337,419,19,1839,2258,1018,22,780,1798
"Bolivia","Beni","Iténez","Magdalena","ESCUELA JOSE BALLIVIAN",234338,184,9,1079,1263,584,30,456,1040
"Bolivia","Beni","Iténez","Magdalena","ESCUELA LA CAYOBA",234339,9,0,69,78,45,2,22,67
"Bolivia","Beni","Iténez","Magdalena","ESCUELA SAN BORJA RIO BLANCO",234340,25,4,146,171,77,1,64,141
"Bolivia","Beni","Iténez","Magdalena","ESCUELA SANTA MARIA",234341,8,0,84,92,55,0,29,84
"Bolivia","Beni","Iténez","Magdalena","UNIDAD EDUCATIVA MACEDONIO PAZ PINO",234342,226,8,927,1153,454,23,442,896
"Bolivia","Beni","Mamoré","Puerto Siles","ESCUELA ALEJANDRIA",234330,3,2,47,50,12,1,32,44
"Bolivia","Beni","Mamoré","Puerto Siles","ESCUELA ANTOFAGASTA",234331,57,1,159,216,43,3,112,155
"Bolivia","Beni","Mamoré","Puerto Siles","ESCUELA SANTA ROSA",234332,48,3,121,169,90,0,28,118
"Bolivia","Beni","Mamoré","San Joaquín","ESCUELA CAP. ARTURO CUELLAR REA",232310,431,9,1044,1475,506,80,449,955
"Bolivia","Beni","Mamoré","San Joaquín","ESCUELA CHACO LEJOS",232311,3,1,29,32,9,0,19,28
"Bolivia","Beni","Mamoré","San Joaquín","ESCUELA LAS PEÑITAS",232312,0,0,5,5,0,1,4,4
"Bolivia","Beni","Mamoré","San Joaquín","ESCUELA MORE-MONTE AZUL",232313,12,0,50,62,0,0,50,50
"Bolivia","Beni","Mamoré","San Joaquín","ESCUELA PUERTO USTAREZ",232314,10,1,44,54,14,1,28,42
"Bolivia","Beni","Mamoré","San Joaquín","UNIDAD EDUCATIVA 21 DE AGOSTO",232315,381,11,1044,1425,583,20,430,1013
"Bolivia","Beni","Mamoré","San Ramón","ESCUELA EL CARMEN DE GUACAYANE",233365,5,0,38,43,0,0,38,38
"Bolivia","Beni","Mamoré","San Ramón","ESCUELA EL POYORI",233366,2,1,38,40,6,0,31,37
"Bolivia","Beni","Mamoré","San Ramón","ESCUELA NAPOLEON AÑEZ ORTIZ",233367,463,16,1835,2298,999,24,796,1795
"Bolivia","Beni","Mamoré","San Ramón","UNIDAD EDUCATIVA LAS PEÑAS",233368,7,0,4,11,2,0,2,4
"Bolivia","Beni","Marbán","Loreto","ESCUELA CAMIACO",235922,57,0,246,303,155,7,84,239
"Bolivia","Beni","Marbán","Loreto","ESCUELA GUNDONOVIA",235923,62,4,135,197,79,1,51,130
"Bolivia","Beni","Marbán","Loreto","ESCUELA PERFECTA VDA. DE BEJARANO",235924,155,3,335,490,130,10,192,322
"Bolivia","Beni","Marbán","Loreto","ESCUELA SACHOJERE",235925,60,1,183,243,79,2,101,180
"Bolivia","Beni","Marbán","Loreto","ESCUELA SAN ANTONIO",235926,23,0,55,78,26,1,28,54
"Bolivia","Beni","Marbán","Loreto","ESCUELA SAN PABLO-ISIBORO",235927,33,1,138,171,31,5,101,132
"Bolivia","Beni","Marbán","Loreto","ESCUELA SANTA ROSA DEL CHAPARE",235928,22,0,27,49,21,0,6,27
"Bolivia","Beni","Marbán","Loreto","SANTA ROSA DEL ISIBORO",235929,23,2,71,94,16,0,53,69
"Bolivia","Beni","Marbán","Loreto","UNIDAD EDUCATIVA PALERMO",235930,3,0,21,24,8,0,13,21
"Bolivia","Beni","Marbán","Loreto","UNIDAD EDUCATIVA VILLA EL CARMEN DEL REMANZO",235931,18,0,63,81,21,1,41,62
"Bolivia","Beni","Marbán","San Andrés","ESCUELA 4 DE JULIO",232302,59,6,243,302,35,7,195,230
"Bolivia","Beni","Marbán","San Andrés","ESCUELA BUEN JESUS",232292,45,5,248,293,153,4,86,239
"Bolivia","Beni","Marbán","San Andrés","ESCUELA CAIMANES",232293,32,7,163,195,87,2,67,154
"Bolivia","Beni","Marbán","San Andrés","ESCUELA CENTRAL 2 DE AGOSTO",232294,419,28,1546,1965,595,33,890,1485
"Bolivia","Beni","Marbán","San Andrés","ESCUELA DE NUEVA BETANIA",232303,55,3,219,274,90,3,123,213
"Bolivia","Beni","Marbán","San Andrés","ESCUELA ELVIRA",232304,43,2,181,224,102,2,75,177
"Bolivia","Beni","Marbán","San Andrés","ESCUELA HUMBERTO VELARDE",232295,61,2,225,286,110,5,108,218
"Bolivia","Beni","Marbán","San Andrés","ESCUELA LA ISIGA-PERSEVERA",232296,38,1,38,76,22,0,15,37
"Bolivia","Beni","Marbán","San Andrés","ESCUELA LIMONCITO",232305,0,0,30,30,15,1,14,29
"Bolivia","Beni","Marbán","San Andrés","ESCUELA MONTE CRISTO",232297,29,1,46,75,21,0,24,45
"Bolivia","Beni","Marbán","San Andrés","ESCUELA NUEVA MAGDALENA",232306,51,0,117,168,31,0,86,117
"Bolivia","Beni","Marbán","San Andrés","ESCUELA PEROTO",232298,41,3,145,186,82,1,59,141
"Bolivia","Beni","Marbán","San Andrés","ESCUELA SAN LORENZO",232299,32,2,73,105,34,1,36,70
"Bolivia","Beni","Marbán","San Andrés","ESCUELA SANTA ROSA",232300,97,8,407,504,181,6,212,393
"Bolivia","Beni","Marbán","San Andrés","ESCUELA SOMOPAE",232301,41,1,194,235,99,2,92,191
"Bolivia","Beni","Marbán","San Andrés","ESCUELA TAJIBOTE",232307,5,0,9,14,3,0,6,9
"Bolivia","Beni","Marbán","San Andrés","ESCUELA VILLA ALBA",232308,30,0,135,165,65,2,68,133
"Bolivia","Beni","Marbán","San Andrés","ESCUELA VILLA BANZER",232309,17,0,64,81,25,0,39,64
"Bolivia","Beni","Moxos","San Ignacio","COLEGIO SOCRATES PARADA EGUEZ",235556,661,55,2892,3553,1138,64,1635,2773
"Bolivia","Beni","Moxos","San Ignacio","ESCUELA CENTRAL SAN IGNACITO",235557,8,0,21,29,6,0,15,21
"Bolivia","Beni","Moxos","San Ignacio","ESCUELA CENTRAL SANTA ROSA",235558,5,2,91,96,10,0,79,89
"Bolivia","Beni","Moxos","San Ignacio","ESCUELA DE BERMEO",235578,28,1,82,110,30,0,51,81
"Bolivia","Beni","Moxos","San Ignacio","ESCUELA EL DESENGAÑO",235559,45,2,121,166,59,2,58,117
"Bolivia","Beni","Moxos","San Ignacio","ESCUELA FATIMA",235560,20,0,78,98,44,0,34,78
"Bolivia","Beni","Moxos","San Ignacio","ESCUELA LA ARGENTINA",235561,9,0,68,77,24,1,43,67
"Bolivia","Beni","Moxos","San Ignacio","ESCUELA LITORAL",235562,10,3,107,117,10,0,94,104
"Bolivia","Beni","Moxos","San Ignacio","ESCUELA MERCEDES DE LOJOJOTA",235563,22,4,74,96,8,4,58,66
"Bolivia","Beni","Moxos","San Ignacio","ESCUELA MONTE GRANDE",235564,23,1,90,113,16,8,65,81
"Bolivia","Beni","Moxos","San Ignacio","ESCUELA MONTE MAE",235565,36,0,49,85,28,0,21,49
"Bolivia","Beni","Moxos","San Ignacio","ESCUELA OROMOMO",235566,46,28,279,325,37,6,208,245
"Bolivia","Beni","Moxos","San Ignacio","ESCUELA OVIDIO ROCA C.",235567,123,1,430,553,225,7,197,422
"Bolivia","Beni","Moxos","San Ignacio","ESCUELA PTO. SAN LORENZO",235568,29,6,98,127,41,5,46,87
"Bolivia","Beni","Moxos","San Ignacio","ESCUELA PUERTO SAN BORJA",235569,28,0,83,111,12,2,69,81
"Bolivia","Beni","Moxos","San Ignacio","ESCUELA RETIRO",235570,15,1,106,121,2,2,101,103
"Bolivia","Beni","Moxos","San Ignacio","ESCUELA SAN ANTONIO DE IMOSE",235571,45,2,94,139,48,9,35,83
"Bolivia","Beni","Moxos","San Ignacio","ESCUELA SAN FRANCISCO",235572,63,8,231,294,68,7,148,216
"Bolivia","Beni","Moxos","San Ignacio","ESCUELA SAN JOSE DEL CABITU",235573,60,1,163,223,35,6,121,156
"Bolivia","Beni","Moxos","San Ignacio","ESCUELA SAN JOSE DE PATROCINIO",235574,16,0,22,38,20,0,2,22
"Bolivia","Beni","Moxos","San Ignacio","ESCUELA SAN MIGUELITO ISIBORO",235575,15,1,68,83,6,4,57,63
"Bolivia","Beni","Moxos","San Ignacio","ESCUELA SANTÍSIMA TRINIDAD",235579,21,3,160,181,42,2,113,155
"Bolivia","Beni","Moxos","San Ignacio","ESCUELA SUB-CENTRAL PUEBLO NUEVO",235576,13,0,32,45,5,0,27,32
"Bolivia","Beni","Moxos","San Ignacio","ESCUELA TRINIDACITO",235577,19,0,31,50,27,0,4,31
"Bolivia","Beni","Moxos","San Ignacio","L. GILFREDO CORTEZ CANDIA",235580,671,44,2561,3232,964,47,1506,2470
"Bolivia","Beni","Moxos","San Ignacio","UNIDAD EDUCATIVA SAN BERNARDO",235581,43,2,92,135,73,3,14,87
"Bolivia","Beni","Vaca Diéz","Guayaramerín","CENTRO EDUCATIVO SIMON BOLIVAR",232463,75,4,283,358,175,3,101,276
"Bolivia","Beni","Vaca Diéz","Guayaramerín","COLEGIO 6 DE JUNIO",232464,365,9,1476,1841,976,27,464,1440
"Bolivia","Beni","Vaca Diéz","Guayaramerín","COLEGIO ALTO DE LA ALIANZA",232465,485,15,1787,2272,1098,40,634,1732
"Bolivia","Beni","Vaca Diéz","Guayaramerín","COLEGIO ANTONIO VACA DIEZ",232466,92,3,342,434,224,2,113,337
"Bolivia","Beni","Vaca Diéz","Guayaramerín","COLEGIO EVANGELICO NACIONAL",232468,541,9,1442,1983,905,25,503,1408
"Bolivia","Beni","Vaca Diéz","Guayaramerín","COLEGIO MANUEL ANTONIO OJOPI",232469,732,14,2585,3317,1703,32,836,2539
"Bolivia","Beni","Vaca Diéz","Guayaramerín","COLEGIO MANUEL VICENTE BALLIVIAN",232467,182,1,302,484,218,5,78,296
"Bolivia","Beni","Vaca Diéz","Guayaramerín","DR. ELMER BOTSFORD",232470,225,6,701,926,471,17,207,678
"Bolivia","Beni","Vaca Diéz","Guayaramerín","ESCUELA ANTOFAGASTA",232471,15,0,51,66,28,0,23,51
"Bolivia","Beni","Vaca Diéz","Guayaramerín","ESCUELA BRASIL",232478,153,1,472,625,316,8,147,463
"Bolivia","Beni","Vaca Diéz","Guayaramerín","ESCUELA CENTRAL SAN LORENZO",232472,22,0,85,107,34,1,50,84
"Bolivia","Beni","Vaca Diéz","Guayaramerín","ESCUELA JUDDI DE SUAREZ",232473,80,5,257,337,179,3,70,249
"Bolivia","Beni","Vaca Diéz","Guayaramerín","ESCUELA LOS ALMENDROS",232479,425,10,1488,1913,890,44,544,1434
"Bolivia","Beni","Vaca Diéz","Guayaramerín","ESCUELA MEJILLONES",232474,908,42,3354,4262,2205,58,1049,3254
"Bolivia","Beni","Vaca Diéz","Guayaramerín","ESCUELA ROSARIO DEL YATA",232475,72,3,200,272,84,6,107,191
"Bolivia","Beni","Vaca Diéz","Guayaramerín","ESCUELA SAN FRANCISCO DEL YATA",232476,15,1,46,61,29,0,16,45
"Bolivia","Beni","Vaca Diéz","Guayaramerín","ESCUELA SAN JOSE",232477,402,12,1405,1807,904,25,464,1368
"Bolivia","Beni","Vaca Diéz","Guayaramerín","LIC. MIXTO GUAYAMERIN",232480,541,8,1386,1927,891,24,463,1354
"Bolivia","Beni","Vaca Diéz","Guayaramerín","PENAL GUAYARAMERIN",232462,11,0,22,33,11,1,10,21
"Bolivia","Beni","Vaca Diéz","Guayaramerín","UNIDAD EDUCATIVA 9 DE ABRIL",232481,25,2,266,291,154,5,105,259
"Bolivia","Beni","Vaca Diéz","Guayaramerín","UNIDAD EDUCATIVA BELEN",232482,96,1,433,529,258,10,164,422
"Bolivia","Beni","Vaca Diéz","Guayaramerín","UNIDAD EDUCATIVA MIGUEL ANTELO",232483,49,0,186,235,111,8,67,178
"Bolivia","Beni","Vaca Diéz","Riberalta","COLEGIO 6 DE JUNIO",234762,534,11,1371,1905,1014,18,328,1342
"Bolivia","Beni","Vaca Diéz","Riberalta","COLEGIO EDUARDO ABAROA",234763,637,23,2435,3072,1638,47,727,2365
"Bolivia","Beni","Vaca Diéz","Riberalta","COLEGIO ISMAEL CARRASCO TELLERIA",234764,122,8,387,509,215,12,152,367
"Bolivia","Beni","Vaca Diéz","Riberalta","COLEGIO PEDRO KRAMER",234768,391,8,1297,1688,929,37,323,1252
"Bolivia","Beni","Vaca Diéz","Riberalta","COLEGIO SAN FRANCISCO",234765,81,3,359,440,244,7,105,349
"Bolivia","Beni","Vaca Diéz","Riberalta","COLEGIO SAN JOSE OBRERO",234769,484,12,1271,1755,894,21,344,1238
"Bolivia","Beni","Vaca Diéz","Riberalta","COLEGIO SAN JUAN",234766,542,57,1894,2436,967,57,813,1780
"Bolivia","Beni","Vaca Diéz","Riberalta","COLEGIO WALTER ALPIRE DURAN",234767,157,6,638,795,429,8,195,624
"Bolivia","Beni","Vaca Diéz","Riberalta","COMITE CIVICO TUMICHUCUA",234770,73,11,254,327,145,20,78,223
"Bolivia","Beni","Vaca Diéz","Riberalta","ESCUELA 12 DE OCTUBRE",234774,65,6,206,271,93,2,105,198
"Bolivia","Beni","Vaca Diéz","Riberalta","ESCUELA 1RO DE DICIEMBRE",234775,454,12,1301,1755,933,18,338,1271
"Bolivia","Beni","Vaca Diéz","Riberalta","ESCUELA ALTO IVON",234776,21,4,244,265,4,3,233,237
"Bolivia","Beni","Vaca Diéz","Riberalta","ESCUELA BOLIVAR",234777,93,5,268,361,124,6,133,257
"Bolivia","Beni","Vaca Diéz","Riberalta","ESCUELA BRITANICA",234771,915,39,2819,3734,1780,89,911,2691
"Bolivia","Beni","Vaca Diéz","Riberalta","ESCUELA FELIX SATTORY ROMAN",234772,858,22,3384,4242,2517,66,779,3296
"Bolivia","Beni","Vaca Diéz","Riberalta","ESCUELA JUANA AZURDUY DE PADILLA",234773,257,4,847,1104,649,23,171,820
"Bolivia","Beni","Vaca Diéz","Riberalta","ESCUELA LOS TAJIBOS",234778,1118,41,3198,4316,1929,76,1152,3081
"Bolivia","Beni","Vaca Diéz","Riberalta","ESCUELA MARIPOSA",234779,20,1,87,107,51,5,30,81
"Bolivia","Beni","Vaca Diéz","Riberalta","ESCUELA NAZARETH",234780,22,2,92,114,60,3,27,87
"Bolivia","Beni","Vaca Diéz","Riberalta","ESCUELA PETROLERA",234781,1526,58,4261,5787,2792,100,1311,4103
"Bolivia","Beni","Vaca Diéz","Riberalta","ESCUELA SANTA MARIA",234782,68,9,280,348,112,6,153,265
"Bolivia","Beni","Vaca Diéz","Riberalta","ESCUELA SANTUARIO",234783,6,2,53,59,23,6,22,45
"Bolivia","Beni","Vaca Diéz","Riberalta","ESCUELA WARNES",234784,166,10,185,351,105,4,66,171
"Bolivia","Beni","Vaca Diéz","Riberalta","KINDER JHON F. KENNEDY",234785,298,18,1487,1785,1094,20,355,1449
"Bolivia","Beni","Vaca Diéz","Riberalta","PENAL RIBERALTA",234761,29,1,17,46,9,1,6,15
"Bolivia","Beni","Vaca Diéz","Riberalta","POLITECNICO BENJAMIN BOWLES",234786,866,24,2961,3827,1945,58,934,2879
"Bolivia","Beni","Vaca Diéz","Riberalta","UNIDAD EDUCATIVA BELLA FLOR",234787,4,0,71,75,31,2,38,69
"Bolivia","Beni","Vaca Diéz","Riberalta","UNIDAD EDUCATIVA FEDERICO DEMMER",234788,429,20,1389,1818,904,42,423,1327
"Bolivia","Beni","Vaca Diéz","Riberalta","UNIDAD EDUCATIVA LA ESPERANZA",234789,16,3,147,163,85,14,45,130
"Bolivia","Beni","Vaca Diéz","Riberalta","UNIDAD EDUCATIVA NATANIEL GARCÍA CHAVEZ",234792,687,35,2572,3259,1803,101,633,2436
"Bolivia","Beni","Vaca Diéz","Riberalta","UNIDAD EDUCATIVA NUESTRA SEÑORA DEL CARMEN",234790,465,15,1549,2014,1070,31,433,1503
"Bolivia","Beni","Vaca Diéz","Riberalta","UNIDAD EDUCATIVA POPECHI",234791,26,11,186,212,78,7,90,168
"Bolivia","Beni","Yacuma","Exaltación","ESCUELA CAMPO ANA MARIA",232281,4,0,23,27,6,0,17,23
"Bolivia","Beni","Yacuma","Exaltación","ESCUELA COOPERATIVA",232282,15,0,46,61,19,1,26,45
"Bolivia","Beni","Yacuma","Exaltación","ESCUELA COQUINAL",232283,26,2,165,191,35,2,126,161
"Bolivia","Beni","Yacuma","Exaltación","ESCUELA EL MOTACUSAL",232284,10,1,71,81,34,0,36,70
"Bolivia","Beni","Yacuma","Exaltación","ESCUELA EL TROMPILLO",232285,7,0,10,17,6,0,4,10
"Bolivia","Beni","Yacuma","Exaltación","ESCUELA JOSE MAX PAREDES",232286,133,1,411,544,149,3,258,407
"Bolivia","Beni","Yacuma","Exaltación","ESCUELA NUEVA ESPERANZA",232287,9,0,17,26,9,0,8,17
"Bolivia","Beni","Yacuma","Exaltación","ESCUELA PUERTO SANTIAGO",232290,2,0,16,18,11,0,5,16
"Bolivia","Beni","Yacuma","Exaltación","ESCUELA SAN CARLOS",232288,15,0,44,59,11,0,33,44
"Bolivia","Beni","Yacuma","Exaltación","ESCUELA SAN JUAN DEL JORDAN",232291,12,0,22,34,12,0,10,22
"Bolivia","Beni","Yacuma","Exaltación","ESCUELA SANTA ROSA",232289,1,0,9,10,4,0,5,9
"Bolivia","Beni","Yacuma","Santa Ana","COLEGIO ANDRES ALBERDI SALEGUI",232275,621,21,2129,2750,1406,29,673,2079
"Bolivia","Beni","Yacuma","Santa Ana","COLEGIO GUILLERMO SEARLE",232276,225,7,663,888,403,10,243,646
"Bolivia","Beni","Yacuma","Santa Ana","COLEGIO MONS. DANIEL RIVERO",232277,971,44,3247,4218,1945,65,1193,3138
"Bolivia","Beni","Yacuma","Santa Ana","ESCUELA CEC EL TOTAISAL",232278,58,1,158,216,58,5,94,152
"Bolivia","Beni","Yacuma","Santa Ana","ESCUELA LOS MONTES DE ORO",232279,11,1,13,24,6,0,6,12
"Bolivia","Beni","Yacuma","Santa Ana","ESCUELA WENCESLAO AÑEZ",232280,123,3,350,473,185,8,154,339
"Bolivia","Cochabamba","Arani","Arani","ESCUELA GUALBERTO VILLARROEL",234717,361,59,2584,2945,907,108,1510,2417
"Bolivia","Cochabamba","Arani","Arani","ESCUELA MIXTA POCOATA",234718,82,16,385,467,86,21,262,348
"Bolivia","Cochabamba","Arani","Arani","LICEO DE SEÑORITAS ARANI",234719,374,52,2410,2784,1009,80,1269,2278
"Bolivia","Cochabamba","Arani","Arani","UNIDAD EDUCATIVA COLLPACIACO",234720,103,18,505,608,116,26,345,461
"Bolivia","Cochabamba","Arani","Vacas","ESCUELA EXPERIMENTAL VACAS",234721,371,73,2590,2961,349,95,2073,2422
"Bolivia","Cochabamba","Arani","Vacas","ESCUELA SECCIONAL RODEO A",234722,111,68,926,1037,90,26,742,832
"Bolivia","Cochabamba","Arani","Vacas","UNIDAD EDUCATIVA DAVID MORATO CAÑADAS",234723,30,26,517,547,56,21,414,470
"Bolivia","Cochabamba","Arani","Vacas","UNIDAD EDUCATIVA TOTORAPAMPA",234724,16,5,210,226,14,1,190,204
"Bolivia","Cochabamba","Arque","Arque","ESCUELA E INTERNADO DARIO ANTEZANA V.",234725,98,1,548,646,7,22,518,525
"Bolivia","Cochabamba","Arque","Arque","ESCUELA JUANA AZURDUY - PONGO K'ASA",234726,84,21,375,459,45,25,284,329
"Bolivia","Cochabamba","Arque","Arque","ESCUELA MARCELO QUIROGA SANTA CRUZ",234727,172,11,638,810,65,54,508,573
"Bolivia","Cochabamba","Arque","Arque","ESCUELA NATANIEL AGUIRRE",234728,145,24,746,891,82,32,608,690
"Bolivia","Cochabamba","Arque","Arque","UNIDAD EDUCATIVA CHANGOLLA",234730,26,4,298,324,11,6,277,288
"Bolivia","Cochabamba","Arque","Arque","UNIDAD EDUCATIVA HUAYCHA",234731,24,2,321,345,9,12,298,307
"Bolivia","Cochabamba","Arque","Arque","UNIDAD EDUCATIVA SAN PEDRO",234729,54,11,193,247,14,3,165,179
"Bolivia","Cochabamba","Arque","Arque","UNIDAD ESCOLAR TUPAC KATARI - TARUJAYÑA",234732,32,7,445,477,38,13,387,425
"Bolivia","Cochabamba","Arque","Tacopaya","ESCUELA ADOLFO MERCADO",234733,114,22,1030,1144,120,40,848,968
"Bolivia","Cochabamba","Arque","Tacopaya","ESCUELA ELIZARDO PEREZ (TOTORAPAMPA)",234734,66,11,713,779,67,50,585,652
"Bolivia","Cochabamba","Arque","Tacopaya","ESCUELA MARTIN CARDENAS (TUJUTA)",234735,55,3,277,332,25,11,238,263
"Bolivia","Cochabamba","Arque","Tacopaya","ESCUELA SECCIONAL RENE BARRIENTOS",234736,95,15,473,568,61,29,368,429
"Bolivia","Cochabamba","Arque","Tacopaya","ESCUELA VICENTE DONOSO (AGUAS CALIENTES)",234737,35,5,327,362,29,11,282,311
"Bolivia","Cochabamba","Arque","Tacopaya","UNIDAD EDUCATIVA ANICETO ARCE",234738,68,4,290,358,29,21,236,265
"Bolivia","Cochabamba","Arque","Tacopaya","UNIDAD EDUCATIVA AUQUIPAMPA",234739,48,1,523,571,33,17,472,505
"Bolivia","Cochabamba","Arque","Tacopaya","UNIDAD EDUCATIVA MICHAYANI GRANDE",234740,47,0,225,272,12,12,201,213
"Bolivia","Cochabamba","Ayopaya","Cocapata","COLEGIO SECUNDARIO COCAPATA",234380,71,10,258,329,53,19,176,229
"Bolivia","Cochabamba","Ayopaya","Cocapata","ESCUELA 15 DE FEBRERO (EL CHORO)",234381,109,3,605,714,134,23,445,579
"Bolivia","Cochabamba","Ayopaya","Cocapata","ESCUELA CHOQUECAMATA (FALSURI)",234382,27,7,611,638,217,32,355,572
"Bolivia","Cochabamba","Ayopaya","Cocapata","ESCUELA OSCAR ALFARO - VILLA VINTO",234383,189,7,873,1062,170,58,638,808
"Bolivia","Cochabamba","Ayopaya","Cocapata","ESCUELA PEDRO DOMINGO MURILLO -CALIENTES",234384,91,8,471,562,80,30,353,433
"Bolivia","Cochabamba","Ayopaya","Cocapata","ESCUELA SECCIONAL MACHACAYMA",234385,117,6,674,791,112,63,493,605
"Bolivia","Cochabamba","Ayopaya","Cocapata","NUCLEO ESCOLAR PEDRO LAIME CHUSPI",234386,64,0,237,301,47,25,165,212
"Bolivia","Cochabamba","Ayopaya","Cocapata","NUCLEO GERMAN BUSCH (CHILLAVI)",234387,21,5,166,187,31,7,123,154
"Bolivia","Cochabamba","Ayopaya","Cocapata","SEDE SUB - CENTRAL VISCACHAS",234388,26,2,33,59,11,0,20,31
"Bolivia","Cochabamba","Ayopaya","Cocapata","UNIDAD EDUCATIVA CHIARAJE",234389,16,2,225,241,41,18,164,205
"Bolivia","Cochabamba","Ayopaya","Cocapata","UNIDAD EDUCATIVA COLORADO",234390,37,2,197,234,33,4,158,191
"Bolivia","Cochabamba","Ayopaya","Cocapata","UNIDAD EDUCATIVA EL CHORITO",234391,18,3,208,226,58,9,138,196
"Bolivia","Cochabamba","Ayopaya","Cocapata","UNIDAD EDUCATIVA ICARI",234392,52,2,313,365,77,10,224,301
"Bolivia","Cochabamba","Ayopaya","Cocapata","UNIDAD EDUCATIVA MARAVILLAS",234393,67,9,366,433,43,17,297,340
"Bolivia","Cochabamba","Ayopaya","Cocapata","UNIDAD EDUCATIVA TOTORANI",234394,45,2,349,394,38,3,306,344
"Bolivia","Cochabamba","Ayopaya","Cocapata","UNIDAD EDUCATIVA TUNARI (PUCARITA)",234395,98,10,460,558,27,18,405,432
"Bolivia","Cochabamba","Ayopaya","Independencia","COLEGIO CHAMACOMA",232316,95,6,474,569,67,24,377,444
"Bolivia","Cochabamba","Ayopaya","Independencia","COLEGIO SIMON BOLIVAR FE Y ALEGRIA",232317,230,39,2038,2268,502,89,1408,1910
"Bolivia","Cochabamba","Ayopaya","Independencia","ESCUELA MARIANO BAPTISTA (CALCHANI)",232318,101,19,641,742,33,51,538,571
"Bolivia","Cochabamba","Ayopaya","Independencia","UNIDAD EDUCATIVA CHAPISUYO A",232320,100,13,619,719,42,24,540,582
"Bolivia","Cochabamba","Ayopaya","Independencia","UNIDAD EDUCATIVA CHARAHUAYTU",232321,161,45,1018,1179,167,52,754,921
"Bolivia","Cochabamba","Ayopaya","Independencia","UNIDAD EDUCATIVA JOSE MIGUEL LANZA",232319,508,67,2313,2821,498,138,1610,2108
"Bolivia","Cochabamba","Ayopaya","Independencia","UNIDAD EDUCATIVA MACHACA",232322,42,5,225,267,34,9,177,211
"Bolivia","Cochabamba","Ayopaya","Independencia","UNIDAD EDUCATIVA POCANCHE",232323,70,7,399,469,17,24,351,368
"Bolivia","Cochabamba","Ayopaya","Independencia","UNIDAD EDUCATIVA SABINO WALLKU",232324,54,13,393,447,34,14,332,366
"Bolivia","Cochabamba","Ayopaya","Independencia","UNIDAD EDUCATIVA SISI PALERMO",232325,42,5,335,377,34,50,246,280
"Bolivia","Cochabamba","Ayopaya","Independencia","UNIDAD EDUCATIVA TAPAZA",232326,11,3,136,147,15,4,114,129
"Bolivia","Cochabamba","Ayopaya","Independencia","UNIDAD EDUCATIVA VILLA PUCARA",232327,123,27,507,630,74,20,386,460
"Bolivia","Cochabamba","Ayopaya","Morochata","COLEGIO RENE BARRIENTOS ORTUÑO -PIUSILLA",234522,91,18,575,666,121,24,412,533
"Bolivia","Cochabamba","Ayopaya","Morochata","ESCUELA 26 DE MAYO - CHAUPISUYO B",234523,84,11,723,807,116,46,550,666
"Bolivia","Cochabamba","Ayopaya","Morochata","ESCUELA GILDARO ANTEZANA ROJAS",234524,130,37,893,1023,88,47,721,809
"Bolivia","Cochabamba","Ayopaya","Morochata","ESCUELA HILARION GRAGEDA - YAYANI",234525,121,30,707,828,118,53,506,624
"Bolivia","Cochabamba","Ayopaya","Morochata","ESCUELA JULIO ESPINOZA CANELAS-PUNACACHI",234526,134,46,714,848,112,59,497,609
"Bolivia","Cochabamba","Ayopaya","Morochata","ESCUELA MARIANO BAPTISTA- MOROCHATA",234527,151,27,1561,1712,177,94,1263,1440
"Bolivia","Cochabamba","Ayopaya","Morochata","UNIDAD EDUCATIVA HUMAMARCA",234528,16,8,235,251,31,14,182,213
"Bolivia","Cochabamba","Ayopaya","Morochata","UNIDAD EDUCATIVA IGLESIANI",234529,17,0,175,192,39,2,134,173
"Bolivia","Cochabamba","Ayopaya","Morochata","UNIDAD EDUCATIVA PUCARANI GRANDE",234530,29,0,118,147,7,3,108,115
"Bolivia","Cochabamba","Bolívar","Bolivar","ESCUELA COYUMA",232407,23,3,86,109,31,7,45,76
"Bolivia","Cochabamba","Bolívar","Bolivar","ESCUELA JORENKO VILLA VERDE",232408,8,5,404,412,79,16,304,383
"Bolivia","Cochabamba","Bolívar","Bolivar","ESCUELA MEJILLONES",232409,92,3,352,444,71,18,260,331
"Bolivia","Cochabamba","Bolívar","Bolivar","ESCUELA SAN JUAN DE LA COMUNA",232410,29,4,137,166,25,9,99,124
"Bolivia","Cochabamba","Bolívar","Bolivar","ESCUELA SIMON BOLIVAR",232411,147,14,641,788,161,35,431,592
"Bolivia","Cochabamba","Bolívar","Bolivar","ESCUELA TANGALIQUE",232412,22,3,224,246,43,9,169,212
"Bolivia","Cochabamba","Bolívar","Bolivar","ESCUELA VILACAYMA",232413,24,14,308,332,76,15,203,279
"Bolivia","Cochabamba","Bolívar","Bolivar","ESCUELA YARVICOYA",232414,65,5,260,325,14,6,235,249
"Bolivia","Cochabamba","Bolívar","Bolivar","NUCLEO ESCOLAR CARPANI",232415,20,3,467,487,68,20,376,444
"Bolivia","Cochabamba","Bolívar","Bolivar","UNIDAD EDUCATIVA CHALLOMA",232416,24,3,185,209,46,13,123,169
"Bolivia","Cochabamba","Bolívar","Bolivar","UNIDAD EDUCATIVA VILAPAMPA",232417,4,0,198,202,54,9,135,189
"Bolivia","Cochabamba","Campero","Aiquile","ESCUELA 20 DE DICIEMBRE",232934,436,56,2234,2670,970,111,1097,2067
"Bolivia","Cochabamba","Campero","Aiquile","ESCUELA MANUEL DE UGARTE",232935,405,33,2026,2431,849,62,1082,1931
"Bolivia","Cochabamba","Campero","Aiquile","ESCUELA SIMON RODRIGUEZ",232936,417,54,2337,2754,972,87,1224,2196
"Bolivia","Cochabamba","Campero","Aiquile","NUCLEO EDUCATIVO TIPAJARA",232937,30,6,274,304,45,8,215,260
"Bolivia","Cochabamba","Campero","Aiquile","NUCLEO ESCOLAR EL CERCADO",232938,78,13,326,404,36,8,269,305
"Bolivia","Cochabamba","Campero","Aiquile","NUCLEO ESCOLAR VILLA GRANADO",232939,175,22,907,1082,143,32,710,853
"Bolivia","Cochabamba","Campero","Aiquile","UNIDAD EDUCATIVA CHAQUI MAYU",232940,20,4,158,178,9,4,141,150
"Bolivia","Cochabamba","Campero","Aiquile","UNIDAD EDUCATIVA EJE PAMPA",232941,52,11,284,336,31,17,225,256
"Bolivia","Cochabamba","Campero","Aiquile","UNIDAD EDUCATIVA ESTANZUELA",232942,54,2,228,282,21,4,201,222
"Bolivia","Cochabamba","Campero","Aiquile","UNIDAD EDUCATIVA KEWIÑAL",232943,27,11,188,215,50,15,112,162
"Bolivia","Cochabamba","Campero","Aiquile","UNIDAD EDUCATIVA LAGARPAMPA",232944,71,3,214,285,13,4,194,207
"Bolivia","Cochabamba","Campero","Aiquile","UNIDAD EDUCATIVA LAIME",232945,23,5,175,198,8,9,153,161
"Bolivia","Cochabamba","Campero","Aiquile","UNIDAD EDUCATIVA NOVILLERO",232946,103,11,532,635,130,20,371,501
"Bolivia","Cochabamba","Campero","Aiquile","UNIDAD EDUCATIVA PANAMA",232947,36,3,256,292,44,5,204,248
"Bolivia","Cochabamba","Campero","Aiquile","UNIDAD EDUCATIVA QUIROGA",232948,165,24,849,1014,106,33,686,792
"Bolivia","Cochabamba","Campero","Omereque","ESCUELA CENTRAL PEÑA COLORADA",232955,52,5,342,394,63,13,261,324
"Bolivia","Cochabamba","Campero","Omereque","ESCUELA SECCIONAL CHARI CHARI",232956,12,3,67,79,23,5,36,59
"Bolivia","Cochabamba","Campero","Omereque","ESCUELA SECCIONAL PEREZ",232957,21,2,167,188,32,6,127,159
"Bolivia","Cochabamba","Campero","Omereque","UNIDAD EDUCATIVA HUANACUNI GRANDE",232958,22,2,162,184,22,2,136,158
"Bolivia","Cochabamba","Campero","Omereque","UNIDAD EDUCATIVA OMEREQUE",232959,303,37,1547,1850,467,34,1009,1476
"Bolivia","Cochabamba","Campero","Omereque","UNIDAD EDUCATIVA PERERETA",232960,28,5,178,206,42,9,122,164
"Bolivia","Cochabamba","Campero","Pasorapa","COLEGIO TTE. CNEL. NATANIEL VERDUGUEZ",232949,181,11,748,929,404,26,307,711
"Bolivia","Cochabamba","Campero","Pasorapa","ESCUELA CENTRAL QUINORI",232950,63,1,228,291,35,4,188,223
"Bolivia","Cochabamba","Campero","Pasorapa","SEDE SINDICAL YAJO PAMPA",232951,2,0,37,39,14,0,23,37
"Bolivia","Cochabamba","Campero","Pasorapa","UNIDAD EDUCATIVA PAMPAS",232953,11,0,112,123,21,0,91,112
"Bolivia","Cochabamba","Campero","Pasorapa","UNIDAD EDUCATIVA REDONDO",232952,3,2,69,72,8,4,55,63
"Bolivia","Cochabamba","Campero","Pasorapa","UNIDAD EDUCATIVA SEIBAS",232954,36,5,141,177,24,2,110,134
"Bolivia","Cochabamba","Capinota","Capinota","ESCUELA APILLAPAMPA",234741,55,16,662,717,38,24,584,622
"Bolivia","Cochabamba","Capinota","Capinota","ESCUELA CENTRAL MARCAVI",234742,38,14,320,358,20,10,276,296
"Bolivia","Cochabamba","Capinota","Capinota","ESCUELA VICTOR BARRIENTOS",234743,716,109,4531,5247,1681,208,2533,4214
"Bolivia","Cochabamba","Capinota","Capinota","NUCLEO CENTRAL HORNOMA",234744,38,19,363,401,9,8,327,336
"Bolivia","Cochabamba","Capinota","Capinota","UNIDAD EDUCATIVA CUSTODIO AYAVIRI",234745,346,52,2853,3199,1223,93,1485,2708
"Bolivia","Cochabamba","Capinota","Capinota","UNIDAD EDUCATIVA GUSTAVO GARCIA (CHARAMO",234746,91,23,719,810,229,29,438,667
"Bolivia","Cochabamba","Capinota","Capinota","UNIDAD EDUCATIVA JUANA AZURDUY DE PADILLA",234747,103,5,421,524,116,18,282,398
"Bolivia","Cochabamba","Capinota","Capinota","UNIDAD EDUCATIVA TOCOHALLA",234748,20,0,81,101,1,4,76,77
"Bolivia","Cochabamba","Capinota","Capinota","UNIDAD EDUCATIVA YATAMOCO",234749,40,5,475,515,122,13,335,457
"Bolivia","Cochabamba","Capinota","Santivañez","DOMICILIO PARTICULAR",233485,24,4,189,213,44,6,135,179
"Bolivia","Cochabamba","Capinota","Santivañez","ESCUELA PRUDENCIO ARAUCO (SANTIVAÑEZ)",233486,249,24,1618,1867,434,45,1115,1549
"Bolivia","Cochabamba","Capinota","Santivañez","SUB CENTRAL ENRIQUE ENCINAS (EX CALERA)",233487,73,5,509,582,61,13,430,491
"Bolivia","Cochabamba","Capinota","Santivañez","UNIDAD EDUCATIVA CAPORAYA",233489,31,9,247,278,25,5,208,233
"Bolivia","Cochabamba","Capinota","Santivañez","UNIDAD EDUCATIVA CASTOR ZAMBRANA HUAYÑACOTA",233488,75,4,419,494,65,6,344,409
"Bolivia","Cochabamba","Capinota","Santivañez","UNIDAD EDUCATIVA JOSE RIVERA",233490,34,2,183,217,54,4,123,177
"Bolivia","Cochabamba","Capinota","Santivañez","UNIDAD EDUCATIVA PAMPA CHURIHUA",233491,18,4,141,159,5,4,128,133
"Bolivia","Cochabamba","Capinota","Santivañez","UNIDAD EDUCATIVA ROCHA RANCHO",233492,83,9,460,543,74,15,362,436
"Bolivia","Cochabamba","Capinota","Sicaya","ESCUELA GERMAN BUSCH",232618,74,23,535,609,81,25,406,487
"Bolivia","Cochabamba","Capinota","Sicaya","NUCLEO HUMANISTICO SICAYA",232619,110,24,817,927,69,42,682,751
"Bolivia","Cochabamba","Carrasco","Chimore","ESCUELA GERÓNIMO UZEDA FE Y ALEGRIA",233902,1485,117,7075,8560,1647,222,5089,6736
"Bolivia","Cochabamba","Carrasco","Chimore","ESCUELA LA MISION",233903,39,3,348,387,98,9,238,336
"Bolivia","Cochabamba","Carrasco","Chimore","NUCLEO EDUCATIVO ENTRE RIOS TACUARAL",233904,60,2,570,630,43,7,518,561
"Bolivia","Cochabamba","Carrasco","Chimore","NUCLEO ESCOLAR PUERTO AURORA",233905,62,18,475,537,56,11,390,446
"Bolivia","Cochabamba","Carrasco","Chimore","UNIDAD EDUCATIVA CESAR ZAMA (CHIMORE)",233906,162,21,1626,1788,154,32,1419,1573
"Bolivia","Cochabamba","Carrasco","Chimore","UNIDAD EDUCATIVA EL CARMEN",233907,32,1,98,130,23,5,69,92
"Bolivia","Cochabamba","Carrasco","Chimore","UNIDAD EDUCATIVA PUERTO LAS FLORES",233908,12,3,65,77,24,3,35,59
"Bolivia","Cochabamba","Carrasco","Chimore","UNIDAD EDUCATIVA SAN ANDRÉS",233909,59,5,543,602,25,12,501,526
"Bolivia","Cochabamba","Carrasco","Chimore","UNIDAD EDUCATIVA SANTA ANITA",233910,42,2,89,131,19,5,63,82
"Bolivia","Cochabamba","Carrasco","Chimore","UNIDAD EDUCATIVA SANTA ISABEL",233911,19,1,51,70,13,1,36,49
"Bolivia","Cochabamba","Carrasco","Chimore","UNIDAD EDUCATIVA TRES ISLAS",233912,30,5,170,200,27,3,135,162
"Bolivia","Cochabamba","Carrasco","Chimore","UNIDAD EDUCATIVA TRINIDADCITO",233913,8,0,61,69,31,0,30,61
"Bolivia","Cochabamba","Carrasco","Entre Rios","COLEGIO FRANZ TAMAYO",236397,1086,104,7861,8947,1358,224,6175,7533
"Bolivia","Cochabamba","Carrasco","Entre Rios","COLEGIO NACIONAL SAN MARCOS",236398,390,53,3533,3923,441,72,2967,3408
"Bolivia","Cochabamba","Carrasco","Entre Rios","ESCUELA EDUARDO AVAROA (ISARZAMA)",236399,202,12,2085,2287,130,27,1916,2046
"Bolivia","Cochabamba","Carrasco","Entre Rios","UNIDAD EDUCATIVA ESTEBAN ARCE",236400,9,4,254,263,7,8,235,242
"Bolivia","Cochabamba","Carrasco","Entre Rios","UNIDAD EDUCATIVA JOSÉ CARRASCO (MANCO KAPAC)",236401,270,33,2874,3144,243,48,2550,2793
"Bolivia","Cochabamba","Carrasco","Entre Rios","UNIDAD EDUCATIVA NACIONAL AYACUCHO",236402,7,0,66,73,10,0,56,66
"Bolivia","Cochabamba","Carrasco","Entre Rios","UNIDAD EDUCATIVA RIO BLANCO",236403,260,18,1278,1538,170,42,1048,1218
"Bolivia","Cochabamba","Carrasco","Pocona","CENTRO DE ATENCION AL TURISTA",232687,12,5,369,381,34,9,321,355
"Bolivia","Cochabamba","Carrasco","Pocona","ESCUELA LADISLAO CABRERA",232688,68,11,418,486,61,12,334,395
"Bolivia","Cochabamba","Carrasco","Pocona","NUCLEO ESCOLAR ISMAEL MONTES",232689,80,14,821,901,104,26,677,781
"Bolivia","Cochabamba","Carrasco","Pocona","UNIDAD EDUCATIVA 6 DE AGOSTO",232690,165,22,936,1101,139,44,731,870
"Bolivia","Cochabamba","Carrasco","Pocona","UNIDAD EDUCATIVA CHIMBOATA",232691,24,3,402,426,46,12,341,387
"Bolivia","Cochabamba","Carrasco","Pocona","UNIDAD EDUCATIVA HUAYAPACHA",232692,85,30,837,922,98,35,674,772
"Bolivia","Cochabamba","Carrasco","Pocona","UNIDAD EDUCATIVA JAVIER GONZALES",232693,3,0,61,64,1,1,59,60
"Bolivia","Cochabamba","Carrasco","Pocona","UNIDAD EDUCATIVA LA TRANCA",232694,10,4,109,119,8,0,97,105
"Bolivia","Cochabamba","Carrasco","Pocona","UNIDAD EDUCATIVA MONTE PUNCU",232695,55,13,394,449,46,17,318,364
"Bolivia","Cochabamba","Carrasco","Pocona","UNIDAD EDUCATIVA POCONA",232696,106,18,389,495,72,18,281,353
"Bolivia","Cochabamba","Carrasco","Pojo","COLEGIO VENANCIO LOSS",232752,225,31,1448,1673,246,38,1133,1379
"Bolivia","Cochabamba","Carrasco","Pojo","NUCLEO ESCOLAR DURAZNILLO",232753,39,3,142,181,14,2,123,137
"Bolivia","Cochabamba","Carrasco","Pojo","UNIDAD EDUCATIVA CHALLHUANI",232755,73,0,648,721,13,34,601,614
"Bolivia","Cochabamba","Carrasco","Pojo","UNIDAD EDUCATIVA DIAN PAMPA",232756,31,3,322,353,26,12,281,307
"Bolivia","Cochabamba","Carrasco","Pojo","UNIDAD EDUCATIVA JAIME LAREDO",232757,5,1,104,109,5,3,95,100
"Bolivia","Cochabamba","Carrasco","Pojo","UNIDAD EDUCATIVA KARA HUASI - POJO",232758,23,2,246,269,20,10,214,234
"Bolivia","Cochabamba","Carrasco","Pojo","UNIDAD EDUCATIVA LA HABANA",232759,29,2,289,318,17,2,268,285
"Bolivia","Cochabamba","Carrasco","Pojo","UNIDAD EDUCATIVA PALCA C",232760,20,2,511,531,17,4,488,505
"Bolivia","Cochabamba","Carrasco","Pojo","UNIDAD EDUCATIVA RODEO C",232761,52,1,341,393,4,24,312,316
"Bolivia","Cochabamba","Carrasco","Pojo","UNIDAD EDUCATIVA THAGO LAGUNA",232762,0,0,61,61,0,4,57,57
"Bolivia","Cochabamba","Carrasco","Pojo","UNIDAD EDUCATIVA YUTHUPAMPA",232763,59,7,532,591,25,11,489,514
"Bolivia","Cochabamba","Carrasco","Puerto Villarroel","COLEGIO EDUARDO AVAROA (P.VILLARROEL)",232697,297,17,1057,1354,336,18,686,1022
"Bolivia","Cochabamba","Carrasco","Puerto Villarroel","COLEGIO JUAN PABLO II (SACTA)",232698,408,40,3634,4042,344,74,3176,3520
"Bolivia","Cochabamba","Carrasco","Puerto Villarroel","COLEGIO LIBERTAD",232699,75,6,849,924,64,17,762,826
"Bolivia","Cochabamba","Carrasco","Puerto Villarroel","COLEGIO MARCELO QUIROGA SANTA CRUZ",232700,245,17,2028,2273,215,41,1755,1970
"Bolivia","Cochabamba","Carrasco","Puerto Villarroel","ESCUELA AYOPAYA (P.VILLAROEL)",232701,77,8,900,977,49,15,828,877
"Bolivia","Cochabamba","Carrasco","Puerto Villarroel","ESCUELA BUENAS NUEVAS (VALLE IVIRZA)",232702,182,23,1235,1417,134,22,1056,1190
"Bolivia","Cochabamba","Carrasco","Puerto Villarroel","ESCUELA CENTRAL VILLA NUEVA",232703,71,6,722,793,40,9,667,707
"Bolivia","Cochabamba","Carrasco","Puerto Villarroel","ESCUELA SENDA 6",232704,130,18,1312,1442,84,25,1185,1269
"Bolivia","Cochabamba","Carrasco","Puerto Villarroel","ESCUELA TORIBIO CLAURE (V. HERMOSO)",232705,204,14,1538,1742,156,26,1342,1498
"Bolivia","Cochabamba","Carrasco","Puerto Villarroel","UNIDAD EDUCATIVA 2 DE MARZO",232706,56,4,670,726,30,9,627,657
"Bolivia","Cochabamba","Carrasco","Puerto Villarroel","UNIDAD EDUCATIVA BIARECUATÉ",232707,31,0,59,90,5,0,54,59
"Bolivia","Cochabamba","Carrasco","Puerto Villarroel","UNIDAD EDUCATIVA CESAR ZAMA (P. VILLARRO",232708,20,2,177,197,14,6,155,169
"Bolivia","Cochabamba","Carrasco","Puerto Villarroel","UNIDAD EDUCATIVA ISRAEL",232709,38,7,536,574,45,8,476,521
"Bolivia","Cochabamba","Carrasco","Puerto Villarroel","UNIDAD EDUCATIVA JUANA AZURDUY DE PADILLA",232710,90,3,527,617,79,10,435,514
"Bolivia","Cochabamba","Carrasco","Puerto Villarroel","UNIDAD EDUCATIVA SAN FRANCISCO DE ASIS",232711,1395,123,9073,10468,1583,289,7078,8661
"Bolivia","Cochabamba","Carrasco","Puerto Villarroel","UNIDAD EDUCATIVA VALLE TUNARI",232712,175,17,1599,1774,101,28,1453,1554
"Bolivia","Cochabamba","Carrasco","Totora","COLEGIO 8 DE SEPTIEMBRE",232677,44,9,554,598,51,16,478,529
"Bolivia","Cochabamba","Carrasco","Totora","SEDE DE LA JUNTA VECINAL DE EPIZANA",232678,72,12,785,857,95,28,650,745
"Bolivia","Cochabamba","Carrasco","Totora","SEDE SOCIAL YUNGAS DE VANDIOLA",232679,74,8,477,551,130,12,327,457
"Bolivia","Cochabamba","Carrasco","Totora","UNIDAD EDUCATIVA ANTAQAWA",232680,8,0,131,139,9,1,121,130
"Bolivia","Cochabamba","Carrasco","Totora","UNIDAD EDUCATIVA LAIME TORO",232681,42,8,572,614,46,18,500,546
"Bolivia","Cochabamba","Carrasco","Totora","UNIDAD EDUCATIVA POTRERO",232682,14,1,119,133,5,0,113,118
"Bolivia","Cochabamba","Carrasco","Totora","UNIDAD EDUCATIVA RODEO GRANDE",232683,59,10,861,920,43,12,796,839
"Bolivia","Cochabamba","Carrasco","Totora","UNIDAD EDUCATIVA TIKA PAMPA",232684,17,4,125,142,4,4,113,117
"Bolivia","Cochabamba","Carrasco","Totora","UNIDAD EDUCATIVA TIRAQUE C",232685,14,4,305,319,16,4,281,297
"Bolivia","Cochabamba","Carrasco","Totora","UNIDA EDUCATIVA LA PAZ",232686,425,48,2708,3133,516,83,2061,2577
"Bolivia","Cochabamba","Cercado","Cochabamba","CAMPO FERIAL",232797,634,33,4556,5190,2374,149,2000,4374
"Bolivia","Cochabamba","Cercado","Cochabamba","CEMA CENTRO FRUTILLITAS",232801,39,1,481,520,347,14,119,466
"Bolivia","Cochabamba","Cercado","Cochabamba","CENTRO EDUCATIVO P. MARIA AUXILIADORA",232802,703,41,5203,5906,2680,191,2291,4971
"Bolivia","Cochabamba","Cercado","Cochabamba","CENTRO EDUCATIVO SAN FRANCISCO DE ASIS",232803,185,6,1313,1498,861,18,428,1289
"Bolivia","Cochabamba","Cercado","Cochabamba","CENTRO INMACULADA CONCEPCION",232804,394,9,2504,2898,2142,37,316,2458
"Bolivia","Cochabamba","Cercado","Cochabamba","CENTRO INTEGRADO EL SALVADOR S-VERA CRUZ",232805,436,26,2949,3385,1227,102,1594,2821
"Bolivia","Cochabamba","Cercado","Cochabamba","CENTRO KANATA",232806,145,2,879,1024,560,25,292,852
"Bolivia","Cochabamba","Cercado","Cochabamba","CENTRO PARTICULAR GERONIMO DE OSORIO",232807,883,24,5680,6563,3767,147,1742,5509
"Bolivia","Cochabamba","Cercado","Cochabamba","COLEGIO ABAROA",232808,540,12,3076,3616,2308,56,700,3008
"Bolivia","Cochabamba","Cercado","Cochabamba","COLEGIO ALBERT EINSTEIN",232809,368,13,3155,3523,2474,98,570,3044
"Bolivia","Cochabamba","Cercado","Cochabamba","COLEGIO ALEMAN SANTA MARIA",232810,351,8,2029,2380,1666,34,321,1987
"Bolivia","Cochabamba","Cercado","Cochabamba","COLEGIO AMOR DE DIOS",232811,1164,33,6625,7789,4045,135,2412,6457
"Bolivia","Cochabamba","Cercado","Cochabamba","COLEGIO BOLIVAR",232812,297,11,1610,1907,1191,20,388,1579
"Bolivia","Cochabamba","Cercado","Cochabamba","COLEGIO BOLIVIANO ARGENTINO",232813,151,5,713,864,551,10,147,698
"Bolivia","Cochabamba","Cercado","Cochabamba","COLEGIO BRANCO PETRICEVIC",232814,837,32,6224,7061,4425,146,1621,6046
"Bolivia","Cochabamba","Cercado","Cochabamba","COLEGIO BUENAS NUEVAS C",232815,730,42,4605,5335,2290,140,2133,4423
"Bolivia","Cochabamba","Cercado","Cochabamba","COLEGIO CRISTO REY",232816,590,9,4395,4985,3349,88,949,4298
"Bolivia","Cochabamba","Cercado","Cochabamba","COLEGIO DON BOSCO",232817,694,15,4015,4709,3327,58,615,3942
"Bolivia","Cochabamba","Cercado","Cochabamba","COLEGIO FEDERICO FROEBEL",232818,428,14,3451,3879,2475,76,886,3361
"Bolivia","Cochabamba","Cercado","Cochabamba","COLEGIO HISPANO BOLIVIANO",232819,479,14,2579,3058,1866,66,633,2499
"Bolivia","Cochabamba","Cercado","Cochabamba","COLEGIO IRLANDES",232820,71,1,536,607,447,8,80,527
"Bolivia","Cochabamba","Cercado","Cochabamba","COLEGIO ISMAEL MONTES O LUIS ESPINAL",232821,562,33,3962,4524,1912,124,1893,3805
"Bolivia","Cochabamba","Cercado","Cochabamba","COLEGIO JAIME ESCALANTE",232822,188,9,1369,1557,1122,21,217,1339
"Bolivia","Cochabamba","Cercado","Cochabamba","COLEGIO LA SALLE",232823,736,11,3643,4379,3037,45,550,3587
"Bolivia","Cochabamba","Cercado","Cochabamba","COLEGIO LA SALLE FISCAL",232824,700,22,4983,5683,3548,98,1315,4863
"Bolivia","Cochabamba","Cercado","Cochabamba","COLEGIO LAURA VICUÑA",232825,129,15,1094,1223,419,33,627,1046
"Bolivia","Cochabamba","Cercado","Cochabamba","COLEGIO LOYOLA",232826,321,4,1795,2116,1486,28,277,1763
"Bolivia","Cochabamba","Cercado","Cochabamba","COLEGIO LUIS QUINTIN VILA",232827,788,21,6106,6894,4295,189,1601,5896
"Bolivia","Cochabamba","Cercado","Cochabamba","COLEGIO MARISTA",232828,580,16,4753,5333,3384,87,1266,4650
"Bolivia","Cochabamba","Cercado","Cochabamba","COLEGIO MARISTA NUESTRA SEÑORA DEL PILAR",232829,778,26,5557,6335,3331,161,2039,5370
"Bolivia","Cochabamba","Cercado","Cochabamba","COLEGIO MARTIN CARDENAS",232830,489,20,4069,4558,2209,94,1746,3955
"Bolivia","Cochabamba","Cercado","Cochabamba","COLEGIO MARYKNOLL",232831,779,8,4947,5726,4183,64,692,4875
"Bolivia","Cochabamba","Cercado","Cochabamba","COLEGIO NACIONAL MIXTO COCHABAMBA",232832,701,29,5441,6142,3787,92,1533,5320
"Bolivia","Cochabamba","Cercado","Cochabamba","COLEGIO PAULO VI",232833,369,8,2610,2979,2079,52,471,2550
"Bolivia","Cochabamba","Cercado","Cochabamba","COLEGIO PIO XII",232834,233,7,1454,1687,1045,21,381,1426
"Bolivia","Cochabamba","Cercado","Cochabamba","COLEGIO RICHARD VON WEIZACKER",232835,305,10,2765,3070,2173,38,544,2717
"Bolivia","Cochabamba","Cercado","Cochabamba","COLEGIO SAN ANTONIO DE PUCARA",232836,1458,92,8964,10422,3375,324,5173,8548
"Bolivia","Cochabamba","Cercado","Cochabamba","COLEGIO SAN FRANCISCO DE ASIS",232837,813,34,5774,6587,3177,138,2425,5602
"Bolivia","Cochabamba","Cercado","Cochabamba","COLEGIO SAN FRANCISCO (VILLA PAGADOR)",232838,820,66,5571,6391,1769,211,3525,5294
"Bolivia","Cochabamba","Cercado","Cochabamba","COLEGIO SAN RAFAEL",232839,653,16,4393,5046,3310,49,1018,4328
"Bolivia","Cochabamba","Cercado","Cochabamba","COLEGIO SANTA LUISA MARILLAC",232840,730,49,5518,6248,2277,172,3020,5297
"Bolivia","Cochabamba","Cercado","Cochabamba","COLEGIO SANTO DOMINGO SAVIO",232841,297,16,2234,2531,1401,60,757,2158
"Bolivia","Cochabamba","Cercado","Cochabamba","COLEGIO SEBASTIAN PAGADOR",232842,1528,101,11230,12758,3900,353,6876,10776
"Bolivia","Cochabamba","Cercado","Cochabamba","COLEGIO SERGIO ALMARAZ PAZ",232843,766,23,5259,6025,3325,143,1768,5093
"Bolivia","Cochabamba","Cercado","Cochabamba","COLEGIO TECNICO HUMANISTICO ABAROA",232844,147,6,1098,1245,738,23,331,1069
"Bolivia","Cochabamba","Cercado","Cochabamba","COLEGIO VENEZUELA",232845,420,16,2985,3405,2348,52,569,2917
"Bolivia","Cochabamba","Cercado","Cochabamba","COLEGIO VENJAMNIN",232846,264,29,2102,2366,892,70,1111,2003
"Bolivia","Cochabamba","Cercado","Cochabamba","COLEGIO YUGOSLAVIA ( EX MARISCAL SANTA CRUZ)",232847,355,11,2438,2793,1665,53,709,2374
"Bolivia","Cochabamba","Cercado","Cochabamba","ESCUELA 6 DE AGOSTO",232850,604,71,4681,5285,1408,160,3042,4450
"Bolivia","Cochabamba","Cercado","Cochabamba","ESCUELA ANTOFAGASTA",232851,721,45,5926,6647,4016,133,1732,5748
"Bolivia","Cochabamba","Cercado","Cochabamba","ESCUELA BOLIVAR",232852,239,5,1240,1479,857,19,359,1216
"Bolivia","Cochabamba","Cercado","Cochabamba","ESCUELA BUENAS NUEVAS A",232853,411,25,2759,3170,1307,81,1346,2653
"Bolivia","Cochabamba","Cercado","Cochabamba","ESCUELA CAMARA JUNIOR",232854,346,17,2088,2434,1166,78,827,1993
"Bolivia","Cochabamba","Cercado","Cochabamba","ESCUELA CARLOS MEDINACELI",232855,765,40,5459,6224,2177,157,3085,5262
"Bolivia","Cochabamba","Cercado","Cochabamba","ESCUELA CEFERINO NAMUNCURA",232856,181,8,1063,1244,381,34,640,1021
"Bolivia","Cochabamba","Cercado","Cochabamba","ESCUELA CENTRAL TAQUIÑA A",232857,706,52,5677,6383,2965,161,2499,5464
"Bolivia","Cochabamba","Cercado","Cochabamba","ESCUELA CENTRAL TAQUIÑA C",232858,686,30,5223,5909,2725,147,2321,5046
"Bolivia","Cochabamba","Cercado","Cochabamba","ESCUELA EUSEBIO TUDELA",232859,450,48,3770,4220,1177,135,2410,3587
"Bolivia","Cochabamba","Cercado","Cochabamba","ESCUELA FISCAL JUAN XXIII A",232860,540,14,4012,4552,2580,66,1352,3932
"Bolivia","Cochabamba","Cercado","Cochabamba","ESCUELA FISCAL JUAN XXIII A - JUANCITO PINTO",232848,214,5,1650,1864,1081,31,533,1614
"Bolivia","Cochabamba","Cercado","Cochabamba","ESCUELA GERARDO VARGAS",232861,872,64,5519,6391,1967,190,3298,5265
"Bolivia","Cochabamba","Cercado","Cochabamba","ESCUELA GUALBERTO VILLARROEL",232862,292,4,1962,2254,1557,24,377,1934
"Bolivia","Cochabamba","Cercado","Cochabamba","ESCUELA GUTIERREZ MARISCAL",232863,652,46,5679,6331,3301,162,2170,5471
"Bolivia","Cochabamba","Cercado","Cochabamba","ESCUELA HUMBERTO PORTOCARRERO",232864,592,23,4078,4670,1757,127,2171,3928
"Bolivia","Cochabamba","Cercado","Cochabamba","ESCUELA IV CENTENARIO",232865,698,33,5144,5842,3146,117,1848,4994
"Bolivia","Cochabamba","Cercado","Cochabamba","ESCUELA JOSE GABRIEL DE GUMUCIO",232866,246,3,1779,2025,1468,32,276,1744
"Bolivia","Cochabamba","Cercado","Cochabamba","ESCUELA JOSE MARIA SANTIVAÑEZ",232867,604,10,4205,4809,3397,48,750,4147
"Bolivia","Cochabamba","Cercado","Cochabamba","ESCUELA MARYKNOLL",232868,172,1,1224,1396,1064,15,144,1208
"Bolivia","Cochabamba","Cercado","Cochabamba","ESCUELA MIXTA FISCAL TEMPORAL A",232869,656,29,5205,5861,3175,152,1849,5024
"Bolivia","Cochabamba","Cercado","Cochabamba","ESCUELA OTTO FELIPE BRAWN",232870,555,19,4174,4729,2655,97,1403,4058
"Bolivia","Cochabamba","Cercado","Cochabamba","ESCUELA REPUBLICA DEL PERU O I. VASQUEZ",232849,1100,29,6962,8062,4546,136,2251,6797
"Bolivia","Cochabamba","Cercado","Cochabamba","ESCUELA RICARDO PRUDENCIO",232871,449,22,2988,3437,1337,95,1534,2871
"Bolivia","Cochabamba","Cercado","Cochabamba","ESCUELA WALTER VALLEJO",232872,240,3,1370,1610,861,30,476,1337
"Bolivia","Cochabamba","Cercado","Cochabamba","ESCUELA WILGE RODRIGUEZ",232873,163,6,900,1063,676,22,196,872
"Bolivia","Cochabamba","Cercado","Cochabamba","INSTITUTO AMERICANO",232874,933,22,5993,6926,4669,95,1207,5876
"Bolivia","Cochabamba","Cercado","Cochabamba","INSTITUTO EDUARDO LAREDO",232875,454,2,2164,2618,1825,21,316,2141
"Bolivia","Cochabamba","Cercado","Cochabamba","LICEO ADELA ZAMUDIO",232876,546,8,2869,3415,2130,77,654,2784
"Bolivia","Cochabamba","Cercado","Cochabamba","LICEO ELENA ARZE DE ARZE",232877,568,11,3531,4099,2871,59,590,3461
"Bolivia","Cochabamba","Cercado","Cochabamba","LICEO GUINDALINA LOAYZA",232878,153,7,1293,1446,1083,15,188,1271
"Bolivia","Cochabamba","Cercado","Cochabamba","LICEO MERCEDES CANDIA DE OVANDO",232879,551,19,3684,4235,2701,90,874,3575
"Bolivia","Cochabamba","Cercado","Cochabamba","PENITENCIARIA SAN ANTONIO",232798,92,2,151,243,70,6,73,143
"Bolivia","Cochabamba","Cercado","Cochabamba","PENITENCIARIA SAN SEBASTIAN MUJERES",232799,48,0,77,125,29,0,48,77
"Bolivia","Cochabamba","Cercado","Cochabamba","PENITENCIARIA SAN SEBASTIAN VARONES",232800,84,1,192,276,61,10,120,181
"Bolivia","Cochabamba","Cercado","Cochabamba","SEMINARIO SAN JOSE",232880,361,9,2916,3277,2014,69,824,2838
"Bolivia","Cochabamba","Cercado","Cochabamba","UNIDAD EDUCATIVA 14 DE SEPTIEMBRE",232884,87,1,933,1020,708,15,209,917
"Bolivia","Cochabamba","Cercado","Cochabamba","UNIDAD EDUCATIVA 26 DE OCTUBRE",232885,39,0,545,584,269,15,261,530
"Bolivia","Cochabamba","Cercado","Cochabamba","UNIDAD EDUCATIVA 9 DE MARZO",232886,76,15,1007,1083,263,32,697,960
"Bolivia","Cochabamba","Cercado","Cochabamba","UNIDAD EDUCATIVA ALTO COCHABAMBA",232887,48,4,422,470,132,13,273,405
"Bolivia","Cochabamba","Cercado","Cochabamba","UNIDAD EDUCATIVA AMERICA DEL SUR - MEJILLONES A",232888,39,7,342,381,158,11,166,324
"Bolivia","Cochabamba","Cercado","Cochabamba","UNIDAD EDUCATIVA ANDRES BELLO",232889,596,25,3737,4333,1845,91,1776,3621
"Bolivia","Cochabamba","Cercado","Cochabamba","UNIDAD EDUCATIVA ANTONIO DIEZ",232890,93,14,1553,1646,522,57,960,1482
"Bolivia","Cochabamba","Cercado","Cochabamba","UNIDAD EDUCATIVA ATIY",232891,124,12,1138,1262,378,26,722,1100
"Bolivia","Cochabamba","Cercado","Cochabamba","UNIDAD EDUCATIVA BARBARA LAMAS",232892,469,55,3502,3971,796,151,2500,3296
"Bolivia","Cochabamba","Cercado","Cochabamba","UNIDAD EDUCATIVA BOLIVIA (LA MAICA)",232893,145,9,1277,1422,351,42,875,1226
"Bolivia","Cochabamba","Cercado","Cochabamba","UNIDAD EDUCATIVA CATOLICO GUADALUPANO (EX CALIFORNIA AMERICAN SCHOOL)",232894,367,11,2791,3158,2054,50,676,2730
"Bolivia","Cochabamba","Cercado","Cochabamba","UNIDAD EDUCATIVA CLUB DE LEONES",232895,502,19,3494,3996,2514,73,888,3402
"Bolivia","Cochabamba","Cercado","Cochabamba","UNIDAD EDUCATIVA DANIEL SALAMANCA (EX COLEGIO NAL. MIXTO 6 DE AGOSTO)",232896,82,3,583,665,448,10,122,570
"Bolivia","Cochabamba","Cercado","Cochabamba","UNIDAD EDUCATIVA DE LA FUERZA AEREA",232897,196,3,658,854,397,19,239,636
"Bolivia","Cochabamba","Cercado","Cochabamba","UNIDAD EDUCATIVA DEMETRIO CANELAS",232898,217,24,1874,2091,627,56,1167,1794
"Bolivia","Cochabamba","Cercado","Cochabamba","UNIDAD EDUCATIVA DIONISIO MORALES CHOQUE",232899,929,91,7321,8250,1596,285,5349,6945
"Bolivia","Cochabamba","Cercado","Cochabamba","UNIDAD EDUCATIVA DOMINGO SAVIO (EX LORENZO FILHO)",232900,218,1,1194,1412,939,26,228,1167
"Bolivia","Cochabamba","Cercado","Cochabamba","UNIDAD EDUCATIVA EDUARDO LOPEZ O E.DON BOSCO",232931,373,29,2362,2735,1017,57,1259,2276
"Bolivia","Cochabamba","Cercado","Cochabamba","UNIDAD EDUCATIVA EL SALVADOR SAN JAVIER",232901,584,38,3769,4353,1520,85,2126,3646
"Bolivia","Cochabamba","Cercado","Cochabamba","UNIDAD EDUCATIVA ESTADOS UNIDOS",232902,219,11,1660,1879,1034,42,573,1607
"Bolivia","Cochabamba","Cercado","Cochabamba","UNIDAD EDUCATIVA ESTEBAN ARZE",232903,431,8,3409,3840,2256,104,1041,3297
"Bolivia","Cochabamba","Cercado","Cochabamba","UNIDAD EDUCATIVA FACUNDO QUIROGA",232904,47,3,366,413,274,8,81,355
"Bolivia","Cochabamba","Cercado","Cochabamba","UNIDAD EDUCATIVA FELIX CAPRILES",232905,73,4,784,857,534,19,227,761
"Bolivia","Cochabamba","Cercado","Cochabamba","UNIDAD EDUCATIVA GARIBALDI",232906,222,13,1744,1966,1027,25,679,1706
"Bolivia","Cochabamba","Cercado","Cochabamba","UNIDAD EDUCATIVA HNO PACIFICO FELETTI",232907,98,13,905,1003,205,33,654,859
"Bolivia","Cochabamba","Cercado","Cochabamba","UNIDAD EDUCATIVA JOSE IGNACIO SANJINES",232908,95,7,1050,1145,661,27,355,1016
"Bolivia","Cochabamba","Cercado","Cochabamba","UNIDAD EDUCATIVA JUAN JOSE TORREZ",232909,149,17,1415,1564,442,40,916,1358
"Bolivia","Cochabamba","Cercado","Cochabamba","UNIDAD EDUCATIVA MADRE DE LA DIVINA PROVIDENCIA",232881,31,4,443,474,186,17,236,422
"Bolivia","Cochabamba","Cercado","Cochabamba","UNIDAD EDUCATIVA MARIA EMILIA RIQUELME (EX MARIA CRISTINA)",232910,479,20,3711,4190,2143,117,1431,3574
"Bolivia","Cochabamba","Cercado","Cochabamba","UNIDAD EDUCATIVA MARIA JOSEFA MUJIA",232911,325,42,2969,3294,862,119,1946,2808
"Bolivia","Cochabamba","Cercado","Cochabamba","UNIDAD EDUCATIVA NACIONAL SAN ISIDRO",232882,545,57,4004,4549,1009,162,2776,3785
"Bolivia","Cochabamba","Cercado","Cochabamba","UNIDAD EDUCATIVA NATANIEL AGUIRRE",232912,22,1,332,354,237,8,86,323
"Bolivia","Cochabamba","Cercado","Cochabamba","UNIDAD EDUCATIVA NUEVA ESPERANZA",232913,628,77,5669,6297,1543,230,3819,5362
"Bolivia","Cochabamba","Cercado","Cochabamba","UNIDAD EDUCATIVA NUEVA VERA CRUZ",232914,420,21,2889,3309,1009,97,1762,2771
"Bolivia","Cochabamba","Cercado","Cochabamba","UNIDAD EDUCATIVA OBISPO ANAYA",232915,340,21,2445,2785,1038,64,1322,2360
"Bolivia","Cochabamba","Cercado","Cochabamba","UNIDAD EDUCATIVA PRIMERO DE MAYO",232916,798,74,5989,6787,1676,212,4027,5703
"Bolivia","Cochabamba","Cercado","Cochabamba","UNIDAD EDUCATIVA PROF. OSCAR ROJAS CABALLERO",232917,34,2,318,352,157,6,153,310
"Bolivia","Cochabamba","Cercado","Cochabamba","UNIDAD EDUCATIVA RENE BARRIENTOS ORTUÑO",232918,993,89,6018,7011,1732,243,3954,5686
"Bolivia","Cochabamba","Cercado","Cochabamba","UNIDAD EDUCATIVA RENE CRESPO",232919,95,6,823,918,275,33,509,784
"Bolivia","Cochabamba","Cercado","Cochabamba","UNIDAD EDUCATIVA ROSENDO PEÑA",232920,45,1,481,526,361,12,107,468
"Bolivia","Cochabamba","Cercado","Cochabamba","UNIDAD EDUCATIVA SAN MIGUEL",232921,471,22,2432,2903,1105,67,1238,2343
"Bolivia","Cochabamba","Cercado","Cochabamba","UNIDAD EDUCATIVA SAN MIGUEL ALTA TENSION",232922,79,16,649,728,215,13,405,620
"Bolivia","Cochabamba","Cercado","Cochabamba","UNIDAD EDUCATIVA SAN NICOLAS CLUB DE LEONES",232883,180,33,1796,1976,381,75,1307,1688
"Bolivia","Cochabamba","Cercado","Cochabamba","UNIDAD EDUCATIVA SANTA CRUZ - EDUARDO OCAMPO MOSCOSO",232923,20,1,132,152,51,2,78,129
"Bolivia","Cochabamba","Cercado","Cochabamba","UNIDAD EDUCATIVA SANTA MARIA MICAELA",232924,717,16,5180,5897,3518,125,1521,5039
"Bolivia","Cochabamba","Cercado","Cochabamba","UNIDAD EDUCATIVA SANTIAGO",232925,383,23,3641,4024,1680,131,1807,3487
"Bolivia","Cochabamba","Cercado","Cochabamba","UNIDAD EDUCATIVA SIGLO XX - GABRIELA MISTRAL",232926,140,16,1338,1478,485,38,799,1284
"Bolivia","Cochabamba","Cercado","Cochabamba","UNIDAD EDUCATIVA STEFANO HOTELLIER",232927,184,24,1891,2075,487,75,1305,1792
"Bolivia","Cochabamba","Cercado","Cochabamba","UNIDAD EDUCATIVA VERDAD Y VIDA",232928,235,33,2227,2462,598,80,1516,2114
"Bolivia","Cochabamba","Cercado","Cochabamba","UNIDAD EDUCATIVA VISION MUNDIAL",232929,692,39,4831,5523,2164,146,2482,4646
"Bolivia","Cochabamba","Cercado","Cochabamba","UNIDAD EDUCATIVA VOCES LIBRES",232930,23,7,329,352,66,9,247,313
"Bolivia","Cochabamba","Cercado","Cochabamba","UNIVERSIDAD CATOLICA",232932,863,26,5636,6499,4383,97,1130,5513
"Bolivia","Cochabamba","Cercado","Cochabamba","UNIVERSIDAD UCATEC (EX CEIVO)",232933,253,8,2127,2380,1606,38,475,2081
"Bolivia","Cochabamba","Chapare","Colomi","NUCLEO ESCOLAR CANDELARIA",232399,156,31,1832,1988,331,88,1382,1713
"Bolivia","Cochabamba","Chapare","Colomi","NUCLEO ESCOLAR TABLAS MONTE",232400,83,16,568,651,48,10,494,542
"Bolivia","Cochabamba","Chapare","Colomi","UNIDAD EDUCATIVA CORANI PAMPA",232402,106,19,1142,1248,205,41,877,1082
"Bolivia","Cochabamba","Chapare","Colomi","UNIDAD EDUCATIVA EL PALMAR",232403,45,4,260,305,55,5,196,251
"Bolivia","Cochabamba","Chapare","Colomi","UNIDAD EDUCATIVA PARACTI (COLOMI)",232404,60,5,516,576,172,25,314,486
"Bolivia","Cochabamba","Chapare","Colomi","UNIDAD EDUCATIVA PUCA MAYU (COLOMI)",232405,1,0,8,9,0,0,8,8
"Bolivia","Cochabamba","Chapare","Colomi","UNIDAD EDUCATIVA ROSARIO",232401,3,3,87,90,36,1,47,83
"Bolivia","Cochabamba","Chapare","Colomi","UNIDAD EDUCATIVA SAMUEL FINA SAVIO",232406,914,144,5977,6891,1880,370,3583,5463
"Bolivia","Cochabamba","Chapare","Sacaba","COLEGIO BOLIVIANO JAPONES",232363,1004,54,7211,8215,4531,203,2423,6954
"Bolivia","Cochabamba","Chapare","Sacaba","COLEGIO FRANZ TAMAYO (CHIÑATA)",232364,525,41,3978,4503,1427,154,2356,3783
"Bolivia","Cochabamba","Chapare","Sacaba","COLEGIO NATANIEL AGUIRRE",232365,148,8,1266,1414,208,52,998,1206
"Bolivia","Cochabamba","Chapare","Sacaba","COLEGIO PUERTO MEJILLONES",232366,576,26,4465,5041,2823,87,1529,4352
"Bolivia","Cochabamba","Chapare","Sacaba","COLEGIO QUINTANILLA",232367,1591,97,10227,11818,5854,343,3933,9787
"Bolivia","Cochabamba","Chapare","Sacaba","COLEGIO RENE FERNANDEZ BECERRA",232368,124,13,1040,1164,158,16,853,1011
"Bolivia","Cochabamba","Chapare","Sacaba","COLEGIO SEÑOR DE MAYO",232369,919,33,6076,6995,4052,119,1872,5924
"Bolivia","Cochabamba","Chapare","Sacaba","ESCUELA 6 DE JUNIO - TACOPOCA",232370,437,63,3749,4186,1461,150,2075,3536
"Bolivia","Cochabamba","Chapare","Sacaba","ESCUELA CARLOS PEREDO SANDOVAL",232371,1065,98,7387,8452,3470,306,3513,6983
"Bolivia","Cochabamba","Chapare","Sacaba","ESCUELA COPACABANA",232372,460,36,3588,4048,2090,106,1356,3446
"Bolivia","Cochabamba","Chapare","Sacaba","ESCUELA GERMAN BUSCH",232373,745,56,4774,5519,2474,200,2044,4518
"Bolivia","Cochabamba","Chapare","Sacaba","ESCUELA GUADALUPE",232374,843,31,5983,6826,3471,189,2292,5763
"Bolivia","Cochabamba","Chapare","Sacaba","ESCUELA JESUS TERCEROS",232375,438,6,3210,3648,2324,71,809,3133
"Bolivia","Cochabamba","Chapare","Sacaba","ESCUELA MAN CESPED",232376,911,69,6361,7272,3261,258,2773,6034
"Bolivia","Cochabamba","Chapare","Sacaba","ESCUELA NATALIO ARAUCO",232377,675,49,4489,5164,2353,148,1939,4292
"Bolivia","Cochabamba","Chapare","Sacaba","ESCUELA RENE BARRIENTOS ORTUÑO (UCUCHI)",232378,90,8,574,664,139,19,408,547
"Bolivia","Cochabamba","Chapare","Sacaba","INSTITUTO TECNICO SACABA (ITSA)",232379,16,2,126,142,58,5,61,119
"Bolivia","Cochabamba","Chapare","Sacaba","LICEO DE SEÑORITAS SACABA",232380,928,66,6075,7003,3243,194,2572,5815
"Bolivia","Cochabamba","Chapare","Sacaba","PENITENCIARIA EL ABRA",232361,65,1,223,288,56,4,162,218
"Bolivia","Cochabamba","Chapare","Sacaba","PENITENCIARIA SAN PEDRO (SACABA)",232362,51,2,105,156,21,3,79,100
"Bolivia","Cochabamba","Chapare","Sacaba","UNIDAD EDUCATIVA 27 DE AGOSTO",232384,17,4,390,407,115,11,260,375
"Bolivia","Cochabamba","Chapare","Sacaba","UNIDAD EDUCATIVA BOLIVIANO BRITÁNICO",232385,395,42,3050,3445,1205,108,1695,2900
"Bolivia","Cochabamba","Chapare","Sacaba","UNIDAD EDUCATIVA CEILAB",232386,14,2,167,181,110,7,48,158
"Bolivia","Cochabamba","Chapare","Sacaba","UNIDAD EDUCATIVA DEL VALLE",232387,203,13,1838,2041,1097,42,686,1783
"Bolivia","Cochabamba","Chapare","Sacaba","UNIDAD EDUCATIVA EDMUNDO BOJANOWSKI",232388,35,1,397,432,249,9,138,387
"Bolivia","Cochabamba","Chapare","Sacaba","UNIDAD EDUCATIVA ENTRE RIOS",232389,9,3,167,176,50,10,104,154
"Bolivia","Cochabamba","Chapare","Sacaba","UNIDAD EDUCATIVA HERNÁN RIVERO FIORILO",232390,177,17,1925,2102,859,57,992,1851
"Bolivia","Cochabamba","Chapare","Sacaba","UNIDAD EDUCATIVA ISRAELÍ EL ABRA",232391,627,66,5585,6212,2018,217,3284,5302
"Bolivia","Cochabamba","Chapare","Sacaba","UNIDAD EDUCATIVA KANATA",232392,89,3,708,797,560,16,129,689
"Bolivia","Cochabamba","Chapare","Sacaba","UNIDAD EDUCATIVA LARATI",232393,30,6,773,803,93,11,663,756
"Bolivia","Cochabamba","Chapare","Sacaba","UNIDAD EDUCATIVA MARCELO QUIROGA SANTA CRUZ (PACATA)",232381,15,1,161,176,104,2,54,158
"Bolivia","Cochabamba","Chapare","Sacaba","UNIDAD EDUCATIVA NUEVO AMANECER",232382,29,11,603,632,130,48,414,544
"Bolivia","Cochabamba","Chapare","Sacaba","UNIDAD EDUCATIVA PAMPILLA",232394,195,49,2082,2277,498,128,1407,1905
"Bolivia","Cochabamba","Chapare","Sacaba","UNIDAD EDUCATIVA RENÉ BARRIENTOS ORTUÑO",232395,135,5,1137,1272,714,27,391,1105
"Bolivia","Cochabamba","Chapare","Sacaba","UNIDAD EDUCATIVA REPUBLICA DE ITALIA",232396,156,15,1465,1621,637,34,779,1416
"Bolivia","Cochabamba","Chapare","Sacaba","UNIDAD EDUCATIVA TUTIMAYU",232383,49,16,878,927,269,27,566,835
"Bolivia","Cochabamba","Chapare","Sacaba","UNIDAD EDUCATIVA ULINCATE",232397,109,14,1042,1151,384,40,604,988
"Bolivia","Cochabamba","Chapare","Sacaba","UNIDAD EDUCATIVA VILLA GRACIELA",232398,288,15,2428,2716,1496,43,874,2370
"Bolivia","Cochabamba","Chapare","Villa Tunari","COLEGIO FE Y ALEGRIA",233848,164,18,1661,1825,199,43,1401,1600
"Bolivia","Cochabamba","Chapare","Villa Tunari","COLEGIO FRANCISCO VIGNAUD",233849,119,5,521,640,170,7,339,509
"Bolivia","Cochabamba","Chapare","Villa Tunari","COLEGIO MIXTO TECNICO HUM. VILLA BOLIVAR",233850,54,6,496,550,40,6,444,484
"Bolivia","Cochabamba","Chapare","Villa Tunari","COLEGIO NUEVA TACOPAYA",233851,102,7,1124,1226,117,33,967,1084
"Bolivia","Cochabamba","Chapare","Villa Tunari","ESCUELA 27 DE MAYO",233852,115,13,533,648,90,25,405,495
"Bolivia","Cochabamba","Chapare","Villa Tunari","ESCUELA CRISTAL MAYU",233853,193,18,1595,1788,138,31,1408,1546
"Bolivia","Cochabamba","Chapare","Villa Tunari","ESCUELA ELIZARDO PEREZ",233854,242,25,1966,2208,236,45,1660,1896
"Bolivia","Cochabamba","Chapare","Villa Tunari","ESCUELA LA ESTRELLA",233855,47,3,573,620,49,17,504,553
"Bolivia","Cochabamba","Chapare","Villa Tunari","ESCUELA LA ESTRELLA (SAN GABRIEL)",233856,281,4,2075,2356,163,37,1871,2034
"Bolivia","Cochabamba","Chapare","Villa Tunari","ESCUELA SAMUZABETI",233857,201,12,2121,2322,133,49,1927,2060
"Bolivia","Cochabamba","Chapare","Villa Tunari","ESCUELA SAN ANTONIO DE VILLA TUNARI",233858,359,17,1849,2208,607,44,1181,1788
"Bolivia","Cochabamba","Chapare","Villa Tunari","ESCUELA SAN JOSE (V.TUNARI)",233859,152,5,1283,1435,69,17,1192,1261
"Bolivia","Cochabamba","Chapare","Villa Tunari","ESCUELA VILLA 14 DE SEPTIEMBRE",233860,677,73,4890,5567,597,121,4099,4696
"Bolivia","Cochabamba","Chapare","Villa Tunari","NUCLEO ESCOLAR NUEVA AROMA",233861,86,14,917,1003,60,4,839,899
"Bolivia","Cochabamba","Chapare","Villa Tunari","UNIDAD EDUCATIVA 1RO DE MAYO",233865,50,2,591,641,52,16,521,573
"Bolivia","Cochabamba","Chapare","Villa Tunari","UNIDAD EDUCATIVA 27 DE MAYO",233866,18,1,326,344,12,2,311,323
"Bolivia","Cochabamba","Chapare","Villa Tunari","UNIDAD EDUCATIVA INDEPENDENCIA (VILLA TUNARI)",233862,88,14,975,1063,41,13,907,948
"Bolivia","Cochabamba","Chapare","Villa Tunari","UNIDAD EDUCATIVA JATUN PAMPA",233867,115,14,1017,1132,160,28,815,975
"Bolivia","Cochabamba","Chapare","Villa Tunari","UNIDAD EDUCATIVA MIXTA ETERAZAMA",233868,535,52,4318,4853,672,112,3482,4154
"Bolivia","Cochabamba","Chapare","Villa Tunari","UNIDAD EDUCATIVA MOLETO ICOYA (V.TUNARI)",233869,43,6,645,688,25,14,600,625
"Bolivia","Cochabamba","Chapare","Villa Tunari","UNIDAD EDUCATIVA PARACTITO",233870,228,19,1648,1876,289,54,1286,1575
"Bolivia","Cochabamba","Chapare","Villa Tunari","UNIDAD EDUCATIVA PARACTI (VILLA TUNARI)",233871,65,6,326,391,46,7,267,313
"Bolivia","Cochabamba","Chapare","Villa Tunari","UNIDAD EDUCATIVA PARAISO-TODO SANTOS",233872,149,20,1507,1656,182,41,1264,1446
"Bolivia","Cochabamba","Chapare","Villa Tunari","UNIDAD EDUCATIVA SAN BENITO",233863,18,2,56,74,5,1,48,53
"Bolivia","Cochabamba","Chapare","Villa Tunari","UNIDAD EDUCATIVA SAN FRANCISCO KM 21",233873,31,7,603,634,32,15,549,581
"Bolivia","Cochabamba","Chapare","Villa Tunari","UNIDAD EDUCATIVA SAN JOSE DE ANGOSTA",233874,75,5,207,282,20,20,162,182
"Bolivia","Cochabamba","Chapare","Villa Tunari","UNIDAD EDUCATIVA SANTA ROSA DE LA BOCA",233864,28,0,25,53,24,0,1,25
"Bolivia","Cochabamba","Chapare","Villa Tunari","UNIDAD EDUCATIVA SIMON RODRIGUEZ (EX PUCA MAYU (V. TUNARI))",233875,65,9,501,566,44,12,436,480
"Bolivia","Cochabamba","Chapare","Villa Tunari","UNIDAD EDUCATIVA TOCOPILLA",233876,33,7,378,411,22,10,339,361
"Bolivia","Cochabamba","Chapare","Villa Tunari","UNIDAD EDUCATIVA UNCIA",233877,42,10,573,615,26,18,519,545
"Bolivia","Cochabamba","Chapare","Villa Tunari","UNIDAD EDUCATIVA VILLA NUEVA",233878,21,1,314,335,27,10,276,303
"Bolivia","Cochabamba","Esteban Arce","Anzaldo","ESCUELA ESTEBAN ANDIA ESCOBAR - PACCHA PATA",233437,29,6,157,186,29,7,115,144
"Bolivia","Cochabamba","Esteban Arce","Anzaldo","NUCLEO EDUCATIVO LA VIÑA",233438,46,4,194,240,42,6,142,184
"Bolivia","Cochabamba","Esteban Arce","Anzaldo","UNIDAD EDUCATIVA ALFAMAYU",233440,9,1,68,77,2,2,63,65
"Bolivia","Cochabamba","Esteban Arce","Anzaldo","UNIDAD EDUCATIVA ARTURO SARMIENTO",233441,47,3,252,299,31,16,202,233
"Bolivia","Cochabamba","Esteban Arce","Anzaldo","UNIDAD EDUCATIVA SAN JOSE DE CALAZANS-LITORAL",233439,405,93,2084,2489,570,102,1319,1889
"Bolivia","Cochabamba","Esteban Arce","Anzaldo","UNIDAD EDUCATIVA THAGO KASA",233442,13,2,120,133,11,2,105,116
"Bolivia","Cochabamba","Esteban Arce","Arbieto","CENTRO EDUCATIVO GERMAN BUSCH - ARBIETO",233443,372,33,1648,2020,467,62,1086,1553
"Bolivia","Cochabamba","Esteban Arce","Arbieto","ESCUELA SECCIONAL ARPITA",233444,196,20,1007,1203,160,39,788,948
"Bolivia","Cochabamba","Esteban Arce","Arbieto","UNIDAD EDUCATIVA 6 DE JUNIO - MAMANACA",233445,131,13,547,678,138,17,379,517
"Bolivia","Cochabamba","Esteban Arce","Arbieto","UNIDAD EDUCATIVA ANTONIO ARNEZ -ARANJUEZ",233446,56,4,340,396,101,10,225,326
"Bolivia","Cochabamba","Esteban Arce","Arbieto","UNIDAD EDUCATIVA CARLOS CANELAS",233447,262,40,2833,3095,515,128,2150,2665
"Bolivia","Cochabamba","Esteban Arce","Arbieto","UNIDAD ESCOLAR CASIMIRO LOPEZ T.",233448,66,7,354,420,128,6,213,341
"Bolivia","Cochabamba","Esteban Arce","Sacabamba","ESCUELA ELISEO TORRICO - SACABAMBA",234712,112,22,664,776,176,37,429,605
"Bolivia","Cochabamba","Esteban Arce","Sacabamba","ESCUELA SECCIONAL CHALLAQUE",234713,32,5,228,260,57,14,152,209
"Bolivia","Cochabamba","Esteban Arce","Sacabamba","NUCLEO ESCOLAR QUEKOMA",234714,46,10,263,309,22,8,223,245
"Bolivia","Cochabamba","Esteban Arce","Sacabamba","NUCLEO MATARANI",234715,97,12,592,689,103,24,453,556
"Bolivia","Cochabamba","Esteban Arce","Sacabamba","UNIDAD EDUCATIVA APILLAPA",234716,12,3,172,184,20,6,143,163
"Bolivia","Cochabamba","Esteban Arce","Tarata","COLEGIO MY. VICTOR USTARIZ",233430,498,23,1636,2134,548,58,1007,1555
"Bolivia","Cochabamba","Esteban Arce","Tarata","ESCUELA ESTEBAN ARZE",233431,206,25,1195,1401,327,46,797,1124
"Bolivia","Cochabamba","Esteban Arce","Tarata","ESCUELA LUIS TERRAZAS",233432,36,3,182,218,7,6,166,173
"Bolivia","Cochabamba","Esteban Arce","Tarata","ESCUELA RENE BARRIENTOS O.",233433,322,22,1254,1576,383,37,812,1195
"Bolivia","Cochabamba","Esteban Arce","Tarata","UNIDAD EDUCATIVA HUASA RANCHO",233434,31,6,141,172,38,3,94,132
"Bolivia","Cochabamba","Esteban Arce","Tarata","UNIDAD EDUCATIVA HUAYCULI",233435,87,8,537,624,59,14,456,515
"Bolivia","Cochabamba","Esteban Arce","Tarata","UNIDAD EDUCATIVA HUERTA MAYU",233436,42,3,351,393,8,6,334,342
"Bolivia","Cochabamba","Germán Jordán","Cliza","COLEGIO JUAN DE DIOS BALDERRAMA",232620,762,62,4482,5244,1702,131,2587,4289
"Bolivia","Cochabamba","Germán Jordán","Cliza","COLEGIO NACIONAL MIXTO UCUREÑA",232621,264,29,2045,2309,630,42,1344,1974
"Bolivia","Cochabamba","Germán Jordán","Cliza","ESCUELA SUCRE",232622,819,45,3548,4367,1273,112,2118,3391
"Bolivia","Cochabamba","Germán Jordán","Cliza","UNIDAD EDUCATIVA CHULLPAS",232623,134,11,628,762,146,27,444,590
"Bolivia","Cochabamba","Germán Jordán","Cliza","UNIDAD EDUCATIVA HUASACALLE",232624,75,13,537,612,151,11,362,513
"Bolivia","Cochabamba","Germán Jordán","Cliza","UNIDAD EDUCATIVA SANTA LUCIA",232625,94,7,409,503,126,18,258,384
"Bolivia","Cochabamba","Germán Jordán","Toco","COLEGIO AMBROSINI",233190,517,52,2421,2938,476,65,1828,2304
"Bolivia","Cochabamba","Germán Jordán","Toco","UNIDAD EDUCATIVA SICHES",233191,37,8,206,243,29,8,161,190
"Bolivia","Cochabamba","Germán Jordán","Tolata","COLEGIO VICTOR ROSALES",232674,426,35,1615,2041,526,66,988,1514
"Bolivia","Cochabamba","Germán Jordán","Tolata","ESCUELA SAN ISIDRO",232675,110,14,348,458,82,14,238,320
"Bolivia","Cochabamba","Germán Jordán","Tolata","ESCUELA SANTA MARIA (CARCAJE)",232676,427,25,1648,2075,692,64,867,1559
"Bolivia","Cochabamba","Mizque","Alalay","ESCUELA DR. DEMETRIO CANELAS",234196,47,10,382,429,88,14,270,358
"Bolivia","Cochabamba","Mizque","Alalay","UNIDAD EDUCATIVA ABRAHAM FLORES VELASQUEZ",234197,73,4,334,407,30,7,293,323
"Bolivia","Cochabamba","Mizque","Alalay","UNIDAD EDUCATIVA QUTURI",234198,26,6,185,211,18,4,157,175
"Bolivia","Cochabamba","Mizque","Alalay","UNIDAD EDUCATIVA YANA KHAKHA",234199,52,1,207,259,11,6,189,200
"Bolivia","Cochabamba","Mizque","Mizque","COLEGIO PEDRO IGNACIO RIVERO",232713,629,74,4377,5006,1495,205,2603,4098
"Bolivia","Cochabamba","Mizque","Mizque","ESCUELA AGUADA",232714,124,14,586,710,74,22,476,550
"Bolivia","Cochabamba","Mizque","Mizque","ESCUELA GUILLERMO VISCARRA",232715,74,6,511,585,41,13,451,492
"Bolivia","Cochabamba","Mizque","Mizque","ESCUELA MIXTA DR. MARTIN CARDENAS",232716,134,26,854,988,239,43,546,785
"Bolivia","Cochabamba","Mizque","Mizque","NUCLEO CENTRO SALVIA",232717,22,4,248,270,16,9,219,235
"Bolivia","Cochabamba","Mizque","Mizque","NUCLEO ESCOLAR BETA RAQAY PAMPA",232718,153,18,1127,1280,27,36,1046,1073
"Bolivia","Cochabamba","Mizque","Mizque","NUCLEO ESCOLAR LAGUNA GRANDE",232719,104,19,827,931,40,18,750,790
"Bolivia","Cochabamba","Mizque","Mizque","NUCLEO JOSÉ CLAURE (UNIDAD EDUCATIVA SAN VICENTE)",232720,61,3,353,414,23,8,319,342
"Bolivia","Cochabamba","Mizque","Mizque","SEDE CENTRAL CAMPESINA (KURI)",232721,21,6,295,316,30,14,245,275
"Bolivia","Cochabamba","Mizque","Mizque","SEDE SINDICAL DE CHAHUARANI CHICO",232722,7,8,211,218,13,10,180,193
"Bolivia","Cochabamba","Mizque","Mizque","SEDE SOCIAL DE TIPA TIPA",232723,69,28,479,548,114,16,321,435
"Bolivia","Cochabamba","Mizque","Mizque","UNIDAD EDUCATIVA CAUTA",232724,24,3,175,199,21,9,142,163
"Bolivia","Cochabamba","Mizque","Mizque","UNIDAD EDUCATIVA MOLINERO",232725,56,9,299,355,17,14,259,276
"Bolivia","Cochabamba","Mizque","Mizque","UNIDAD EDUCATIVA SANTIAGO",232726,20,8,313,333,14,10,281,295
"Bolivia","Cochabamba","Mizque","Mizque","UNIDAD EDUCATIVA THAGO THAGO",232727,35,14,447,482,69,27,337,406
"Bolivia","Cochabamba","Mizque","Mizque","UNIDAD EDUCATIVA TIN TIN",232728,114,18,699,813,135,23,523,658
"Bolivia","Cochabamba","Mizque","Mizque","UNIDAD EDUCATIVA UCHHAMA ALTA",232729,9,0,139,148,5,1,133,138
"Bolivia","Cochabamba","Mizque","Vila Vila","ESCUELA HUMBERTO NOGALES",232730,123,16,674,797,51,11,596,647
"Bolivia","Cochabamba","Mizque","Vila Vila","NUCLEO ESCOLAR SIQUIMIRA",232731,37,3,386,423,12,4,367,379
"Bolivia","Cochabamba","Mizque","Vila Vila","NUCLEO ESCOLAR SIVINGANI",232732,60,15,290,350,37,17,221,258
"Bolivia","Cochabamba","Mizque","Vila Vila","UNIDAD EDUCATIVA POCOTAICA",232733,10,1,71,81,4,2,64,68
"Bolivia","Cochabamba","Punata","Punata","ESCUELA ADELA ZAMUDIO",234200,855,54,4243,5098,1989,207,1993,3982
"Bolivia","Cochabamba","Punata","Punata","ESCUELA ANDRES MARIA TORRICO",234201,632,57,3452,4084,1480,160,1755,3235
"Bolivia","Cochabamba","Punata","Punata","LICEO JOSEFA M. GANDARILLAS (EX SUCRE)",234202,650,47,3300,3950,1624,155,1474,3098
"Bolivia","Cochabamba","Punata","Punata","SEDE SINDICAL THACO",234203,66,14,552,618,147,24,367,514
"Bolivia","Cochabamba","Punata","Punata","UNIDAD EDUCATIVA MANUEL A. VILLARROEL (EX BOLIVAR)",234204,640,39,3571,4211,1654,165,1713,3367
"Bolivia","Cochabamba","Punata","Punata","UNIDAD EDUCATIVA MAYOR ROCHA (YACANAHUYO",234207,96,25,771,867,308,36,402,710
"Bolivia","Cochabamba","Punata","Punata","UNIDAD EDUCATIVA MOLLE HUMA",234208,84,19,555,639,111,19,406,517
"Bolivia","Cochabamba","Punata","Punata","UNIDAD EDUCATIVA RENE BARRIENTOS O. - LA VILLA",234205,113,29,506,619,101,21,355,456
"Bolivia","Cochabamba","Punata","Punata","UNIDAD EDUCATIVA RUBEN FERRUFINO (CAMACHO RANCHO)",234206,126,18,747,873,222,38,469,691
"Bolivia","Cochabamba","Punata","Punata","UNIDAD EDUCATIVA TAJAMAR",234209,95,22,744,839,308,39,375,683
"Bolivia","Cochabamba","Punata","Punata","UNIDAD EDUCATIVA TAMBILLO CHICO",234210,59,8,387,446,108,24,247,355
"Bolivia","Cochabamba","Punata","Tacachi","UNIDAD EDUCATIVA TACACHI",234246,88,6,471,559,178,24,263,441
"Bolivia","Cochabamba","Punata","Villa Gualberto Villarroel (Cuchumuela)","ESCUELA CUCHU MUELA",234054,64,9,578,642,225,20,324,549
"Bolivia","Cochabamba","Punata","Villa Gualberto Villarroel (Cuchumuela)","NUCLEO ESCOLAR YANA RUMI",234055,36,8,256,292,26,7,215,241
"Bolivia","Cochabamba","Punata","Villa Quintin Mendoza (San Benito)","COLEGIO SIMON BOLIVAR (HUARICAYA)",233914,142,22,999,1141,294,24,659,953
"Bolivia","Cochabamba","Punata","Villa Quintin Mendoza (San Benito)","ESCUELA EXPERIMENTAL PARACAYA",233915,329,44,2533,2862,688,93,1708,2396
"Bolivia","Cochabamba","Punata","Villa Quintin Mendoza (San Benito)","UNIDAD EDUCATIVA 27 DE MAYO (EX JOSE B. PEREIRA)",233916,441,46,3114,3555,1004,98,1966,2970
"Bolivia","Cochabamba","Punata","Villa Quintin Mendoza (San Benito)","UNIDAD EDUCATIVA SUNCHU PAMPA",233917,150,20,801,951,210,28,543,753
"Bolivia","Cochabamba","Punata","Villa Quintin Mendoza (San Benito)","UNIDAD EDUCATIVA WAÑAKAHUA",233918,46,6,518,564,130,22,360,490
"Bolivia","Cochabamba","Punata","Villa Rivero","COLEGIO TEC IND COMUNITARIO MARCELO QUIROGA",234211,543,36,2422,2965,385,75,1926,2311
"Bolivia","Cochabamba","Punata","Villa Rivero","ESCUELA GUALBERTO VILLARROEL (V. RIVERO)",234212,393,42,1776,2169,719,86,929,1648
"Bolivia","Cochabamba","Punata","Villa Rivero","UNIDAD EDUCATIVA MARTÍN CÁRDENAS HERMOSO",234213,37,5,258,295,35,6,212,247
"Bolivia","Cochabamba","Quillacollo","Colcapirhua","COLEGIO MAX FERNANDEZ",233836,720,28,5274,5994,2955,156,2135,5090
"Bolivia","Cochabamba","Quillacollo","Colcapirhua","ESCUELA JESUS LARA",233837,575,25,4805,5380,2928,110,1742,4670
"Bolivia","Cochabamba","Quillacollo","Colcapirhua","INSTITUTO MARÍA CRISTINA",233838,263,6,1638,1901,968,40,624,1592
"Bolivia","Cochabamba","Quillacollo","Colcapirhua","SEDE SOCIAL CALLAJ CHULLPA (COLCAPIRHUA)",233839,57,8,449,506,213,22,206,419
"Bolivia","Cochabamba","Quillacollo","Colcapirhua","SEDE SOCIAL DE LA OTB MARTIN CARDENAS (EX COMPLEJO EL CARMEN)",233840,36,3,223,259,118,5,97,215
"Bolivia","Cochabamba","Quillacollo","Colcapirhua","UNIDAD EDUCATIVA DANIEL SALAMANCA",233842,843,58,6585,7428,3511,198,2818,6329
"Bolivia","Cochabamba","Quillacollo","Colcapirhua","UNIDAD EDUCATIVA EL SAUSALITO",233843,645,28,5005,5650,2809,167,2001,4810
"Bolivia","Cochabamba","Quillacollo","Colcapirhua","UNIDAD EDUCATIVA LA SAGRADA FAMILIA",233844,120,14,1624,1744,904,36,670,1574
"Bolivia","Cochabamba","Quillacollo","Colcapirhua","UNIDAD EDUCATIVA PROF. BENEDICTO DURÁN ORTÍZ",233841,85,1,708,793,385,23,299,684
"Bolivia","Cochabamba","Quillacollo","Colcapirhua","UNIDAD EDUCATIVA SAN JOSÉ DE KAMI",233845,574,43,4339,4913,1944,168,2184,4128
"Bolivia","Cochabamba","Quillacollo","Colcapirhua","UNIDAD EDUCATIVA SAN LORENZO",233846,71,6,718,789,373,15,324,697
"Bolivia","Cochabamba","Quillacollo","Colcapirhua","UNIDAD EDUCATIVA SIMON BOLIVAR (SUMUNPAYA)",233847,15,2,144,159,48,7,87,135
"Bolivia","Cochabamba","Quillacollo","Quillacollo","CENTRO INTEGRAL NIÑO JESUS FE Y ALEGRIA",232329,128,10,1113,1241,581,32,490,1071
"Bolivia","Cochabamba","Quillacollo","Quillacollo","CENTRO INTERNADO MISICUNI",232330,21,7,289,310,76,12,194,270
"Bolivia","Cochabamba","Quillacollo","Quillacollo","COLEGIO CRISTINA PRADA",232331,299,8,2508,2807,1593,68,839,2432
"Bolivia","Cochabamba","Quillacollo","Quillacollo","COLEGIO FRANZ TAMAYO",232332,700,32,5075,5775,3034,106,1903,4937
"Bolivia","Cochabamba","Quillacollo","Quillacollo","COLEGIO NACIONAL CALAMA (NUEVA INFRAESTRUCTURA)",232333,23,2,105,128,51,3,49,100
"Bolivia","Cochabamba","Quillacollo","Quillacollo","ESCUELA 12 DE SEPTIEMBRE",232334,676,43,4621,5297,2097,118,2363,4460
"Bolivia","Cochabamba","Quillacollo","Quillacollo","ESCUELA ARTURO QUITÓN",232335,446,34,3281,3727,1260,115,1872,3132
"Bolivia","Cochabamba","Quillacollo","Quillacollo","ESCUELA FELIX MARTINEZ",232336,1055,244,9354,10409,4711,319,4080,8791
"Bolivia","Cochabamba","Quillacollo","Quillacollo","ESCUELA FIDELIA C. DE SANCHEZ",232337,212,10,2271,2483,1508,45,708,2216
"Bolivia","Cochabamba","Quillacollo","Quillacollo","ESCUELA SIMÓN BOLIVAR",232338,498,23,3673,4171,2084,107,1459,3543
"Bolivia","Cochabamba","Quillacollo","Quillacollo","ESCUELA TOMAS BATA",232339,423,33,3703,4126,2039,113,1518,3557
"Bolivia","Cochabamba","Quillacollo","Quillacollo","INSTITUTO PARTICULAR QUILLACOLLO",232340,410,21,3415,3825,2173,94,1127,3300
"Bolivia","Cochabamba","Quillacollo","Quillacollo","INSTITUTO TECNOLOGICO EL PASO",232341,110,12,999,1109,376,28,583,959
"Bolivia","Cochabamba","Quillacollo","Quillacollo","KINDER MARISCAL JOSE BALLIVIAN",232342,523,27,2359,2882,1182,62,1088,2270
"Bolivia","Cochabamba","Quillacollo","Quillacollo","LICEO AMÉRICA",232343,617,25,4759,5376,3114,116,1504,4618
"Bolivia","Cochabamba","Quillacollo","Quillacollo","NORMAL SIMÓN RODRÍGUEZ (EX NUCLEO ESCOLAR PAUCARPATA)",232344,388,19,2532,2920,1087,96,1330,2417
"Bolivia","Cochabamba","Quillacollo","Quillacollo","PENAL SAN PABLO",232328,34,1,107,141,40,1,65,105
"Bolivia","Cochabamba","Quillacollo","Quillacollo","TEOFILO VARGAS CANDIA B",232345,493,23,4126,4619,2284,116,1703,3987
"Bolivia","Cochabamba","Quillacollo","Quillacollo","UNIDAD EDUCATIVA BELLA VISTA",232349,636,70,3889,4525,1131,194,2494,3625
"Bolivia","Cochabamba","Quillacollo","Quillacollo","UNIDAD EDUCATIVA EL PASO",232350,973,78,6333,7306,2231,217,3807,6038
"Bolivia","Cochabamba","Quillacollo","Quillacollo","UNIDAD EDUCATIVA FLORA SALINAS HINOJOSA - AMALIA ECHALAR DE",232351,0,0,16,16,10,0,6,16
"Bolivia","Cochabamba","Quillacollo","Quillacollo","UNIDAD EDUCATIVA HEROINAS",232352,334,18,2434,2768,1302,77,1037,2339
"Bolivia","Cochabamba","Quillacollo","Quillacollo","UNIDAD EDUCATIVA IRONCOLLO",232353,552,61,4171,4723,1610,151,2349,3959
"Bolivia","Cochabamba","Quillacollo","Quillacollo","UNIDAD EDUCATIVA JOSE MIGUEL LANZA (ILLATACO)",232346,149,17,1435,1584,441,45,932,1373
"Bolivia","Cochabamba","Quillacollo","Quillacollo","UNIDAD EDUCATIVA LIRIUNI",232354,10,3,188,198,29,9,147,176
"Bolivia","Cochabamba","Quillacollo","Quillacollo","UNIDAD EDUCATIVA MARIA AUXILIADORA",232355,77,11,760,837,304,36,409,713
"Bolivia","Cochabamba","Quillacollo","Quillacollo","UNIDAD EDUCATIVA MARQUINA",232356,365,39,2802,3167,907,135,1721,2628
"Bolivia","Cochabamba","Quillacollo","Quillacollo","UNIDAD EDUCATIVA MARTIN CARDENAS",232357,153,9,1253,1406,565,63,616,1181
"Bolivia","Cochabamba","Quillacollo","Quillacollo","UNIDAD EDUCATIVA MILIVOY ETEROVIC MATENDA",232347,272,13,1861,2133,1012,47,789,1801
"Bolivia","Cochabamba","Quillacollo","Quillacollo","UNIDAD EDUCATIVA NESTOR ADRIAZOLA (EX COLEGIO NACIONAL CALAMA)",232358,948,52,6841,7789,3587,252,2950,6537
"Bolivia","Cochabamba","Quillacollo","Quillacollo","UNIDAD EDUCATIVA RENE BARRIENOS ORTUÑO (MISICUNI)",232348,45,14,504,549,141,30,319,460
"Bolivia","Cochabamba","Quillacollo","Quillacollo","UNIDAD EDUCATIVA VILLA DE URKUPIÑA",232359,302,28,2780,3082,795,88,1869,2664
"Bolivia","Cochabamba","Quillacollo","Quillacollo","UNIDAD EDUCATIVA VILLA MODERNA",232360,303,13,2050,2353,1045,43,949,1994
"Bolivia","Cochabamba","Quillacollo","Sipe Sipe","ESCUELA BOLVIANA AMERICANA",233494,293,40,2375,2668,635,90,1610,2245
"Bolivia","Cochabamba","Quillacollo","Sipe Sipe","ESCUELA RENE BARRIENTOS ORTUÑO (ITAPAYA)",233493,181,19,1139,1320,312,49,759,1071
"Bolivia","Cochabamba","Quillacollo","Sipe Sipe","ESCUELA SUCRE (SIPE SIPE)",233495,881,88,6828,7709,2186,297,4257,6443
"Bolivia","Cochabamba","Quillacollo","Sipe Sipe","UNIDAD EDUCATIVA 3 DE ABRIL",233496,112,16,1405,1517,447,54,888,1335
"Bolivia","Cochabamba","Quillacollo","Sipe Sipe","UNIDAD EDUCATIVA ANDRES UZEDA OCAMPO",233497,65,7,469,534,146,11,305,451
"Bolivia","Cochabamba","Quillacollo","Sipe Sipe","UNIDAD EDUCATIVA CARAMARCA COLLPA",233498,68,28,586,654,176,21,361,537
"Bolivia","Cochabamba","Quillacollo","Sipe Sipe","UNIDAD EDUCATIVA CAVILOMA",233499,22,15,549,571,158,27,349,507
"Bolivia","Cochabamba","Quillacollo","Sipe Sipe","UNIDAD EDUCATIVA EDUARDO ABAROA",233500,394,75,2474,2868,645,111,1643,2288
"Bolivia","Cochabamba","Quillacollo","Sipe Sipe","UNIDAD EDUCATIVA SAUCE RANCHO",233501,735,72,4872,5607,1711,205,2884,4595
"Bolivia","Cochabamba","Quillacollo","Sipe Sipe","UNIDAD EDUCATIVA SUTICOLLO",233502,417,25,2313,2730,1040,95,1153,2193
"Bolivia","Cochabamba","Quillacollo","Sipe Sipe","UNIDAD EDUCATIVA TORIBIO CLAURE",233503,12,4,353,365,36,9,304,340
"Bolivia","Cochabamba","Quillacollo","Sipe Sipe","UNIDAD EDUCATIVA UCHU UCHU",233504,14,0,440,454,4,21,415,419
"Bolivia","Cochabamba","Quillacollo","Sipe Sipe","UNIDAD EDUCATIVA VILOMA",233505,225,26,1574,1799,283,54,1211,1494
"Bolivia","Cochabamba","Quillacollo","Tiquipaya","ALDEAS S.O.S",233506,340,19,2682,3022,1473,101,1089,2562
"Bolivia","Cochabamba","Quillacollo","Tiquipaya","COLEGIO CRISTO NACIÓN (UNIDAD EDUCATIVA BOLIVIA JAPÓN)",233507,21,0,94,115,71,0,23,94
"Bolivia","Cochabamba","Quillacollo","Tiquipaya","COLEGIO SAN MIGUEL (TIQUIPAYA)",233508,688,45,4701,5389,2299,146,2211,4510
"Bolivia","Cochabamba","Quillacollo","Tiquipaya","COLEGIO SIMON BOLIVAR (TIQUIPAYA)",233509,844,65,5884,6728,2635,209,2975,5610
"Bolivia","Cochabamba","Quillacollo","Tiquipaya","ESCUELA EUGENIA RAVASCO",233510,152,16,1392,1544,776,26,574,1350
"Bolivia","Cochabamba","Quillacollo","Tiquipaya","ESCUELA ISAAC ATTIE",233511,236,12,2034,2270,1278,47,697,1975
"Bolivia","Cochabamba","Quillacollo","Tiquipaya","ESCUELA SECCIONAL WARIPUCARA",233512,16,0,101,117,4,2,95,99
"Bolivia","Cochabamba","Quillacollo","Tiquipaya","ESCUELA TORIBIO CLAURE",233513,847,55,6649,7496,3403,202,2989,6392
"Bolivia","Cochabamba","Quillacollo","Tiquipaya","NUCLEO EDUCATIVO CHAPISIRCA",233514,111,24,1001,1112,93,31,853,946
"Bolivia","Cochabamba","Quillacollo","Tiquipaya","UNIDAD EDUCATIVA CUATRO ESQUINAS",233515,144,13,1279,1423,669,39,558,1227
"Bolivia","Cochabamba","Quillacollo","Tiquipaya","UNIDAD EDUCATIVA JESUS MAESTRO",233516,68,14,988,1056,412,35,527,939
"Bolivia","Cochabamba","Quillacollo","Tiquipaya","UNIDAD EDUCATIVA LIBERTAD",233517,615,33,4959,5574,2443,159,2324,4767
"Bolivia","Cochabamba","Quillacollo","Tiquipaya","UNIDAD EDUCATIVA MONTECILLO",233518,22,1,240,262,8,4,227,235
"Bolivia","Cochabamba","Quillacollo","Tiquipaya","UNIDAD EDUCATIVA NUESTRA SRA. DE ALTAGRACIA",233519,47,5,335,382,156,15,159,315
"Bolivia","Cochabamba","Quillacollo","Vinto","ESCUELA ISMAEL MONTES",233520,394,34,2914,3308,1177,162,1541,2718
"Bolivia","Cochabamba","Quillacollo","Vinto","ESCUELA MARTÍN CARDENAS",233521,924,66,6104,7028,2607,210,3221,5828
"Bolivia","Cochabamba","Quillacollo","Vinto","ESCUELA MELCHOR CUADROS",233522,1244,76,9163,10407,4501,378,4208,8709
"Bolivia","Cochabamba","Quillacollo","Vinto","NUCLEO ESCOLAR SIMON BOLIVAR (THIOMOKO)",233523,86,21,839,925,136,44,638,774
"Bolivia","Cochabamba","Quillacollo","Vinto","UNIDAD EDUCATIVA ANOCARAIRE",233524,411,55,3719,4130,1396,154,2114,3510
"Bolivia","Cochabamba","Quillacollo","Vinto","UNIDAD EDUCATIVA DAVID ARZABE",233525,95,14,968,1063,359,45,550,909
"Bolivia","Cochabamba","Quillacollo","Vinto","UNIDAD EDUCATIVA KERAYA",233526,30,3,286,316,13,5,265,278
"Bolivia","Cochabamba","Quillacollo","Vinto","UNIDAD EDUCATIVA REINO UNIDO",233527,495,77,4437,4932,1328,227,2805,4133
"Bolivia","Cochabamba","Quillacollo","Vinto","UNIDAD EDUCATIVA SAGRADA FAMILIA",233528,318,28,1980,2298,892,91,969,1861
"Bolivia","Cochabamba","Tapacarí","Tapacari","ESCUELA CHALLA GRANDE",233879,43,17,344,387,107,30,190,297
"Bolivia","Cochabamba","Tapacarí","Tapacari","ESCUELA CHUÑU CHUÑINI",233880,7,2,420,427,28,6,384,412
"Bolivia","Cochabamba","Tapacarí","Tapacari","ESCUELA MONSEÑOR ANGEL GELMI",233881,80,12,464,544,17,13,422,439
"Bolivia","Cochabamba","Tapacarí","Tapacari","NUCLEO ESCOLAR CHARAPAYA",233882,41,1,233,274,8,4,220,228
"Bolivia","Cochabamba","Tapacarí","Tapacari","NUCLEO ESCOLAR CONFITAL",233883,43,10,397,440,37,20,330,367
"Bolivia","Cochabamba","Tapacarí","Tapacari","UNIDAD EDUCATIVA APHARUMIRI",233888,17,0,184,201,0,9,175,175
"Bolivia","Cochabamba","Tapacarí","Tapacari","UNIDAD EDUCATIVA ARASAYA",233884,2,2,152,154,3,3,144,147
"Bolivia","Cochabamba","Tapacarí","Tapacari","UNIDAD EDUCATIVA CALLIRI",233889,5,0,53,58,0,1,52,52
"Bolivia","Cochabamba","Tapacarí","Tapacari","UNIDAD EDUCATIVA CALUYO",233887,69,12,554,623,46,25,471,517
"Bolivia","Cochabamba","Tapacarí","Tapacari","UNIDAD EDUCATIVA CENTRAL VILLA PEREIRA",233890,80,20,532,612,43,24,445,488
"Bolivia","Cochabamba","Tapacarí","Tapacari","UNIDAD EDUCATIVA CHILLCA GRANDE",233885,1,1,170,171,7,1,161,168
"Bolivia","Cochabamba","Tapacarí","Tapacari","UNIDAD EDUCATIVA CHULLPA K'ASA",233891,23,0,184,207,13,6,165,178
"Bolivia","Cochabamba","Tapacarí","Tapacari","UNIDAD EDUCATIVA JAPO K'ASA",233892,84,9,749,833,60,24,656,716
"Bolivia","Cochabamba","Tapacarí","Tapacari","UNIDAD EDUCATIVA KATARIRI",233893,27,9,423,450,24,12,378,402
"Bolivia","Cochabamba","Tapacarí","Tapacari","UNIDAD EDUCATIVA KJARKAS",233894,33,11,356,389,46,23,276,322
"Bolivia","Cochabamba","Tapacarí","Tapacari","UNIDAD EDUCATIVA LACOLACONI",233886,3,5,273,276,21,15,232,253
"Bolivia","Cochabamba","Tapacarí","Tapacari","UNIDAD EDUCATIVA LLAVINI",233895,20,1,327,347,47,11,268,315
"Bolivia","Cochabamba","Tapacarí","Tapacari","UNIDAD EDUCATIVA NORBERTO JIMENEZ",233896,119,17,391,510,42,23,309,351
"Bolivia","Cochabamba","Tapacarí","Tapacari","UNIDAD EDUCATIVA RAMADAS",233897,114,7,741,855,85,24,625,710
"Bolivia","Cochabamba","Tapacarí","Tapacari","UNIDAD EDUCATIVA SAN ANTONIO",233898,33,2,258,291,30,5,221,251
"Bolivia","Cochabamba","Tapacarí","Tapacari","UNIDAD EDUCATIVA SUCRE",233899,226,18,1465,1691,36,127,1284,1320
"Bolivia","Cochabamba","Tapacarí","Tapacari","UNIDAD EDUCATIVA TUNAS VINTO-APHARUMIRI",233900,75,6,514,589,10,25,473,483
"Bolivia","Cochabamba","Tapacarí","Tapacari","UNIDAD EDUCATIVA WACA PLAYA",233901,149,22,864,1013,55,23,764,819
"Bolivia","Cochabamba","Tiraque","Shinahota","ESCUELA GERMAN BUSCH",234499,1092,99,6453,7545,1798,231,4325,6123
"Bolivia","Cochabamba","Tiraque","Shinahota","UNIDAD EDUCATIVA 4 DE ABRIL",234504,15,1,326,341,16,8,301,317
"Bolivia","Cochabamba","Tiraque","Shinahota","UNIDAD EDUCATIVA CHURO GRANDE",234505,12,1,222,234,11,4,206,217
"Bolivia","Cochabamba","Tiraque","Shinahota","UNIDAD EDUCATIVA DEMETRIO CANELAS",234500,10,3,249,259,23,3,220,243
"Bolivia","Cochabamba","Tiraque","Shinahota","UNIDAD EDUCATIVA IBUELO",234506,400,29,1247,1647,203,24,991,1194
"Bolivia","Cochabamba","Tiraque","Shinahota","UNIDAD EDUCATIVA IVIRIZU VANDIOLA",234507,61,9,388,449,55,11,313,368
"Bolivia","Cochabamba","Tiraque","Shinahota","UNIDAD EDUCATIVA MAJO PAMPA A",234508,14,2,281,295,11,2,266,277
"Bolivia","Cochabamba","Tiraque","Shinahota","UNIDAD EDUCATIVA MARCELO QUIROGA SANTA CRUZ",234501,62,9,707,769,91,24,583,674
"Bolivia","Cochabamba","Tiraque","Shinahota","UNIDAD EDUCATIVA MARISCAL SUCRE",234502,18,5,195,213,24,9,157,181
"Bolivia","Cochabamba","Tiraque","Shinahota","UNIDAD EDUCATIVA PUERTO AROMA",234509,5,1,72,77,12,1,58,70
"Bolivia","Cochabamba","Tiraque","Shinahota","UNIDAD EDUCATIVA SAN ISIDRO",234510,29,11,826,855,42,10,763,805
"Bolivia","Cochabamba","Tiraque","Shinahota","UNIDAD EDUCATIVA SAN LUIS",234503,19,4,475,494,29,5,437,466
"Bolivia","Cochabamba","Tiraque","Tiraque","COLEGIO JUAN JOSE CARRASCO",234490,833,150,5741,6574,1161,271,4159,5320
"Bolivia","Cochabamba","Tiraque","Tiraque","ESCUELA COTANI BAJO",234491,64,13,802,866,119,80,590,709
"Bolivia","Cochabamba","Tiraque","Tiraque","ESCUELA KOARI (NUCLEO ESCOLAR S. BOLIVAR)",234492,174,19,1153,1327,119,62,953,1072
"Bolivia","Cochabamba","Tiraque","Tiraque","ESCUELA SECCIONAL PAIRUMANI",234493,87,9,709,796,69,20,611,680
"Bolivia","Cochabamba","Tiraque","Tiraque","ESCUELA SECCIONAL SACABAMBILLA",234494,40,7,367,407,54,25,281,335
"Bolivia","Cochabamba","Tiraque","Tiraque","NUCLEO ESCOLAR ILURI GRANDE",234495,0,16,662,662,80,40,526,606
"Bolivia","Cochabamba","Tiraque","Tiraque","UNIDAD EDUCATIVA 3 DE AGOSTO",234496,24,4,344,368,38,19,283,321
"Bolivia","Cochabamba","Tiraque","Tiraque","UNIDAD EDUCATIVA PALCA T",234497,14,4,125,139,29,4,88,117
"Bolivia","Cochabamba","Tiraque","Tiraque","UNIDAD EDUCATIVA RODEO",234498,26,17,307,333,40,21,229,269
"Bolivia","La Paz","Abel Iturralde","Ixiamas","ESCUELA ESPERANZA DEL MADIDI",234575,46,4,130,176,58,0,68,126
"Bolivia","La Paz","Abel Iturralde","Ixiamas","ESCUELA GERMAN BUSCH",234576,695,27,2273,2968,993,78,1175,2168
"Bolivia","La Paz","Abel Iturralde","Ixiamas","ESCUELA NUEVA IDIAMAS",234577,7,0,10,17,2,0,8,10
"Bolivia","La Paz","Abel Iturralde","Ixiamas","ESCUELA PUERTO ARAONA",234578,34,0,14,48,1,0,13,14
"Bolivia","La Paz","Abel Iturralde","Ixiamas","ESCUELA PUERTO PEREZ",234579,85,0,134,219,111,2,21,132
"Bolivia","La Paz","Abel Iturralde","Ixiamas","ESCUELA TOMAS CATARI",234580,16,1,110,126,11,1,97,108
"Bolivia","La Paz","Abel Iturralde","Ixiamas","ESCUELA UNIDAD EDUCATIVA DE TAHUA",234582,19,0,107,126,50,1,56,106
"Bolivia","La Paz","Abel Iturralde","Ixiamas","ESCUELA VILLA FATIMA",234581,4,0,25,29,16,0,9,25
"Bolivia","La Paz","Abel Iturralde","Ixiamas","SEDE DEL CARMEN DEL EMERO",234583,10,0,65,75,61,0,4,65
"Bolivia","La Paz","Abel Iturralde","Ixiamas","UNIDAD EDUCATIVA 10 DE ABRIL",234585,3,2,72,75,39,2,29,68
"Bolivia","La Paz","Abel Iturralde","Ixiamas","UNIDAD EDUCATIVA EL TIGRE",234586,23,0,53,76,31,1,21,52
"Bolivia","La Paz","Abel Iturralde","Ixiamas","UNIDAD EDUCATIVA MANURIMI",234584,67,2,107,174,41,0,64,105
"Bolivia","La Paz","Abel Iturralde","San Buenaventura","COLEGIO TUMUPASA B",234587,157,13,986,1143,414,22,537,951
"Bolivia","La Paz","Abel Iturralde","San Buenaventura","ESCUELA CHAUPY YACHAY HUASI",234588,30,2,120,150,67,5,46,113
"Bolivia","La Paz","Abel Iturralde","San Buenaventura","ESCUELA JOSE MANUEL PANDO",234589,580,38,2262,2842,941,71,1212,2153
"Bolivia","La Paz","Abel Iturralde","San Buenaventura","UNIDAD EDUCATIVA CENTRAL BUENA VISTA",234590,32,4,157,189,52,3,98,150
"Bolivia","La Paz","Abel Iturralde","San Buenaventura","UNIDAD EDUCATIVA SAN MIGUEL",234591,10,1,88,98,32,1,54,86
"Bolivia","La Paz","Aroma","Ayo Ayo","CASA DE GOBIERNO",233449,5,4,115,120,17,3,91,108
"Bolivia","La Paz","Aroma","Ayo Ayo","COLEGIO AYO AYO",233450,163,30,1714,1877,426,62,1196,1622
"Bolivia","La Paz","Aroma","Ayo Ayo","COLEGIO JOSÉ BALLIVIÁN",233451,11,0,141,152,40,8,93,133
"Bolivia","La Paz","Aroma","Ayo Ayo","ESCUELA CALACACHI",233452,45,10,492,537,194,13,275,469
"Bolivia","La Paz","Aroma","Ayo Ayo","ESCUELA FRANZ TAMAYO",233453,73,15,789,862,230,22,522,752
"Bolivia","La Paz","Aroma","Ayo Ayo","ESCUELA STA. ROSA DE LIMA",233454,46,6,282,328,75,7,194,269
"Bolivia","La Paz","Aroma","Calamarca","CASA DE GOBIERNO",233824,80,6,1022,1102,295,65,656,951
"Bolivia","La Paz","Aroma","Calamarca","CASA DE GOBIERNO",233825,80,6,1022,1102,295,65,656,951
"Bolivia","La Paz","Aroma","Calamarca","ESCUELA CENTRAL CHORITOTORA",233826,47,18,404,451,52,18,316,368
"Bolivia","La Paz","Aroma","Calamarca","ESCUELA EDUARDO AVAROA",233827,63,6,540,603,122,14,398,520
"Bolivia","La Paz","Aroma","Calamarca","PLAZA 14 DE SEPTIEMBRE",233828,131,25,1422,1553,612,49,736,1348
"Bolivia","La Paz","Aroma","Calamarca","PLAZA 16 DE JULIO",233829,43,5,470,513,120,30,315,435
"Bolivia","La Paz","Aroma","Calamarca","PLAZA 6 DE AGOSTO",233830,70,22,1143,1213,325,50,746,1071
"Bolivia","La Paz","Aroma","Calamarca","PLAZA PRINCIPAL",233831,49,9,497,546,150,22,316,466
"Bolivia","La Paz","Aroma","Calamarca","PLAZA TOTORANI",233832,71,4,406,477,107,11,284,391
"Bolivia","La Paz","Aroma","Calamarca","UNIDAD EDUCATIVA FRANZ TAMAYO",233834,19,6,361,380,68,11,276,344
"Bolivia","La Paz","Aroma","Calamarca","UNIDAD EDUCATIVA JUAN JOSÉ TORREZ",233833,32,16,439,471,109,20,294,403
"Bolivia","La Paz","Aroma","Calamarca","UNIDAD EDUCATIVA SUCANAVI",233835,5,3,139,144,46,6,84,130
"Bolivia","La Paz","Aroma","Collana","CASA SOCIAL",232534,9,0,188,197,31,4,153,184
"Bolivia","La Paz","Aroma","Collana","SEDE SOCIAL",232536,164,24,1652,1816,594,60,974,1568
"Bolivia","La Paz","Aroma","Collana","SEDE SOCIAL",232535,164,24,1652,1816,594,60,974,1568
"Bolivia","La Paz","Aroma","Colquencha","ESCUELA LADISLAO CABRERA",232530,80,13,743,823,172,32,526,698
"Bolivia","La Paz","Aroma","Colquencha","ESCUELA LITORAL",232531,14,0,184,198,40,5,139,179
"Bolivia","La Paz","Aroma","Colquencha","PLAZA 15 DE AGOSTO",232532,132,25,1862,1994,575,84,1178,1753
"Bolivia","La Paz","Aroma","Colquencha","SEDE SOCIAL",232533,61,20,907,968,286,24,577,863
"Bolivia","La Paz","Aroma","Patacamaya","CASA DE GOBIERNO",232513,27,2,300,327,48,8,242,290
"Bolivia","La Paz","Aroma","Patacamaya","COLEGIO 23 DE MARZO",232514,20,0,487,507,90,11,386,476
"Bolivia","La Paz","Aroma","Patacamaya","COLEGIO FRANZ TAMAYO",232515,53,16,546,599,109,17,404,513
"Bolivia","La Paz","Aroma","Patacamaya","ESCUELA COLCHANI",232520,3,15,432,435,85,21,311,396
"Bolivia","La Paz","Aroma","Patacamaya","ESCUELA ROBERTO PABON",232516,967,89,6002,6969,1989,171,3753,5742
"Bolivia","La Paz","Aroma","Patacamaya","ESCUELA SECCIONAL JATUQUIRA",232517,3,2,64,67,16,2,44,60
"Bolivia","La Paz","Aroma","Patacamaya","ESCUELA TAYPILLANGA",232518,20,5,395,415,78,9,303,381
"Bolivia","La Paz","Aroma","Patacamaya","NUCLEO EDUCATIVO BELEN IQUIACA",232521,23,4,333,356,66,9,254,320
"Bolivia","La Paz","Aroma","Patacamaya","PLAZA 16 DE JULIO",232522,28,3,398,426,80,12,303,383
"Bolivia","La Paz","Aroma","Patacamaya","SEDE MUNICIPAL",232523,2,0,138,140,42,2,94,136
"Bolivia","La Paz","Aroma","Patacamaya","SEDE SOCIAL",232525,43,11,434,477,94,15,314,408
"Bolivia","La Paz","Aroma","Patacamaya","SEDE SOCIAL",232524,43,11,434,477,94,15,314,408
"Bolivia","La Paz","Aroma","Patacamaya","UNIDAD EDUCATIVA GERMAN BUSCH",232526,40,5,484,524,210,11,258,468
"Bolivia","La Paz","Aroma","Patacamaya","UNIDAD EDUCATIVA MURUCHAPI",232528,7,0,49,56,7,1,41,48
"Bolivia","La Paz","Aroma","Patacamaya","UNIDAD EDUCATIVA VISCACHANI",232529,61,19,682,743,123,8,532,655
"Bolivia","La Paz","Aroma","Sica Sica","CASA DE GOBIERNO",232236,5,2,361,366,75,17,267,342
"Bolivia","La Paz","Aroma","Sica Sica","COLEGIO 6 DE JUNIO",232237,2,0,151,153,0,0,151,151
"Bolivia","La Paz","Aroma","Sica Sica","COLEGIO NAL. SICA SICA",232239,161,26,1285,1446,530,42,687,1217
"Bolivia","La Paz","Aroma","Sica Sica","COLEGIO TAWANTINSUYO",232238,11,2,371,382,79,8,282,361
"Bolivia","La Paz","Aroma","Sica Sica","COLEGIO TOMAS KATARI",232240,2,3,305,307,21,7,274,295
"Bolivia","La Paz","Aroma","Sica Sica","ESCUELA EDEN",232242,276,32,2399,2675,700,96,1571,2271
"Bolivia","La Paz","Aroma","Sica Sica","ESCUELA JOSE M. PANDO",232241,61,3,447,508,87,4,353,440
"Bolivia","La Paz","Aroma","Sica Sica","ESCUELA SIMON BOLIVAR",232243,50,7,522,572,90,18,407,497
"Bolivia","La Paz","Aroma","Sica Sica","PLAZA CANTON MACHACAMARCA",232244,49,8,427,476,116,22,281,397
"Bolivia","La Paz","Aroma","Sica Sica","PLAZA PRINCIPAL JARUMA",232245,100,2,640,740,125,16,497,622
"Bolivia","La Paz","Aroma","Sica Sica","PLAZA SAN FRANCISCO",232246,27,1,222,249,40,1,180,220
"Bolivia","La Paz","Aroma","Sica Sica","SEDE SOCIAL AYAMAYA",232247,10,2,253,263,69,4,178,247
"Bolivia","La Paz","Aroma","Sica Sica","UNIDAD EDUCATIVA BARTOLINA SISA A",232248,17,1,191,208,34,1,155,189
"Bolivia","La Paz","Aroma","Sica Sica","UNIDAD EDUCATIVA CHUACOLLO GRANDE",232249,7,3,161,168,12,1,145,157
"Bolivia","La Paz","Aroma","Sica Sica","UNIDAD EDUCATIVA CONANI",232250,169,35,1726,1895,480,64,1147,1627
"Bolivia","La Paz","Aroma","Sica Sica","UNIDAD EDUCATIVA PEDRO DOMINGO MURILLO",232251,17,13,662,679,163,17,469,632
"Bolivia","La Paz","Aroma","Umala","CASA DE GOBIERNO",233327,96,23,788,884,231,40,494,725
"Bolivia","La Paz","Aroma","Umala","CASA DE GOBIERNO",233326,96,23,788,884,231,40,494,725
"Bolivia","La Paz","Aroma","Umala","COLEGIO DE VENTILLA",233328,21,5,312,333,68,9,230,298
"Bolivia","La Paz","Aroma","Umala","COLEGIO NAL. MIXTO SAN JOSE",233329,28,3,337,365,89,13,232,321
"Bolivia","La Paz","Aroma","Umala","ESCUELA SAN MIGUEL DE COPANI",233330,32,8,248,280,45,14,181,226
"Bolivia","La Paz","Aroma","Umala","PLAZA 16 DE JULIO",233331,77,9,478,555,133,18,318,451
"Bolivia","La Paz","Aroma","Umala","PLAZA HUARI BELEN 6 DE AGOSTO",233332,69,2,428,497,79,6,341,420
"Bolivia","La Paz","Aroma","Umala","PLAZA VITUY VINTO",233333,23,1,231,254,70,4,156,226
"Bolivia","La Paz","Aroma","Umala","SEDE SOCIAL",233334,51,1,321,372,78,13,229,307
"Bolivia","La Paz","Aroma","Umala","UNIDAD EDUCATIVA KELLHUIRI",233335,8,5,200,208,32,7,156,188
"Bolivia","La Paz","Aroma","Umala","UNIDAD EDUCATIVA LLANGA BELEN",233336,35,4,238,273,89,8,137,226
"Bolivia","La Paz","Bautista Saavedra","Charazani","CALLINSANI",232252,22,8,153,175,21,4,120,141
"Bolivia","La Paz","Bautista Saavedra","Charazani","CASA DE GOBIERNO",232253,27,6,197,224,31,13,147,178
"Bolivia","La Paz","Bautista Saavedra","Charazani","ESCUELA ATIQUE",232254,7,3,64,71,7,1,53,60
"Bolivia","La Paz","Bautista Saavedra","Charazani","ESCUELA CENTRAL MOYAPAMPA",232255,22,2,132,154,28,11,91,119
"Bolivia","La Paz","Bautista Saavedra","Charazani","ESCUELA CHARAZANI",232256,116,31,590,706,130,41,388,518
"Bolivia","La Paz","Bautista Saavedra","Charazani","ESCUELA GENERAL RAMON GONZALES",232257,22,4,117,139,14,3,96,110
"Bolivia","La Paz","Bautista Saavedra","Charazani","ESCUELA PAUJE YUYO",232258,29,0,122,151,18,3,101,119
"Bolivia","La Paz","Bautista Saavedra","Charazani","ESCUELA SECCIONAL CHARI",232259,0,4,141,141,13,8,116,129
"Bolivia","La Paz","Bautista Saavedra","Charazani","ESCUELA SECCIONAL SIATHA",232260,16,2,105,121,18,4,81,99
"Bolivia","La Paz","Bautista Saavedra","Charazani","PLAZA 26 DE JULIO",232261,16,3,91,107,15,9,64,79
"Bolivia","La Paz","Bautista Saavedra","Charazani","PLAZA AMARKA",232262,44,3,228,272,51,8,166,217
"Bolivia","La Paz","Bautista Saavedra","Charazani","PLAZA PRINCIPAL AMARETE",232263,121,26,1016,1137,156,49,785,941
"Bolivia","La Paz","Bautista Saavedra","Charazani","SEDE SOCIAL",232264,88,14,476,564,59,18,385,444
"Bolivia","La Paz","Bautista Saavedra","Charazani","SEDE SOCIAL",232265,88,14,476,564,59,18,385,444
"Bolivia","La Paz","Bautista Saavedra","Charazani","UNIDAD EDUCATIVA APACHETA",232266,26,2,181,207,45,12,122,167
"Bolivia","La Paz","Bautista Saavedra","Charazani","UNIDAD EDUCATIVA KALLURHUAYA",232267,11,7,170,181,14,6,143,157
"Bolivia","La Paz","Bautista Saavedra","Curva","CASA DE GOBIERNO",234148,34,2,118,152,26,11,79,105
"Bolivia","La Paz","Bautista Saavedra","Curva","ESCUELA KAPNA",234149,9,1,43,52,5,5,32,37
"Bolivia","La Paz","Bautista Saavedra","Curva","NUCLEO ESCOLAR UPINUAYA",234150,18,4,86,104,13,2,67,80
"Bolivia","La Paz","Bautista Saavedra","Curva","RECINTO TAIPI CANUMA",234151,0,0,189,189,18,2,169,187
"Bolivia","La Paz","Bautista Saavedra","Curva","SEDE COMUNAL",234152,3,0,25,28,8,0,17,25
"Bolivia","La Paz","Bautista Saavedra","Curva","SEDE SOCIAL",234153,65,8,255,320,52,25,170,222
"Bolivia","La Paz","Bautista Saavedra","Curva","SEDE SOCIAL",234154,65,8,255,320,52,25,170,222
"Bolivia","La Paz","Bautista Saavedra","Curva","SEDE SOCIAL",234155,65,8,255,320,52,25,170,222
"Bolivia","La Paz","Camacho","Escoma","COLEGIO DON BOSCO",233154,317,67,2520,2837,603,141,1709,2312
"Bolivia","La Paz","Camacho","Escoma","PLAZA 26 DE OCTUBRE",233155,41,2,262,303,49,17,194,243
"Bolivia","La Paz","Camacho","Escoma","PLAZA PRINCIPAL",233156,21,5,271,292,94,16,156,250
"Bolivia","La Paz","Camacho","Escoma","PLAZA PRINCIPAL DE COLLASUYO",233157,1,2,121,122,30,0,89,119
"Bolivia","La Paz","Camacho","Humanata","COLEGIO SAN FRANCISCO DE PADUA",236315,246,62,1646,1892,381,165,1038,1419
"Bolivia","La Paz","Camacho","Humanata","COLEGIO SANTA ANA DE CUTUCUTU",236316,32,5,192,224,41,13,133,174
"Bolivia","La Paz","Camacho","Humanata","ESCUELA S. J. DE PACOLLO",236317,13,1,220,233,58,7,154,212
"Bolivia","La Paz","Camacho","Mocomoco","COLEGIO CARIQUINA CHICO",233384,21,3,133,154,24,9,97,121
"Bolivia","La Paz","Camacho","Mocomoco","COLEGIO SAN JOSE",233386,19,7,352,371,84,15,246,330
"Bolivia","La Paz","Camacho","Mocomoco","COLEGIO SAN LUIS WILA CALA",233387,92,15,573,665,100,28,430,530
"Bolivia","La Paz","Camacho","Mocomoco","COLEGIO TAJANI",233388,37,14,438,475,105,30,289,394
"Bolivia","La Paz","Camacho","Mocomoco","COLEGIO TECNICO YOCARGUAYA",233385,51,4,180,231,12,6,158,170
"Bolivia","La Paz","Camacho","Mocomoco","ESCUELA QUILLIMA",233389,14,0,363,377,73,14,276,349
"Bolivia","La Paz","Camacho","Mocomoco","ESCUELA SECCIONAL V. JACHATIRA",233390,0,1,65,65,18,1,45,63
"Bolivia","La Paz","Camacho","Mocomoco","ESCUELA TUNTUNANI",233391,24,3,102,126,18,2,79,97
"Bolivia","La Paz","Camacho","Mocomoco","ESCUELA UNIDAD EDUCATIVA PACAURES",233392,67,25,528,595,83,21,399,482
"Bolivia","La Paz","Camacho","Mocomoco","NUCLEO ESCOLAR PUMANA",233393,39,2,222,261,25,12,183,208
"Bolivia","La Paz","Camacho","Mocomoco","NÚCLEO ESCOLAR TAYPI AYCA",233394,5,2,169,174,10,3,154,164
"Bolivia","La Paz","Camacho","Mocomoco","PLAZA MOCO MOCO",233395,211,46,967,1178,262,78,581,843
"Bolivia","La Paz","Camacho","Mocomoco","PLAZA SANTIAGO DE ILAVE",233396,79,19,464,543,75,23,347,422
"Bolivia","La Paz","Camacho","Mocomoco","SEDE SOCIAL",233397,0,1,60,60,21,2,36,57
"Bolivia","La Paz","Camacho","Mocomoco","UNIDAD EDUCATIVA CAJCACHI",233398,12,2,149,161,34,13,100,134
"Bolivia","La Paz","Camacho","Mocomoco","UNIDAD EDUCATIVA ITALAQUE",233399,101,19,432,533,49,37,327,376
"Bolivia","La Paz","Camacho","Mocomoco","UNIDAD EDUCATIVA QUEÑI",233400,56,8,199,255,60,15,116,176
"Bolivia","La Paz","Camacho","Puerto Acosta","COLEGIO NACIONAL MIXTO CHIÑAYA",233455,89,24,447,536,102,29,292,394
"Bolivia","La Paz","Camacho","Puerto Acosta","COLEGIO NACIONAL SALLACUCHO",233456,36,9,328,364,51,21,247,298
"Bolivia","La Paz","Camacho","Puerto Acosta","COLEGIO NICOLAS ACOSTA",233457,222,42,1690,1912,581,86,981,1562
"Bolivia","La Paz","Camacho","Puerto Acosta","ESCUELA CENTRO BELEN",233462,19,6,232,251,68,10,148,216
"Bolivia","La Paz","Camacho","Puerto Acosta","ESCUELA CHACAHUARA",233463,9,0,53,62,14,7,32,46
"Bolivia","La Paz","Camacho","Puerto Acosta","ESCUELA COTA PATA",233458,16,10,211,227,46,12,143,189
"Bolivia","La Paz","Camacho","Puerto Acosta","ESCUELA JUPANI",233459,33,6,309,342,126,20,157,283
"Bolivia","La Paz","Camacho","Puerto Acosta","ESCUELA PUERTO BELEN",233460,17,4,361,378,78,1,278,356
"Bolivia","La Paz","Camacho","Puerto Acosta","ESCUELA SECCIONAL CANCANANI",233461,9,2,56,65,4,0,50,54
"Bolivia","La Paz","Camacho","Puerto Acosta","PLAZA PUERTO PARAJACHI",233464,42,6,700,742,236,10,448,684
"Bolivia","La Paz","Camacho","Puerto Acosta","UNIDAD EDUCATIVA CENTRO CALANGACHI",233466,28,2,165,193,52,0,111,163
"Bolivia","La Paz","Camacho","Puerto Acosta","UNIDAD EDUCATIVA ORURILLO",233467,9,2,144,153,58,8,76,134
"Bolivia","La Paz","Camacho","Puerto Acosta","UNIDAD EDUCATIVA PARAJACHI II",233465,12,0,147,159,41,6,100,141
"Bolivia","La Paz","Camacho","Puerto Carabuco","COLEGIO COTAÑANI",233401,16,3,131,147,24,2,102,126
"Bolivia","La Paz","Camacho","Puerto Carabuco","COLEGIO MARTIN CARDENAS",233402,215,25,1074,1289,355,64,630,985
"Bolivia","La Paz","Camacho","Puerto Carabuco","COLEGIO NACIONAL MIXTO CHUANI",233403,33,7,347,380,75,23,242,317
"Bolivia","La Paz","Camacho","Puerto Carabuco","COLEGIO PASARANI",233404,104,15,468,572,97,19,337,434
"Bolivia","La Paz","Camacho","Puerto Carabuco","ESCUELA HUILACUNCA",233407,62,19,296,358,53,13,211,264
"Bolivia","La Paz","Camacho","Puerto Carabuco","ESCUELA MCAL. SUCRE",233405,89,10,495,584,65,32,388,453
"Bolivia","La Paz","Camacho","Puerto Carabuco","ESCUELA S. M. DE YARICOA",233406,28,8,232,260,50,22,152,202
"Bolivia","La Paz","Camacho","Puerto Carabuco","PLAZA PRINCIPAL COPUSQUIA",233408,66,9,476,542,56,19,392,448
"Bolivia","La Paz","Camacho","Puerto Carabuco","PLAZA SISASANI",233409,53,7,351,404,75,17,252,327
"Bolivia","La Paz","Camacho","Puerto Carabuco","UNIDAD EDUCATIVA URSULA GOYZUETA",233410,216,37,1524,1740,381,83,1023,1404
"Bolivia","La Paz","Caranavi","Alto Beni","ESCUELA CASERIO NUEVE",236411,56,0,316,372,66,8,242,308
"Bolivia","La Paz","Caranavi","Alto Beni","ESCUELA C. BELLA VISTA",236409,67,6,483,550,130,30,317,447
"Bolivia","La Paz","Caranavi","Alto Beni","ESCUELA N. SARARIA",236410,90,4,481,571,114,35,328,442
"Bolivia","La Paz","Caranavi","Alto Beni","ESCUELA PIQUENDO",236412,95,6,638,733,128,28,476,604
"Bolivia","La Paz","Caranavi","Alto Beni","LOCAL AMAS DE CASA",236413,31,7,227,258,60,3,157,217
"Bolivia","La Paz","Caranavi","Alto Beni","NUCLEO ESCOLAR SAN ANTONIO",236414,167,13,929,1096,154,21,741,895
"Bolivia","La Paz","Caranavi","Alto Beni","SEDE SOCIAL",236416,107,14,577,684,138,15,410,548
"Bolivia","La Paz","Caranavi","Alto Beni","SEDE SOCIAL",236415,107,14,577,684,138,15,410,548
"Bolivia","La Paz","Caranavi","Alto Beni","UNIDAD EDUCATIVA PUENTE ALTO BENI",236417,13,5,146,159,24,4,113,137
"Bolivia","La Paz","Caranavi","Alto Beni","UNIDAD EDUCATIVA VILLA EL PORVENIR",236418,26,1,313,339,35,7,270,305
"Bolivia","La Paz","Caranavi","Alto Beni","UNIDAD EDUCATIVA VILLA LITORAL",236419,20,4,266,286,22,11,229,251
"Bolivia","La Paz","Caranavi","Caranavi","COLEGIO GUILLERMO MOLINA",236269,204,14,911,1115,133,27,737,870
"Bolivia","La Paz","Caranavi","Caranavi","COLEGIO JHON F. KENEDDY",236270,1199,55,4839,6038,1946,141,2697,4643
"Bolivia","La Paz","Caranavi","Caranavi","COLEGIO LOS ANDES",236271,59,7,519,578,86,6,420,506
"Bolivia","La Paz","Caranavi","Caranavi","COLEGIO MADRE MARIA FEDERICA",236272,728,47,3533,4261,1531,105,1850,3381
"Bolivia","La Paz","Caranavi","Caranavi","COLEGIO SAN LORENZO",236273,95,5,903,998,129,23,746,875
"Bolivia","La Paz","Caranavi","Caranavi","ESCUELA CARRASCO LA RESERVA",236274,199,20,1453,1652,153,38,1242,1395
"Bolivia","La Paz","Caranavi","Caranavi","ESCUELA C. DE CHOJNA",236275,14,1,259,273,55,4,199,254
"Bolivia","La Paz","Caranavi","Caranavi","ESCUELA CENTRAL VILLAMONTES",236284,44,2,262,306,34,4,222,256
"Bolivia","La Paz","Caranavi","Caranavi","ESCUELA F. INCAHUARA",236276,16,0,55,71,3,1,51,54
"Bolivia","La Paz","Caranavi","Caranavi","ESCUELA MSCAL. SANTA CRUZ",236277,69,9,397,466,35,7,346,381
"Bolivia","La Paz","Caranavi","Caranavi","ESCUELA N. CHORO",236278,23,2,133,156,36,4,91,127
"Bolivia","La Paz","Caranavi","Caranavi","ESCUELA P. DOMINGO MURILLO",236279,263,19,1631,1894,334,55,1223,1557
"Bolivia","La Paz","Caranavi","Caranavi","ESCUELA SAN PEDRO",236280,19,1,102,121,4,7,90,94
"Bolivia","La Paz","Caranavi","Caranavi","ESCUELA SECCIONAL SANTA ANA",236281,73,9,367,440,57,10,291,348
"Bolivia","La Paz","Caranavi","Caranavi","ESCUELA SIMON BOLIVAR",236282,162,19,770,932,136,33,582,718
"Bolivia","La Paz","Caranavi","Caranavi","ESCUELA SIMON BOLIVAR DE SANTA FE",236285,84,4,524,608,143,16,361,504
"Bolivia","La Paz","Caranavi","Caranavi","ESCUELA TUPAC KATARI",236283,84,8,484,568,66,13,397,463
"Bolivia","La Paz","Caranavi","Caranavi","ESCUELA UYUNENSE",236286,53,10,419,472,68,19,322,390
"Bolivia","La Paz","Caranavi","Caranavi","INSTITUTO AMERICANO",236287,19,0,69,88,31,2,36,67
"Bolivia","La Paz","Caranavi","Caranavi","SEDE SOCIAL",236288,170,6,1140,1310,137,75,922,1059
"Bolivia","La Paz","Caranavi","Caranavi","SEDE SOCIAL",236290,170,6,1140,1310,137,75,922,1059
"Bolivia","La Paz","Caranavi","Caranavi","SEDE SOCIAL",236289,170,6,1140,1310,137,75,922,1059
"Bolivia","La Paz","Caranavi","Caranavi","UNIDAD EDUCATIVA MANCHEGO",236294,15,1,163,178,60,2,100,160
"Bolivia","La Paz","Caranavi","Caranavi","UNIDAD EDUCATIVA NUEVA LLUSTA 2DA",236295,51,3,317,368,38,7,269,307
"Bolivia","La Paz","Caranavi","Caranavi","UNIDAD EDUCATIVA RENE ZENON PORTILLO CHAVARRIA",236291,34,1,279,313,66,7,205,271
"Bolivia","La Paz","Caranavi","Caranavi","UNIDAD EDUCATIVA SIMON BOLIVAR",236296,647,26,2798,3445,1060,84,1628,2688
"Bolivia","La Paz","Caranavi","Caranavi","UNIDAD EDUCATIVA SUAZO",236292,17,1,86,103,34,4,47,81
"Bolivia","La Paz","Caranavi","Caranavi","UNIDAD EDUCATIVA VENEZUELA",236293,22,1,87,109,24,3,59,83
"Bolivia","La Paz","Franz Tamayo","Apolo","ESCUELA CENTRAL ATEN",232780,44,8,245,289,139,17,81,220
"Bolivia","La Paz","Franz Tamayo","Apolo","ESCUELA CENTRAL INCA",232781,49,6,240,289,75,11,148,223
"Bolivia","La Paz","Franz Tamayo","Apolo","ESCUELA CORREO",232789,21,2,164,185,12,1,149,161
"Bolivia","La Paz","Franz Tamayo","Apolo","ESCUELA MACHUA",232782,25,7,162,187,56,13,86,142
"Bolivia","La Paz","Franz Tamayo","Apolo","ESCUELA MOJOS",232783,2,2,25,27,5,1,17,22
"Bolivia","La Paz","Franz Tamayo","Apolo","ESCUELA MUNAYPATA",232790,50,5,222,272,78,4,135,213
"Bolivia","La Paz","Franz Tamayo","Apolo","ESCUELA NAZARIO PARDO VALLE",232784,1132,137,4104,5236,2147,188,1632,3779
"Bolivia","La Paz","Franz Tamayo","Apolo","ESCUELA NAZARIO PARDO VALLE",232785,1132,137,4104,5236,2147,188,1632,3779
"Bolivia","La Paz","Franz Tamayo","Apolo","ESCUELA PATA SAN ANTONIO",232786,0,2,102,102,34,19,47,81
"Bolivia","La Paz","Franz Tamayo","Apolo","ESCUELA PUCHAHUI",232787,75,6,378,453,168,16,188,356
"Bolivia","La Paz","Franz Tamayo","Apolo","ESCUELA SANTA CATALINA",232788,99,15,363,462,130,23,195,325
"Bolivia","La Paz","Franz Tamayo","Apolo","UNIDADA EDUCATIVA TOREWA",232791,45,0,21,66,8,1,12,20
"Bolivia","La Paz","Franz Tamayo","Apolo","UNIDAD EDUCATIVA INDIGENA TOREWA",232792,15,0,18,33,3,1,14,17
"Bolivia","La Paz","Franz Tamayo","Pelechuco","ESCUELA AGUA BLANCA",234620,16,3,163,179,64,5,91,155
"Bolivia","La Paz","Franz Tamayo","Pelechuco","ESCUELA CANTON SUCHES",234616,38,3,173,211,78,7,85,163
"Bolivia","La Paz","Franz Tamayo","Pelechuco","ESCUELA COLEGIO FRANZ TAMAYO",234617,54,11,433,487,172,26,224,396
"Bolivia","La Paz","Franz Tamayo","Pelechuco","ESCUELA DE PUYO PUYO",234621,13,2,171,184,106,3,60,166
"Bolivia","La Paz","Franz Tamayo","Pelechuco","ESCUELA NAZARIO PARDO VALLE",234618,100,13,606,706,249,34,310,559
"Bolivia","La Paz","Franz Tamayo","Pelechuco","ESCUELA PUINA",234619,14,0,90,104,22,4,64,86
"Bolivia","La Paz","Franz Tamayo","Pelechuco","ESCUELA SAN MIGUEL DE THAPI",234622,19,0,103,122,63,4,36,99
"Bolivia","La Paz","Franz Tamayo","Pelechuco","ESCUELA SORAPATA",234623,19,2,110,129,53,9,46,99
"Bolivia","La Paz","Franz Tamayo","Pelechuco","IGLESIA COPACABANA DE ANTIQUILLA",234624,36,9,281,317,68,9,195,263
"Bolivia","La Paz","Franz Tamayo","Pelechuco","NUCLEO EDUCATIVO HICHOCOLLO",234625,12,2,220,232,70,14,134,204
"Bolivia","La Paz","Franz Tamayo","Pelechuco","SEDE DEL SINDICATO",234626,73,2,278,351,81,27,168,249
"Bolivia","La Paz","General Jose Manuel","Catacora","ESCUELA THOLA COLLO",234634,14,0,78,92,16,2,60,76
"Bolivia","La Paz","General Jose Manuel","Catacora","NUCLEO ESCOLAR CATACORA",234635,40,0,187,227,37,6,144,181
"Bolivia","La Paz","General Jose Manuel","Catacora","NUCLEO ESCOLAR PAIRUMANI GRANDE",234636,9,1,85,94,19,3,62,81
"Bolivia","La Paz","General Jose Manuel","Catacora","PLAZA 6 DE AGOSTO",234637,7,1,84,91,6,0,77,83
"Bolivia","La Paz","General Jose Manuel","Santiago De Machaca","COLEGIO BAUTISTA SAAVEDRA",232032,42,0,100,142,10,1,89,99
"Bolivia","La Paz","General Jose Manuel","Santiago De Machaca","COLEGIO PEDRO KRAMER",232033,14,0,49,63,13,1,35,48
"Bolivia","La Paz","General Jose Manuel","Santiago De Machaca","ESCUELA ATACUNI",232034,5,0,54,59,2,0,52,54
"Bolivia","La Paz","General Jose Manuel","Santiago De Machaca","ESCUELA CENTRAL HUARI PHUJO",232035,6,0,82,88,7,1,74,81
"Bolivia","La Paz","General Jose Manuel","Santiago De Machaca","ESCUELA SANTIAGO DE MACHACA",232036,244,25,1208,1452,220,32,931,1151
"Bolivia","La Paz","General Jose Manuel","Santiago De Machaca","PLAZA VILLA EXALTACION",232037,4,0,125,129,18,0,107,125
"Bolivia","La Paz","Gualberto Villarroel","Chacarilla","ESCUELA PUERTO AROMA",232029,8,3,204,212,42,6,153,195
"Bolivia","La Paz","Gualberto Villarroel","Chacarilla","PLAZA CHACARILLA",232030,53,1,279,332,47,10,221,268
"Bolivia","La Paz","Gualberto Villarroel","Chacarilla","PLAZA ROSAPATA",232031,25,2,262,287,43,8,209,252
"Bolivia","La Paz","Gualberto Villarroel","Papel Pampa","CASA DE GOBIERNO",232017,94,16,772,866,170,18,568,738
"Bolivia","La Paz","Gualberto Villarroel","Papel Pampa","CASA DE GOBIERNO",232018,94,16,772,866,170,18,568,738
"Bolivia","La Paz","Gualberto Villarroel","Papel Pampa","ESCUELA CIRCA CRUZANI",232020,2,0,65,67,7,1,57,64
"Bolivia","La Paz","Gualberto Villarroel","Papel Pampa","ESCUELA COLQUE AMAYA ALTA",232021,14,4,266,280,51,8,203,254
"Bolivia","La Paz","Gualberto Villarroel","Papel Pampa","ESCUELA TITUZA",232019,9,2,88,97,17,3,66,83
"Bolivia","La Paz","Gualberto Villarroel","Papel Pampa","PLAZA MOLLEBAMBA",232022,55,7,622,677,123,15,477,600
"Bolivia","La Paz","Gualberto Villarroel","Papel Pampa","PLAZA PRINCIPAL UNO PATA",232023,54,4,417,471,88,16,309,397
"Bolivia","La Paz","Gualberto Villarroel","Papel Pampa","PLAZA RIVERA ALTA",232024,15,2,271,286,98,8,163,261
"Bolivia","La Paz","Gualberto Villarroel","Papel Pampa","SEDE SINDICAL",232025,3,0,72,75,10,0,62,72
"Bolivia","La Paz","Gualberto Villarroel","Papel Pampa","SEDE SOCIAL CAYLLA CHURO",232026,4,0,50,54,8,0,42,50
"Bolivia","La Paz","Gualberto Villarroel","Papel Pampa","UNIDAD EDUCATIVA PACOLLO",232027,3,0,129,132,9,2,118,127
"Bolivia","La Paz","Gualberto Villarroel","Papel Pampa","UNIDAD EDUCATIVA SAN JOSE",232028,25,4,183,208,53,2,124,177
"Bolivia","La Paz","Gualberto Villarroel","San Pedro De Curahuara","CASA COMUNAL",232006,3,3,87,90,23,1,60,83
"Bolivia","La Paz","Gualberto Villarroel","San Pedro De Curahuara","CASA DE GOBIERNO",232007,75,4,516,591,52,16,444,496
"Bolivia","La Paz","Gualberto Villarroel","San Pedro De Curahuara","COLEGIO HERNANDO SILES",232008,79,6,530,609,52,21,451,503
"Bolivia","La Paz","Gualberto Villarroel","San Pedro De Curahuara","COLEGIO LUIS ESPINAL",232009,46,1,377,423,30,2,344,374
"Bolivia","La Paz","Gualberto Villarroel","San Pedro De Curahuara","COLEGIO WISCO KARI",232010,6,0,425,431,121,9,295,416
"Bolivia","La Paz","Gualberto Villarroel","San Pedro De Curahuara","ESCUELA CHILAGUALA",232011,10,0,89,99,9,2,78,87
"Bolivia","La Paz","Gualberto Villarroel","San Pedro De Curahuara","ESCUELA JUAN CANCIO COLQUE",232012,4,0,38,42,11,2,25,36
"Bolivia","La Paz","Gualberto Villarroel","San Pedro De Curahuara","PLAZA JANKO MARCA",232013,0,0,397,397,0,4,393,393
"Bolivia","La Paz","Gualberto Villarroel","San Pedro De Curahuara","PLAZA PEDRO DOMINGO MURILLO",232014,9,0,368,377,86,3,279,365
"Bolivia","La Paz","Gualberto Villarroel","San Pedro De Curahuara","PLAZA ROSARIO",232015,4,0,313,317,5,20,288,293
"Bolivia","La Paz","Gualberto Villarroel","San Pedro De Curahuara","SEDE SINDICAL",232016,0,2,88,88,5,3,78,83
"Bolivia","La Paz","Ingaví","Desaguadero","COLEGIO BATALLON COLORADOS",232776,310,26,2535,2845,1635,66,808,2443
"Bolivia","La Paz","Ingaví","Desaguadero","ESCUELA AZAFRANAL",232777,27,3,289,316,90,6,190,280
"Bolivia","La Paz","Ingaví","Desaguadero","ESCUELA MCAL. ANDRES DE SANTA CRUZ",232778,57,12,463,520,112,29,310,422
"Bolivia","La Paz","Ingaví","Desaguadero","UNIDAD EDUCATIVA SIMÓN BOLÍVAR",232779,19,5,143,162,54,11,73,127
"Bolivia","La Paz","Ingaví","Guaqui","COLEGIO DANIEL SANCHEZ BUSTAMANTE",232772,162,19,780,942,234,43,484,718
"Bolivia","La Paz","Ingaví","Guaqui","COLEGIO TOMAS KATARI",232773,165,47,1601,1766,335,59,1160,1495
"Bolivia","La Paz","Ingaví","Guaqui","ESCUELA ISMAEL MONTES",232774,223,17,873,1096,281,41,534,815
"Bolivia","La Paz","Ingaví","Guaqui","UNIDAD EDUCATIVA WILACOLLO",232775,17,4,168,185,38,9,117,155
"Bolivia","La Paz","Ingaví","Jesús De Machaka","COLEGIO CHAMA",236341,17,6,292,309,78,10,198,276
"Bolivia","La Paz","Ingaví","Jesús De Machaka","COLEGIO HOLANDA",236342,38,7,415,453,110,18,280,390
"Bolivia","La Paz","Ingaví","Jesús De Machaka","COLEGIO MEJILLONES",236343,16,6,304,320,81,7,210,291
"Bolivia","La Paz","Ingaví","Jesús De Machaka","COLEGIO REP. DE NORUEGA",236344,31,15,376,407,98,8,255,353
"Bolivia","La Paz","Ingaví","Jesús De Machaka","ESCUELA FRANZ TAMAYO",236345,0,2,107,107,22,3,80,102
"Bolivia","La Paz","Ingaví","Jesús De Machaka","ESCUELA GERMAN BUSCH",236349,22,4,334,356,62,9,259,321
"Bolivia","La Paz","Ingaví","Jesús De Machaka","ESCUELA NUCLEO CUIPA ESPANA DE MACHACA",236346,4,6,273,277,27,9,231,258
"Bolivia","La Paz","Ingaví","Jesús De Machaka","ESCUELA SAN FELIPE DE CORPA",236347,73,4,955,1028,135,36,780,915
"Bolivia","La Paz","Ingaví","Jesús De Machaka","ESCUELA SECC. KHONKHO",236348,21,2,140,161,30,4,104,134
"Bolivia","La Paz","Ingaví","Jesús De Machaka","PLAZA DEL PUEBLO",236350,29,4,331,360,61,6,260,321
"Bolivia","La Paz","Ingaví","Jesús De Machaka","PLAZA PRINCIPAL",236351,77,18,635,712,164,15,438,602
"Bolivia","La Paz","Ingaví","Jesús De Machaka","PLAZA VILLA ASUNCION DE MACHACA",236352,27,2,378,405,95,6,275,370
"Bolivia","La Paz","Ingaví","Jesús De Machaka","POSTA SANITARIA",236353,33,10,168,201,35,5,118,153
"Bolivia","La Paz","Ingaví","Jesús De Machaka","SEDE SOCIAL",236355,33,7,428,461,93,24,304,397
"Bolivia","La Paz","Ingaví","Jesús De Machaka","SEDE SOCIAL",236354,33,7,428,461,93,24,304,397
"Bolivia","La Paz","Ingaví","San Andres De Machaca","COLEGIO BOLIVIANO JAPONES",236330,46,3,171,217,17,3,148,165
"Bolivia","La Paz","Ingaví","San Andres De Machaca","COLEGIO TUPAK KATARI DE CONCHACOLLO",236331,10,1,257,267,59,5,192,251
"Bolivia","La Paz","Ingaví","San Andres De Machaca","COLEGIO VILLA PUSUMA ALTO MACHACA",236332,23,3,153,176,17,2,131,148
"Bolivia","La Paz","Ingaví","San Andres De Machaca","ESCUELA DE SAN ANDRES DE MACHACA",236336,100,9,355,455,69,17,260,329
"Bolivia","La Paz","Ingaví","San Andres De Machaca","ESCUELA FRANZ TAMAYO",236333,23,1,96,119,7,1,87,94
"Bolivia","La Paz","Ingaví","San Andres De Machaca","ESCUELA LITORAL CHUNCARCOTA",236334,9,3,127,136,23,6,95,118
"Bolivia","La Paz","Ingaví","San Andres De Machaca","ESCUELA NUCLEO LAQUINAMAYA",236335,43,3,238,281,47,3,185,232
"Bolivia","La Paz","Ingaví","San Andres De Machaca","PLAZA PRINCIPAL",236337,21,8,169,190,51,4,106,157
"Bolivia","La Paz","Ingaví","San Andres De Machaca","SEDE SOCIAL (COMUNIDAD MAURI)",236338,10,1,110,120,16,0,93,109
"Bolivia","La Paz","Ingaví","San Andres De Machaca","UNIDAD EDUCATIVA ANTAQUIRANI",236339,4,1,79,83,20,1,57,77
"Bolivia","La Paz","Ingaví","San Andres De Machaca","UNIDAD EDUCATIVA ROSA PATA ERBEN KALLA",236340,9,1,143,152,27,7,108,135
"Bolivia","La Paz","Ingaví","Taraco","COLEGIO NUCLEO FRAY JOSE ZAMPA",233161,24,6,212,236,37,4,165,202
"Bolivia","La Paz","Ingaví","Taraco","COLEGIO OVANDO CANDIA",233162,40,16,562,602,90,30,426,516
"Bolivia","La Paz","Ingaví","Taraco","ESCUELA TARACO",233163,158,24,1348,1506,269,60,995,1264
"Bolivia","La Paz","Ingaví","Taraco","SEDE SOCIAL",233164,6,6,229,235,47,9,167,214
"Bolivia","La Paz","Ingaví","Tiahuanacu","COLEGIO JOSE BALLIVIAN",233158,90,17,1170,1260,212,55,886,1098
"Bolivia","La Paz","Ingaví","Tiahuanacu","COLEGIO NACIONAL ARTURO POSNANSKI",233159,311,56,3225,3536,900,175,2094,2994
"Bolivia","La Paz","Ingaví","Tiahuanacu","ESCUELA CENTRAL PILLAPI",233160,57,13,957,1014,225,31,688,913
"Bolivia","La Paz","Ingaví","Viacha","CASA DE GOBIERNO",234592,19,5,177,196,41,12,119,160
"Bolivia","La Paz","Ingaví","Viacha","COLEGIO BALLIVIAN",234593,1101,111,8727,9828,3309,320,4987,8296
"Bolivia","La Paz","Ingaví","Viacha","COLEGIO HACIA EL MAR",234595,55,16,601,656,101,37,447,548
"Bolivia","La Paz","Ingaví","Viacha","COLEGIO JHONN F. KENNEDI",234594,53,16,692,745,183,30,463,646
"Bolivia","La Paz","Ingaví","Viacha","COLEGIO NAL. MIXTO CALAMA",234596,32,14,398,430,93,17,274,367
"Bolivia","La Paz","Ingaví","Viacha","ESCUELA 18 DE NOVIEMBRE",234597,463,43,3785,4248,1450,129,2163,3613
"Bolivia","La Paz","Ingaví","Viacha","ESCUELA ACHICA ARRIBA",234598,48,6,767,815,179,47,535,714
"Bolivia","La Paz","Ingaví","Viacha","ESCUELA CENTRO TILATA",234599,888,115,10123,11011,2890,388,6730,9620
"Bolivia","La Paz","Ingaví","Viacha","ESCUELA EVARISTO VALLE",234600,563,69,5014,5577,1890,189,2866,4756
"Bolivia","La Paz","Ingaví","Viacha","ESCUELA SAN LUIS",234601,379,32,3724,4103,1550,114,2028,3578
"Bolivia","La Paz","Ingaví","Viacha","ESCUELA VILIROCO",234602,246,33,3367,3613,817,195,2322,3139
"Bolivia","La Paz","Ingaví","Viacha","PLAZA JOSE BALLIVIAN",234603,20,5,309,329,87,11,206,293
"Bolivia","La Paz","Ingaví","Viacha","PLAZA PRINCIPAL",234604,51,2,256,307,57,7,190,247
"Bolivia","La Paz","Ingaví","Viacha","SAN PEDRO DE CHONCHOCORO",234605,18,0,111,129,62,1,48,110
"Bolivia","La Paz","Ingaví","Viacha","SEDE SOCIAL",234606,4,4,160,164,37,6,113,150
"Bolivia","La Paz","Ingaví","Viacha","UNIDAD EDUCATIVA BATALLA DE INGAVI",234607,15,3,58,73,20,1,34,54
"Bolivia","La Paz","Ingaví","Viacha","UNIDAD EDUCATIVA LITORAL",234608,31,5,262,293,54,7,196,250
"Bolivia","La Paz","Ingaví","Viacha","UNIDAD EDUCATIVA TONCOPUJIO",234609,6,4,160,166,18,4,134,152
"Bolivia","La Paz","Inquisivi","Cajuata","CASA DE GOBIERNO",233991,128,24,1066,1194,132,26,884,1016
"Bolivia","La Paz","Inquisivi","Cajuata","CASA DE GOBIERNO",233992,128,24,1066,1194,132,26,884,1016
"Bolivia","La Paz","Inquisivi","Cajuata","ESCUELA",233993,62,11,374,436,60,10,293,353
"Bolivia","La Paz","Inquisivi","Cajuata","ESCUELA HUARITOLO",233994,51,15,364,415,59,14,276,335
"Bolivia","La Paz","Inquisivi","Cajuata","UNIDAD EDUCATIVA CIRCUATA",233995,97,18,808,905,155,35,600,755
"Bolivia","La Paz","Inquisivi","Cajuata","UNIDAD EDUCATIVA MIGUILLAS",233996,55,5,357,412,25,1,326,351
"Bolivia","La Paz","Inquisivi","Cajuata","UNIDA EDUCATIVA CAJUATA",233997,262,62,1722,1984,366,64,1230,1596
"Bolivia","La Paz","Inquisivi","Colquiri","CASA DE GOBIERNO",233919,98,51,737,835,156,45,485,641
"Bolivia","La Paz","Inquisivi","Colquiri","CASA DE GOBIERNO",233921,98,51,737,835,156,45,485,641
"Bolivia","La Paz","Inquisivi","Colquiri","CASA DE GOBIERNO",233920,98,51,737,835,156,45,485,641
"Bolivia","La Paz","Inquisivi","Colquiri","COLEGIO ALTO DE LA ALIANZA",233922,23,4,259,282,57,41,157,214
"Bolivia","La Paz","Inquisivi","Colquiri","COLEGIO SIMON BOLIVAR",233923,62,12,553,615,114,31,396,510
"Bolivia","La Paz","Inquisivi","Colquiri","ESCUELA ANICETO ARCE",233925,24,9,205,229,37,7,152,189
"Bolivia","La Paz","Inquisivi","Colquiri","ESCUELA CAQUENA ENTRE RIOS",233926,21,0,222,243,12,2,208,220
"Bolivia","La Paz","Inquisivi","Colquiri","ESCUELA CENTRAL UYUNI",233927,39,37,280,319,68,20,155,223
"Bolivia","La Paz","Inquisivi","Colquiri","ESCUELA JOSE MIGUEL LANZA",233928,80,19,618,698,119,13,467,586
"Bolivia","La Paz","Inquisivi","Colquiri","ESCUELA PIPINI",233929,25,3,191,216,45,11,132,177
"Bolivia","La Paz","Inquisivi","Colquiri","ESCUELA SECCIONAL CHUALLA",233930,11,0,157,168,31,4,122,153
"Bolivia","La Paz","Inquisivi","Colquiri","ESCUELA SECCIONAL CORIRI",233931,15,3,92,107,14,4,71,85
"Bolivia","La Paz","Inquisivi","Colquiri","ESCUELA SIMON BOLIVAR",233924,19,3,161,180,39,9,110,149
"Bolivia","La Paz","Inquisivi","Colquiri","LADISLAO CABRERA",233932,344,57,2869,3213,1250,153,1409,2659
"Bolivia","La Paz","Inquisivi","Colquiri","UNIDAD EDUCATIVA MARISCAL DE ZEPITA",233933,174,29,1489,1663,602,68,790,1392
"Bolivia","La Paz","Inquisivi","Colquiri","UNIDAD EDUCATIVA MARQUIRIVI",233934,16,0,205,221,37,3,165,202
"Bolivia","La Paz","Inquisivi","Ichoca","CASA DE GOBIERNO",233998,4,6,107,111,30,3,68,98
"Bolivia","La Paz","Inquisivi","Ichoca","ESCUELA CENTRAL LURUTA",233999,29,3,156,185,43,3,107,150
"Bolivia","La Paz","Inquisivi","Ichoca","ESCUELA JOSE ANTONIO DE SUCRE",234000,13,6,321,334,38,8,269,307
"Bolivia","La Paz","Inquisivi","Ichoca","ESCUELA PEDRO DOMINGO MURILLO",234001,19,6,209,228,22,6,175,197
"Bolivia","La Paz","Inquisivi","Ichoca","ESCUELA REPUBLICA DE VENEZUELA",234002,25,8,130,155,19,6,97,116
"Bolivia","La Paz","Inquisivi","Ichoca","UNIDAD EDUCATIVA",234003,141,15,569,710,91,19,444,535
"Bolivia","La Paz","Inquisivi","Ichoca","UNIDAD EDUCATIVA GERMAN BUSCH",234004,1,5,173,174,62,4,102,164
"Bolivia","La Paz","Inquisivi","Inquisivi","ESCUELA CENTRAL CAVARI",233970,81,14,373,454,53,21,285,338
"Bolivia","La Paz","Inquisivi","Inquisivi","ESCUELA EDUARDO AVAROA",233971,77,8,374,451,24,12,330,354
"Bolivia","La Paz","Inquisivi","Inquisivi","ESCUELA ELIODORO CAMACHO",233973,149,13,777,926,244,39,481,725
"Bolivia","La Paz","Inquisivi","Inquisivi","ESCUELA PEDRO DOMINGO MURILLO",233972,52,5,334,386,50,16,263,313
"Bolivia","La Paz","Inquisivi","Inquisivi","ESCUELA SIMON BOLIVAR",233974,67,37,245,312,39,15,154,193
"Bolivia","La Paz","Inquisivi","Inquisivi","PLAZA DE LA FERIA DE VILLA VICTORIA",233975,15,0,86,101,10,1,75,85
"Bolivia","La Paz","Inquisivi","Inquisivi","PLAZA PRINCIPAL",233976,126,5,576,702,50,8,513,563
"Bolivia","La Paz","Inquisivi","Inquisivi","PLAZA PRINCIPAL 16 DE JULIO",233977,201,12,654,855,125,12,505,630
"Bolivia","La Paz","Inquisivi","Inquisivi","SEDE SOCIAL",233979,26,2,80,106,28,1,49,77
"Bolivia","La Paz","Inquisivi","Inquisivi","SEDE SOCIAL",233978,26,2,80,106,28,1,49,77
"Bolivia","La Paz","Inquisivi","Inquisivi","UNIDAD EDUCATIVA ESCOLA",233980,79,8,446,525,57,11,370,427
"Bolivia","La Paz","Inquisivi","Inquisivi","UNIDAD EDUCATIVA KANAMARCA",233981,44,3,212,256,25,4,180,205
"Bolivia","La Paz","Inquisivi","Inquisivi","UNIDAD EDUCATIVA MARISCAL SUCRE",233982,13,2,140,153,22,3,113,135
"Bolivia","La Paz","Inquisivi","Inquisivi","UNIDAD EDUCATIVA SIGUAS",233983,31,20,283,314,49,24,190,239
"Bolivia","La Paz","Inquisivi","Inquisivi","UNIDAD EDUCATIVA TUPAK KATARI",233984,83,24,470,553,83,67,296,379
"Bolivia","La Paz","Inquisivi","Licoma Pampa","ESCUELA ELIODORO CAMACHO",233935,149,25,821,970,134,37,625,759
"Bolivia","La Paz","Inquisivi","Licoma Pampa","ESCUELA MIXTA CHARAPAXI",233936,29,1,175,204,16,4,154,170
"Bolivia","La Paz","Inquisivi","Quime","ESCUELA HUAYNACOTA",233987,0,1,26,26,10,0,15,25
"Bolivia","La Paz","Inquisivi","Quime","ESCUELA PONGO B2",233985,18,7,192,210,34,9,142,176
"Bolivia","La Paz","Inquisivi","Quime","ESCUELA SIMON BOLIVAR",233988,119,14,492,611,255,13,210,465
"Bolivia","La Paz","Inquisivi","Quime","ESCUELA TEODOMIRO URQUIOLA",233986,292,70,2265,2557,758,137,1300,2058
"Bolivia","La Paz","Inquisivi","Quime","ESCUELA UNIDAD EDUCATIVA TITIAMAYA",233989,4,0,110,114,21,4,85,106
"Bolivia","La Paz","Inquisivi","Quime","UNIDAD EDUCATIVA CHOQUETANGA",233990,49,16,412,461,116,16,264,380
"Bolivia","La Paz","Larecaja","Combaya","ESCUELA CENTRAL SOREJAYA",234192,22,5,333,355,61,21,246,307
"Bolivia","La Paz","Larecaja","Combaya","ESCUELA NUCLEO TICAMBLAYA",234193,23,18,186,209,46,8,114,160
"Bolivia","La Paz","Larecaja","Combaya","UNIDAD EDUCATIVA EDUARDO AVAROA",234194,52,29,293,345,67,19,178,245
"Bolivia","La Paz","Larecaja","Combaya","UNIDAD EDUCATIVA HUAYCHO",234195,17,6,170,187,7,10,147,154
"Bolivia","La Paz","Larecaja","Guanay","ESCUELA C. CRESPO",232734,409,21,1763,2172,783,46,913,1696
"Bolivia","La Paz","Larecaja","Guanay","ESCUELA CENTRAL CARURA",232735,72,9,465,537,127,8,321,448
"Bolivia","La Paz","Larecaja","Guanay","ESCUELA MARIAPU",232736,5,1,72,77,54,2,15,69
"Bolivia","La Paz","Larecaja","Guanay","ESCUELA PABLO AMAYA",232741,11,0,79,90,21,8,50,71
"Bolivia","La Paz","Larecaja","Guanay","ESCUELA PAJONAL VILAQUE",232742,22,3,146,168,89,2,52,141
"Bolivia","La Paz","Larecaja","Guanay","ESCUELA SAN JUAN DE CHALLANA",232737,7,0,60,67,49,1,10,59
"Bolivia","La Paz","Larecaja","Guanay","ESCUELA SECC. DE POROMA",232738,33,3,156,189,32,1,120,152
"Bolivia","La Paz","Larecaja","Guanay","ESCUELA SECC. MIXTA LA FABULOSA",232739,3,0,42,45,3,0,39,42
"Bolivia","La Paz","Larecaja","Guanay","ESCUELA SECC. TRAPICHEPONTE",232740,42,3,182,224,36,3,140,176
"Bolivia","La Paz","Larecaja","Guanay","LA AGUADA",232743,25,0,181,206,108,1,72,180
"Bolivia","La Paz","Larecaja","Guanay","NUCLEO ESCOLAR DE AMAGUAYA",232744,15,0,80,95,30,1,49,79
"Bolivia","La Paz","Larecaja","Guanay","SEDE SOCIAL",232745,1,2,45,46,15,0,28,43
"Bolivia","La Paz","Larecaja","Guanay","SINDICATO",232746,1,0,59,60,9,7,43,52
"Bolivia","La Paz","Larecaja","Guanay","UNIDAD EDUCATIVA ALTO CHIJINI",232747,5,0,37,42,9,0,28,37
"Bolivia","La Paz","Larecaja","Guanay","UNIDAD EDUCATIVA BUENOS AIRES",232748,32,3,222,254,67,3,149,216
"Bolivia","La Paz","Larecaja","Guanay","UNIDAD EDUCATIVA CANDELARIA",232749,32,4,465,497,110,3,348,458
"Bolivia","La Paz","Larecaja","Guanay","UNIDAD EDUCATIVA NACIONAL GUANAY",232750,457,27,1864,2321,823,65,949,1772
"Bolivia","La Paz","Larecaja","Guanay","UNIDAD EDUCATIVA YOLOSANI",232751,14,1,82,96,20,2,59,79
"Bolivia","La Paz","Larecaja","Mapiri","COLEGIO 1º DE MAYO",234627,95,6,534,629,195,12,321,516
"Bolivia","La Paz","Larecaja","Mapiri","ESCUELA 16 DE JULIO",234628,466,39,1816,2282,756,63,958,1714
"Bolivia","La Paz","Larecaja","Mapiri","ESCUELA CENTRAL DE SANTA ROSA",234629,497,19,1423,1920,510,44,850,1360
"Bolivia","La Paz","Larecaja","Mapiri","ESCUELA CHIMATE",234632,33,1,153,186,36,5,111,147
"Bolivia","La Paz","Larecaja","Mapiri","ESCUELA DE SARAMPIUNI",234630,19,0,118,137,27,2,89,116
"Bolivia","La Paz","Larecaja","Mapiri","ESCUELA MONJE ZAPATA",234631,98,6,419,517,112,17,284,396
"Bolivia","La Paz","Larecaja","Mapiri","ESCUELA UNIDAD EDUCATIVA VILAQUE GRANDE",234633,26,3,189,215,49,4,133,182
"Bolivia","La Paz","Larecaja","Quiabaya","ESCUELA MIXTA JULIO CORDERO",234531,182,34,1025,1207,291,64,636,927
"Bolivia","La Paz","Larecaja","Sorata","COLEGIO JUAN XXIII",234173,235,59,1651,1886,550,74,968,1518
"Bolivia","La Paz","Larecaja","Sorata","ESCUELA CENTRAL CARAZANI",234174,18,2,197,215,35,20,140,175
"Bolivia","La Paz","Larecaja","Sorata","ESCUELA CENTRAL CHEJE",234175,39,1,292,331,23,5,263,286
"Bolivia","La Paz","Larecaja","Sorata","ESCUELA CENTRAL CHOJLLA",234176,28,2,76,104,16,1,57,73
"Bolivia","La Paz","Larecaja","Sorata","ESCUELA CENTRAL DE YANI",234177,96,12,601,697,382,36,171,553
"Bolivia","La Paz","Larecaja","Sorata","ESCUELA COMBILILI",234186,8,0,83,91,33,6,44,77
"Bolivia","La Paz","Larecaja","Sorata","ESCUELA FERNANDO ELOY GUACHALLA",234178,99,54,809,908,147,48,560,707
"Bolivia","La Paz","Larecaja","Sorata","ESCUELA MACHACAMARCA",234187,24,0,154,178,14,1,139,153
"Bolivia","La Paz","Larecaja","Sorata","ESCUELA NEMECIO AYALA",234179,31,8,181,212,35,8,130,165
"Bolivia","La Paz","Larecaja","Sorata","ESCUELA NUCLEO ABISPAYA",234180,41,12,314,355,77,21,204,281
"Bolivia","La Paz","Larecaja","Sorata","ESCUELA NUCLEO COCOY",234181,1,0,292,293,152,19,121,273
"Bolivia","La Paz","Larecaja","Sorata","ESCUELA NUCLEO LARIPATA",234182,91,25,807,898,226,39,517,743
"Bolivia","La Paz","Larecaja","Sorata","ESCUELA NUCLEO SAN ANTONIO DE MILLIPA",234183,15,7,790,805,229,22,532,761
"Bolivia","La Paz","Larecaja","Sorata","ESCUELA PACOLLO",234188,5,0,200,205,58,8,134,192
"Bolivia","La Paz","Larecaja","Sorata","ESCUELA SANTA MARIA",234189,54,4,115,169,26,4,81,107
"Bolivia","La Paz","Larecaja","Sorata","ESCUELA SECC. DE ANKOMA SUR",234184,17,8,162,179,87,7,60,147
"Bolivia","La Paz","Larecaja","Sorata","ESCUELA SECCIONAL CHUSSI",234185,2,1,166,168,28,1,136,164
"Bolivia","La Paz","Larecaja","Sorata","ESCUELA UNIDAD EDUCATIVA OKARA",234190,11,4,50,61,16,2,28,44
"Bolivia","La Paz","Larecaja","Sorata","H.A.M. DE SORATA",234191,290,53,1733,2023,547,94,1039,1586
"Bolivia","La Paz","Larecaja","Tacacoma","COLEGIO CENTRAL SAN AGUSTIN",232764,75,11,346,421,77,18,240,317
"Bolivia","La Paz","Larecaja","Tacacoma","ESCUELA ANANEA",232765,28,1,192,220,93,6,92,185
"Bolivia","La Paz","Larecaja","Tacacoma","ESCUELA CENTRAL CHUMISA",232766,56,6,464,520,114,14,330,444
"Bolivia","La Paz","Larecaja","Tacacoma","ESCUELA PALLAYUNGA",232767,60,1,212,272,48,10,153,201
"Bolivia","La Paz","Larecaja","Tacacoma","ESCUELA UNIDAD EDUCATIVA CAMILLAYA",232769,17,3,81,98,24,1,53,77
"Bolivia","La Paz","Larecaja","Tacacoma","ESCUELA XVI DE JULIO",232768,140,16,967,1107,467,54,430,897
"Bolivia","La Paz","Larecaja","Tacacoma","NUCLEO ESCOLAR INCACHACA",232770,70,2,213,283,124,2,85,209
"Bolivia","La Paz","Larecaja","Tacacoma","PLAZA COLLABAMBA",232771,19,2,111,130,67,7,35,102
"Bolivia","La Paz","Larecaja","Teoponte","COLEGIO NAL. MIXTO TEOPONTE",236385,263,23,1142,1405,404,22,693,1097
"Bolivia","La Paz","Larecaja","Teoponte","COLEGIO NUCLEO TAJLIHUI",236386,20,1,143,163,21,8,113,134
"Bolivia","La Paz","Larecaja","Teoponte","ESCUELA EDUARDO AVAROA",236387,15,4,127,142,15,6,102,117
"Bolivia","La Paz","Larecaja","Teoponte","ESCUELA MIXTA TOMACHI",236388,86,2,316,402,104,10,200,304
"Bolivia","La Paz","Larecaja","Teoponte","ESCUELA NUCLEO VILLA AROMA",236389,33,4,371,404,56,10,301,357
"Bolivia","La Paz","Larecaja","Teoponte","NUCLEO RED UNO",236390,12,1,59,71,4,2,52,56
"Bolivia","La Paz","Larecaja","Teoponte","SEDE SOCIAL",236391,228,13,1044,1272,240,22,769,1009
"Bolivia","La Paz","Larecaja","Tipuani","ESCUELA 16 DE JULIO",234610,225,7,651,876,204,10,430,634
"Bolivia","La Paz","Larecaja","Tipuani","ESCUELA CHUQUINI",234614,281,9,787,1068,198,15,565,763
"Bolivia","La Paz","Larecaja","Tipuani","ESCUELA EDUARDO AVAROA",234611,478,18,1581,2059,646,37,880,1526
"Bolivia","La Paz","Larecaja","Tipuani","ESCUELA MIXTA GERMAN BUSCH",234612,40,2,192,232,77,6,107,184
"Bolivia","La Paz","Larecaja","Tipuani","ESCUELA NESTOR PAZ ZAMORA",234613,11,0,56,67,4,2,50,54
"Bolivia","La Paz","Larecaja","Tipuani","UNIDAD EDUCATIVA PEDRO DOMINGO MURILLO",234615,97,5,388,485,150,9,224,374
"Bolivia","La Paz","Loayza","Cairoma","COLEGIO GERMAN BUSCH",233959,136,27,1065,1201,246,55,737,983
"Bolivia","La Paz","Loayza","Cairoma","COLEGIO LUIS ESPINAL",233960,29,10,325,354,92,2,221,313
"Bolivia","La Paz","Loayza","Cairoma","ESCUELA DE SAYA",233961,8,2,105,113,40,5,58,98
"Bolivia","La Paz","Loayza","Cairoma","ESCUELA TIENDA PATA",233962,14,1,126,140,38,5,82,120
"Bolivia","La Paz","Loayza","Cairoma","PLAZA LLOJA",233963,22,1,184,206,10,1,172,182
"Bolivia","La Paz","Loayza","Cairoma","PLAZA TORRE PAMPA",233964,63,8,346,409,67,10,261,328
"Bolivia","La Paz","Loayza","Cairoma","UNIDAD EDUCATIVA BARTOLINA SISA",233965,23,0,118,141,13,8,97,110
"Bolivia","La Paz","Loayza","Cairoma","UNIDAD EDUCATIVA BOLIVAR",233966,69,19,489,558,68,16,386,454
"Bolivia","La Paz","Loayza","Cairoma","UNIDAD EDUCATIVA BOLIVIA-VILOCO",233967,159,5,706,865,165,22,514,679
"Bolivia","La Paz","Loayza","Cairoma","UNIDAD EDUCATIVA LIBERTAD",233968,55,9,341,396,54,14,264,318
"Bolivia","La Paz","Loayza","Cairoma","UNIDAD EDUCATIVA SACANI",233969,16,3,365,381,57,8,297,354
"Bolivia","La Paz","Loayza","Luribay","COLEGIO AZAMBO",234532,29,4,371,400,66,13,288,354
"Bolivia","La Paz","Loayza","Luribay","COLEGIO RVDO. VICTOR ARUAZO-PLAZA PRINCIPAL",234534,88,10,630,718,135,19,466,601
"Bolivia","La Paz","Loayza","Luribay","COLEGIO VILLA LITORAL",234533,37,2,383,420,47,8,326,373
"Bolivia","La Paz","Loayza","Luribay","ESCUELA ANQUIMOA",234535,49,6,587,636,60,11,510,570
"Bolivia","La Paz","Loayza","Luribay","ESCUELA EL PORVENIR",234536,44,3,617,661,107,12,495,602
"Bolivia","La Paz","Loayza","Luribay","ESCUELA MURMUNTANI",234537,20,1,171,191,13,4,153,166
"Bolivia","La Paz","Loayza","Luribay","ESCUELA UNIDAD EDUCATIVA BRAVO",234538,17,3,198,215,19,3,173,192
"Bolivia","La Paz","Loayza","Luribay","PLAZA 5 DE AGOSTO",234539,64,5,422,486,57,11,349,406
"Bolivia","La Paz","Loayza","Luribay","PLAZA 6 DE AGOSTO",234540,60,4,349,409,33,24,288,321
"Bolivia","La Paz","Loayza","Luribay","PLAZA TOTORA",234541,5,0,90,95,11,0,79,90
"Bolivia","La Paz","Loayza","Luribay","UNIDAD EDUCATIVA COLLIRI",234542,32,1,225,257,31,8,185,216
"Bolivia","La Paz","Loayza","Luribay","UNIDAD EDUCATIVA PEDRO DOMINGO MURILLO",234543,88,8,596,684,94,3,491,585
"Bolivia","La Paz","Loayza","Luribay","UNIDAD EDUCATIVA POROMA",234544,23,1,299,322,37,1,260,297
"Bolivia","La Paz","Loayza","Malla","ESCUELA SIMON BOLIVAR",234566,3,0,99,102,3,2,94,97
"Bolivia","La Paz","Loayza","Malla","PLAZA 14 DE SEPTIEMBRE",234567,13,2,408,421,55,5,346,401
"Bolivia","La Paz","Loayza","Malla","UNIDAD EDUCATIVA FRANZ TAMAYO",234568,38,2,254,292,55,9,188,243
"Bolivia","La Paz","Loayza","Sapahaqui","ESCUELA EDUARDO AVAROA",234545,43,2,413,456,44,5,362,406
"Bolivia","La Paz","Loayza","Sapahaqui","ESCUELA SIXILLA BAJA",234546,0,1,325,325,42,2,280,322
"Bolivia","La Paz","Loayza","Sapahaqui","MURUHUTA",234547,43,2,373,416,66,16,289,355
"Bolivia","La Paz","Loayza","Sapahaqui","PLAZA PRINCIPAL HUANCANE",234548,13,2,321,334,52,5,262,314
"Bolivia","La Paz","Loayza","Sapahaqui","UNIDAD EDUCATIVA CHIVISIVI",234549,49,7,565,614,86,4,468,554
"Bolivia","La Paz","Loayza","Sapahaqui","UNIDAD EDUCATIVA OCUIRI",234550,21,0,228,249,20,6,202,222
"Bolivia","La Paz","Loayza","Sapahaqui","UNIDAD EDUCATIVA SAN MARCOS",234551,192,11,1391,1583,215,51,1114,1329
"Bolivia","La Paz","Loayza","Sapahaqui","UNIDAD EDUCATIVA SAPAHAQUI",234552,204,31,1625,1829,323,69,1202,1525
"Bolivia","La Paz","Loayza","Sapahaqui","UNIDAD EDUCATIVA TACOBAMBA",234553,63,3,616,679,93,17,503,596
"Bolivia","La Paz","Loayza","Sapahaqui","UNIDAD EDUCATIVA URUPAYA",234554,12,0,94,106,16,2,76,92
"Bolivia","La Paz","Loayza","Yaco","COLEGIO REPUBLICA VENEZUELA",234555,43,5,589,632,169,21,394,563
"Bolivia","La Paz","Loayza","Yaco","ESCUELA CHALLOMA",234556,22,2,235,257,12,5,216,228
"Bolivia","La Paz","Loayza","Yaco","ESCUELA UMALACO",234557,4,1,74,78,8,1,64,72
"Bolivia","La Paz","Loayza","Yaco","PLAZA 14 DE SEPTIEMBRE",234558,9,2,116,125,23,7,84,107
"Bolivia","La Paz","Loayza","Yaco","PLAZA CENTRAL",234559,27,11,431,458,98,46,276,374
"Bolivia","La Paz","Loayza","Yaco","UNIDAD EDUCATIVA CHUCAMARCA",234560,34,4,238,272,34,10,190,224
"Bolivia","La Paz","Loayza","Yaco","UNIDAD EDUCATIVA DANIEL GOMEZ GARCIA",234561,36,7,284,320,50,20,207,257
"Bolivia","La Paz","Loayza","Yaco","UNIDAD EDUCATIVA GERMAN BUSCH",234562,18,0,119,137,25,5,89,114
"Bolivia","La Paz","Loayza","Yaco","UNIDAD EDUCATIVA HURNUNI",234563,12,1,240,252,87,5,147,234
"Bolivia","La Paz","Loayza","Yaco","UNIDAD EDUCATIVA SIMON BOLIVAR",234564,0,7,137,137,38,5,87,125
"Bolivia","La Paz","Loayza","Yaco","UNIDAD EDUCATIVA YACO",234565,84,13,368,452,78,25,252,330
"Bolivia","La Paz","Los Andes","Batallas","COLEGIO DON BOSCO",233142,60,18,729,789,166,29,516,682
"Bolivia","La Paz","Los Andes","Batallas","COLEGIO FISCAL BOLIVIANO CUBANO",233144,64,13,724,788,224,26,461,685
"Bolivia","La Paz","Los Andes","Batallas","COLEGIO PEDRO DOMINGO MURILLO",233145,62,11,535,597,213,23,288,501
"Bolivia","La Paz","Los Andes","Batallas","COLEGIO TÉCNICO HUMANÍSTICO CHIRAPACA",233143,21,4,406,427,136,16,250,386
"Bolivia","La Paz","Los Andes","Batallas","ESCUELA GENOVEVA RIOS",233146,339,47,2937,3276,953,124,1813,2766
"Bolivia","La Paz","Los Andes","Batallas","PLAZA LA PAZ",233147,36,4,566,602,193,19,350,543
"Bolivia","La Paz","Los Andes","Batallas","PLAZA PRINCIPAL",233148,112,16,1192,1304,434,57,685,1119
"Bolivia","La Paz","Los Andes","Batallas","PLAZA PRINCIPAL",233149,112,16,1192,1304,434,57,685,1119
"Bolivia","La Paz","Los Andes","Batallas","PLAZA TUPAC KATARI",233150,75,17,642,717,150,35,440,590
"Bolivia","La Paz","Los Andes","Batallas","PLAZA TUQUIA",233151,67,13,684,751,186,44,441,627
"Bolivia","La Paz","Los Andes","Batallas","PLAZA V. ASUNCION DE CALUYO",233152,15,0,198,213,34,4,160,194
"Bolivia","La Paz","Los Andes","Batallas","SEDE SOCIAL",233153,16,3,250,266,77,9,161,238
"Bolivia","La Paz","Los Andes","Laja","COLEGIO PEDRO DOMINGO MURILLO",234136,294,57,3397,3691,824,159,2357,3181
"Bolivia","La Paz","Los Andes","Laja","COLEGIO TEC. HUMANISTICO TAMBILLO",234137,56,13,515,571,151,28,323,474
"Bolivia","La Paz","Los Andes","Laja","ESCUELA QUINTUPATA",234138,3,3,135,138,30,1,101,131
"Bolivia","La Paz","Los Andes","Laja","ESCUELA REPUBLICA DE IRAN",234139,113,16,1084,1197,287,47,734,1021
"Bolivia","La Paz","Los Andes","Laja","MERCADO SAN JUAN",234140,36,13,460,496,56,24,367,423
"Bolivia","La Paz","Los Andes","Laja","PLAZA CURVA PUCARA",234141,22,12,579,601,99,21,447,546
"Bolivia","La Paz","Los Andes","Laja","PLAZA PRINCIPAL",234142,38,22,1018,1056,176,53,767,943
"Bolivia","La Paz","Los Andes","Laja","PLAZA PRINCIPAL",234144,38,22,1018,1056,176,53,767,943
"Bolivia","La Paz","Los Andes","Laja","PLAZA PRINCIPAL",234143,38,22,1018,1056,176,53,767,943
"Bolivia","La Paz","Los Andes","Laja","UNIDAD EDUCATIVA CALLAMARCA",234145,2,3,380,382,73,19,285,358
"Bolivia","La Paz","Los Andes","Laja","UNIDAD EDUCATIVA COPAJIRA",234147,38,10,617,655,118,33,456,574
"Bolivia","La Paz","Los Andes","Laja","UNIDAD EDUCATIVA GUALBERTO VILLARROEL DE SACACANI",234146,0,0,216,216,48,8,160,208
"Bolivia","La Paz","Los Andes","Pucarani","COLEGIO CHIARPATA",234041,30,20,480,510,148,25,287,435
"Bolivia","La Paz","Los Andes","Pucarani","COLEGIO COHANA",234042,25,16,685,710,136,25,508,644
"Bolivia","La Paz","Los Andes","Pucarani","COLEGIO MARIO GUTIERREZ",234043,80,43,1028,1108,366,92,527,893
"Bolivia","La Paz","Los Andes","Pucarani","COLEGIO NAL. CHOJÑA COLLO",234045,17,9,393,410,128,35,221,349
"Bolivia","La Paz","Los Andes","Pucarani","COLEGIO SAN SALVADOR",234044,133,40,1707,1840,473,103,1091,1564
"Bolivia","La Paz","Los Andes","Pucarani","ESCUELA ANTOFAGASTA",234048,88,53,1728,1816,627,161,887,1514
"Bolivia","La Paz","Los Andes","Pucarani","ESCUELA CATAVI",234049,61,22,675,736,193,30,430,623
"Bolivia","La Paz","Los Andes","Pucarani","ESCUELA CENTRAL CHIPAMAYA",234046,34,7,457,491,140,21,289,429
"Bolivia","La Paz","Los Andes","Pucarani","ESCUELA CHOJASIVI",234050,10,10,676,686,231,26,409,640
"Bolivia","La Paz","Los Andes","Pucarani","ESCUELA JOSE SALMON BALLIVIAN",234047,294,81,3005,3299,1094,162,1668,2762
"Bolivia","La Paz","Los Andes","Pucarani","PLAZA 6 DE AGOSTO",234051,120,31,1482,1602,323,63,1065,1388
"Bolivia","La Paz","Los Andes","Pucarani","PLAZA PRINCIPAL",234052,67,16,725,792,110,11,588,698
"Bolivia","La Paz","Los Andes","Pucarani","PLAZA VILLA ROSARIO DE CORAPATA",234053,72,22,920,992,390,47,461,851
"Bolivia","La Paz","Los Andes","Puerto Perez","ESCUELA CENTRAL CASCACHI",232232,37,13,518,555,91,35,379,470
"Bolivia","La Paz","Los Andes","Puerto Perez","ESCUELA GUALBERTO VILLARROEL",232230,65,6,453,518,151,26,270,421
"Bolivia","La Paz","Los Andes","Puerto Perez","ESCUELA MIXTO 16 DE JULIO",232231,62,27,874,936,173,36,638,811
"Bolivia","La Paz","Los Andes","Puerto Perez","ESCUELA PUERTO PEREZ",232233,90,20,1047,1137,243,26,758,1001
"Bolivia","La Paz","Los Andes","Puerto Perez","ESCUELAS POPULARES DON BOSCO",232234,28,2,314,342,91,9,212,303
"Bolivia","La Paz","Los Andes","Puerto Perez","UNIDAD EDUCATIVA CUMANA",232235,20,4,257,277,42,5,206,248
"Bolivia","La Paz","Manco Kapac","Copacabana","CENTRO DE SALUD SIRIPACA",234156,39,7,243,282,25,3,208,233
"Bolivia","La Paz","Manco Kapac","Copacabana","COLEGIO CHALLA",234157,64,12,938,1002,47,15,864,911
"Bolivia","La Paz","Manco Kapac","Copacabana","COLEGIO NACIONAL MIXTO COPACABANA",234158,569,57,3967,4536,1210,144,2556,3766
"Bolivia","La Paz","Manco Kapac","Copacabana","ESCUELA 16 DE JULIO",234159,110,16,881,991,288,36,541,829
"Bolivia","La Paz","Manco Kapac","Copacabana","ESCUELA COLEGIO TEC. HUMANISTICO HUACUYO",234160,71,3,409,480,81,16,309,390
"Bolivia","La Paz","Manco Kapac","Copacabana","ESCUELA SECCIONAL SAMPAYA",234161,44,7,321,365,47,15,252,299
"Bolivia","La Paz","Manco Kapac","Copacabana","ESCUELA VILLA ROSARIO",234162,37,9,328,365,68,11,240,308
"Bolivia","La Paz","Manco Kapac","San Pedro De Tiquina","COLEGIO SIMON BOLIVAR",234164,260,19,1043,1303,306,53,665,971
"Bolivia","La Paz","Manco Kapac","San Pedro De Tiquina","COLEGIO VILLA AMACARI",234163,14,8,184,198,48,5,123,171
"Bolivia","La Paz","Manco Kapac","San Pedro De Tiquina","ESCUELA MIXTA SAN PABLO DE TIQUINA",234165,75,20,651,726,249,30,352,601
"Bolivia","La Paz","Manco Kapac","San Pedro De Tiquina","PLAZA 25 DE JUNIO",234166,31,2,212,243,62,4,144,206
"Bolivia","La Paz","Manco Kapac","San Pedro De Tiquina","SEDE SOCIAL",234167,52,8,303,355,55,7,233,288
"Bolivia","La Paz","Manco Kapac","Tito Yupanqui","COLEGIO NACIONAL MIXTO TITO YUPANQUI",233363,122,25,653,775,215,21,392,607
"Bolivia","La Paz","Manco Kapac","Tito Yupanqui","ESCUELA HUATAPAMPA",233364,14,1,165,179,39,8,117,156
"Bolivia","La Paz","Muñecas","Aucapata","COLEGIO 2 DE AGOSTO",234168,101,10,391,492,52,22,307,359
"Bolivia","La Paz","Muñecas","Aucapata","ESCUELA DR. ANGEL GEMIO ERGUETA",234169,66,2,169,235,51,16,100,151
"Bolivia","La Paz","Muñecas","Aucapata","IGLESIA SANTO DOMINGO",234170,72,10,195,267,34,13,138,172
"Bolivia","La Paz","Muñecas","Aucapata","NUCLEO ESCOLAR YANAHUAYA",234171,110,22,384,494,83,22,257,340
"Bolivia","La Paz","Muñecas","Aucapata","UNIDAD EDUCATIVA ROSARIO",234172,168,12,489,657,91,20,366,457
"Bolivia","La Paz","Muñecas","Ayata","COLEGIO NEMESIO ALIAGA BENAVENTE",233423,245,60,811,1056,118,57,576,694
"Bolivia","La Paz","Muñecas","Ayata","ESCUELA CAMATA",233425,79,17,385,464,72,18,278,350
"Bolivia","La Paz","Muñecas","Ayata","ESCUELA NUCLEO ELIZARDO PEREZ DE M.",233426,81,30,444,525,97,28,289,386
"Bolivia","La Paz","Muñecas","Ayata","ESCUELA SAIHUANI",233427,102,15,420,522,32,17,356,388
"Bolivia","La Paz","Muñecas","Ayata","ESCUELA SAN JUANITO",233424,58,3,367,425,44,19,301,345
"Bolivia","La Paz","Muñecas","Ayata","ESCUELA SECCIONAL MULTIGRADO UPANI",233428,52,5,276,328,7,29,235,242
"Bolivia","La Paz","Muñecas","Ayata","UNIDAD EDUCATIVA VILLA ROSARIO",233429,0,3,87,87,13,3,68,81
"Bolivia","La Paz","Muñecas","Chuma","COLEGIO HUMANISTICO SOCOCONI",233411,67,11,508,575,57,13,427,484
"Bolivia","La Paz","Muñecas","Chuma","COLEGIO POCOAYA",233412,16,1,118,134,26,8,83,109
"Bolivia","La Paz","Muñecas","Chuma","CUSAHUAYA",233413,7,3,206,213,14,3,186,200
"Bolivia","La Paz","Muñecas","Chuma","ESCUELA CENTRAL TITICACHI",233415,63,10,409,472,88,21,290,378
"Bolivia","La Paz","Muñecas","Chuma","ESCUELA CHAJLAYA",233416,57,5,535,592,104,20,406,510
"Bolivia","La Paz","Muñecas","Chuma","ESCUELA DE LUQUISANI",233417,24,6,269,293,93,17,153,246
"Bolivia","La Paz","Muñecas","Chuma","ESCUELA DE TUILUNI",233418,27,9,258,285,68,25,156,224
"Bolivia","La Paz","Muñecas","Chuma","ESCUELA MAXIMILIANO ORTIZ",233419,252,37,830,1082,184,54,555,739
"Bolivia","La Paz","Muñecas","Chuma","ESCUELA PALOHUAYA",233420,14,1,124,138,28,4,91,119
"Bolivia","La Paz","Muñecas","Chuma","ESCUELA TIMUSI",233414,31,1,266,297,35,7,223,258
"Bolivia","La Paz","Muñecas","Chuma","PLAZA CAPAYQUE",233421,13,4,212,225,18,9,181,199
"Bolivia","La Paz","Muñecas","Chuma","PLAZA JICHUHUAYA",233422,13,0,104,117,20,1,83,103
"Bolivia","La Paz","Murillo","Achocalla","COLEGIO 16 DE AGOSTO",232598,114,6,1115,1229,320,26,763,1083
"Bolivia","La Paz","Murillo","Achocalla","ESCUELA ASUNTA QUILLVIRI",232599,81,18,1012,1093,238,67,689,927
"Bolivia","La Paz","Murillo","Achocalla","ESCUELA CHAÑOCAHUA",232600,347,30,3694,4041,1028,129,2507,3535
"Bolivia","La Paz","Murillo","Achocalla","ESCUELA MARQUIRIVI",232601,278,37,2011,2289,498,51,1425,1923
"Bolivia","La Paz","Murillo","Achocalla","ESCUELA VILLA CONCEPCION",232602,28,9,522,550,101,27,385,486
"Bolivia","La Paz","Murillo","Achocalla","UNIDAD EDUCATIVA ANTONIO DIAZ VILLAMIL",232603,148,34,1803,1951,514,52,1203,1717
"Bolivia","La Paz","Murillo","Achocalla","UNIDAD EDUCATIVA RENE BARRIENTOS ORTUÑO",232604,143,13,1235,1378,410,29,783,1193
"Bolivia","La Paz","Murillo","Achocalla","UNIDAD EDUCATIVA TUNI",232605,26,2,348,374,69,7,270,339
"Bolivia","La Paz","Murillo","El Alto","CENTRO EDUCATIVO CATOLICO MERCEDES",231873,214,28,2435,2649,824,121,1462,2286
"Bolivia","La Paz","Murillo","El Alto","COLEGIO 18 DE DICIEMBRE",231874,338,27,3263,3601,1006,144,2086,3092
"Bolivia","La Paz","Murillo","El Alto","COLEGIO 1RO DE MAYO",231875,657,49,7853,8510,3644,396,3764,7408
"Bolivia","La Paz","Murillo","El Alto","COLEGIO 23 DE MARZO",231882,770,87,6619,7389,1738,305,4489,6227
"Bolivia","La Paz","Murillo","El Alto","COLEGIO 25 DE JULIO",231876,838,75,6599,7437,2202,295,4027,6229
"Bolivia","La Paz","Murillo","El Alto","COLEGIO 27 DE MAYO",231883,595,88,5668,6263,1618,298,3664,5282
"Bolivia","La Paz","Murillo","El Alto","COLEGIO 6 DE JUNIO",231884,516,40,4530,5046,1597,147,2746,4343
"Bolivia","La Paz","Murillo","El Alto","COLEGIO ADRIAN CASTILLO NAVA",231885,842,92,8873,9715,3409,395,4977,8386
"Bolivia","La Paz","Murillo","El Alto","COLEGIO ANDRES DE STA CRUZ",231886,623,80,6837,7460,2609,386,3762,6371
"Bolivia","La Paz","Murillo","El Alto","COLEGIO ANTONIO PAREDES CANDIA",231887,918,144,10853,11771,3838,538,6333,10171
"Bolivia","La Paz","Murillo","El Alto","COLEGIO ATIPIRIS",231877,321,40,2932,3253,866,149,1877,2743
"Bolivia","La Paz","Murillo","El Alto","COLEGIO BASILL MILLER",231878,230,19,2919,3149,1330,130,1440,2770
"Bolivia","La Paz","Murillo","El Alto","COLEGIO BOLIVIA",231879,467,46,4155,4622,1592,215,2302,3894
"Bolivia","La Paz","Murillo","El Alto","COLEGIO BOLIVIA MAR",231888,264,24,2518,2782,660,107,1727,2387
"Bolivia","La Paz","Murillo","El Alto","COLEGIO CALAMA",231880,626,52,7137,7763,2855,316,3914,6769
"Bolivia","La Paz","Murillo","El Alto","COLEGIO DON BOSCO",231889,746,78,7399,8145,2631,249,4441,7072
"Bolivia","La Paz","Murillo","El Alto","COLEGIO EDUARDO AVAROA",231881,319,22,2726,3045,1119,115,1470,2589
"Bolivia","La Paz","Murillo","El Alto","COLEGIO ESPAÑA",231905,1083,87,9120,10203,2893,393,5747,8640
"Bolivia","La Paz","Murillo","El Alto","COLEGIO FERNANDO NOGALES CASTRO",231890,289,37,3484,3773,1511,133,1803,3314
"Bolivia","La Paz","Murillo","El Alto","COLEGIO GRAN BRETAÑA",231906,490,42,5632,6122,2556,229,2805,5361
"Bolivia","La Paz","Murillo","El Alto","COLEGIO HEROES DEL PACIFICO",231907,396,13,4315,4711,2896,119,1287,4183
"Bolivia","La Paz","Murillo","El Alto","COLEGIO HUAYNA POTOSI",231891,666,114,8029,8695,2771,410,4734,7505
"Bolivia","La Paz","Murillo","El Alto","COLEGIO ILLIMANI",231892,694,71,7226,7920,2297,267,4591,6888
"Bolivia","La Paz","Murillo","El Alto","COLEGIO LIBERTADOR S. BOLIVAR",231908,462,34,4467,4929,1991,177,2265,4256
"Bolivia","La Paz","Murillo","El Alto","COLEGIO LUIS ESPINAL CAMPS",231893,980,111,9286,10266,3175,314,5686,8861
"Bolivia","La Paz","Murillo","El Alto","COLEGIO LUIS ESPINAL CAMPS (AEROPUERTO)",231894,352,33,2977,3329,1046,156,1742,2788
"Bolivia","La Paz","Murillo","El Alto","COLEGIO MARISCAL ANDRES DE SANTA CRUZ",231895,133,16,1349,1482,748,42,543,1291
"Bolivia","La Paz","Murillo","El Alto","COLEGIO MARTIN CARDENAS",231896,1058,70,9815,10873,4851,385,4509,9360
"Bolivia","La Paz","Murillo","El Alto","COLEGIO M QUIROGA SANTA CRUZ",231897,295,158,4768,5063,1919,264,2427,4346
"Bolivia","La Paz","Murillo","El Alto","COLEGIO MUTUAL LA PAZ",231909,361,43,4042,4403,1871,136,1992,3863
"Bolivia","La Paz","Murillo","El Alto","COLEGIO NESTOR PAZ",231898,495,45,4940,5435,1684,272,2939,4623
"Bolivia","La Paz","Murillo","El Alto","COLEGIO PARTICULAR SAN MIGUEL",231899,224,15,2154,2378,1059,100,980,2039
"Bolivia","La Paz","Murillo","El Alto","COLEGIO PUERTO DEL ROSARIO",231901,1107,83,10673,11780,4517,402,5671,10188
"Bolivia","La Paz","Murillo","El Alto","COLEGIO PUERTO DEL ROSARIO",231900,1107,83,10673,11780,4517,402,5671,10188
"Bolivia","La Paz","Murillo","El Alto","COLEGIO PUERTO MEJILLONES",231910,788,41,7782,8570,5150,204,2387,7537
"Bolivia","La Paz","Murillo","El Alto","COLEGIO RAFAEL MENDOZA",231911,492,48,4903,5395,2342,267,2246,4588
"Bolivia","La Paz","Murillo","El Alto","COLEGIO REPUBLICA DE ITALIA",231912,215,25,2000,2215,636,91,1248,1884
"Bolivia","La Paz","Murillo","El Alto","COLEGIO ROTARY CHUQUIAGO MARCA",231913,1011,81,8411,9422,3437,350,4543,7980
"Bolivia","La Paz","Murillo","El Alto","COLEGIO SAN JOSE",231902,876,111,10039,10915,4092,467,5369,9461
"Bolivia","La Paz","Murillo","El Alto","COLEGIO SANTA MARIA DE LOS ANGELES",231914,613,57,6809,7422,3221,351,3180,6401
"Bolivia","La Paz","Murillo","El Alto","COLEGIO SAN VICENTE DE PAUL",231915,720,71,7407,8127,2690,299,4347,7037
"Bolivia","La Paz","Murillo","El Alto","COLEGIO TEC. HUMANISTICO JOSE BALLIVIAN",231916,313,42,3459,3772,1487,184,1746,3233
"Bolivia","La Paz","Murillo","El Alto","COLEGIO TOPATER",231917,482,35,5105,5587,1886,196,2988,4874
"Bolivia","La Paz","Murillo","El Alto","COLEGIO TUNARI",231918,1276,134,13812,15088,5846,623,7209,13055
"Bolivia","La Paz","Murillo","El Alto","COLEGIO VICENTE TEJADA",231919,558,55,5652,6210,2603,228,2766,5369
"Bolivia","La Paz","Murillo","El Alto","COLEGIO WALTER ALPIRE 1ER PATIO",231903,515,36,4904,5419,2435,204,2229,4664
"Bolivia","La Paz","Murillo","El Alto","COLEGIO WALTER ALPIRE 2DO PATIO",231904,233,30,3092,3325,1664,90,1308,2972
"Bolivia","La Paz","Murillo","El Alto","ESCUELA 16 DE FEBRERO",231929,661,95,7448,8109,2757,268,4328,7085
"Bolivia","La Paz","Murillo","El Alto","ESCUELA BALLIVIAN",231920,328,44,3921,4249,1573,201,2103,3676
"Bolivia","La Paz","Murillo","El Alto","ESCUELA BOLIVAR MUNICIPAL",231921,303,36,3647,3950,1409,147,2055,3464
"Bolivia","La Paz","Murillo","El Alto","ESCUELA BRASIL",231930,456,38,5008,5464,2223,211,2536,4759
"Bolivia","La Paz","Murillo","El Alto","ESCUELA ELIZARDO PEREZ",231922,428,43,4525,4953,1912,218,2352,4264
"Bolivia","La Paz","Murillo","El Alto","ESCUELA GUAQUI",231931,563,74,6164,6727,2203,301,3586,5789
"Bolivia","La Paz","Murillo","El Alto","ESCUELA JUAN CARLOS FLORES BEDREGAL",231933,693,95,7769,8462,3069,266,4339,7408
"Bolivia","La Paz","Murillo","El Alto","ESCUELA JUAN CARLOS FLORES BEDREGAL",231932,693,95,7769,8462,3069,266,4339,7408
"Bolivia","La Paz","Murillo","El Alto","ESCUELA JUAN JOSE TORREZ",231934,363,55,4053,4416,1349,196,2453,3802
"Bolivia","La Paz","Murillo","El Alto","ESCUELA JUVENAL MARIACA",231923,715,55,7081,7796,3574,293,3159,6733
"Bolivia","La Paz","Murillo","El Alto","ESCUELA LIBERTAD EN LAS AMERICAS",231924,767,73,7221,7988,3007,258,3883,6890
"Bolivia","La Paz","Murillo","El Alto","ESCUELA LOS ANDES",231925,304,34,3283,3587,1507,147,1595,3102
"Bolivia","La Paz","Murillo","El Alto","ESCUELA LUIS ESPINAL CAMPS",231926,245,31,2568,2813,916,116,1505,2421
"Bolivia","La Paz","Murillo","El Alto","ESCUELA PRIMAVERA",231927,174,13,1555,1729,685,64,793,1478
"Bolivia","La Paz","Murillo","El Alto","ESCUELA RAFAEL PABON",231935,305,75,4175,4480,1240,279,2581,3821
"Bolivia","La Paz","Murillo","El Alto","ESCUELA RAUL SALMON DE LA BARRA",231936,282,31,3411,3693,1445,154,1781,3226
"Bolivia","La Paz","Murillo","El Alto","ESCUELA REPUBLICA DE CHINA POPULAR",231937,422,72,4824,5246,1516,168,3068,4584
"Bolivia","La Paz","Murillo","El Alto","ESCUELA TARAPACA",231928,554,71,5829,6383,1548,243,3967,5515
"Bolivia","La Paz","Murillo","El Alto","ESCUELA TEJADA TRIANGULAR",231938,273,22,2802,3075,1340,107,1333,2673
"Bolivia","La Paz","Murillo","El Alto","ESCUELA TUPAC KATARI",231939,330,45,3613,3943,1557,150,1861,3418
"Bolivia","La Paz","Murillo","El Alto","INSTITUTO EDUCATIVO JESUS DE NAZARETH",231940,459,45,4099,4558,1855,130,2069,3924
"Bolivia","La Paz","Murillo","El Alto","SEDE SOCIAL JUNTA VECINAL",231941,155,21,1394,1549,521,34,818,1339
"Bolivia","La Paz","Murillo","El Alto","SEDE VECINAL",231942,39,3,471,510,281,18,169,450
"Bolivia","La Paz","Murillo","El Alto","UNIDAD EDUCATIVA 12 DE OCTUBRE",231953,455,32,4604,5059,2562,138,1872,4434
"Bolivia","La Paz","Murillo","El Alto","UNIDAD EDUCATIVA 25 DE JULIO",231954,450,53,4141,4591,1412,204,2472,3884
"Bolivia","La Paz","Murillo","El Alto","UNIDAD EDUCATIVA 3 DE MAYO",231955,509,72,5791,6300,1877,199,3643,5520
"Bolivia","La Paz","Murillo","El Alto","UNIDAD EDUCATIVA 6 DE JUNIO",231956,476,42,4617,5093,1571,163,2841,4412
"Bolivia","La Paz","Murillo","El Alto","UNIDAD EDUCATIVA ADELA ZAMUDIO",231957,174,19,2157,2331,883,87,1168,2051
"Bolivia","La Paz","Murillo","El Alto","UNIDAD EDUCATIVA ALTO DE LA ALIANZA",231958,340,31,3555,3895,1476,146,1902,3378
"Bolivia","La Paz","Murillo","El Alto","UNIDAD EDUCATIVA AMIGOS DEL CHACO",231943,86,11,1048,1134,424,31,582,1006
"Bolivia","La Paz","Murillo","El Alto","UNIDAD EDUCATIVA ANDRES BELLO",231959,109,16,1031,1140,577,26,412,989
"Bolivia","La Paz","Murillo","El Alto","UNIDAD EDUCATIVA ANDRES BELLO (UNIDAD EDUCATIVA 16 DE JULIO)",231960,72,3,577,649,357,16,201,558
"Bolivia","La Paz","Murillo","El Alto","UNIDAD EDUCATIVA ANICETO ARCE",231961,177,30,1945,2122,776,62,1077,1853
"Bolivia","La Paz","Murillo","El Alto","UNIDAD EDUCATIVA BAUTISTA SAAVEDRA",231962,839,109,8195,9034,3042,352,4692,7734
"Bolivia","La Paz","Murillo","El Alto","UNIDAD EDUCATIVA BRASILIA",231963,424,31,4386,4810,2189,148,2018,4207
"Bolivia","La Paz","Murillo","El Alto","UNIDAD EDUCATIVA CARLOS PALENQUE",231964,334,21,3284,3618,1331,154,1778,3109
"Bolivia","La Paz","Murillo","El Alto","UNIDAD EDUCATIVA CRISTAL",231944,68,12,1343,1411,390,32,909,1299
"Bolivia","La Paz","Murillo","El Alto","UNIDAD EDUCATIVA DONOZO TORRES",231965,360,20,3654,4014,2192,105,1337,3529
"Bolivia","La Paz","Murillo","El Alto","UNIDAD EDUCATIVA ECOLOGICO LOS PINOS",231966,506,47,4661,5167,1207,202,3205,4412
"Bolivia","La Paz","Murillo","El Alto","UNIDAD EDUCATIVA EDUARDO AVAROA I",231967,45,17,638,683,201,27,393,594
"Bolivia","La Paz","Murillo","El Alto","UNIDAD EDUCATIVA EVA PERON",231968,437,35,4267,4704,2171,150,1911,4082
"Bolivia","La Paz","Murillo","El Alto","UNIDAD EDUCATIVA FRANZ TAMAYO",231969,484,54,5632,6116,1700,232,3646,5346
"Bolivia","La Paz","Murillo","El Alto","UNIDAD EDUCATIVA FUERZA AEREA ARGENTINA",231945,66,16,934,1000,283,46,589,872
"Bolivia","La Paz","Murillo","El Alto","UNIDAD EDUCATIVA GRAL. ARMANDO ESCOBAR URIA",231946,145,3,1622,1767,1077,52,490,1567
"Bolivia","La Paz","Murillo","El Alto","UNIDAD EDUCATIVA GRAN PODER",231970,261,18,2224,2485,850,91,1265,2115
"Bolivia","La Paz","Murillo","El Alto","UNIDAD EDUCATIVA ILLIMANI",231971,441,56,4632,5073,1563,258,2755,4318
"Bolivia","La Paz","Murillo","El Alto","UNIDAD EDUCATIVA INGAVI",231972,421,55,4620,5041,1480,261,2824,4304
"Bolivia","La Paz","Murillo","El Alto","UNIDAD EDUCATIVA INTEGRACION",231973,310,25,2597,2907,1405,84,1083,2488
"Bolivia","La Paz","Murillo","El Alto","UNIDAD EDUCATIVA JUAN CAPRILES",231974,357,36,3402,3759,1632,96,1638,3270
"Bolivia","La Paz","Murillo","El Alto","UNIDAD EDUCATIVA JUAN JOSE TORRES",231975,522,59,5218,5740,1935,197,3027,4962
"Bolivia","La Paz","Murillo","El Alto","UNIDAD EDUCATIVA LA PAZ",231976,340,34,2798,3138,1226,106,1432,2658
"Bolivia","La Paz","Murillo","El Alto","UNIDAD EDUCATIVA MARISCAL ANTONIO JOSE E",231977,638,73,6087,6725,1994,312,3708,5702
"Bolivia","La Paz","Murillo","El Alto","UNIDAD EDUCATIVA MERCEDES ELIO DE RIVERO",231978,300,46,3477,3777,973,116,2342,3315
"Bolivia","La Paz","Murillo","El Alto","UNIDAD EDUCATIVA M. QUIROGA SANTA CRUZ",231998,242,32,2762,3004,1151,116,1463,2614
"Bolivia","La Paz","Murillo","El Alto","UNIDAD EDUCATIVA NORUEGA",231979,559,75,5561,6120,2065,300,3121,5186
"Bolivia","La Paz","Murillo","El Alto","UNIDAD EDUCATIVA OSCAR ALFARO",231947,444,61,4838,5282,1745,229,2803,4548
"Bolivia","La Paz","Murillo","El Alto","UNIDAD EDUCATIVA PABLO ZARATE VILLCA",231980,23,4,403,426,126,22,251,377
"Bolivia","La Paz","Murillo","El Alto","UNIDAD EDUCATIVA PARTICULAR INTERANDINO BOLIVIANO",231948,34,2,196,230,99,8,87,186
"Bolivia","La Paz","Murillo","El Alto","UNIDAD EDUCATIVA PROGRESO",231981,449,97,5662,6111,1942,284,3339,5281
"Bolivia","La Paz","Murillo","El Alto","UNIDAD EDUCATIVA REP. DEL URUGUAY",231982,40,8,550,590,228,17,297,525
"Bolivia","La Paz","Murillo","El Alto","UNIDAD EDUCATIVA REPUBLICA DE CUBA",231983,425,64,5159,5584,1716,234,3145,4861
"Bolivia","La Paz","Murillo","El Alto","UNIDAD EDUCATIVA REPUBLICA DE CUBA",231984,425,64,5159,5584,1716,234,3145,4861
"Bolivia","La Paz","Murillo","El Alto","UNIDAD EDUCATIVA REPUBLICA DE FRANCIA",231985,686,64,6429,7115,2256,285,3824,6080
"Bolivia","La Paz","Murillo","El Alto","UNIDAD EDUCATIVA SAN ANDRES",231949,165,13,1751,1916,724,56,958,1682
"Bolivia","La Paz","Murillo","El Alto","UNIDAD EDUCATIVA SAN JUAN DE CALAMA",231986,346,42,3643,3989,1473,121,2007,3480
"Bolivia","La Paz","Murillo","El Alto","UNIDAD EDUCATIVA SAN LUIS",231987,468,45,4851,5319,1876,169,2761,4637
"Bolivia","La Paz","Murillo","El Alto","UNIDAD EDUCATIVA SAN ROQUE",231988,1063,189,11300,12363,3640,629,6842,10482
"Bolivia","La Paz","Murillo","El Alto","UNIDAD EDUCATIVA SANTA ROSA DE LIMA",231989,179,21,1769,1948,504,121,1123,1627
"Bolivia","La Paz","Murillo","El Alto","UNIDAD EDUCATIVA SANTIAGO I",231990,481,31,4108,4589,1971,154,1952,3923
"Bolivia","La Paz","Murillo","El Alto","UNIDAD EDUCATIVA TECNICA YUNGUYO",231991,393,59,4853,5246,1809,184,2801,4610
"Bolivia","La Paz","Murillo","El Alto","UNIDAD EDUCATIVA THE STRONGEST",231992,191,23,2072,2263,743,113,1193,1936
"Bolivia","La Paz","Murillo","El Alto","UNIDAD EDUCATIVA TOKIO",231950,254,22,2749,3003,901,195,1631,2532
"Bolivia","La Paz","Murillo","El Alto","UNIDAD EDUCATIVA TUPAC AMARU",231993,208,15,2137,2345,642,88,1392,2034
"Bolivia","La Paz","Murillo","El Alto","UNIDAD EDUCATIVA UNION EUROPEA",231994,1265,109,12979,14244,6059,474,6337,12396
"Bolivia","La Paz","Murillo","El Alto","UNIDAD EDUCATIVA VILLA ADELA YUNGUYO",231951,380,45,3453,3833,1447,167,1794,3241
"Bolivia","La Paz","Murillo","El Alto","UNIDAD EDUCATIVA VILLA ADELA YUNGUYO",231952,380,45,3453,3833,1447,167,1794,3241
"Bolivia","La Paz","Murillo","El Alto","UNIDAD EDUCATIVA VILLA ALEMANIA",231996,345,28,3017,3362,1348,116,1525,2873
"Bolivia","La Paz","Murillo","El Alto","UNIDAD EDUCATIVA VILLA COOPERATIVA",231997,415,83,4399,4814,1389,197,2730,4119
"Bolivia","La Paz","Murillo","La Paz","CANCHA DEPORTIVA",231682,488,31,4394,4882,2337,98,1928,4265
"Bolivia","La Paz","Murillo","La Paz","CANCHA DEPORTIVA",231683,488,31,4394,4882,2337,98,1928,4265
"Bolivia","La Paz","Murillo","La Paz","C. E. ADVENTISTA BELLO HORIZONTE",231687,49,3,276,325,170,4,99,269
"Bolivia","La Paz","Murillo","La Paz","CENTRO DE CAPACITACION INTI PAXSI",231688,147,20,1528,1675,906,25,577,1483
"Bolivia","La Paz","Murillo","La Paz","COF MIRAFLORES",231684,19,1,37,56,24,0,12,36
"Bolivia","La Paz","Murillo","La Paz","COF OBRAJES",231685,49,0,91,140,55,3,33,88
"Bolivia","La Paz","Murillo","La Paz","COLEGIO 6 DE JUNIO",231698,749,37,7987,8736,5501,162,2287,7788
"Bolivia","La Paz","Murillo","La Paz","COLEGIO ADOLFO COSTA DU RELS",231699,937,107,9552,10489,3476,413,5556,9032
"Bolivia","La Paz","Murillo","La Paz","COLEGIO AMERICAN SCHOOL",231689,174,5,1645,1819,1132,28,480,1612
"Bolivia","La Paz","Murillo","La Paz","COLEGIO AMOR DE DIOS",231690,492,14,3097,3589,2449,48,586,3035
"Bolivia","La Paz","Murillo","La Paz","COLEGIO AMORETTI",231700,359,35,2687,3046,1965,62,625,2590
"Bolivia","La Paz","Murillo","La Paz","COLEGIO ANTONIO DIAZ VILLAMIL",231701,416,9,3298,3714,2229,59,1001,3230
"Bolivia","La Paz","Murillo","La Paz","COLEGIO AVE MARIA",231702,999,85,8459,9458,5018,223,3133,8151
"Bolivia","La Paz","Murillo","La Paz","COLEGIO AVE MARIA",231703,999,85,8459,9458,5018,223,3133,8151
"Bolivia","La Paz","Murillo","La Paz","COLEGIO BOLIVAR",231704,219,4,1926,2145,1410,37,475,1885
"Bolivia","La Paz","Murillo","La Paz","COLEGIO CANADA",231691,338,23,3090,3428,1674,84,1309,2983
"Bolivia","La Paz","Murillo","La Paz","COLEGIO CANADIENSE",231705,138,5,1267,1405,932,10,320,1252
"Bolivia","La Paz","Murillo","La Paz","COLEGIO CARACAS",231692,164,19,2109,2273,854,71,1165,2019
"Bolivia","La Paz","Murillo","La Paz","COLEGIO CERVANTES",231693,241,5,2333,2574,1925,28,375,2300
"Bolivia","La Paz","Murillo","La Paz","COLEGIO COPACABANA",231694,615,41,6023,6638,3634,164,2184,5818
"Bolivia","La Paz","Murillo","La Paz","COLEGIO CRISTO REY",231695,472,38,5029,5501,2771,162,2058,4829
"Bolivia","La Paz","Murillo","La Paz","COLEGIO DANIEL SANCHEZ BUSTAMANTE",231697,951,63,7627,8578,3660,200,3704,7364
"Bolivia","La Paz","Murillo","La Paz","COLEGIO DANIEL SANCHEZ BUSTAMANTE",231696,951,63,7627,8578,3660,200,3704,7364
"Bolivia","La Paz","Murillo","La Paz","COLEGIO DELIA GAMBARTE",231706,214,14,1670,1884,661,96,899,1560
"Bolivia","La Paz","Murillo","La Paz","COLEGIO DON BOSCO",231707,480,37,4722,5202,2385,178,2122,4507
"Bolivia","La Paz","Murillo","La Paz","COLEGIO EXPERIMENTAL HUGO DAVILA",231731,531,19,4620,5151,3472,84,1045,4517
"Bolivia","La Paz","Murillo","La Paz","COLEGIO FELIPE 1DO. GUZMAN",231732,420,4,2238,2658,1689,44,501,2190
"Bolivia","La Paz","Murillo","La Paz","COLEGIO FRANCIA",231708,167,10,1655,1822,966,63,616,1582
"Bolivia","La Paz","Murillo","La Paz","COLEGIO FRANCO BOLIVIANO",231709,1454,27,9591,11045,7542,152,1870,9412
"Bolivia","La Paz","Murillo","La Paz","COLEGIO FRANZ TAMAYO",231733,621,43,6283,6904,3522,133,2585,6107
"Bolivia","La Paz","Murillo","La Paz","COLEGIO GERMAN BUSCH",231710,301,12,2679,2980,1835,71,761,2596
"Bolivia","La Paz","Murillo","La Paz","COLEGIO GREGORIO REYNOLDS",231734,403,12,3564,3967,2513,106,933,3446
"Bolivia","La Paz","Murillo","La Paz","COLEGIO GUILLEN PINTO",231735,440,59,4970,5410,2167,111,2633,4800
"Bolivia","La Paz","Murillo","La Paz","COLEGIO HERSCHELL",231736,639,23,4356,4995,3064,89,1180,4244
"Bolivia","La Paz","Murillo","La Paz","COLEGIO HOLANDA",231711,1282,103,11070,12352,5057,312,5598,10655
"Bolivia","La Paz","Murillo","La Paz","COLEGIO HOLANDA",231712,1282,103,11070,12352,5057,312,5598,10655
"Bolivia","La Paz","Murillo","La Paz","COLEGIO IGNACIO CALDERON",231713,448,30,4516,4964,2644,88,1754,4398
"Bolivia","La Paz","Murillo","La Paz","COLEGIO IRENE NAVA",231714,777,50,6498,7275,3348,174,2926,6274
"Bolivia","La Paz","Murillo","La Paz","COLEGIO ITALIA",231715,477,40,4954,5431,2332,142,2440,4772
"Bolivia","La Paz","Murillo","La Paz","COLEGIO ITALIA",231716,477,40,4954,5431,2332,142,2440,4772
"Bolivia","La Paz","Murillo","La Paz","COLEGIO JERUSALEM",231717,347,31,3295,3642,1462,119,1683,3145
"Bolivia","La Paz","Murillo","La Paz","COLEGIO LORETTO",231737,368,7,2531,2899,2168,35,321,2489
"Bolivia","La Paz","Murillo","La Paz","COLEGIO LUIS ALBERTO PABON",231718,164,5,1608,1772,1018,58,527,1545
"Bolivia","La Paz","Murillo","La Paz","COLEGIO LUIS ESPINAL CAMPS",231738,759,79,7471,8230,2797,297,4298,7095
"Bolivia","La Paz","Murillo","La Paz","COLEGIO LUIS VELASCO FLORES",231739,80,21,1440,1520,428,37,954,1382
"Bolivia","La Paz","Murillo","La Paz","COLEGIO MARIA AUXILIADORA",231740,224,14,2250,2474,1613,56,567,2180
"Bolivia","La Paz","Murillo","La Paz","COLEGIO MARIEN GARTEN",231741,436,33,4756,5192,2232,115,2376,4608
"Bolivia","La Paz","Murillo","La Paz","COLEGIO MAX TOLEDO",231719,694,62,6847,7541,3709,171,2905,6614
"Bolivia","La Paz","Murillo","La Paz","COLEGIO MAX TOLEDO",231720,694,62,6847,7541,3709,171,2905,6614
"Bolivia","La Paz","Murillo","La Paz","COLEGIO NACIONAL AYACUCHO",231742,257,5,1650,1907,1077,41,527,1604
"Bolivia","La Paz","Murillo","La Paz","COLEGIO NUESTRA SEÑORA DE FATIMA",231721,260,12,2429,2689,1246,104,1067,2313
"Bolivia","La Paz","Murillo","La Paz","COLEGIO RENE BARRIENTOS",231722,404,10,2490,2894,2055,34,391,2446
"Bolivia","La Paz","Murillo","La Paz","COLEGIO SAINT PETERS",231723,171,36,1737,1908,1289,23,389,1678
"Bolivia","La Paz","Murillo","La Paz","COLEGIO SAN FRANCISCO",231743,221,12,1804,2025,1268,48,476,1744
"Bolivia","La Paz","Murillo","La Paz","COLEGIO SAN IGNACIO",231724,826,10,2927,3753,2340,40,537,2877
"Bolivia","La Paz","Murillo","La Paz","COLEGIO SAN JAVIER",231744,205,9,2253,2458,1500,62,682,2182
"Bolivia","La Paz","Murillo","La Paz","COLEGIO SAN LUIS",231725,570,27,6069,6639,3939,105,1998,5937
"Bolivia","La Paz","Murillo","La Paz","COLEGIO SAN MARTIN",231745,265,16,2143,2408,1349,50,728,2077
"Bolivia","La Paz","Murillo","La Paz","COLEGIO SANTA ANA",231746,156,6,1384,1540,1065,15,298,1363
"Bolivia","La Paz","Murillo","La Paz","COLEGIO SERGIO ALMARAZ",231747,439,19,4025,4464,2262,126,1618,3880
"Bolivia","La Paz","Murillo","La Paz","COLEGIO SERGIO VILLEGAS",231726,512,46,4716,5228,2035,165,2470,4505
"Bolivia","La Paz","Murillo","La Paz","COLEGIO SIMON RODRIGUEZ",231727,493,28,3834,4327,2054,80,1672,3726
"Bolivia","La Paz","Murillo","La Paz","COLEGIO TOPATER",231728,320,28,3267,3587,1508,93,1638,3146
"Bolivia","La Paz","Murillo","La Paz","COLEGIO VILLARROEL",231730,378,19,3172,3550,1967,79,1107,3074
"Bolivia","La Paz","Murillo","La Paz","COLEGIO VILLARROEL",231729,378,19,3172,3550,1967,79,1107,3074
"Bolivia","La Paz","Murillo","La Paz","COMPLEJO DEPORTIVO CAMIRI",231748,228,7,2261,2489,1551,40,663,2214
"Bolivia","La Paz","Murillo","La Paz","COMPLEJO DEPORTIVO SAN LUIS",231749,93,3,1118,1211,817,26,272,1089
"Bolivia","La Paz","Murillo","La Paz","COOP. EDUCACIONAL SAN MARCOS LTDA",231750,110,2,910,1020,639,19,250,889
"Bolivia","La Paz","Murillo","La Paz","DIR DISTRITAL DE EDUCACION",231751,296,13,2235,2531,1636,30,556,2192
"Bolivia","La Paz","Murillo","La Paz","E.N.S.A.F.",231752,249,6,2128,2377,1691,26,405,2096
"Bolivia","La Paz","Murillo","La Paz","ESCUELA 13 DE JUNIO CHINCHAYA",231790,56,18,653,709,132,19,484,616
"Bolivia","La Paz","Murillo","La Paz","ESCUELA 6 DE AGOSTO",231791,236,18,2365,2601,1569,49,729,2298
"Bolivia","La Paz","Murillo","La Paz","ESCUELA ABRAHAM LINCOLN",231753,294,31,3303,3597,1529,109,1634,3163
"Bolivia","La Paz","Murillo","La Paz","ESCUELA AGUSTIN ASPIAZU",231792,447,11,3167,3614,2455,62,639,3094
"Bolivia","La Paz","Murillo","La Paz","ESCUELA ALCIDES ARGUEDAS",231754,135,4,1163,1298,738,23,398,1136
"Bolivia","La Paz","Murillo","La Paz","ESCUELA ALFREDO VARGAS",231755,504,22,4654,5158,2764,167,1701,4465
"Bolivia","La Paz","Murillo","La Paz","ESCUELA ALONZO DE MENDOZA",231756,109,1,849,958,645,17,186,831
"Bolivia","La Paz","Murillo","La Paz","ESCUELA ALONZO DE MENDOZA (UNIDAD EDUCATIVA BICHITO DE LUZ)",231757,423,6,3195,3618,2488,82,619,3107
"Bolivia","La Paz","Murillo","La Paz","ESCUELA ALTO ACHUMANI",231793,618,46,6259,6877,3573,129,2511,6084
"Bolivia","La Paz","Murillo","La Paz","ESCUELA ALTO TEMBLADERANI",231758,152,13,1316,1468,444,41,818,1262
"Bolivia","La Paz","Murillo","La Paz","ESCUELA CALLAPA (PLAZA DE CALLAPA)",231794,140,13,1291,1431,327,55,896,1223
"Bolivia","La Paz","Murillo","La Paz","ESCUELA CHASQUIPAMPA",231795,1021,79,10620,11641,4104,312,6125,10229
"Bolivia","La Paz","Murillo","La Paz","ESCUELA CHUCURA",231759,2,4,62,64,12,7,39,51
"Bolivia","La Paz","Murillo","La Paz","ESCUELA CIUDAD DEL NIÑO",231796,223,18,2315,2538,1129,111,1057,2186
"Bolivia","La Paz","Murillo","La Paz","ESCUELA CLUB DE LEONES",231760,805,66,8556,9361,4139,267,4084,8223
"Bolivia","La Paz","Murillo","La Paz","ESCUELA CLUB DE LEONES",231761,805,66,8556,9361,4139,267,4084,8223
"Bolivia","La Paz","Murillo","La Paz","ESCUELA ECUADOR",231762,403,12,2193,2596,1785,23,373,2158
"Bolivia","La Paz","Murillo","La Paz","ESCUELA EDUARDO AVAROA",231763,583,31,5181,5764,3038,133,1979,5017
"Bolivia","La Paz","Murillo","La Paz","ESCUELA EDUCACIONAL LUIS ERNEST",231764,154,9,1860,2014,1069,52,730,1799
"Bolivia","La Paz","Murillo","La Paz","ESCUELA ELOY ALVAREZ PLATA",231797,157,2,1559,1716,1077,35,445,1522
"Bolivia","La Paz","Murillo","La Paz","ESCUELA FRANCISCO DE MIRANDA",231765,429,42,4542,4971,1991,133,2376,4367
"Bolivia","La Paz","Murillo","La Paz","ESCUELA GENOVEVA RIOS",231766,561,34,5280,5841,2583,163,2500,5083
"Bolivia","La Paz","Murillo","La Paz","ESCUELA GIL TAPIA RADA",231767,358,52,4327,4685,2055,118,2102,4157
"Bolivia","La Paz","Murillo","La Paz","ESCUELA GRAL. JOSE MANUEL PANDO",231768,155,13,1820,1975,940,41,826,1766
"Bolivia","La Paz","Murillo","La Paz","ESCUELA IND PEDRO DOMINGO MURILLO",231769,542,44,4544,5086,2448,135,1917,4365
"Bolivia","La Paz","Murillo","La Paz","ESCUELA JOHN F. KENNEDY",231798,139,5,1301,1440,764,29,503,1267
"Bolivia","La Paz","Murillo","La Paz","ESCUELA JOSE SANTOS",231770,349,40,3453,3802,1248,124,2041,3289
"Bolivia","La Paz","Murillo","La Paz","ESCUELA JUAN PABLO II",231799,318,14,2822,3140,2154,39,615,2769
"Bolivia","La Paz","Murillo","La Paz","ESCUELA LADISLAO CABRERA",231771,568,44,5104,5672,2501,170,2389,4890
"Bolivia","La Paz","Murillo","La Paz","ESCUELA LA MERCED",231772,692,74,6376,7068,2523,180,3599,6122
"Bolivia","La Paz","Murillo","La Paz","ESCUELA LIMANIPATA 10 DE JUNIO",231773,113,14,1442,1555,421,35,972,1393
"Bolivia","La Paz","Murillo","La Paz","ESCUELA MCAL SANTA CRUZ",231774,78,3,660,738,412,12,233,645
"Bolivia","La Paz","Murillo","La Paz","ESCUELA MSCAL ANDRES DE SANTA CRUZ",231775,25,3,205,230,41,2,159,200
"Bolivia","La Paz","Murillo","La Paz","ESCUELA MSCAL ANTONIO JOSE DE SUCRE",231776,57,21,722,779,183,12,506,689
"Bolivia","La Paz","Murillo","La Paz","ESCUELA NATALIA PALACIOS",231777,311,20,2708,3019,1921,49,718,2639
"Bolivia","La Paz","Murillo","La Paz","ESCUELA NICOLAS FERNANDEZ NARANJO",231778,803,90,8289,9092,3687,219,4293,7980
"Bolivia","La Paz","Murillo","La Paz","ESCUELA PABLO ITURRI",231779,620,60,5124,5744,1729,178,3157,4886
"Bolivia","La Paz","Murillo","La Paz","ESCUELA PANAMA",231780,450,7,3456,3906,2736,68,645,3381
"Bolivia","La Paz","Murillo","La Paz","ESCUELA PEDRO POVEDA",231800,408,22,3418,3826,1789,96,1511,3300
"Bolivia","La Paz","Murillo","La Paz","ESCUELA PEDRO POVEDA",231801,408,22,3418,3826,1789,96,1511,3300
"Bolivia","La Paz","Murillo","La Paz","ESCUELA PILOTO NACIONES UNIDAS",231802,132,7,1191,1323,877,20,287,1164
"Bolivia","La Paz","Murillo","La Paz","ESCUELA REMBERTO TAPIA",231781,399,42,4556,4955,2112,146,2256,4368
"Bolivia","La Paz","Murillo","La Paz","ESCUELA REPUBLICA DE JAPON",231803,634,47,5956,6590,2582,191,3136,5718
"Bolivia","La Paz","Murillo","La Paz","ESCUELA REPUBLICA DE JAPON",231804,634,47,5956,6590,2582,191,3136,5718
"Bolivia","La Paz","Murillo","La Paz","ESCUELA REPUBLICA DEL BRASIL",231805,263,13,2453,2716,1571,57,812,2383
"Bolivia","La Paz","Murillo","La Paz","ESCUELA REPUBLICA DEL PERU",231782,102,1,588,690,452,9,126,578
"Bolivia","La Paz","Murillo","La Paz","ESCUELA ROSEMARI DE BARRIENTOS",231806,1191,18,7850,9041,6275,101,1456,7731
"Bolivia","La Paz","Murillo","La Paz","ESCUELA RURAL CANAVIRI",231783,26,8,187,213,54,2,123,177
"Bolivia","La Paz","Murillo","La Paz","ESCUELA SAGRADO CORAZON DE JESUS",231784,683,56,7063,7746,2748,200,4059,6807
"Bolivia","La Paz","Murillo","La Paz","ESCUELA SAN JOSE",231785,348,21,3872,4220,2099,95,1657,3756
"Bolivia","La Paz","Murillo","La Paz","ESCUELA SAN MARTIN",231786,666,42,6132,6798,3862,233,1995,5857
"Bolivia","La Paz","Murillo","La Paz","ESCUELA SAN MIGUEL",231787,51,6,488,539,115,13,354,469
"Bolivia","La Paz","Murillo","La Paz","ESCUELA SANTA ROSA DE LIMA",231788,448,63,5381,5829,1329,192,3797,5126
"Bolivia","La Paz","Murillo","La Paz","ESCUELA SANTA ROSA LA FLORIDA",231807,605,19,3640,4245,2534,57,1030,3564
"Bolivia","La Paz","Murillo","La Paz","ESCUELA SERGIO SUAREZ",231789,670,57,6254,6924,2747,164,3286,6033
"Bolivia","La Paz","Murillo","La Paz","ESCUELA SUPERIOR DE FORMACIÓN DE MAESTROS SIMON BOLIVAR",231808,255,16,2820,3075,1843,70,891,2734
"Bolivia","La Paz","Murillo","La Paz","ESCUELA VICTOR PAZ ESTENSORO",231809,324,24,2934,3258,1563,77,1270,2833
"Bolivia","La Paz","Murillo","La Paz","ESCUELA WALTER STRAUB",231810,534,13,4299,4833,2707,135,1444,4151
"Bolivia","La Paz","Murillo","La Paz","FACULTAD DE TECNOLOGIA (U.M.S.A)",231811,216,3,1075,1291,883,17,172,1055
"Bolivia","La Paz","Murillo","La Paz","INSTITUTO AMERICANO",231812,518,32,4253,4771,3290,107,824,4114
"Bolivia","La Paz","Murillo","La Paz","INSTITUTO AMERICANO",231813,518,32,4253,4771,3290,107,824,4114
"Bolivia","La Paz","Murillo","La Paz","INSTITUTO AMERICANO OBRAJES",231814,469,17,4081,4550,3137,79,848,3985
"Bolivia","La Paz","Murillo","La Paz","INSTITUTO DOMINGO SAVIO",231815,377,11,1687,2064,1337,26,313,1650
"Bolivia","La Paz","Murillo","La Paz","INSTITUTO MENDEZ ARCOS",231816,356,10,3726,4082,2767,62,887,3654
"Bolivia","La Paz","Murillo","La Paz","KINDER BOLIVIA",231817,203,20,2238,2441,942,57,1219,2161
"Bolivia","La Paz","Murillo","La Paz","KINDER FLORA PEREZ DE SAAVEDRA",231818,137,18,1613,1750,895,50,650,1545
"Bolivia","La Paz","Murillo","La Paz","KINDER NAZARIO PARDO",231819,213,8,1861,2074,1047,61,745,1792
"Bolivia","La Paz","Murillo","La Paz","LICEO BOLIVIA",231820,181,6,1296,1477,1035,31,224,1259
"Bolivia","La Paz","Murillo","La Paz","LICEO LA PAZ",231821,184,2,1210,1394,881,24,303,1184
"Bolivia","La Paz","Murillo","La Paz","LICEO TEC. H. NUESTRA SRA DE LA PAZ",231822,220,4,1729,1949,1161,41,523,1684
"Bolivia","La Paz","Murillo","La Paz","PANOPTICO",231686,288,4,491,779,238,16,233,471
"Bolivia","La Paz","Murillo","La Paz","PARQUE MIRADOR KILLI KILLI",231823,269,19,2437,2706,1555,89,774,2329
"Bolivia","La Paz","Murillo","La Paz","PLAZA DANIEL RODRIGUEZ",231824,240,9,2405,2645,1329,54,1013,2342
"Bolivia","La Paz","Murillo","La Paz","POLIFUNCIONAL SAN ISIDRO (IGLESIA SAN ISIDRO)",231825,176,17,1566,1742,814,47,688,1502
"Bolivia","La Paz","Murillo","La Paz","SEDE JUNTA VECINAL",231826,47,8,587,634,247,6,326,573
"Bolivia","La Paz","Murillo","La Paz","SEDE SOCIAL CAJA FERROVIARIA",231827,111,11,1350,1461,414,30,895,1309
"Bolivia","La Paz","Murillo","La Paz","SEDE SOCIAL CARPANI",231828,42,27,491,533,34,10,420,454
"Bolivia","La Paz","Murillo","La Paz","SEDE SOCIAL DE CUSICANCHA",231829,113,15,1205,1318,476,49,665,1141
"Bolivia","La Paz","Murillo","La Paz","SEDE SOCIAL PLAN AUTOPISTA",231830,164,16,1598,1762,775,45,762,1537
"Bolivia","La Paz","Murillo","La Paz","SEDE SOCIAL PURA PURA",231831,222,7,2201,2423,1105,64,1025,2130
"Bolivia","La Paz","Murillo","La Paz","SEDE SOCIAL VILLA LITORAL",231832,91,15,1008,1099,466,22,505,971
"Bolivia","La Paz","Murillo","La Paz","SEMINARIO NAZARENO",231833,101,1,554,655,427,8,118,545
"Bolivia","La Paz","Murillo","La Paz","TECNICO AYACUCHO",231834,1357,58,11903,13260,8561,237,3047,11608
"Bolivia","La Paz","Murillo","La Paz","TECNICO AYACUCHO",231835,1357,58,11903,13260,8561,237,3047,11608
"Bolivia","La Paz","Murillo","La Paz","UNIDAD EDUCATIVA 20 DE OCTUBRE N° 1",231866,107,21,1283,1390,354,30,878,1232
"Bolivia","La Paz","Murillo","La Paz","UNIDAD EDUCATIVA 24 DE JUNIO",231847,554,47,5633,6187,2554,215,2817,5371
"Bolivia","La Paz","Murillo","La Paz","UNIDAD EDUCATIVA ABRAHAM REYES (FE Y ALEGRIA)",231836,555,58,5865,6420,2519,167,3121,5640
"Bolivia","La Paz","Murillo","La Paz","UNIDAD EDUCATIVA ANDINA",231837,252,16,1986,2238,1079,39,852,1931
"Bolivia","La Paz","Murillo","La Paz","UNIDAD EDUCATIVA ARABE DE EGIPTO",231848,150,13,1683,1833,1044,26,600,1644
"Bolivia","La Paz","Murillo","La Paz","UNIDAD EDUCATIVA CARLOS MEDINACELLI",231849,484,20,4452,4936,2561,134,1737,4298
"Bolivia","La Paz","Murillo","La Paz","UNIDAD EDUCATIVA CARLOS SALINAS",231838,60,2,503,563,326,14,161,487
"Bolivia","La Paz","Murillo","La Paz","UNIDAD EDUCATIVA CRISTIANA VIDA NUEVA",231850,257,13,2715,2972,1681,66,955,2636
"Bolivia","La Paz","Murillo","La Paz","UNIDAD EDUCATIVA EL PEDREGAL (URB. PEDREGAL)",231839,86,10,1091,1177,375,35,671,1046
"Bolivia","La Paz","Murillo","La Paz","UNIDAD EDUCATIVA FABRIL 18 DE MAYO",231851,321,14,2914,3235,1856,67,977,2833
"Bolivia","La Paz","Murillo","La Paz","UNIDAD EDUCATIVA FABRIL 18 DE MAYO",231852,321,14,2914,3235,1856,67,977,2833
"Bolivia","La Paz","Murillo","La Paz","UNIDAD EDUCATIVA FF. AA. DE LA NACIÓN",231840,358,17,2923,3281,1732,76,1098,2830
"Bolivia","La Paz","Murillo","La Paz","UNIDAD EDUCATIVA FILADELFIA",231841,53,11,763,816,279,36,437,716
"Bolivia","La Paz","Murillo","La Paz","UNIDAD EDUCATIVA GRAN BRETAÑA",231842,10,0,76,86,43,1,32,75
"Bolivia","La Paz","Murillo","La Paz","UNIDAD EDUCATIVA HUGO BANZER SUAREZ",231868,178,15,1665,1843,909,28,713,1622
"Bolivia","La Paz","Murillo","La Paz","UNIDAD EDUCATIVA JAIME ESCALANTE",231869,414,55,3784,4198,1398,106,2225,3623
"Bolivia","La Paz","Murillo","La Paz","UNIDAD EDUCATIVA JOAQUIN HERNANN",231870,95,25,1081,1176,172,19,865,1037
"Bolivia","La Paz","Murillo","La Paz","UNIDAD EDUCATIVA JORGE VARGAS",231871,213,11,2192,2405,1060,93,1028,2088
"Bolivia","La Paz","Murillo","La Paz","UNIDAD EDUCATIVA JUPAPINA",231853,144,11,1176,1320,524,40,601,1125
"Bolivia","La Paz","Murillo","La Paz","UNIDAD EDUCATIVA KINDER CAROLA IÑIGUEZ (FE Y ALEGRIA)",231843,188,10,1615,1803,658,32,915,1573
"Bolivia","La Paz","Murillo","La Paz","UNIDAD EDUCATIVA LITORAL A",231854,374,23,3347,3721,1673,96,1555,3228
"Bolivia","La Paz","Murillo","La Paz","UNIDAD EDUCATIVA LOS PINOS",231855,663,13,4322,4985,3695,100,514,4209
"Bolivia","La Paz","Murillo","La Paz","UNIDAD EDUCATIVA MALLASA",231856,169,17,1674,1843,775,36,846,1621
"Bolivia","La Paz","Murillo","La Paz","UNIDAD EDUCATIVA PANTALEON DALENCE",231844,165,10,1890,2055,1199,44,637,1836
"Bolivia","La Paz","Murillo","La Paz","UNIDAD EDUCATIVA PRIVADA LA PAZ",231857,151,12,1459,1610,796,35,616,1412
"Bolivia","La Paz","Murillo","La Paz","UNIDAD EDUCATIVA PRIVADA LA PAZ",231858,151,12,1459,1610,796,35,616,1412
"Bolivia","La Paz","Murillo","La Paz","UNIDAD EDUCATIVA PUERTO RICO",231859,345,30,3573,3918,1885,120,1538,3423
"Bolivia","La Paz","Murillo","La Paz","UNIDAD EDUCATIVA RAUL SALMON DE LA BARRA",231872,293,31,2955,3248,1034,97,1793,2827
"Bolivia","La Paz","Murillo","La Paz","UNIDAD EDUCATIVA REPUBLICA DE CHINA",231860,300,16,2812,3112,1704,69,1023,2727
"Bolivia","La Paz","Murillo","La Paz","UNIDAD EDUCATIVA REPUBLICA DE CUBA",231861,334,14,2639,2973,1903,50,672,2575
"Bolivia","La Paz","Murillo","La Paz","UNIDAD EDUCATIVA ROSARIO (URB. EL ROSARIO)",231862,24,1,507,531,284,11,211,495
"Bolivia","La Paz","Murillo","La Paz","UNIDAD EDUCATIVA SAN ANDRÉS",231845,348,11,2701,3049,2009,59,622,2631
"Bolivia","La Paz","Murillo","La Paz","UNIDAD EDUCATIVA SAN JOSE (UNIDAD EDUCATIVA MANUEL B. MARIACA)",231863,284,15,3352,3636,1943,70,1324,3267
"Bolivia","La Paz","Murillo","La Paz","UNIDAD EDUCATIVA VALLE HERMOSO",231864,256,23,3022,3278,1358,80,1561,2919
"Bolivia","La Paz","Murillo","La Paz","UNIDAD EDUCATIVA VILLA HARCA",231865,35,6,291,326,101,13,171,272
"Bolivia","La Paz","Murillo","La Paz","UNIDAD EDUCATIVA WALDO BALLIVIAN",231846,461,24,5077,5538,2780,169,2104,4884
"Bolivia","La Paz","Murillo","La Paz","UNID EDUCATIVA BETESTA",231867,227,25,2750,2977,952,99,1674,2626
"Bolivia","La Paz","Murillo","Mecapaca","COLEGIO 6 DE JUNIO",232587,5,0,270,275,38,1,231,269
"Bolivia","La Paz","Murillo","Mecapaca","COLEGIO SAN SIMON DE AYACUCHO",232588,67,9,353,420,77,13,254,331
"Bolivia","La Paz","Murillo","Mecapaca","ESCUELA EL PALOMAR",232589,76,18,1072,1148,237,33,784,1021
"Bolivia","La Paz","Murillo","Mecapaca","ESCUELA HUARICANA ALTO",232590,45,9,794,839,130,14,641,771
"Bolivia","La Paz","Murillo","Mecapaca","ESCUELA JANKOSUNI",232591,8,0,252,260,29,1,222,251
"Bolivia","La Paz","Murillo","Mecapaca","ESCUELA SANTIAGO DE COLLANA",232592,40,5,599,639,97,12,485,582
"Bolivia","La Paz","Murillo","Mecapaca","ESCUELA SIMONA MANZANEDA",232593,204,17,1878,2082,571,49,1241,1812
"Bolivia","La Paz","Murillo","Mecapaca","PLAZA PRINCIPAL HUAJCHILLA",232594,128,7,1429,1557,477,40,905,1382
"Bolivia","La Paz","Murillo","Mecapaca","UNIDAD EDUCATIVA CONDOR DE LOS ANDES",232597,14,4,336,350,38,9,285,323
"Bolivia","La Paz","Murillo","Mecapaca","UNIDAD EDUCATIVA LLUTO",232595,20,11,267,287,35,21,200,235
"Bolivia","La Paz","Murillo","Mecapaca","UNIDAD EDUCATIVA MILLOCATO",232596,19,2,315,334,37,5,271,308
"Bolivia","La Paz","Murillo","Palca","COLEGIO PEDRO DOMINGO MURILLO",232579,247,50,1923,2170,259,95,1519,1778
"Bolivia","La Paz","Murillo","Palca","ESCUELA CAYIMBAYA",232580,53,15,595,648,162,31,387,549
"Bolivia","La Paz","Murillo","Palca","ESCUELA COHONI",232581,152,46,1329,1481,147,76,1060,1207
"Bolivia","La Paz","Murillo","Palca","ESCUELA COTAÑA",232582,50,6,542,592,76,14,446,522
"Bolivia","La Paz","Murillo","Palca","ESCUELA QUILLIHUAYA",232583,107,17,935,1042,111,29,778,889
"Bolivia","La Paz","Murillo","Palca","ESCUELA TAHUAPALCA",232584,39,12,498,537,54,15,417,471
"Bolivia","La Paz","Murillo","Palca","ESCUELA TIRATA",232585,29,0,257,286,25,0,232,257
"Bolivia","La Paz","Murillo","Palca","UNIDAD EDUCATIVA UNI",232586,46,13,755,801,73,34,635,708
"Bolivia","La Paz","Nor Yungas","Coripata","CASA CULTURAL SAN JUAN DE CORIPATA",234569,39,7,498,537,70,9,412,482
"Bolivia","La Paz","Nor Yungas","Coripata","COLEGIO ANDRES DE SANTA CRUZ",234570,284,34,2254,2538,856,133,1231,2087
"Bolivia","La Paz","Nor Yungas","Coripata","COLEGIO FRAZ TAMAYO FE Y ALEGRIA",234571,146,12,1020,1166,419,58,531,950
"Bolivia","La Paz","Nor Yungas","Coripata","COLEGIO SANTIAGO TOCORONI",234572,112,8,907,1019,193,32,674,867
"Bolivia","La Paz","Nor Yungas","Coripata","ESCUELA CAPITAN LUIS REVERO SANCHEZ",234573,709,67,4092,4801,1462,156,2407,3869
"Bolivia","La Paz","Nor Yungas","Coripata","ESCUELA MILLUHUAYA ALTO",234574,74,6,735,809,194,20,515,709
"Bolivia","La Paz","Nor Yungas","Coroico","CASA DE GOBIERNO",232537,68,5,472,540,145,24,298,443
"Bolivia","La Paz","Nor Yungas","Coroico","COLEGIO TEC. HUM. CRUZ LOMA",232538,89,10,853,942,226,32,585,811
"Bolivia","La Paz","Nor Yungas","Coroico","ESCUELA FELIX REYES ORTIZ",232539,363,35,1842,2205,754,80,973,1727
"Bolivia","La Paz","Nor Yungas","Coroico","ESCUELA FRANZ TAMAYO",232540,84,9,487,571,133,13,332,465
"Bolivia","La Paz","Nor Yungas","Coroico","ESCUELA JHON F. KENNEDY",232541,53,7,513,566,96,17,393,489
"Bolivia","La Paz","Nor Yungas","Coroico","ESCUELA PACOLLO",232542,104,8,633,737,148,25,452,600
"Bolivia","La Paz","Nor Yungas","Coroico","ESCUELA SANTA ROSA DE QUILO QUILO",232543,57,8,706,763,111,19,568,679
"Bolivia","La Paz","Nor Yungas","Coroico","ESCUELA UNDUAVI",232544,7,1,58,65,13,4,40,53
"Bolivia","La Paz","Nor Yungas","Coroico","UNIDAD EDUCATIVA PUENTE ARMAS",232546,78,4,441,519,77,11,349,426
"Bolivia","La Paz","Nor Yungas","Coroico","UNIDAD EDUCATIVA SAN PEDRO",232547,361,40,2079,2440,833,77,1129,1962
"Bolivia","La Paz","Nor Yungas","Coroico","UNIDAD EDUCATIVA YOLOSA",232545,62,6,424,486,129,9,280,409
"Bolivia","La Paz","Omasuyos","Achacachi","CASA DE GOBIERNO",236429,61,26,744,805,206,33,479,685
"Bolivia","La Paz","Omasuyos","Achacachi","COLEGIO ANTOFAGASTA",236430,48,14,695,743,198,24,459,657
"Bolivia","La Paz","Omasuyos","Achacachi","COLEGIO FRANZ TAMAYO",236431,63,26,882,945,209,41,606,815
"Bolivia","La Paz","Omasuyos","Achacachi","COLEGIO MARISCAL SANTA CRUZ",236432,489,72,3710,4199,1320,204,2114,3434
"Bolivia","La Paz","Omasuyos","Achacachi","COLEGIO OMASUYOS",236433,386,76,3572,3958,1253,182,2061,3314
"Bolivia","La Paz","Omasuyos","Achacachi","COLEGIO SIMON BOLIVAR",236434,16,3,403,419,121,33,246,367
"Bolivia","La Paz","Omasuyos","Achacachi","COLEGIO SUÑASIVI",236435,84,14,641,725,140,49,438,578
"Bolivia","La Paz","Omasuyos","Achacachi","ESCUELA AJLLATA GRANDE",236437,96,37,1289,1385,515,50,687,1202
"Bolivia","La Paz","Omasuyos","Achacachi","ESCUELA APLICACION HUARIZATA",236438,191,40,1450,1641,508,89,813,1321
"Bolivia","La Paz","Omasuyos","Achacachi","ESCUELA APURAYA",236439,49,18,759,808,190,33,518,708
"Bolivia","La Paz","Omasuyos","Achacachi","ESCUELA BELEN",236440,49,11,490,539,112,22,345,457
"Bolivia","La Paz","Omasuyos","Achacachi","ESCUELA CENTRAL CASAMAYA",236441,32,6,354,386,85,27,236,321
"Bolivia","La Paz","Omasuyos","Achacachi","ESCUELA KILLOSA",236442,10,0,126,136,35,7,84,119
"Bolivia","La Paz","Omasuyos","Achacachi","ESCUELA SIMON BOLIVIAR",236436,299,80,2719,3018,969,141,1529,2498
"Bolivia","La Paz","Omasuyos","Achacachi","ESCUELA VILLA LIPE",236443,55,17,672,727,166,40,449,615
"Bolivia","La Paz","Omasuyos","Achacachi","ESCUELA WALATA CHICO",236444,31,6,260,291,60,5,189,249
"Bolivia","La Paz","Omasuyos","Achacachi","NUCLEO ECOLAR MURUMAMANI",236445,19,2,499,518,84,14,399,483
"Bolivia","La Paz","Omasuyos","Achacachi","NUCLEO EDUCATIVO TAHARI",236446,8,2,421,429,138,17,264,402
"Bolivia","La Paz","Omasuyos","Achacachi","NÚCLEO ESCOLAR CHALLUYO",236447,20,14,435,455,91,21,309,400
"Bolivia","La Paz","Omasuyos","Achacachi","NUCLEO TACAMARA",236448,88,17,831,919,193,51,570,763
"Bolivia","La Paz","Omasuyos","Achacachi","PLAZA VILLA ASUNCION DE CORPAPUTO",236449,65,14,503,568,115,20,354,469
"Bolivia","La Paz","Omasuyos","Ancoraimes","COLEGIO CAJIATA",232606,4,4,324,328,32,11,277,309
"Bolivia","La Paz","Omasuyos","Ancoraimes","COLEGIO MACAMACA",232607,37,6,663,700,116,22,519,635
"Bolivia","La Paz","Omasuyos","Ancoraimes","ESCUELA FRANZ TAMAYO",232608,186,29,1152,1338,298,74,751,1049
"Bolivia","La Paz","Omasuyos","Ancoraimes","ESCUELA SECCIONAL CHIÑAJA",232609,1,2,94,95,14,2,76,90
"Bolivia","La Paz","Omasuyos","Ancoraimes","ESCUELA SOTALAYA",232610,3,8,316,319,53,8,247,300
"Bolivia","La Paz","Omasuyos","Ancoraimes","ESCUELA TURRINI",232611,14,3,288,302,67,10,208,275
"Bolivia","La Paz","Omasuyos","Ancoraimes","MOROCOLLO PLAZA PRINCIPAL",232612,103,23,909,1012,222,49,615,837
"Bolivia","La Paz","Omasuyos","Ancoraimes","NUCLEO ESCOLAR DE PATAPATANI",232613,5,1,109,114,17,1,90,107
"Bolivia","La Paz","Omasuyos","Ancoraimes","PLAZA 14 DE FEBRERO",232614,95,10,955,1050,184,37,724,908
"Bolivia","La Paz","Omasuyos","Ancoraimes","SEDE SOCIAL CHOJÑAPATA",232615,7,0,97,104,20,1,76,96
"Bolivia","La Paz","Omasuyos","Ancoraimes","SEDE SOCIAL INKA CATURAPI",232616,20,8,285,305,105,3,169,274
"Bolivia","La Paz","Omasuyos","Ancoraimes","TEC. HUMANISTA POCOATA GRANDE",232617,31,13,597,628,138,24,422,560
"Bolivia","La Paz","Omasuyos","Chua Cocani","CASA DE GOBIERNO",236450,53,7,480,533,162,14,297,459
"Bolivia","La Paz","Omasuyos","Chua Cocani","ESCUELA CHUA COCANI",236451,150,11,725,875,265,31,418,683
"Bolivia","La Paz","Omasuyos","Chua Cocani","ESCUELA CORPACHILAYA",236452,39,5,330,369,120,10,195,315
"Bolivia","La Paz","Omasuyos","Chua Cocani","UNIDAD EDUCATIVA COMPI",236453,55,21,704,759,166,32,485,651
"Bolivia","La Paz","Omasuyos","Huarina","CASA DE GOBIERNO",236404,46,2,380,426,78,6,294,372
"Bolivia","La Paz","Omasuyos","Huarina","ESCUELA APUVILLQUE MOROCOLLO",236405,38,12,312,350,75,23,202,277
"Bolivia","La Paz","Omasuyos","Huarina","ESCUELA BERNABE LEDEZMA",236406,57,13,574,631,182,26,353,535
"Bolivia","La Paz","Omasuyos","Huarina","ESCUELA MARISCAL DE SANTA CRUZ",236407,305,49,2169,2474,705,103,1312,2017
"Bolivia","La Paz","Omasuyos","Huarina","ESCUELA UNIDAD EDUCATIVAO COROMATA BAJA",236408,35,8,323,358,113,11,191,304
"Bolivia","La Paz","Omasuyos","Huatajata","COLEGIO NACIONAL MIXTO HUATAJATA",236454,170,26,1382,1552,536,51,769,1305
"Bolivia","La Paz","Omasuyos","Huatajata","ESCUELA SANCA JAHUIRA",236455,28,13,329,357,111,14,191,302
"Bolivia","La Paz","Omasuyos","Santiago De Huata","COLEGIO CENTRAL POREJONI",236318,36,14,329,365,51,7,257,308
"Bolivia","La Paz","Omasuyos","Santiago De Huata","COLEGIO SANTIAGO DE HUATA",236319,191,71,1619,1810,532,94,922,1454
"Bolivia","La Paz","Omasuyos","Santiago De Huata","ESCUELA WATARI",236320,25,5,189,214,44,13,127,171
"Bolivia","La Paz","Omasuyos","Santiago De Huata","PLAZA WICHI WICHI",236321,51,9,541,592,125,17,390,515
"Bolivia","La Paz","Pacajes","Calacoto","COLEGIO ANTOFAGASTA",232652,14,3,179,193,46,5,125,171
"Bolivia","La Paz","Pacajes","Calacoto","COLEGIO CAMACHO",232653,66,2,156,222,28,2,124,152
"Bolivia","La Paz","Pacajes","Calacoto","COLEGIO FRANZ TAMAYO",232654,27,0,223,250,51,3,169,220
"Bolivia","La Paz","Pacajes","Calacoto","COLEGIO HEROES DEL PACIFICO",232655,6,1,125,131,25,0,99,124
"Bolivia","La Paz","Pacajes","Calacoto","COLEGIO HUARISCATA",232657,26,0,142,168,13,1,128,141
"Bolivia","La Paz","Pacajes","Calacoto","COLEGIO J. SARCO KRAMER",232658,39,3,135,174,34,2,96,130
"Bolivia","La Paz","Pacajes","Calacoto","COLEGIO PLAYA VINTO",232656,15,3,107,122,14,1,89,103
"Bolivia","La Paz","Pacajes","Calacoto","ESCUELA ACHAVICO",232662,5,1,56,61,8,2,45,53
"Bolivia","La Paz","Pacajes","Calacoto","ESCUELA LAGUNA BLANCA",232659,7,0,127,134,18,3,106,124
"Bolivia","La Paz","Pacajes","Calacoto","ESCUELA N. LERCO",232660,32,2,205,237,42,6,155,197
"Bolivia","La Paz","Pacajes","Calacoto","ESCUELA PABLO LAVADENS",232661,97,4,445,542,114,18,309,423
"Bolivia","La Paz","Pacajes","Calacoto","ESCUELA PLAYA VERDE",232663,19,2,185,204,30,4,149,179
"Bolivia","La Paz","Pacajes","Calacoto","ESCUELA ULLOMA",232664,10,2,181,191,50,2,127,177
"Bolivia","La Paz","Pacajes","Calacoto","PLAZA AUDIENCIA",232665,19,3,368,387,72,2,291,363
"Bolivia","La Paz","Pacajes","Calacoto","PLAZA CHALLUYO",232666,22,4,113,135,33,3,73,106
"Bolivia","La Paz","Pacajes","Calacoto","PLAZA PRINCIPAL",232667,30,2,110,140,10,3,95,105
"Bolivia","La Paz","Pacajes","Calacoto","SEDE SOCIAL MAX TOLEDO",232668,33,1,149,182,34,3,111,145
"Bolivia","La Paz","Pacajes","Caquiaviri","COLEGIO CALLA LLALLAGUA",232639,34,0,142,176,14,5,123,137
"Bolivia","La Paz","Pacajes","Caquiaviri","ESCUELA ACHIRI",232640,226,17,874,1100,226,27,604,830
"Bolivia","La Paz","Pacajes","Caquiaviri","ESCUELA ANTAQUIRA VILLA BELEN",232641,41,2,279,320,66,4,207,273
"Bolivia","La Paz","Pacajes","Caquiaviri","ESCUELA CALAMA QUINTAVI",232642,5,0,32,37,12,0,20,32
"Bolivia","La Paz","Pacajes","Caquiaviri","ESCUELA CAQUIAVIRI",232643,202,23,908,1110,210,31,644,854
"Bolivia","La Paz","Pacajes","Caquiaviri","ESCUELA CENTRAL",232644,44,3,320,364,54,11,252,306
"Bolivia","La Paz","Pacajes","Caquiaviri","ESCUELA CHOJNA PAMPA DE VICHAYA",232645,2,0,103,105,29,0,74,103
"Bolivia","La Paz","Pacajes","Caquiaviri","ESCUELA JIHUACUTA",232646,46,8,336,382,62,14,252,314
"Bolivia","La Paz","Pacajes","Caquiaviri","ESCUELA VILLA CHOCOROSI",232647,32,4,213,245,80,5,124,204
"Bolivia","La Paz","Pacajes","Caquiaviri","NUCLEO ESCOLAR VICHAYA",232648,37,5,342,379,98,9,230,328
"Bolivia","La Paz","Pacajes","Caquiaviri","PLAZA 14 DE SEPTIEMBRE",232649,18,4,262,280,37,3,218,255
"Bolivia","La Paz","Pacajes","Caquiaviri","PLAZA SAN MIGUEL",232650,37,3,318,355,80,10,225,305
"Bolivia","La Paz","Pacajes","Caquiaviri","SEDE SOCIAL",232651,20,2,62,82,25,1,34,59
"Bolivia","La Paz","Pacajes","Charaña","COLEGIO EDUARDO AVAROA",231999,183,9,599,782,218,16,356,574
"Bolivia","La Paz","Pacajes","Charaña","COLEGIO TEC. HUMANISTICO TOPATER",232000,5,0,72,77,26,2,44,70
"Bolivia","La Paz","Pacajes","Charaña","ESCUELA CHINOCAVI",232001,14,1,84,98,14,1,68,82
"Bolivia","La Paz","Pacajes","Charaña","ESCUELA EDUARDO AVAROA",232002,3,0,42,45,14,2,26,40
"Bolivia","La Paz","Pacajes","Charaña","ESCUELA GUALBERTO VILLARROEL",232003,5,1,51,56,8,2,40,48
"Bolivia","La Paz","Pacajes","Charaña","ESCUELA RIO BLANCO",232004,25,3,136,161,61,5,67,128
"Bolivia","La Paz","Pacajes","Charaña","ESCUELA SICUANI CONDOROCA",232005,26,1,123,149,19,1,102,121
"Bolivia","La Paz","Pacajes","Comanche","COLEGIO COMANCHE",232669,138,18,938,1076,244,38,638,882
"Bolivia","La Paz","Pacajes","Comanche","COLEGIO TOCOPILLA CANTUYO",232670,24,3,324,348,68,10,243,311
"Bolivia","La Paz","Pacajes","Comanche","ESCUELA KELLA KELLA",232671,5,2,126,131,53,3,68,121
"Bolivia","La Paz","Pacajes","Comanche","SEDE SOCIAL",232672,37,6,289,326,84,5,194,278
"Bolivia","La Paz","Pacajes","Comanche","SEDE SOCIAL",232673,37,6,289,326,84,5,194,278
"Bolivia","La Paz","Pacajes","Coro Coro","CASA DE GOBIERNO",232626,21,3,279,300,73,12,191,264
"Bolivia","La Paz","Pacajes","Coro Coro","COLEGIO CANCASILLA",232627,18,2,121,139,36,3,80,116
"Bolivia","La Paz","Pacajes","Coro Coro","COLEGIO JAYUMA LLALLAGUA",232629,9,2,128,137,37,2,87,124
"Bolivia","La Paz","Pacajes","Coro Coro","COLEGIO JOSE MANUEL PANDO",232628,37,8,389,426,93,17,271,364
"Bolivia","La Paz","Pacajes","Coro Coro","ESCUELA PEDRO DOMINGO MURILLO",232630,0,2,191,191,30,9,150,180
"Bolivia","La Paz","Pacajes","Coro Coro","ESCUELA SECCIONAL ANCO AQUE",232631,1,7,331,332,91,7,226,317
"Bolivia","La Paz","Pacajes","Coro Coro","ESCUELA TOPOHOCO",232632,19,14,316,335,58,18,226,284
"Bolivia","La Paz","Pacajes","Coro Coro","ESCUELA VICENTA JUARISTE EGUINO",232633,244,9,1228,1472,313,58,848,1161
"Bolivia","La Paz","Pacajes","Coro Coro","NUCLEO ESCOLAR CENTRAL ENEQUELLA",232634,32,3,297,329,77,4,213,290
"Bolivia","La Paz","Pacajes","Coro Coro","PLAZA APOSTOL SANTIAGO",232635,37,17,289,326,70,16,186,256
"Bolivia","La Paz","Pacajes","Coro Coro","PLAZA CANTON ROSAPATA",232636,30,2,136,166,29,4,101,130
"Bolivia","La Paz","Pacajes","Coro Coro","PLAZA MEJILLONES",232637,50,6,279,329,79,5,189,268
"Bolivia","La Paz","Pacajes","Coro Coro","PLAZA PRINCIPAL",232638,33,4,194,227,34,9,147,181
"Bolivia","La Paz","Pacajes","Nazacara De Pacajes","PLAZA PRINCIPAL",233325,56,3,275,331,49,7,216,265
"Bolivia","La Paz","Pacajes","Santiago De Callapa","COLEGIO TECNICO HUMANISTICO TUPAC AMARU",233372,37,5,161,198,39,6,111,150
"Bolivia","La Paz","Pacajes","Santiago De Callapa","ESCUELA HUAYLLAPANTA",233373,9,3,86,95,27,3,53,80
"Bolivia","La Paz","Pacajes","Santiago De Callapa","ESCUELA HUICHURAYA",233374,15,2,115,130,30,3,80,110
"Bolivia","La Paz","Pacajes","Santiago De Callapa","ESCUELA LIBERTADOR SIMON BOLIVIAR",233377,12,1,150,162,41,2,106,147
"Bolivia","La Paz","Pacajes","Santiago De Callapa","ESCUELA N. CANUHUTA",233375,50,2,291,341,65,4,220,285
"Bolivia","La Paz","Pacajes","Santiago De Callapa","ESCUELA POQUEVILLQUE",233376,17,1,118,135,23,4,90,113
"Bolivia","La Paz","Pacajes","Santiago De Callapa","ESCUELA ROMERO PAMPA",233378,23,4,231,254,75,7,145,220
"Bolivia","La Paz","Pacajes","Santiago De Callapa","PLAZA 29 DE JUNIO",233379,17,6,273,290,67,14,186,253
"Bolivia","La Paz","Pacajes","Santiago De Callapa","PLAZA SANTIAGO DE CALLAPA",233380,145,11,449,594,113,19,306,419
"Bolivia","La Paz","Pacajes","Santiago De Callapa","PLAZA VILLA PUCHUNI",233381,24,4,169,193,52,5,108,160
"Bolivia","La Paz","Pacajes","Santiago De Callapa","P. S. FRANCISCO YARIBAY",233382,54,0,225,279,44,3,178,222
"Bolivia","La Paz","Pacajes","Santiago De Callapa","UNIDAD EDUCATIVA HUAJRUMA",233383,7,0,76,83,31,1,44,75
"Bolivia","La Paz","Pacajes","Waldo Ballivian","PATIO HISTORICO TUMARAPI",233192,68,9,919,987,207,35,668,875
"Bolivia","La Paz","Sur Yungas","Chulumani","CASA DE GOBIERNO",233937,66,11,536,602,122,10,393,515
"Bolivia","La Paz","Sur Yungas","Chulumani","COLEGIO AGUSTIN ASPIAZU",233938,810,48,4209,5019,1510,168,2483,3993
"Bolivia","La Paz","Sur Yungas","Chulumani","COLEGIO GRAL. ARMANDO ESCOBAR URIA",233939,85,6,648,733,237,18,387,624
"Bolivia","La Paz","Sur Yungas","Chulumani","COLEGIO JUAN RAMOS DE TAGMA",233940,88,9,756,844,250,29,468,718
"Bolivia","La Paz","Sur Yungas","Chulumani","ESCUELA COLOPAMPA",233941,6,3,136,142,20,1,112,132
"Bolivia","La Paz","Sur Yungas","Chulumani","PLAZA PRINCIPAL",233942,29,6,445,474,80,14,345,425
"Bolivia","La Paz","Sur Yungas","Chulumani","UNIDAD EDUCATIVA HUANCANE",233944,238,18,1579,1817,437,64,1060,1497
"Bolivia","La Paz","Sur Yungas","Chulumani","UNIDAD EDUCATIVA TÉCNICO HUMANÍSTICO PASTO PATA",233943,95,11,725,820,263,24,427,690
"Bolivia","La Paz","Sur Yungas","Irupana","CANCHA DE UNION HUIRI",233945,41,9,450,491,47,13,381,428
"Bolivia","La Paz","Sur Yungas","Irupana","COLEGIO NUCLEO ROSARIO",233947,19,3,178,197,41,5,129,170
"Bolivia","La Paz","Sur Yungas","Irupana","COLEGIO TTE. CNL. RAFAEL PABON",233946,221,27,865,1086,328,28,482,810
"Bolivia","La Paz","Sur Yungas","Irupana","ESCUELA CENTRAL LA PLAZUELA",233948,50,2,273,323,69,5,197,266
"Bolivia","La Paz","Sur Yungas","Irupana","ESCUELA TTE. CNL. RAFAEL PABON",233949,26,2,170,196,28,5,135,163
"Bolivia","La Paz","Sur Yungas","Irupana","ESCUELA VICTOR CENTELLAS",233950,48,15,330,378,123,8,184,307
"Bolivia","La Paz","Sur Yungas","Irupana","ESCUELA VICTORIO LANZA",233951,62,8,553,615,134,76,335,469
"Bolivia","La Paz","Sur Yungas","Irupana","PLAZA 25 DE JULIO",233952,49,15,342,391,64,9,254,318
"Bolivia","La Paz","Sur Yungas","Irupana","UNIDAD EDUCATIVA AGUSTIN ASPIAZU",233953,471,54,2962,3433,978,111,1819,2797
"Bolivia","La Paz","Sur Yungas","Irupana","UNIDAD EDUCATIVA CHICALOMA",233954,100,29,730,830,232,28,441,673
"Bolivia","La Paz","Sur Yungas","Irupana","UNIDAD EDUCATIVA CURIHUATI",233955,12,1,102,114,31,1,69,100
"Bolivia","La Paz","Sur Yungas","Irupana","UNIDAD EDUCATIVA NUCLEO ALEJANDRO PEREZ",233956,11,1,119,130,22,5,91,113
"Bolivia","La Paz","Sur Yungas","Irupana","UNIDAD EDUCATIVA SIQUILJARA",233957,4,0,49,53,7,5,37,44
"Bolivia","La Paz","Sur Yungas","Irupana","UNIDAD EDUCATIVA TACA",233958,14,23,247,261,51,9,164,215
"Bolivia","La Paz","Sur Yungas","La Asunta","CASA DE GOBIERNO",234023,74,7,437,511,130,12,288,418
"Bolivia","La Paz","Sur Yungas","La Asunta","CASA DE GOBIERNO",234022,74,7,437,511,130,12,288,418
"Bolivia","La Paz","Sur Yungas","La Asunta","COLEGIO LAS MERCEDES",234024,156,24,1110,1266,239,16,831,1070
"Bolivia","La Paz","Sur Yungas","La Asunta","COLEGIO PEDRO DOMINGO MURILLO",234025,156,30,1193,1349,296,29,838,1134
"Bolivia","La Paz","Sur Yungas","La Asunta","ESCUELA BATALLON COLORADOS",234026,61,6,344,405,63,14,261,324
"Bolivia","La Paz","Sur Yungas","La Asunta","ESCUELA PEDRO DOMINGO MURILLO",234027,70,18,594,664,97,20,459,556
"Bolivia","La Paz","Sur Yungas","La Asunta","ESCUELA PUERTO RICO",234029,169,22,904,1073,268,26,588,856
"Bolivia","La Paz","Sur Yungas","La Asunta","ESCUELA RENE BARRIENTOS ORTUNO",234028,868,75,4955,5823,1599,235,3046,4645
"Bolivia","La Paz","Sur Yungas","La Asunta","ESCUELA YANAMAYU",234030,66,11,479,545,94,12,362,456
"Bolivia","La Paz","Sur Yungas","La Asunta","PLAZA 5 DE AGOSTO",234031,92,8,686,778,130,23,525,655
"Bolivia","La Paz","Sur Yungas","La Asunta","PLAZA PRINCIPAL",234032,17,10,498,515,92,19,377,469
"Bolivia","La Paz","Sur Yungas","La Asunta","PLAZA PRINCIPAL PICHARI",234033,33,1,172,205,28,1,142,170
"Bolivia","La Paz","Sur Yungas","La Asunta","SEDE SOCIAL 16 DE JULIO",234034,94,13,604,698,66,18,507,573
"Bolivia","La Paz","Sur Yungas","La Asunta","SEDE SOCIAL CHARIA",234035,76,6,627,703,139,17,465,604
"Bolivia","La Paz","Sur Yungas","La Asunta","SEDE SOCIAL - ESCUELA FISCAL CALIZAYA",234036,102,15,857,959,287,34,521,808
"Bolivia","La Paz","Sur Yungas","La Asunta","UNIDAD EDUCATIVA CENTRAL QUINUNI",234038,180,33,1240,1420,297,44,866,1163
"Bolivia","La Paz","Sur Yungas","La Asunta","UNIDAD EDUCATIVA NUEVOS HORIZONTES",234039,59,9,353,412,79,9,256,335
"Bolivia","La Paz","Sur Yungas","La Asunta","UNIDAD EDUCATIVA SANTA ROSA",234037,34,3,420,454,42,13,362,404
"Bolivia","La Paz","Sur Yungas","La Asunta","UNIDAD EDUCATIVA SIGUANI GRANDE",234040,157,12,782,939,155,15,600,755
"Bolivia","La Paz","Sur Yungas","Palos Blancos","COLEGIO GRAL. JUAN JOSE TORREZ",234009,93,8,438,531,95,18,317,412
"Bolivia","La Paz","Sur Yungas","Palos Blancos","COLEGIO INICUA ALTO",234010,240,26,1316,1556,198,42,1050,1248
"Bolivia","La Paz","Sur Yungas","Palos Blancos","ESCUELA 13 DE MAYO",234018,75,8,370,445,70,7,285,355
"Bolivia","La Paz","Sur Yungas","Palos Blancos","ESCUELA CENTRAL SAPECHO",234011,175,12,932,1107,202,28,690,892
"Bolivia","La Paz","Sur Yungas","Palos Blancos","ESCUELA COCOCHI",234019,76,4,517,593,46,9,458,504
"Bolivia","La Paz","Sur Yungas","Palos Blancos","ESCUELA FRANZ TAMAYO",234012,129,7,568,697,93,28,440,533
"Bolivia","La Paz","Sur Yungas","Palos Blancos","ESCUELA MAPURICHUQUI",234013,13,0,104,117,10,2,92,102
"Bolivia","La Paz","Sur Yungas","Palos Blancos","ESCUELA REMOLINOS",234014,20,4,165,185,28,2,131,159
"Bolivia","La Paz","Sur Yungas","Palos Blancos","ESCUELA SAN MIGUEL DE HUACHI",234015,117,7,556,673,148,21,380,528
"Bolivia","La Paz","Sur Yungas","Palos Blancos","ESCUELA SANTA ANA DE MOSETENES",234016,61,13,519,580,101,17,388,489
"Bolivia","La Paz","Sur Yungas","Palos Blancos","ESCUELA SECC. PUERTO CARMEN",234017,76,3,513,589,53,15,442,495
"Bolivia","La Paz","Sur Yungas","Palos Blancos","ESCUELA UNIDAD EDUCATIVA POPOY",234020,87,4,507,594,91,11,401,492
"Bolivia","La Paz","Sur Yungas","Palos Blancos","ESCUELA UNI. EDUCATIVA PALOS BLANCOS",234021,754,39,3769,4523,1274,160,2296,3570
"Bolivia","La Paz","Sur Yungas","Yanacachi","AGENCIA CANTONAL",234005,18,2,195,213,43,5,145,188
"Bolivia","La Paz","Sur Yungas","Yanacachi","ESCUELA EDUARDO AVAROA",234006,84,5,727,811,161,19,542,703
"Bolivia","La Paz","Sur Yungas","Yanacachi","ESCUELA PUENTE VILLA",234007,125,7,605,730,113,27,458,571
"Bolivia","La Paz","Sur Yungas","Yanacachi","UNIDAD EDUCATIVA FELIX ERNESTO MOSCOSO",234008,105,20,837,942,162,40,615,777
"Bolivia","Oruro","Abaroa","Challapata","CASA COMUNAL",234276,4,3,52,56,17,4,28,45
"Bolivia","Oruro","Abaroa","Challapata","COLEGIO NEMECIO BARRIENTOS",234277,93,52,1851,1944,183,92,1524,1707
"Bolivia","Oruro","Abaroa","Challapata","COLEGIO SIMON BOLIVAR",234278,133,23,724,857,184,53,464,648
"Bolivia","Oruro","Abaroa","Challapata","ESCUELA ELIZARDO PEREZ",234279,35,5,201,236,65,11,120,185
"Bolivia","Oruro","Abaroa","Challapata","ESCUELA GUALBERTO VILLARROEL",234280,57,6,487,544,131,30,320,451
"Bolivia","Oruro","Abaroa","Challapata","ESCUELA GUALBERTO VILLARROEL",234281,57,6,487,544,131,30,320,451
"Bolivia","Oruro","Abaroa","Challapata","IGLESIA",234282,77,27,481,558,134,26,294,428
"Bolivia","Oruro","Abaroa","Challapata","UNIDAD EDUCATIVA ANTOFAGASTA",234283,156,18,984,1140,464,54,448,912
"Bolivia","Oruro","Abaroa","Challapata","UNIDAD EDUCATIVA CHIRITAMBO",234284,6,0,37,43,9,8,20,29
"Bolivia","Oruro","Abaroa","Challapata","UNIDAD EDUCATIVA CHURACANI",234285,17,3,190,207,94,8,85,179
"Bolivia","Oruro","Abaroa","Challapata","UNIDAD EDUCATIVA COCHUYO",234286,15,6,176,191,26,12,132,158
"Bolivia","Oruro","Abaroa","Challapata","UNIDAD EDUCATIVA CRUCE AGUAS CALIENTES",234287,23,16,336,359,105,23,192,297
"Bolivia","Oruro","Abaroa","Challapata","UNIDAD EDUCATIVA EDUARDO AVAROA",234288,455,46,2647,3102,1299,159,1143,2442
"Bolivia","Oruro","Abaroa","Challapata","UNIDAD EDUCATIVA GERMAN BUSCH",234289,15,3,175,190,77,13,82,159
"Bolivia","Oruro","Abaroa","Challapata","UNIDAD EDUCATIVA HUANCANE",234290,33,7,353,386,153,32,161,314
"Bolivia","Oruro","Abaroa","Challapata","UNIDAD EDUCATIVA MONS. RICARDO BENI MORO",234291,218,23,1153,1371,559,63,508,1067
"Bolivia","Oruro","Abaroa","Challapata","UNIDAD EDUCATIVA REPUBLICA ARGENTINA",234292,480,63,2859,3339,1366,218,1212,2578
"Bolivia","Oruro","Abaroa","Challapata","UNIDAD EDUCATIVA SAN JUAN DE DIOS",234293,375,36,2256,2631,1116,125,979,2095
"Bolivia","Oruro","Abaroa","Challapata","UNIDAD EDUCATIVA WILAÑEQUE",234294,5,2,63,68,14,4,43,57
"Bolivia","Oruro","Abaroa","Santuario De Quillacas","COLEGIO NAL. MIXTO SEVARUYO",234295,91,17,762,853,194,30,521,715
"Bolivia","Oruro","Abaroa","Santuario De Quillacas","ESCUELA SORAGA",234296,29,1,236,265,30,4,201,231
"Bolivia","Oruro","Abaroa","Santuario De Quillacas","UNIDAD EDUCATIVA SANTUARIO DE QUILLACAS",234297,100,14,679,779,171,16,478,649
"Bolivia","Oruro","Carangas","Choquecota","ESCUELA JOSE BALLIVIAN",234056,147,10,493,640,85,13,385,470
"Bolivia","Oruro","Carangas","Choquecota","UNIDAD EDUCATIVA GERMAN BUSCH",234057,16,0,63,79,8,0,55,63
"Bolivia","Oruro","Carangas","Corque","COLEGIO JOSE TRIFIRO",234298,433,22,1058,1491,262,38,736,998
"Bolivia","Oruro","Carangas","Corque","COLEGIO QUITA QUITA",234299,20,1,125,145,28,1,95,123
"Bolivia","Oruro","Carangas","Corque","ESCUELA CENTRAL ANDAPATA LUPE",234300,23,2,134,157,41,1,90,131
"Bolivia","Oruro","Carangas","Corque","ESCUELA ELIZARDO PEREZ",234301,4,0,192,196,39,1,152,191
"Bolivia","Oruro","Carangas","Corque","ESCUELA GERMAN BUSCH",234302,3,0,124,127,39,2,83,122
"Bolivia","Oruro","Carangas","Corque","ESCUELA RAFAEL PABON",234303,5,2,314,319,77,8,227,304
"Bolivia","Oruro","Carangas","Corque","ESCUELA SECCIONAL VILLA NUEVA",234304,2,0,90,92,10,1,79,89
"Bolivia","Oruro","Carangas","Corque","ESCUELA SECCIONAL VILLA REMEDIOS",234305,12,9,103,115,15,2,77,92
"Bolivia","Oruro","Carangas","Corque","NUCLEO JANCOCALA",234306,19,3,119,138,29,4,83,112
"Bolivia","Oruro","Carangas","Corque","PROYECTO CRISTIAN CHILDRENS",234307,37,4,348,385,73,7,264,337
"Bolivia","Oruro","Carangas","Corque","UNIDAD EDUCATIVA CONDORIRI",234308,3,0,143,146,14,5,124,138
"Bolivia","Oruro","Carangas","Corque","UNIDAD EDUCATIVA EDUARDO AVAROA",234309,8,2,108,116,23,2,81,104
"Bolivia","Oruro","Carangas","Corque","UNIDAD EDUCATIVA FRANZ TAMAYO",234310,2,0,199,201,11,1,187,198
"Bolivia","Oruro","Carangas","Corque","UNIDAD EDUCATIVA FRANZ TAMAYO - VILLA ESPERANZA",234311,37,2,227,264,37,2,186,223
"Bolivia","Oruro","Carangas","Corque","UNIDAD EDUCATIVA HUAYLLAPACHA",234312,11,0,109,120,9,1,99,108
"Bolivia","Oruro","Carangas","Corque","UNIDAD EDUCATIVA HUAYLLOCO",234313,41,3,157,198,34,4,116,150
"Bolivia","Oruro","Carangas","Corque","UNIDAD EDUCATIVA ISMAEL MONTES",234314,9,0,123,132,27,2,94,121
"Bolivia","Oruro","Carangas","Corque","UNIDAD EDUCATIVA VILLA COPACABANA",234315,23,1,205,228,63,4,137,200
"Bolivia","Oruro","Carangas","Corque","UNIDAD EDUCATIVA VILLA TARUCACHI",234316,33,2,135,168,15,3,115,130
"Bolivia","Oruro","Cercado","Caracollo","CASA COMUNAL",234247,27,6,232,259,52,6,168,220
"Bolivia","Oruro","Cercado","Caracollo","ESCUELA ARCA DE NOE",234248,27,5,221,248,52,9,155,207
"Bolivia","Oruro","Cercado","Caracollo","ESCUELA CASIMIRO OLAÑETA",234249,15,6,98,113,23,1,68,91
"Bolivia","Oruro","Cercado","Caracollo","ESCUELA CENTRAL HORENCO",234250,41,13,508,549,114,30,351,465
"Bolivia","Oruro","Cercado","Caracollo","ESCUELA ELIZARDO PEREZ",234251,25,6,325,350,76,20,223,299
"Bolivia","Oruro","Cercado","Caracollo","ESCUELA GUALBERTO VILLARROEL",234252,2,1,156,158,48,7,100,148
"Bolivia","Oruro","Cercado","Caracollo","ESCUELA MARISCAL SUCRE",234253,576,68,4543,5119,1534,200,2741,4275
"Bolivia","Oruro","Cercado","Caracollo","ESCUELA RENE BERNAL ESCALANTE",234254,26,8,227,253,35,9,175,210
"Bolivia","Oruro","Cercado","Caracollo","ESCUELA SECCIONAL ANCOTANGA",234255,10,3,108,118,45,1,59,104
"Bolivia","Oruro","Cercado","Caracollo","ESCUELA TUPAC KATARI",234256,4,0,35,39,4,1,30,34
"Bolivia","Oruro","Cercado","Caracollo","PLAZA 21 DE SEPTIEMBRE",234257,11,1,182,193,52,1,128,180
"Bolivia","Oruro","Cercado","Caracollo","U. ESCUELA MARCELO QUIROGA SANTA CRUZ",234267,25,1,192,217,43,1,147,190
"Bolivia","Oruro","Cercado","Caracollo","UNIDAD EDUCATIVA ADELA ZAMUDIO B",234258,0,1,66,66,14,0,51,65
"Bolivia","Oruro","Cercado","Caracollo","UNIDAD EDUCATIVA ALEMANIA",234259,66,8,484,550,117,23,336,453
"Bolivia","Oruro","Cercado","Caracollo","UNIDAD EDUCATIVA AYACUCHO",234260,52,11,267,319,94,12,150,244
"Bolivia","Oruro","Cercado","Caracollo","UNIDAD EDUCATIVA FLORENCIO ALVARADO",234261,10,6,203,213,49,6,142,191
"Bolivia","Oruro","Cercado","Caracollo","UNIDAD EDUCATIVA JAIME LAREDO UNZUETA",234262,3,5,55,58,12,0,38,50
"Bolivia","Oruro","Cercado","Caracollo","UNIDAD EDUCATIVA LITORAL",234263,141,11,632,773,202,35,384,586
"Bolivia","Oruro","Cercado","Caracollo","UNIDAD EDUCATIVA MARISCAL SUCRE B",234264,134,14,707,841,232,28,433,665
"Bolivia","Oruro","Cercado","Caracollo","UNIDAD EDUCATIVA MAX FERNANDEZ",234265,38,3,436,474,98,9,326,424
"Bolivia","Oruro","Cercado","Caracollo","UNIDAD EDUCATIVA OTTO SAUCEDO RIVERA",234266,20,2,156,176,70,8,76,146
"Bolivia","Oruro","Cercado","Caracollo","UNIDAD EDUCATIVA SEBASTIAN PAGADOR",234268,40,5,342,382,68,12,257,325
"Bolivia","Oruro","Cercado","Caracollo","UNIDAD EDUCATIVA SIMON BOLIVAR PRIMARIO",234269,45,6,342,387,105,28,203,308
"Bolivia","Oruro","Cercado","Caracollo","UNIDAD EDUCATIVA VICTOR PAZ ESTENSORO",234270,18,1,83,101,33,3,46,79
"Bolivia","Oruro","Cercado","El Choro","ESCUELA GUALBERTO VILLARROEL",234271,30,8,229,259,83,5,133,216
"Bolivia","Oruro","Cercado","El Choro","ESCUELA JOSE BALLIVIAN",234272,100,12,470,570,107,20,331,438
"Bolivia","Oruro","Cercado","El Choro","ESCUELA SEBASTIAN PAGADOR",234273,115,12,573,688,132,41,388,520
"Bolivia","Oruro","Cercado","El Choro","PLAZA PRINCIPAL",234274,43,3,241,284,73,13,152,225
"Bolivia","Oruro","Cercado","El Choro","UNIDAD EDUCATIVA SAN FELIPE DE CHAITAVI",234275,13,2,164,177,56,6,100,156
"Bolivia","Oruro","Cercado","Oruro","CEMEI",234397,62,3,565,627,374,17,171,545
"Bolivia","Oruro","Cercado","Oruro","CENTRO DE ALFABETIZACION HUAJARA III",234398,52,7,453,505,213,16,217,430
"Bolivia","Oruro","Cercado","Oruro","CENTRO DE MADRES VILLA DORINA (U. ESCUELA GTANJA CAPACHOS)",234399,51,2,529,580,219,21,287,506
"Bolivia","Oruro","Cercado","Oruro","CENTRO EDUCATIVO ALCIRA CARDONA",234400,301,20,2236,2537,1192,72,952,2144
"Bolivia","Oruro","Cercado","Oruro","CENTRO EDUCATIVO LUIS ESPINAL",234401,133,6,1049,1182,638,39,366,1004
"Bolivia","Oruro","Cercado","Oruro","COLEGIO ANICETO ARCE",234402,239,11,1749,1988,1161,39,538,1699
"Bolivia","Oruro","Cercado","Oruro","COLEGIO DONATO VASQUEZ",234403,167,16,1394,1561,1032,28,318,1350
"Bolivia","Oruro","Cercado","Oruro","COLEGIO IGNACIO LEON",234405,271,9,2057,2328,1535,47,466,2001
"Bolivia","Oruro","Cercado","Oruro","COLEGIO JESUS MARIA FE Y ALEGRIA",234404,127,4,1082,1209,843,11,224,1067
"Bolivia","Oruro","Cercado","Oruro","COLEGIO JORGE OBLITAS",234406,218,5,1470,1688,1017,48,400,1417
"Bolivia","Oruro","Cercado","Oruro","COLEGIO MARCOS BELTRAN AVILA",234407,323,13,1753,2076,949,52,739,1688
"Bolivia","Oruro","Cercado","Oruro","COLEGIO MIXTO SAN JOSE",234408,108,5,902,1010,553,19,325,878
"Bolivia","Oruro","Cercado","Oruro","COLEGIO NAL. ANTONIO JOSE DE SAINZ",234409,296,9,1926,2222,1206,61,650,1856
"Bolivia","Oruro","Cercado","Oruro","COLEGIO NAL. JUAN MISAEL SARACHO",234410,212,7,1694,1906,1283,34,370,1653
"Bolivia","Oruro","Cercado","Oruro","COLEGIO NAL. MIXTO BOLIVIA",234411,635,27,3246,3881,1758,98,1363,3121
"Bolivia","Oruro","Cercado","Oruro","COLEGIO NAL. MIXTO CARMEN GUZMAN DE MIER",234412,716,42,5553,6269,2944,258,2309,5253
"Bolivia","Oruro","Cercado","Oruro","COLEGIO NAL. MIXTO MEJILLONES (V. CHALLACOLLO)",234413,237,14,1290,1527,473,85,718,1191
"Bolivia","Oruro","Cercado","Oruro","COLEGIO NAL. SIMON BOLIVAR",234414,308,12,2228,2536,1608,43,565,2173
"Bolivia","Oruro","Cercado","Oruro","COLEGIO PARTICULAR ANGLO AMERICANO",234415,288,12,2233,2521,1432,66,723,2155
"Bolivia","Oruro","Cercado","Oruro","COLEGIO PARTICULAR BOLIVIA JAPON",234416,200,11,1473,1673,1003,28,431,1434
"Bolivia","Oruro","Cercado","Oruro","COLEGIO PARTICULAR LA SALLE",234417,341,18,2698,3039,1614,99,967,2581
"Bolivia","Oruro","Cercado","Oruro","COLEGIO PARTICULAR NACIONES UNIDAS",234418,108,9,691,799,354,96,232,586
"Bolivia","Oruro","Cercado","Oruro","COLEGIO PARTICULAR REEKIE",234419,196,8,1654,1850,1229,34,383,1612
"Bolivia","Oruro","Cercado","Oruro","ESCUELA FRANZ TAMAYO (LOS PINOS)",234420,133,17,1159,1292,421,34,687,1108
"Bolivia","Oruro","Cercado","Oruro","ESCUELA JACINTO RODRIGUEZ (LA AURORA)",234421,359,22,3129,3488,1641,108,1358,2999
"Bolivia","Oruro","Cercado","Oruro","ESCUELA JUAN PABLO",234422,435,34,2906,3341,1374,92,1406,2780
"Bolivia","Oruro","Cercado","Oruro","ESCUELA MIXTA FERROVIARIA",234423,438,23,3645,4083,2496,74,1052,3548
"Bolivia","Oruro","Cercado","Oruro","FAC. DE DERECHO (ESCUELA 10 DE FEBRERO)",234424,88,5,716,804,515,7,189,704
"Bolivia","Oruro","Cercado","Oruro","FACULTAD DE AGRONOMIA",234425,136,3,827,963,371,25,428,799
"Bolivia","Oruro","Cercado","Oruro","FACULTAD DE MEDICINA",234426,285,15,2294,2579,1257,93,929,2186
"Bolivia","Oruro","Cercado","Oruro","FACULTAD TECNICA",234427,269,18,2399,2668,1640,56,685,2325
"Bolivia","Oruro","Cercado","Oruro","FUNDACION INFOCAL",234428,157,9,1200,1357,648,28,515,1163
"Bolivia","Oruro","Cercado","Oruro","INICIAL CARMEN GUZMAN DE MIER",234429,51,4,407,458,217,16,170,387
"Bolivia","Oruro","Cercado","Oruro","INST. DE APRENDIZAJE INDUSTRIAL - I.A.I.",234430,432,26,3789,4221,2091,115,1557,3648
"Bolivia","Oruro","Cercado","Oruro","INST. NORMAL SUPERIOR ANGEL MENDOZA J.",234431,279,16,2280,2559,1330,74,860,2190
"Bolivia","Oruro","Cercado","Oruro","KINDER CHIRIPUJIO",234432,58,5,317,375,161,6,145,306
"Bolivia","Oruro","Cercado","Oruro","KINDER EDITH ZAMORA DE PAZ",234433,91,7,642,733,310,10,315,625
"Bolivia","Oruro","Cercado","Oruro","KINDER JUANCITO PINTO",234434,222,23,1612,1834,865,51,673,1538
"Bolivia","Oruro","Cercado","Oruro","LICEO ANTOFAGASTA",234435,130,3,1109,1239,753,28,325,1078
"Bolivia","Oruro","Cercado","Oruro","LICEO TEC. HUMANISTICO ADOLFO BALLIVIAN",234436,124,6,997,1121,697,20,274,971
"Bolivia","Oruro","Cercado","Oruro","PENAL SAN PEDRO",234396,51,5,177,228,87,2,83,170
"Bolivia","Oruro","Cercado","Oruro","UNIDAD EDUCATIVA ABY AYALA (MAGDALENA POSTEL II)",234437,34,1,402,436,203,13,185,388
"Bolivia","Oruro","Cercado","Oruro","UNIDAD EDUCATIVA ALTO ORURO",234438,90,7,657,747,270,35,345,615
"Bolivia","Oruro","Cercado","Oruro","UNIDAD EDUCATIVA BOLIVIA VINTO",234439,590,73,4246,4836,1541,406,2226,3767
"Bolivia","Oruro","Cercado","Oruro","UNIDAD EDUCATIVA CARMELA CERRUTO",234440,75,6,423,498,206,18,193,399
"Bolivia","Oruro","Cercado","Oruro","UNIDAD EDUCATIVA EDUARDO AVAROA",234441,202,10,1711,1913,1309,44,348,1657
"Bolivia","Oruro","Cercado","Oruro","UNIDAD EDUCATIVA EJERCITO NACIONAL",234442,452,31,3461,3913,1885,105,1440,3325
"Bolivia","Oruro","Cercado","Oruro","UNIDAD EDUCATIVA EL CARMEN",234443,128,12,1135,1263,479,51,593,1072
"Bolivia","Oruro","Cercado","Oruro","UNIDAD EDUCATIVA GUIDO VILLAGOMEZ",234444,193,15,1750,1943,819,66,850,1669
"Bolivia","Oruro","Cercado","Oruro","UNIDAD EDUCATIVA HIJOS DEL SOL II",234445,68,5,293,361,98,75,115,213
"Bolivia","Oruro","Cercado","Oruro","UNIDAD EDUCATIVA HUAJARA",234446,389,44,3361,3750,1680,121,1516,3196
"Bolivia","Oruro","Cercado","Oruro","UNIDAD EDUCATIVA JESUS DE NAZARETH",234447,425,41,3179,3604,1434,156,1548,2982
"Bolivia","Oruro","Cercado","Oruro","UNIDAD EDUCATIVA JOHN F. KENNEDY",234448,448,28,3490,3938,1760,138,1564,3324
"Bolivia","Oruro","Cercado","Oruro","UNIDAD EDUCATIVA JOSE IGNACIO DE SANJINEZ",234449,442,20,3127,3569,1909,88,1110,3019
"Bolivia","Oruro","Cercado","Oruro","UNIDAD EDUCATIVA JOSE MARIA SIERRA GALVARRO",234450,491,26,3831,4322,2450,94,1261,3711
"Bolivia","Oruro","Cercado","Oruro","UNIDAD EDUCATIVA JUAN VELEZ DE CORDOBA (INCA POZO).",234451,175,19,1556,1731,634,72,831,1465
"Bolivia","Oruro","Cercado","Oruro","UNIDAD EDUCATIVA KANTUTA II (JOSERMO MURILLO)",234452,283,49,2285,2568,969,131,1136,2105
"Bolivia","Oruro","Cercado","Oruro","UNIDAD EDUCATIVA LOS ANGELES DE NAZARIA IGNACIA",234453,133,9,952,1085,306,36,601,907
"Bolivia","Oruro","Cercado","Oruro","UNIDAD EDUCATIVA LUIS MARIO CAREAGA",234454,652,57,3966,4618,1685,131,2093,3778
"Bolivia","Oruro","Cercado","Oruro","UNIDAD EDUCATIVA MARCELO QUIROGA SANTA CRUZ",234455,43,5,649,692,291,15,338,629
"Bolivia","Oruro","Cercado","Oruro","UNIDAD EDUCATIVA MARIA DE NAZARETH",234456,194,22,1558,1752,566,97,873,1439
"Bolivia","Oruro","Cercado","Oruro","UNIDAD EDUCATIVA MCAL. ANDRES DE SANTA CRUZ",234457,361,25,2527,2888,1422,83,997,2419
"Bolivia","Oruro","Cercado","Oruro","UNIDAD EDUCATIVA MCAL. ANTONIO JOSE DE SUCRE",234458,328,16,2490,2818,1720,42,712,2432
"Bolivia","Oruro","Cercado","Oruro","UNIDAD EDUCATIVA MEJILLONES II (SECUNDARIO)",234459,59,5,340,399,118,28,189,307
"Bolivia","Oruro","Cercado","Oruro","UNIDAD EDUCATIVA MISAEL PACHECO LOMA",234460,194,6,1567,1761,932,47,582,1514
"Bolivia","Oruro","Cercado","Oruro","UNIDAD EDUCATIVA MOVIMIENTO SIN TECHO",234461,507,61,3764,4271,947,165,2591,3538
"Bolivia","Oruro","Cercado","Oruro","UNIDAD EDUCATIVA NAL. MIXTO HUAJARA SECUNDARIO",234462,106,13,924,1030,362,114,435,797
"Bolivia","Oruro","Cercado","Oruro","UNIDAD EDUCATIVA NIÑO QUIRQUINCHO FELIZ",234463,188,23,1463,1651,551,113,776,1327
"Bolivia","Oruro","Cercado","Oruro","UNIDAD EDUCATIVA ORURO OTAWA (SECUNDARIA)",234464,213,17,1686,1899,905,40,724,1629
"Bolivia","Oruro","Cercado","Oruro","UNIDAD EDUCATIVA OSCAR UNZAGA DE LA VEGA",234465,446,43,3640,4086,1752,198,1647,3399
"Bolivia","Oruro","Cercado","Oruro","UNIDAD EDUCATIVA OSCAR UNZAGA DE LA VEGA II",234466,183,15,1168,1351,558,42,553,1111
"Bolivia","Oruro","Cercado","Oruro","UNIDAD EDUCATIVA PARTICULAR ARRIETA",234467,27,1,301,328,215,8,77,292
"Bolivia","Oruro","Cercado","Oruro","UNIDAD EDUCATIVA SAN LUIS",234468,49,8,414,463,126,49,231,357
"Bolivia","Oruro","Cercado","Oruro","UNIDAD EDUCATIVA SANTA ROSA",234469,339,24,2098,2437,1054,111,909,1963
"Bolivia","Oruro","Cercado","Oruro","UNIDAD EDUCATIVA SOCAMANI",234486,107,22,857,964,258,58,519,777
"Bolivia","Oruro","Cercado","Oruro","UNIDAD EDUCATIVA TOMAS BARRON",234487,926,88,7014,7940,3184,304,3438,6622
"Bolivia","Oruro","Cercado","Oruro","UNIDAD EDUCATIVA VIRGEN DEL MAR II",234488,251,26,2376,2627,1278,131,941,2219
"Bolivia","Oruro","Cercado","Oruro","UNIDAD EDUCATIVA VIRGEN DEL MAR III",234489,37,1,142,179,91,2,48,139
"Bolivia","Oruro","Cercado","Oruro","UNIDAD ESCOLAR BENEMERITOS DE LA PATRIA",234470,230,14,1568,1798,698,61,795,1493
"Bolivia","Oruro","Cercado","Oruro","UNIDAD ESCOLAR DIOS ES AMOR",234471,99,20,887,986,317,30,520,837
"Bolivia","Oruro","Cercado","Oruro","UNIDAD ESCOLAR EL KASSO - EL PROGRESO",234472,32,7,281,313,85,10,179,264
"Bolivia","Oruro","Cercado","Oruro","UNIDAD ESCOLAR EL PATICO",234473,16,8,270,286,96,15,151,247
"Bolivia","Oruro","Cercado","Oruro","UNIDAD ESCOLAR FRANCISCO FAJARDO",234474,248,10,2030,2278,1172,75,773,1945
"Bolivia","Oruro","Cercado","Oruro","UNIDAD ESCOLAR HIJOS DEL SOL (PLAN 500)",234475,325,13,1820,2145,727,53,1027,1754
"Bolivia","Oruro","Cercado","Oruro","UNIDAD ESCOLAR KANTUTA",234476,586,69,4563,5149,2098,302,2094,4192
"Bolivia","Oruro","Cercado","Oruro","UNIDAD ESCOLAR LUIS LLOSA - ESPAÑA",234477,100,0,987,1087,700,20,267,967
"Bolivia","Oruro","Cercado","Oruro","UNIDAD ESCOLAR MELVIN JONES",234478,254,17,1955,2209,1168,79,691,1859
"Bolivia","Oruro","Cercado","Oruro","UNIDAD ESCOLAR ORURO OTAWA (PRIMARIA)",234479,290,24,2604,2894,1561,61,958,2519
"Bolivia","Oruro","Cercado","Oruro","UNIDAD ESCOLAR SAN IGNACIO DE LOYOLA",234480,621,33,4667,5288,2581,131,1922,4503
"Bolivia","Oruro","Cercado","Oruro","UNIDAD ESCOLAR SAN ISIDRO",234481,202,34,1756,1958,632,83,1007,1639
"Bolivia","Oruro","Cercado","Oruro","UNIDAD ESCOLAR SAN JUAN DE DIOS",234482,65,13,664,729,214,27,410,624
"Bolivia","Oruro","Cercado","Oruro","UNIDAD ESCOLAR SANTA ANA I ARENALES",234483,47,4,504,551,213,16,271,484
"Bolivia","Oruro","Cercado","Oruro","UNIDAD ESCOLAR SEBASTIAN PAGADOR (PRIMARIO)",234484,190,15,1580,1770,1041,41,483,1524
"Bolivia","Oruro","Cercado","Oruro","UNIDAD ESCOLAR URU URU",234485,319,9,2200,2519,1130,91,970,2100
"Bolivia","Oruro","Cercado","Soracachi","COLEGIO EDUARDO AVAROA",235935,31,5,480,511,160,23,292,452
"Bolivia","Oruro","Cercado","Soracachi","COLEGIO NAL. IRUMA",235936,34,6,354,388,112,21,215,327
"Bolivia","Oruro","Cercado","Soracachi","COLEGIO NAL. MIXTO SORACACHI",235937,98,19,844,942,298,59,468,766
"Bolivia","Oruro","Cercado","Soracachi","ESCUELA CACHI CACHI",235938,25,14,298,323,108,14,162,270
"Bolivia","Oruro","Cercado","Soracachi","ESCUELA CARLOS BELTRAN MORALES",235939,41,3,283,324,38,8,234,272
"Bolivia","Oruro","Cercado","Soracachi","ESCUELA CENTRAL PARIA",235940,67,14,696,763,216,40,426,642
"Bolivia","Oruro","Cercado","Soracachi","ESCUELA ELIZARDO PEREZ",235941,15,3,244,259,59,18,164,223
"Bolivia","Oruro","Cercado","Soracachi","ESCUELA LITORAL",235942,10,0,189,199,20,4,165,185
"Bolivia","Oruro","Cercado","Soracachi","ESCUELA MULTIGRADO CULLCUPAMPA",235943,33,5,221,254,56,24,136,192
"Bolivia","Oruro","Cercado","Soracachi","ESCUELA SECCIONAL CONDORCHINOCA",235944,21,6,259,280,47,10,196,243
"Bolivia","Oruro","Cercado","Soracachi","ESCUELA SECCIONAL SAN JUAN PAMPA",235945,40,5,292,332,130,11,146,276
"Bolivia","Oruro","Cercado","Soracachi","ESCUELA SIMON BOLIVAR",235947,69,7,335,404,87,17,224,311
"Bolivia","Oruro","Cercado","Soracachi","ESCUELA SIMON BOLIVAR",235946,69,7,335,404,87,17,224,311
"Bolivia","Oruro","Cercado","Soracachi","PLAZA DE TOLAPALCA",235948,43,8,321,364,62,17,234,296
"Bolivia","Oruro","Cercado","Soracachi","PLAZA TENIENTE BULLAIN",235949,42,17,867,909,266,49,535,801
"Bolivia","Oruro","Cercado","Soracachi","UNIDAD EDUCATIVA CALAPATA",235950,8,2,225,233,66,9,148,214
"Bolivia","Oruro","Cercado","Soracachi","UNIDAD EDUCATIVA EDUARDO AVAROA",235951,45,6,486,531,120,17,343,463
"Bolivia","Oruro","Cercado","Soracachi","UNIDAD EDUCATIVA FRANZ TAMAYO",235952,23,6,120,143,34,7,73,107
"Bolivia","Oruro","Cercado","Soracachi","UNIDAD EDUCATIVA JATITA",235953,22,3,199,221,51,2,143,194
"Bolivia","Oruro","Cercado","Soracachi","UNIDAD EDUCATIVA K'ASA HUASA",235954,16,11,232,248,90,15,116,206
"Bolivia","Oruro","Cercado","Soracachi","UNIDAD EDUCATIVA MCAL. ANTONIO JOSE DE SUCRE",235955,6,0,134,140,43,9,82,125
"Bolivia","Oruro","Cercado","Soracachi","UNIDAD ESCOLAR SIMON BOLIVAR",235956,22,7,211,233,48,9,147,195
"Bolivia","Oruro","Ladislao Cabrera","Pampa Aullagas","ESCUELA FRANZ TAMAYO",234662,3,0,140,143,47,7,86,133
"Bolivia","Oruro","Ladislao Cabrera","Pampa Aullagas","ESCUELA MARIA SANCHEZ FERNANDEZ",234663,136,26,960,1096,279,42,613,892
"Bolivia","Oruro","Ladislao Cabrera","Pampa Aullagas","UNIDAD EDUCATIVA GUALBERTO VILLARROEL",234664,28,2,268,296,90,7,169,259
"Bolivia","Oruro","Ladislao Cabrera","Salinas De Garci Mendoza","COLEGIO ANTOFAGASTA",234069,55,6,465,520,110,17,332,442
"Bolivia","Oruro","Ladislao Cabrera","Salinas De Garci Mendoza","COLEGIO FRANZ TAMAYO",234070,228,15,1143,1371,351,61,716,1067
"Bolivia","Oruro","Ladislao Cabrera","Salinas De Garci Mendoza","ESCUELA AMERICA SAN MARTIN",234071,46,3,198,244,49,7,139,188
"Bolivia","Oruro","Ladislao Cabrera","Salinas De Garci Mendoza","ESCUELA CENTRAL PUQUI",234072,45,6,349,394,54,12,277,331
"Bolivia","Oruro","Ladislao Cabrera","Salinas De Garci Mendoza","ESCUELA ILDEFONSO MURGUIA",234073,7,3,54,61,4,0,47,51
"Bolivia","Oruro","Ladislao Cabrera","Salinas De Garci Mendoza","ESCUELA VILLA ESPERANZA",234074,21,2,183,204,47,9,125,172
"Bolivia","Oruro","Ladislao Cabrera","Salinas De Garci Mendoza","PLAZA PRINCIPAL",234075,6,3,161,167,104,4,50,154
"Bolivia","Oruro","Ladislao Cabrera","Salinas De Garci Mendoza","UNIDAD EDUCATIVA BOLIVIA LUCA",234076,17,1,73,90,9,1,62,71
"Bolivia","Oruro","Ladislao Cabrera","Salinas De Garci Mendoza","UNIDAD EDUCATIVA CONCEPCION DE BELEN",234077,26,1,86,112,46,4,35,81
"Bolivia","Oruro","Ladislao Cabrera","Salinas De Garci Mendoza","UNIDAD EDUCATIVA GERMAN BUSCH",234078,4,0,41,45,11,2,28,39
"Bolivia","Oruro","Ladislao Cabrera","Salinas De Garci Mendoza","UNIDAD EDUCATIVA OTTO SAUCEDO RIVERA",234079,142,12,754,896,232,43,467,699
"Bolivia","Oruro","Litoral","Cruz De Machacamarca","AMB. COMITE CIVICO",232793,1,0,78,79,18,2,58,76
"Bolivia","Oruro","Litoral","Cruz De Machacamarca","CASA COMUNAL",232794,5,0,97,102,40,2,55,95
"Bolivia","Oruro","Litoral","Cruz De Machacamarca","ESCUELA CRUZ DE MACHACAMARCA",232795,12,11,192,204,83,1,97,180
"Bolivia","Oruro","Litoral","Cruz De Machacamarca","ESCUELA TCNL. RAFAEL PABON",232796,0,0,119,119,29,1,89,118
"Bolivia","Oruro","Litoral","Escara","CASA COMUNAL",234751,5,2,82,87,34,2,44,78
"Bolivia","Oruro","Litoral","Escara","CASA DEL NOTARIO",234752,0,2,155,155,54,2,97,151
"Bolivia","Oruro","Litoral","Escara","UNIDAD EDUCATIVA FRANZ TAMAYO",234753,37,32,317,354,137,5,143,280
"Bolivia","Oruro","Litoral","Esmeralda","ESCUELA SEBASTIAN PAGADOR",234638,8,1,185,193,77,0,107,184
"Bolivia","Oruro","Litoral","Esmeralda","IGLESIA",234639,10,2,182,192,65,1,114,179
"Bolivia","Oruro","Litoral","Esmeralda","IGLESIA",234640,10,2,182,192,65,1,114,179
"Bolivia","Oruro","Litoral","Esmeralda","UNIDAD EDUCATIVA PEDRO DOMINGO MURILLO",234641,1,0,118,119,53,0,65,118
"Bolivia","Oruro","Litoral","Huachacalla","ESCUELA FE Y ALEGRIA",234750,313,3,341,654,125,9,204,329
"Bolivia","Oruro","Litoral","Yunguyo Del Litoral","ESCUELA JOSE BALLIVIAN",234058,32,0,94,126,43,6,45,88
"Bolivia","Oruro","Mejillones","Carangas","ESCUELA ELIODORO VILLAZON",235597,29,0,139,168,61,1,77,138
"Bolivia","Oruro","Mejillones","La Rivera","UNIDAD EDUCATIVA LA RIVERA",234806,0,3,250,250,124,2,121,245
"Bolivia","Oruro","Mejillones","Todos Santos","UNIDAD EDUCATIVA EDUARDO AVAROA",235436,62,5,192,254,63,3,121,184
"Bolivia","Oruro","Nor Carangas","Santiago De Huayllamarca","COLEGIO CHOJÑOHUMA",234087,10,5,118,128,23,2,88,111
"Bolivia","Oruro","Nor Carangas","Santiago De Huayllamarca","COLEGIO LLANQUERA",234088,75,4,423,498,106,12,301,407
"Bolivia","Oruro","Nor Carangas","Santiago De Huayllamarca","ESCUELA GERMAN BUSCH",234089,24,2,140,164,59,4,75,134
"Bolivia","Oruro","Nor Carangas","Santiago De Huayllamarca","ESCUELA JESUS BELEN",234090,4,0,119,123,34,2,83,117
"Bolivia","Oruro","Nor Carangas","Santiago De Huayllamarca","ESCUELA TUNUPA",234091,30,2,197,227,51,6,138,189
"Bolivia","Oruro","Nor Carangas","Santiago De Huayllamarca","PLAZA PRINCIPAL",234092,103,16,685,788,153,23,493,646
"Bolivia","Oruro","Nor Carangas","Santiago De Huayllamarca","UNIDAD EDUCATIVA MEJILLONES",234093,16,0,125,141,27,5,93,120
"Bolivia","Oruro","Nor Carangas","Santiago De Huayllamarca","UNIDAD EDUCATIVA PEDRO DOMINGO MURILLO",234094,27,7,298,325,89,3,199,288
"Bolivia","Oruro","Nor Carangas","Santiago De Huayllamarca","UNIDAD EDUCATIVA SAN MIGUEL",234095,17,7,392,409,123,12,250,373
"Bolivia","Oruro","Nor Carangas","Santiago De Huayllamarca","UNIDAD EDUCATIVA SEBASTIAN PAGADOR",234096,24,0,125,149,30,1,94,124
"Bolivia","Oruro","Pantaleón Dalence","Huanuni","COLEGIO AYACUCHO",234647,584,47,3859,4443,1144,193,2475,3619
"Bolivia","Oruro","Pantaleón Dalence","Huanuni","ESCUELA DANIEL SANCHEZ BUSTAMANTE",234648,27,2,130,157,47,9,72,119
"Bolivia","Oruro","Pantaleón Dalence","Huanuni","ESCUELA EDUARDO AVAROA",234649,514,57,4060,4574,1162,179,2662,3824
"Bolivia","Oruro","Pantaleón Dalence","Huanuni","ESCUELA FRANZ TAMAYO",234650,342,39,2940,3282,823,133,1945,2768
"Bolivia","Oruro","Pantaleón Dalence","Huanuni","ESCUELA HUALLATIRI",234651,29,3,189,218,31,3,152,183
"Bolivia","Oruro","Pantaleón Dalence","Huanuni","ESCUELA OSCAR ALFARO",234652,32,6,247,279,119,10,112,231
"Bolivia","Oruro","Pantaleón Dalence","Huanuni","PLAZA PRINCIPAL",234653,24,1,249,273,50,8,190,240
"Bolivia","Oruro","Pantaleón Dalence","Huanuni","UNIDAD EDUCATIVA 12 DE ABRIL",234654,121,6,358,479,134,18,200,334
"Bolivia","Oruro","Pantaleón Dalence","Huanuni","UNIDAD EDUCATIVA MARISCAL SUCRE DE TARUCAMARCA",234655,2,2,90,92,8,6,74,82
"Bolivia","Oruro","Pantaleón Dalence","Huanuni","UNIDAD EDUCATIVA TAYAQUIRA",234656,22,9,324,346,45,6,264,309
"Bolivia","Oruro","Pantaleón Dalence","Huanuni","UNIDAD EDUCATIVA VENEZUELA",234657,42,1,237,279,122,7,107,229
"Bolivia","Oruro","Pantaleón Dalence","Huanuni","UNIDAD EDUCATIVA VICTOR MANUEL AYLLON",234658,41,3,230,271,72,16,139,211
"Bolivia","Oruro","Pantaleón Dalence","Machacamarca","COLEGIO P. D. MURILLO",234659,247,32,1563,1810,542,53,936,1478
"Bolivia","Oruro","Pantaleón Dalence","Machacamarca","ESCUELA ADOLFO MIER",234660,30,1,194,224,68,8,117,185
"Bolivia","Oruro","Pantaleón Dalence","Machacamarca","ESCUELA GERMAN BUSCH",234661,89,9,398,487,130,14,245,375
"Bolivia","Oruro","Poopó","Antequera","ESCUELA MARISCAL ANTONIO JOSE DE SUCRE",234066,11,2,137,148,42,5,88,130
"Bolivia","Oruro","Poopó","Antequera","ESCUELA SEBASTIAN PAGADOR",234067,136,19,1065,1201,557,51,438,995
"Bolivia","Oruro","Poopó","Antequera","PLAZA 2 DE FEBRERO",234068,14,5,141,155,58,8,70,128
"Bolivia","Oruro","Poopó","Pazña","COLEGIO JUAN LECHIN OQUENDO",234642,82,7,534,616,201,17,309,510
"Bolivia","Oruro","Poopó","Pazña","COLEGIO OSCAR UNZAGA DE LA VEGA",234643,145,16,849,994,337,42,454,791
"Bolivia","Oruro","Poopó","Pazña","COLEGIO URMIRI",234644,15,1,117,132,68,1,47,115
"Bolivia","Oruro","Poopó","Pazña","ESCUELA MARISCAL SUCRE",234645,114,18,758,872,216,76,448,664
"Bolivia","Oruro","Poopó","Pazña","UNIDAD EDUCATIVA GUILLERMO GUTIERREZ",234646,23,7,261,284,100,6,148,248
"Bolivia","Oruro","Poopó","Villa Poopo","ESCUELA EDUARDO AVAROA",234059,26,5,114,140,29,8,72,101
"Bolivia","Oruro","Poopó","Villa Poopo","ESCUELA ISMAEL MONTES",234060,276,47,2328,2604,760,113,1408,2168
"Bolivia","Oruro","Poopó","Villa Poopo","ESCUELA MARISCAL SUCRE",234061,13,2,111,124,22,7,80,102
"Bolivia","Oruro","Poopó","Villa Poopo","ESCUELA PUÑACA",234062,5,0,55,60,5,3,47,52
"Bolivia","Oruro","Poopó","Villa Poopo","PLAZA SIMON BOLIVAR",234063,75,10,414,489,112,20,272,384
"Bolivia","Oruro","Poopó","Villa Poopo","UNIDAD EDUCATIVA GERMAN BUSCH",234064,0,0,49,49,11,2,36,47
"Bolivia","Oruro","Poopó","Villa Poopo","UNIDAD EDUCATIVA LIBERTADOR SIMON BOLIVAR",234065,5,5,106,111,16,0,85,101
"Bolivia","Oruro","Sabaya","Chipaya","ESCUELA PUENTE TOPATER",234690,41,1,114,155,11,5,97,108
"Bolivia","Oruro","Sabaya","Chipaya","ESCUELA SAN IGNACIO",234691,20,0,70,90,6,1,63,69
"Bolivia","Oruro","Sabaya","Chipaya","UNIDAD EDUCATIVA SANTA ANA",234692,227,9,411,638,129,8,265,394
"Bolivia","Oruro","Sabaya","Coipasa","UNIDAD EDUCATIVA COIPASA",234689,36,3,346,382,186,4,153,339
"Bolivia","Oruro","Sabaya","Sabaya","CASA COMUNAL",234665,1,0,167,168,118,0,49,167
"Bolivia","Oruro","Sabaya","Sabaya","CASA COMUNAL",234666,1,0,167,168,118,0,49,167
"Bolivia","Oruro","Sabaya","Sabaya","CASA DEL NOTARIO",234667,14,0,91,105,61,1,29,90
"Bolivia","Oruro","Sabaya","Sabaya","ESCUELA EDUARDO AVAROA",234668,0,4,30,30,8,4,14,22
"Bolivia","Oruro","Sabaya","Sabaya","ESCUELA FELIX FERNANDEZ",234669,4,0,97,101,67,0,30,97
"Bolivia","Oruro","Sabaya","Sabaya","ESCUELA FRANZ TAMAYO",234670,0,2,298,298,183,4,109,292
"Bolivia","Oruro","Sabaya","Sabaya","ESCUELA FRANZ TAMAYO",234671,0,2,298,298,183,4,109,292
"Bolivia","Oruro","Sabaya","Sabaya","ESCUELA GERMAN BUSCH",234672,11,0,201,212,80,2,119,199
"Bolivia","Oruro","Sabaya","Sabaya","ESCUELA GUALBERTO VILLARROEL",234673,2,3,107,109,35,2,67,102
"Bolivia","Oruro","Sabaya","Sabaya","ESCUELA ILDEFONSO MURGUIA",234674,8,1,199,207,104,1,93,197
"Bolivia","Oruro","Sabaya","Sabaya","ESCUELA JOSE MARIA EGUES CUELLAR",234675,145,8,404,549,192,20,184,376
"Bolivia","Oruro","Sabaya","Sabaya","ESCUELA JOSE MARIA MONTAÑO",234676,2,0,113,115,92,0,21,113
"Bolivia","Oruro","Sabaya","Sabaya","ESCUELA JOSE MERIDA MONTAÑO",234677,15,0,103,118,78,1,24,102
"Bolivia","Oruro","Sabaya","Sabaya","ESCUELA PITACOLLO",234678,3,1,85,88,14,0,70,84
"Bolivia","Oruro","Sabaya","Sabaya","ESCUELA SEBASTIAN PAGADOR",234679,0,3,154,154,105,1,45,150
"Bolivia","Oruro","Sabaya","Sabaya","ESCUELA VERALINES",234680,4,0,121,125,90,2,29,119
"Bolivia","Oruro","Sabaya","Sabaya","IGLESIA",234681,0,0,54,54,32,0,22,54
"Bolivia","Oruro","Sabaya","Sabaya","PLAZA 25 DE JULIO MIRAFLORES",234682,0,0,33,33,20,0,13,33
"Bolivia","Oruro","Sabaya","Sabaya","PLAZA SIMON BOLIVAR",234683,12,0,67,79,41,0,26,67
"Bolivia","Oruro","Sabaya","Sabaya","UNIDAD EDUCATIVA CONCEPCION COMUJO",234684,2,1,104,106,67,0,36,103
"Bolivia","Oruro","Sabaya","Sabaya","UNIDAD EDUCATIVA JOSE ANTONIO ARCE",234685,24,0,126,150,80,0,46,126
"Bolivia","Oruro","Sabaya","Sabaya","UNIDAD EDUCATIVA LIBERTADOR SIMON BOLIVAR",234686,69,5,224,293,121,13,85,206
"Bolivia","Oruro","Sabaya","Sabaya","UNIDAD EDUCATIVA MARIA EVANS CUELLAR",234687,6,0,120,126,96,1,23,119
"Bolivia","Oruro","Sabaya","Sabaya","UNIDAD EDUCATIVA PEDRO DOMINGO MURILLO",234688,3,0,138,141,90,2,46,136
"Bolivia","Oruro","Sajama","Curahuara De Carangas","COLEGIO BOLIVIA",234317,46,4,160,206,74,7,75,149
"Bolivia","Oruro","Sajama","Curahuara De Carangas","ESCUELA EDUARDO SAGARNAGA",234318,592,39,1589,2181,355,73,1122,1477
"Bolivia","Oruro","Sajama","Curahuara De Carangas","UNIDAD EDUCATIVA HACIA EL MAR",234319,7,0,67,74,17,0,50,67
"Bolivia","Oruro","Sajama","Curahuara De Carangas","UNIDAD EDUCATIVA LITORAL B",234320,29,1,148,177,56,6,85,141
"Bolivia","Oruro","Sajama","Turco","CASA COMUNAL",234321,11,0,57,68,18,0,39,57
"Bolivia","Oruro","Sajama","Turco","ESCUELA CENTRAL TURCO",234322,204,16,956,1160,212,23,705,917
"Bolivia","Oruro","Sajama","Turco","ESCUELA GUALBERTO VILLARROEL - IRUNI",234323,2,0,40,42,6,0,34,40
"Bolivia","Oruro","Sajama","Turco","ESCUELA WALBERTO VILLARROEL",234324,5,0,31,36,6,1,24,30
"Bolivia","Oruro","Sajama","Turco","NUCLEO ESCOLAR TITIRI",234325,23,0,73,96,6,6,61,67
"Bolivia","Oruro","Sajama","Turco","UNIDAD EDUCATIVA ASUNCION DE HUAJRIRE",234326,1,0,21,22,5,1,15,20
"Bolivia","Oruro","Sajama","Turco","UNIDAD EDUCATIVA EDUARDO AVAROA",234327,21,1,96,117,16,2,77,93
"Bolivia","Oruro","Sajama","Turco","UNIDAD EDUCATIVA PEDRO DOMINGO MURILLO A",234328,64,5,377,441,59,10,303,362
"Bolivia","Oruro","Sajama","Turco","UNIDAD EDUCATIVA PORVENIR",234329,43,1,283,326,108,13,161,269
"Bolivia","Oruro","San Pedro De Totora","Totora","COLEGIO NAL. CALAZAYA",234221,64,7,295,359,30,6,252,282
"Bolivia","Oruro","San Pedro De Totora","Totora","COMEDOR ESCOLAR",234222,17,1,100,117,29,4,66,95
"Bolivia","Oruro","San Pedro De Totora","Totora","ESCUELA CENTRAL SORA SORA",234223,13,2,223,236,24,4,193,217
"Bolivia","Oruro","San Pedro De Totora","Totora","ESCUELA FRANZ TAMAYO",234224,10,1,185,195,30,3,151,181
"Bolivia","Oruro","San Pedro De Totora","Totora","ESCUELA LITORAL DE CULTA",234225,29,0,197,226,18,9,170,188
"Bolivia","Oruro","San Pedro De Totora","Totora","ESCUELA MARQUIRIVI",234226,13,0,69,82,26,2,41,67
"Bolivia","Oruro","San Pedro De Totora","Totora","UNIDAD EDUCATIVA CENTRO REVITO",234227,7,0,76,83,18,2,56,74
"Bolivia","Oruro","San Pedro De Totora","Totora","UNIDAD EDUCATIVA ROMEROCOTA",234228,0,2,77,77,4,14,57,61
"Bolivia","Oruro","San Pedro De Totora","Totora","UNIDAD EDUCATIVA SEBASTIAN PAGADOR",234229,14,1,127,141,13,1,112,125
"Bolivia","Oruro","San Pedro De Totora","Totora","UNIDAD EDUCATIVA TOTORA",234230,149,17,789,938,119,46,607,726
"Bolivia","Oruro","San Pedro De Totora","Totora","UNIDAD EDUCATIVA VINO HUTA",234231,12,1,132,144,14,2,115,129
"Bolivia","Oruro","Saucarí","Toledo","CASA COMUNAL",234694,27,0,115,142,41,3,71,112
"Bolivia","Oruro","Saucarí","Toledo","CASA COMUNAL",234693,27,0,115,142,41,3,71,112
"Bolivia","Oruro","Saucarí","Toledo","CASA COMUNAL CENTRAL MOLLOCO",234695,4,4,77,81,14,1,58,72
"Bolivia","Oruro","Saucarí","Toledo","CASA DEL NOTARIO",234696,13,0,67,80,18,1,48,66
"Bolivia","Oruro","Saucarí","Toledo","COLEGIO NACIONAL TOLEDO",234697,250,14,998,1248,299,37,648,947
"Bolivia","Oruro","Saucarí","Toledo","ESCUELA EDUARDO AVAROA",234698,10,1,95,105,26,17,51,77
"Bolivia","Oruro","Saucarí","Toledo","ESCUELA ELIZARDO PEREZ 1",234699,32,2,137,169,31,5,99,130
"Bolivia","Oruro","Saucarí","Toledo","ESCUELA GERMAN BUSCH 1",234700,31,1,139,170,54,5,79,133
"Bolivia","Oruro","Saucarí","Toledo","ESCUELA GERMAN BUSCH II",234701,1,0,123,124,24,5,94,118
"Bolivia","Oruro","Saucarí","Toledo","ESCUELA ISAC PORTO CARRERA",234702,38,2,149,187,28,2,117,145
"Bolivia","Oruro","Saucarí","Toledo","ESCUELA M. M. VACA GUZMAN",234703,70,5,282,352,87,9,181,268
"Bolivia","Oruro","Saucarí","Toledo","ESCUELA PUMASARA",234704,21,0,120,141,19,3,98,117
"Bolivia","Oruro","Saucarí","Toledo","UNIDAD EDUCATIVA ANTONIO JOSE DE SUCRE",234705,10,0,38,48,11,0,27,38
"Bolivia","Oruro","Saucarí","Toledo","UNIDAD EDUCATIVA BARTOLINA SISA",234706,6,1,101,107,21,2,77,98
"Bolivia","Oruro","Saucarí","Toledo","UNIDAD EDUCATIVA FRANZ TAMAYO",234707,5,0,45,50,16,2,27,43
"Bolivia","Oruro","Saucarí","Toledo","UNIDAD EDUCATIVA GUALBERTO VILLARROEL",234708,17,2,121,138,27,1,91,118
"Bolivia","Oruro","Saucarí","Toledo","UNIDAD EDUCATIVA MARCELO QUIROGA SANTA CRUZ",234709,20,1,61,81,9,0,51,60
"Bolivia","Oruro","Saucarí","Toledo","UNIDAD EDUCATIVA OTTO SAUCEDO",234710,5,2,125,130,31,2,90,121
"Bolivia","Oruro","Saucarí","Toledo","UNIDAD ESCOLAR TIJLLACAHUA",234711,19,0,69,88,26,3,40,66
"Bolivia","Oruro","Sebastian Pagador","Santiago De Huari","COLEGIO MIXTO GUALBERTO VILLARROEL",234232,215,27,1528,1743,585,126,790,1375
"Bolivia","Oruro","Sebastian Pagador","Santiago De Huari","ESCUELA CAICO BOLIVAR",234233,9,1,88,97,39,1,47,86
"Bolivia","Oruro","Sebastian Pagador","Santiago De Huari","ESCUELA CALACOTA",234234,8,0,69,77,16,3,50,66
"Bolivia","Oruro","Sebastian Pagador","Santiago De Huari","ESCUELA CASTILLA HUMA",234235,38,4,229,267,86,9,130,216
"Bolivia","Oruro","Sebastian Pagador","Santiago De Huari","ESCUELA CONDO K",234236,14,2,140,154,67,3,68,135
"Bolivia","Oruro","Sebastian Pagador","Santiago De Huari","ESCUELA LLAPALLAPANI",234237,17,2,117,134,25,6,84,109
"Bolivia","Oruro","Sebastian Pagador","Santiago De Huari","ESCUELA VICHAJ LUPE",234238,42,1,245,287,68,12,164,232
"Bolivia","Oruro","Sebastian Pagador","Santiago De Huari","NUCLEO ESCOLAR BOLIVIA",234239,14,1,284,298,50,3,230,280
"Bolivia","Oruro","Sebastian Pagador","Santiago De Huari","NUCLEO MARCA LAGUNILLAS",234240,34,7,472,506,107,23,335,442
"Bolivia","Oruro","Sebastian Pagador","Santiago De Huari","UNIDAD EDUCATIVA LUCUMPAYA",234241,8,0,57,65,10,1,46,56
"Bolivia","Oruro","Sebastian Pagador","Santiago De Huari","UNIDAD EDUCATIVA NAZACARA",234242,0,3,121,121,41,7,70,111
"Bolivia","Oruro","Sebastian Pagador","Santiago De Huari","UNIDAD EDUCATIVA SAN PEDRO DE CONDO",234243,105,9,553,658,205,24,315,520
"Bolivia","Oruro","Sebastian Pagador","Santiago De Huari","UNIDAD EDUCATIVA URMIRI DE QUILLACAS",234244,39,3,211,250,43,4,161,204
"Bolivia","Oruro","Sebastian Pagador","Santiago De Huari","UNIDAD EDUCATIVA VILLA VERDE",234245,23,3,130,153,43,2,82,125
"Bolivia","Oruro","Sur Carangas","Andamarca","ESCUELA SEBASTIAN PAGADOR",234080,183,24,688,871,200,12,452,652
"Bolivia","Oruro","Sur Carangas","Andamarca","UNIDAD EDUCATIVA MEJILLONES",234081,84,25,540,624,111,8,396,507
"Bolivia","Oruro","Sur Carangas","Andamarca","UNIDAD EDUCATIVA ORINOCA",234082,110,3,804,914,64,11,726,790
"Bolivia","Oruro","Sur Carangas","Belén De Andamarca","COLEGIO TEC. HUMANISTICO SIMON BOLIVAR",234083,46,7,330,376,123,7,193,316
"Bolivia","Oruro","Sur Carangas","Belén De Andamarca","ESCUELA ANICETO ARCE",234084,0,4,178,178,36,5,133,169
"Bolivia","Oruro","Sur Carangas","Belén De Andamarca","ESCUELA ELIZARDO PEREZ",234085,11,0,101,112,20,3,78,98
"Bolivia","Oruro","Sur Carangas","Belén De Andamarca","UNIDAD EDUCATIVA BOLIVIA",234086,16,7,183,199,38,9,129,167
"Bolivia","Oruro","Tomas Barrón","Eucaliptus","COLEGIO NAL. EUCALIPTUS",234214,6,1,62,68,11,0,50,61
"Bolivia","Oruro","Tomas Barrón","Eucaliptus","ESCUELA HUANCAROMA",234215,18,0,121,139,18,0,103,121
"Bolivia","Oruro","Tomas Barrón","Eucaliptus","ESCUELA MARISCAL ANTONIO JOSE DE SUCRE",234216,24,4,167,191,19,3,141,160
"Bolivia","Oruro","Tomas Barrón","Eucaliptus","ESCUELA TUPAC KATARI",234217,4,2,200,204,36,6,156,192
"Bolivia","Oruro","Tomas Barrón","Eucaliptus","UNIDAD EDUCATIVA BENEDETO VINCENTI",234218,216,21,1308,1524,381,32,874,1255
"Bolivia","Oruro","Tomas Barrón","Eucaliptus","UNIDAD EDUCATIVA MACHACAMARCA",234219,10,0,105,115,11,4,90,101
"Bolivia","Oruro","Tomas Barrón","Eucaliptus","UNIDAD EDUCATIVA QUELCATA",234220,56,13,325,381,55,8,249,304
"Bolivia","Pando","Abuná","Ingavi","UNIDAD EDUCATIVA DERREPENTE",234103,0,0,68,68,37,12,19,56
"Bolivia","Pando","Abuná","Ingavi","UNIDAD EDUCATIVA HUMAITA",234104,119,2,372,491,178,7,185,363
"Bolivia","Pando","Abuná","Ingavi","UNIDAD EDUCATIVA INGAVI",234105,44,4,99,143,43,3,49,92
"Bolivia","Pando","Abuná","Ingavi","UNIDAD EDUCATIVA LAS AMALIAS",234106,5,0,25,30,1,1,23,24
"Bolivia","Pando","Abuná","Santa Rosa Del Abuna","UNIDAD EDUCATIVA ABUNA",236222,141,5,236,377,114,8,109,223
"Bolivia","Pando","Abuná","Santa Rosa Del Abuna","UNIDAD EDUCATIVA AUGUSTO GUTIERREZ BANZER",236223,1,0,80,81,20,2,58,78
"Bolivia","Pando","Abuná","Santa Rosa Del Abuna","UNIDAD EDUCATIVA GENOVEVA RÍOS",236224,63,5,223,286,45,2,171,216
"Bolivia","Pando","Abuná","Santa Rosa Del Abuna","UNIDAD EDUCATIVA PEDRO DOMINGO MURRILLO",236225,16,0,100,116,8,0,92,100
"Bolivia","Pando","Abuná","Santa Rosa Del Abuna","UNIDAD EDUCATIVA ZACARIAS MORENO",236226,41,0,203,244,127,2,74,201
"Bolivia","Pando","Federico Román","Nueva Esperanza","UNIDAD EDUCATIVA GRAL. FEDERICO ROMÁN",236227,103,1,148,251,95,2,50,145
"Bolivia","Pando","Federico Román","Nueva Esperanza","UNIDAD EDUCATIVA LA GRAN CRUZ",236228,19,2,61,80,7,1,51,58
"Bolivia","Pando","Federico Román","Nueva Esperanza","UNIDAD EDUCATIVA MANUEL ESTREMADOIRO MARTINEZ",236229,213,1,270,483,159,3,107,266
"Bolivia","Pando","Federico Román","Nueva Esperanza","UNIDAD EDUCATIVA MONTE SINAI",236230,30,9,137,167,11,6,111,122
"Bolivia","Pando","Federico Román","Nueva Esperanza","UNIDAD EDUCATIVA RUFINO CHAO",236231,44,3,52,96,30,0,19,49
"Bolivia","Pando","Federico Román","Santos Mercado","19 DE OCTUBRE",236236,181,2,367,548,177,6,182,359
"Bolivia","Pando","Federico Román","Santos Mercado","UNIDAD EDUCATIVA 11 DE SEPTIEMBRE",236237,54,1,170,224,50,2,117,167
"Bolivia","Pando","Federico Román","Santos Mercado","UNIDAD EDUCATIVA 23 DE MARZO",236238,116,5,347,463,169,9,164,333
"Bolivia","Pando","Federico Román","Villa Nueva","UNIDAD EDUCATIVA ANDRES IDAGUA",236232,161,6,476,637,216,7,247,463
"Bolivia","Pando","Federico Román","Villa Nueva","UNIDAD EDUCATIVA ENAREVENA",236233,9,0,51,60,28,0,23,51
"Bolivia","Pando","Federico Román","Villa Nueva","UNIDAD EDUCATIVA JUANA AZURDUY DE PADILLA",236234,39,3,77,116,31,0,43,74
"Bolivia","Pando","Federico Román","Villa Nueva","UNIDAD EDUCATIVA ROBERTO GONZALES",236235,57,5,184,241,76,1,102,178
"Bolivia","Pando","Madre De Dios","El Sena","UNIDAD EDUCATIVA 2 DE AGOSTO",236211,6,4,71,77,51,2,14,65
"Bolivia","Pando","Madre De Dios","El Sena","UNIDAD EDUCATIVA 4 DE AGOSTO",236212,26,1,86,112,26,1,58,84
"Bolivia","Pando","Madre De Dios","El Sena","UNIDAD EDUCATIVA DE PEKIN",236213,43,1,72,115,43,1,27,70
"Bolivia","Pando","Madre De Dios","El Sena","UNIDAD EDUCATIVA EL SENA",236214,498,19,1417,1915,740,25,633,1373
"Bolivia","Pando","Madre De Dios","El Sena","UNIDAD EDUCATIVA EL TURI (RIO MANURAPE)",236215,4,2,46,50,27,4,13,40
"Bolivia","Pando","Madre De Dios","El Sena","UNIDAD EDUCATIVA LAS MERCEDES",236216,7,2,73,80,35,1,35,70
"Bolivia","Pando","Madre De Dios","El Sena","UNIDAD EDUCATIVA PALMA REAL",236217,67,2,174,241,89,5,78,167
"Bolivia","Pando","Madre De Dios","El Sena","UNIDAD EDUCATIVA REMANSO",236218,6,1,66,72,20,0,45,65
"Bolivia","Pando","Madre De Dios","El Sena","UNIDAD EDUCATIVA SAN FRANCISCO",236219,50,5,166,216,53,6,102,155
"Bolivia","Pando","Madre De Dios","El Sena","UNIDAD EDUCATIVA SANTA ELENA",236220,17,2,62,79,17,0,43,60
"Bolivia","Pando","Madre De Dios","El Sena","UNIDAD EDUCATIVA SANTA ROSA",236221,30,0,54,84,25,0,29,54
"Bolivia","Pando","Madre De Dios","Gonzalo Moreno","UNIDAD EDUCATIVA 2 DE AGOSTO",234097,29,1,141,170,44,4,92,136
"Bolivia","Pando","Madre De Dios","Gonzalo Moreno","UNIDAD EDUCATIVA AGUA DULCE",234098,71,0,134,205,61,2,71,132
"Bolivia","Pando","Madre De Dios","Gonzalo Moreno","UNIDAD EDUCATIVA LUZ EN EL CAMINO",234099,419,13,992,1411,426,29,524,950
"Bolivia","Pando","Madre De Dios","Gonzalo Moreno","UNIDAD EDUCATIVA MIRAFLORES",234100,33,2,168,201,37,2,127,164
"Bolivia","Pando","Madre De Dios","Gonzalo Moreno","UNIDAD EDUCATIVA PEDRO HERRERA",234101,184,5,501,685,266,7,223,489
"Bolivia","Pando","Madre De Dios","Gonzalo Moreno","UNIDAD EDUCATIVA PORTACHUELO DIOS ES AMOR",234102,108,8,329,437,50,4,267,317
"Bolivia","Pando","Madre De Dios","San Lorenzo","ESCUELA EDUARDO ABAROA",233468,11,0,74,85,50,1,23,73
"Bolivia","Pando","Madre De Dios","San Lorenzo","UNIDAD EDUCATIVA 21 DE SEPTIEMBRE",233469,9,0,60,69,24,0,36,60
"Bolivia","Pando","Madre De Dios","San Lorenzo","UNIDAD EDUCATIVA 24 DE SEPTIEMBRE",233470,248,13,785,1033,256,13,503,759
"Bolivia","Pando","Madre De Dios","San Lorenzo","UNIDAD EDUCATIVA 27 DE MAYO",233471,19,5,144,163,35,5,99,134
"Bolivia","Pando","Madre De Dios","San Lorenzo","UNIDAD EDUCATIVA 6 DE AGOSTO",233472,0,0,118,118,0,1,117,117
"Bolivia","Pando","Madre De Dios","San Lorenzo","UNIDAD EDUCATIVA 6 DE JUNIO",233473,9,1,62,71,2,0,59,61
"Bolivia","Pando","Madre De Dios","San Lorenzo","UNIDAD EDUCATIVA BRUNO RACUA",233474,12,0,81,93,38,6,37,75
"Bolivia","Pando","Madre De Dios","San Lorenzo","UNIDAD EDUCATIVA DE IBERIA",233475,11,1,30,41,9,0,20,29
"Bolivia","Pando","Madre De Dios","San Lorenzo","UNIDAD EDUCATIVA DE ROSARIO",233476,33,0,52,85,27,0,25,52
"Bolivia","Pando","Madre De Dios","San Lorenzo","UNIDAD EDUCATIVA FEDERICO HECKER",233477,27,0,70,97,31,1,38,69
"Bolivia","Pando","Madre De Dios","San Lorenzo","UNIDAD EDUCATIVA GALILEA",233478,34,5,146,180,39,7,95,134
"Bolivia","Pando","Madre De Dios","San Lorenzo","UNIDAD EDUCATIVA GENOVEVA RIOS",233479,23,0,55,78,29,3,23,52
"Bolivia","Pando","Madre De Dios","San Lorenzo","UNIDAD EDUCATIVA GREGORIA DESTRE MATURANA",233480,19,2,165,184,58,2,103,161
"Bolivia","Pando","Madre De Dios","San Lorenzo","UNIDAD EDUCATIVA NUEVO HORIZONTE",233481,1,0,43,44,20,1,22,42
"Bolivia","Pando","Madre De Dios","San Lorenzo","UNIDAD EDUCATIVA PTO. COPACABANA",233482,99,1,113,212,57,9,46,103
"Bolivia","Pando","Madre De Dios","San Lorenzo","UNIDAD EDUCATIVA SOLEDAD",233483,66,2,173,239,73,2,96,169
"Bolivia","Pando","Madre De Dios","San Lorenzo","UNIDAD EDUCATIVA VISTA ALEGRE",233484,35,2,202,237,97,4,99,196
"Bolivia","Pando","Manuripi","Filadelfia","UNIDAD EDUCATIVA ALTA GRACIA",233347,89,1,39,128,3,0,35,38
"Bolivia","Pando","Manuripi","Filadelfia","UNIDAD EDUCATIVA BUYUYO",233348,14,1,127,141,33,4,89,122
"Bolivia","Pando","Manuripi","Filadelfia","UNIDAD EDUCATIVA CHIVE",233349,93,9,220,313,105,8,98,203
"Bolivia","Pando","Manuripi","Filadelfia","UNIDAD EDUCATIVA CURICHON",233350,24,4,101,125,48,0,49,97
"Bolivia","Pando","Manuripi","Filadelfia","UNIDAD EDUCATIVA DE HOLANDA",233351,46,2,185,231,56,8,119,175
"Bolivia","Pando","Manuripi","Filadelfia","UNIDAD EDUCATIVA DE LA CRUZ",233352,7,0,32,39,9,1,22,31
"Bolivia","Pando","Manuripi","Filadelfia","UNIDAD EDUCATIVA FILADELFIA",233353,105,3,346,451,156,5,182,338
"Bolivia","Pando","Manuripi","Filadelfia","UNIDAD EDUCATIVA FLORIDA",233354,7,1,90,97,34,0,55,89
"Bolivia","Pando","Manuripi","Filadelfia","UNIDAD EDUCATIVA JUANCITO PINTO",233355,51,4,208,259,82,3,119,201
"Bolivia","Pando","Manuripi","Filadelfia","UNIDAD EDUCATIVA LUZ DE AMERICA",233356,10,1,114,124,52,4,57,109
"Bolivia","Pando","Manuripi","Filadelfia","UNIDAD EDUCATIVA NUEVA ALIANZA",233357,57,1,288,345,126,4,157,283
"Bolivia","Pando","Manuripi","Filadelfia","UNIDAD EDUCATIVA NUEVA EMPRESA",233358,57,5,326,383,131,3,187,318
"Bolivia","Pando","Manuripi","Filadelfia","UNIDAD EDUCATIVA SAN ANTONIO",233359,4,1,48,52,16,0,31,47
"Bolivia","Pando","Manuripi","Filadelfia","UNIDAD EDUCATIVA UCIA",233360,14,5,67,81,5,0,57,62
"Bolivia","Pando","Manuripi","Filadelfia","UNIDAD EDUCATIVA VILLA AMERICA",233361,14,1,93,107,44,3,45,89
"Bolivia","Pando","Manuripi","Filadelfia","UNIDAD EDUCATIVA VILLA BELLA",233362,30,3,131,161,73,1,54,127
"Bolivia","Pando","Manuripi","Puerto Rico","UNIDAD EDUCATIVA BATRAJA",233337,27,4,216,243,105,5,102,207
"Bolivia","Pando","Manuripi","Puerto Rico","UNIDAD EDUCATIVA DE LAS ARENAS",233338,195,0,21,216,4,0,17,21
"Bolivia","Pando","Manuripi","Puerto Rico","UNIDAD EDUCATIVA DE PALESTINA",233339,21,0,56,77,25,0,31,56
"Bolivia","Pando","Manuripi","Puerto Rico","UNIDAD EDUCATIVA GERMAN BUSCH",233340,0,7,396,396,151,57,181,332
"Bolivia","Pando","Manuripi","Puerto Rico","UNIDAD EDUCATIVA HIROSHIMA",233341,7,0,24,31,17,1,6,23
"Bolivia","Pando","Manuripi","Puerto Rico","UNIDAD EDUCATIVA LA SALLE EMETERIO RUIZ",233342,735,18,1582,2317,735,42,787,1522
"Bolivia","Pando","Manuripi","Puerto Rico","UNIDAD EDUCATIVA LOS MANDARINOS",233343,1,2,28,29,11,2,13,24
"Bolivia","Pando","Manuripi","Puerto Rico","UNIDAD EDUCATIVA MANCHESTER",233344,39,0,59,98,41,0,18,59
"Bolivia","Pando","Manuripi","Puerto Rico","UNIDAD EDUCATIVA SAN ANTONIO",233345,7,0,85,92,15,3,67,82
"Bolivia","Pando","Manuripi","Puerto Rico","UNIDAD EDUCATIVA SILVERIO ROJAS GONZALES",233346,13,2,96,109,37,0,57,94
"Bolivia","Pando","Manuripi","San Pedro","UNIDAD EDUCATIVA 12 DE ABRIL",233369,120,2,155,275,90,3,60,150
"Bolivia","Pando","Manuripi","San Pedro","UNIDAD EDUCATIVA FORTALEZA",233370,140,0,177,317,77,1,99,176
"Bolivia","Pando","Manuripi","San Pedro","UNIDAD EDUCATIVA JORGE HAENSEL",233371,20,2,135,155,86,1,46,132
"Bolivia","Pando","Nicolás Suárez","Bella Flor","ESCUELA SANTA ELENA",236201,7,0,11,18,6,0,5,11
"Bolivia","Pando","Nicolás Suárez","Bella Flor","UNIDAD EDUCATIVA BUENA VISTA",236202,45,1,80,125,46,1,32,78
"Bolivia","Pando","Nicolás Suárez","Bella Flor","UNIDAD EDUCATIVA DE FLORIDA",236203,5,0,18,23,1,0,17,18
"Bolivia","Pando","Nicolás Suárez","Bella Flor","UNIDAD EDUCATIVA HUGO ANTEQUERA",236204,94,4,320,414,178,9,129,307
"Bolivia","Pando","Nicolás Suárez","Bella Flor","UNIDAD EDUCATIVA JORGE BENITO VERA",236205,154,2,277,431,132,7,136,268
"Bolivia","Pando","Nicolás Suárez","Bella Flor","UNIDAD EDUCATIVA KM. 35 DE KARAMANU",236206,62,5,251,313,84,6,156,240
"Bolivia","Pando","Nicolás Suárez","Bella Flor","UNIDAD EDUCATIVA KM. 60 DE SAN ANTONIO",236207,48,4,143,191,50,0,89,139
"Bolivia","Pando","Nicolás Suárez","Bella Flor","UNIDAD EDUCATIVA MAPAJO",236208,30,1,69,99,32,0,36,68
"Bolivia","Pando","Nicolás Suárez","Bella Flor","UNIDAD EDUCATIVA SANTA LOURDES",236209,23,0,103,126,50,2,51,101
"Bolivia","Pando","Nicolás Suárez","Bella Flor","UNIDAD EDUCATIVA SIMON BOLÍVAR",236210,15,0,142,157,37,5,100,137
"Bolivia","Pando","Nicolás Suárez","Bolpebra","UNIDAD EDUCATIVA BIOCEANICA",233034,45,1,123,168,74,1,47,121
"Bolivia","Pando","Nicolás Suárez","Bolpebra","UNIDAD EDUCATIVA DE BOLPEBRA",233035,21,2,76,97,25,4,45,70
"Bolivia","Pando","Nicolás Suárez","Bolpebra","UNIDAD EDUCATIVA DE MUKDEN",233036,48,3,222,270,168,6,45,213
"Bolivia","Pando","Nicolás Suárez","Bolpebra","UNIDAD EDUCATIVA DE YAMINAHUA",233037,21,0,57,78,16,4,37,53
"Bolivia","Pando","Nicolás Suárez","Bolpebra","UNIDAD EDUCATIVA GENOVEVA RIOS",233038,62,3,218,280,111,3,101,212
"Bolivia","Pando","Nicolás Suárez","Bolpebra","UNIDAD EDUCATIVA NUEVA CANAÁN",233039,49,0,74,123,26,3,45,71
"Bolivia","Pando","Nicolás Suárez","Bolpebra","UNIDAD EDUCATIVA SAN MIGUEL",233040,4,0,12,16,0,0,12,12
"Bolivia","Pando","Nicolás Suárez","Bolpebra","UNIDAD EDUCATIVA SANTA LUCIA",233041,21,0,101,122,55,6,40,95
"Bolivia","Pando","Nicolás Suárez","Bolpebra","UNIDAD EDUCATIVA TRES ESTRELLAS",233042,15,0,65,80,28,1,36,64
"Bolivia","Pando","Nicolás Suárez","Cobija","CARCEL PUBLICA (VILLA BUSCH)",234355,37,2,131,168,61,4,64,125
"Bolivia","Pando","Nicolás Suárez","Cobija","KINDER VICTOR LEON ARUETA (VACA DIEZ MEDIO)",234356,82,1,280,362,195,7,77,272
"Bolivia","Pando","Nicolás Suárez","Cobija","UNIDAD EDUCATIVA 11 DE OCTUBRE",234357,404,10,1729,2133,1009,47,663,1672
"Bolivia","Pando","Nicolás Suárez","Cobija","UNIDAD EDUCATIVA AMERICA",234358,121,6,541,662,353,20,162,515
"Bolivia","Pando","Nicolás Suárez","Cobija","UNIDAD EDUCATIVA COBIJA",234359,761,16,2513,3274,1543,61,893,2436
"Bolivia","Pando","Nicolás Suárez","Cobija","UNIDAD EDUCATIVA DE BELLA VISTA",234360,184,9,920,1104,462,21,428,890
"Bolivia","Pando","Nicolás Suárez","Cobija","UNIDAD EDUCATIVA DEFENSORES DEL ACRE",234361,535,21,2110,2645,1216,46,827,2043
"Bolivia","Pando","Nicolás Suárez","Cobija","UNIDAD EDUCATIVA GERMAN BUSCH",234362,190,7,954,1144,543,18,386,929
"Bolivia","Pando","Nicolás Suárez","Cobija","UNIDAD EDUCATIVA INSTITUTO AMERICANO",234363,161,3,694,855,454,19,218,672
"Bolivia","Pando","Nicolás Suárez","Cobija","UNIDAD EDUCATIVA JOSÉ MANUEL PANDO",234364,546,28,2464,3010,1387,72,977,2364
"Bolivia","Pando","Nicolás Suárez","Cobija","UNIDAD EDUCATIVA JUANA AZURDUY DE PADILLA",234365,194,1,502,696,318,8,175,493
"Bolivia","Pando","Nicolás Suárez","Cobija","UNIDAD EDUCATIVA MANUELA ROJAS",234366,367,15,1822,2189,1158,57,592,1750
"Bolivia","Pando","Nicolás Suárez","Cobija","UNIDAD EDUCATIVA MARIANO BAPTISTA (EDIFICIO SEDUCA)",234367,233,4,916,1149,592,44,276,868
"Bolivia","Pando","Nicolás Suárez","Cobija","UNIDAD EDUCATIVA MARISCAL SUCRE",234368,615,21,2466,3081,1265,66,1114,2379
"Bolivia","Pando","Nicolás Suárez","Cobija","UNIDAD EDUCATIVA NUEVA ESPERANZA",234369,16,0,84,100,53,3,28,81
"Bolivia","Pando","Nicolás Suárez","Cobija","UNIDAD EDUCATIVA ROGELIA MENACHO DE BALCAZAR",234370,356,17,1672,2028,967,50,638,1605
"Bolivia","Pando","Nicolás Suárez","Cobija","UNIDAD EDUCATIVA SIMON BOLIVAR",234371,170,6,1195,1365,638,33,518,1156
"Bolivia","Pando","Nicolás Suárez","Cobija","UNIDAD EDUCATIVA SOFIA CALPIÑEIRO",234372,564,11,2347,2911,1518,65,753,2271
"Bolivia","Pando","Nicolás Suárez","Cobija","UNIDAD EDUCATIVA VACA DIEZ (INTERMEDIO)",234373,136,156,842,978,394,19,273,667
"Bolivia","Pando","Nicolás Suárez","Cobija","UNIDAD EDUCATIVA VACA DIEZ (MEDIO)",234374,166,0,576,742,379,20,177,556
"Bolivia","Pando","Nicolás Suárez","Cobija","UNIDAD EDUCATIVA VILLA CRUZ",234375,595,19,2955,3550,1735,84,1117,2852
"Bolivia","Pando","Nicolás Suárez","Porvenir","UNIDAD EDUCATIVA BRUNO RACUA",234376,288,9,1125,1413,462,29,625,1087
"Bolivia","Pando","Nicolás Suárez","Porvenir","UNIDAD EDUCATIVA GUTEMBERT CRUZ",234377,33,1,191,224,108,1,81,189
"Bolivia","Pando","Nicolás Suárez","Porvenir","UNIDAD EDUCATIVA MONS. SANTISTEBAN",234378,264,9,953,1217,435,13,496,931
"Bolivia","Pando","Nicolás Suárez","Porvenir","UNIDAD EDUCATIVA VILLA BELLA",234379,95,4,584,679,245,9,326,571
"Bolivia","Potosí","Alonso de Ibáñez","Caripuyo","ESCUELA CATARI",235803,21,0,100,121,10,5,85,95
"Bolivia","Potosí","Alonso de Ibáñez","Caripuyo","ESCUELA CHAICURIRI",235804,25,1,104,129,19,1,83,102
"Bolivia","Potosí","Alonso de Ibáñez","Caripuyo","ESCUELA CHALVIRI",235805,37,11,160,197,15,8,126,141
"Bolivia","Potosí","Alonso de Ibáñez","Caripuyo","ESCUELA CHOJLLA",235806,10,2,277,287,13,32,230,243
"Bolivia","Potosí","Alonso de Ibáñez","Caripuyo","ESCUELA COTANA",235807,113,25,466,579,55,13,373,428
"Bolivia","Potosí","Alonso de Ibáñez","Caripuyo","ESCUELA EDUARDO AVAROA",235808,187,65,815,1002,109,38,603,712
"Bolivia","Potosí","Alonso de Ibáñez","Caripuyo","ESCUELA HUANACHACA",235809,15,3,141,156,5,2,131,136
"Bolivia","Potosí","Alonso de Ibáñez","Caripuyo","ESCUELA HUANACOMA",235810,23,19,376,399,76,20,261,337
"Bolivia","Potosí","Alonso de Ibáñez","Caripuyo","ESCUELA JANCKO JANCKO",235811,66,4,311,377,50,29,228,278
"Bolivia","Potosí","Alonso de Ibáñez","Caripuyo","ESCUELA JUNTAVI",235812,53,7,401,454,11,11,372,383
"Bolivia","Potosí","Alonso de Ibáñez","Sacaca","COLEGIO JOSE ALONZO DE IBAÑEZ",232148,512,52,1970,2482,779,146,993,1772
"Bolivia","Potosí","Alonso de Ibáñez","Sacaca","ESCUELA CARCOMA",232149,92,0,491,583,16,1,474,490
"Bolivia","Potosí","Alonso de Ibáñez","Sacaca","ESCUELA CHARCA",232150,22,3,230,252,121,6,100,221
"Bolivia","Potosí","Alonso de Ibáñez","Sacaca","ESCUELA COLLOMA",232151,15,3,105,120,32,5,65,97
"Bolivia","Potosí","Alonso de Ibáñez","Sacaca","ESCUELA DE OVEJERIA",232152,46,5,701,747,88,27,581,669
"Bolivia","Potosí","Alonso de Ibáñez","Sacaca","ESCUELA ITURATA",232153,27,3,260,287,18,10,229,247
"Bolivia","Potosí","Alonso de Ibáñez","Sacaca","ESCUELA JARUMA",232154,14,8,309,323,125,18,158,283
"Bolivia","Potosí","Alonso de Ibáñez","Sacaca","ESCUELA LAYTOCO",232155,21,0,276,297,4,8,264,268
"Bolivia","Potosí","Alonso de Ibáñez","Sacaca","ESCUELA LAYUPAMPA",232156,41,25,439,480,52,23,339,391
"Bolivia","Potosí","Alonso de Ibáñez","Sacaca","ESCUELA SILLU SILLU",232157,3,4,440,443,22,9,405,427
"Bolivia","Potosí","Alonso de Ibáñez","Sacaca","ESCUELA VILA SIRCA",232158,28,4,115,143,36,6,69,105
"Bolivia","Potosí","Alonso de Ibáñez","Sacaca","ESCUELA VILA VILA",232159,27,3,623,650,28,26,566,594
"Bolivia","Potosí","Alonso de Ibáñez","Sacaca","SACANI",232160,10,0,373,383,19,7,347,366
"Bolivia","Potosí","Alonso de Ibáñez","Sacaca","TARHUA CHAPI",232161,65,24,565,630,54,27,460,514
"Bolivia","Potosí","Alonso de Ibáñez","Sacaca","UNIDAD EDUCATIVA BOLIVIA",232162,5,2,174,179,1,9,162,163
"Bolivia","Potosí","Alonso de Ibáñez","Sacaca","UNIDAD EDUCATIVA CAMACACHI",232163,0,1,90,90,0,0,89,89
"Bolivia","Potosí","Alonso de Ibáñez","Sacaca","UNIDAD EDUCATIVA JAYU JAYU",232164,2,10,155,157,4,5,136,140
"Bolivia","Potosí","Alonso de Ibáñez","Sacaca","UNIDAD EDUCATIVA LLAPA LLAPA",232165,2,2,82,84,6,1,73,79
"Bolivia","Potosí","Antonio Quijarro","Porco","ESCUELA AGUA CASTILLA",232961,148,16,1148,1296,844,43,245,1089
"Bolivia","Potosí","Antonio Quijarro","Porco","UNIDAD EDUCATIVA ANTONIO QUIJARRO DE CARMA",232962,27,1,128,155,109,6,12,121
"Bolivia","Potosí","Antonio Quijarro","Porco","UNIDAD EDUCATIVA CONCEPCION DE CHAQUILLA",232963,5,0,89,94,44,1,44,88
"Bolivia","Potosí","Antonio Quijarro","Porco","UNIDAD EDUCATIVA GUALBERTO VILLARROEL DE CHICHUYO",232964,22,1,113,135,62,5,45,107
"Bolivia","Potosí","Antonio Quijarro","Porco","UNIDAD EDUCATIVA JOSE MARIA LINARES",232965,161,13,1042,1203,729,31,269,998
"Bolivia","Potosí","Antonio Quijarro","Porco","UNIDAD EDUCATIVA SAN ANTONIO DE TORCUYO",232966,3,2,100,103,72,4,22,94
"Bolivia","Potosí","Antonio Quijarro","Porco","UNIDAD EDUCATIVA SAN GABRIEL DE CONDORIRI",232967,33,1,117,150,92,1,23,115
"Bolivia","Potosí","Antonio Quijarro","Porco","UNIDAD EDUCATIVA SAN JOSE DE TOPALA",232968,17,0,117,134,76,6,35,111
"Bolivia","Potosí","Antonio Quijarro","Porco","UNIDAD EDUCATIVA SANTA MARIA DE CHURCUITA",232969,24,2,119,143,82,3,32,114
"Bolivia","Potosí","Antonio Quijarro","Porco","UNIDAD EDUCATIVA SANTA ROSA",232970,199,23,1244,1443,841,46,334,1175
"Bolivia","Potosí","Antonio Quijarro","Tomave","COLEGIO ELIZARDO PEREZ A",235898,65,19,573,638,221,23,310,531
"Bolivia","Potosí","Antonio Quijarro","Tomave","COLEGIO SIMON RODRIGUEZ CARREÑO",235899,35,2,184,219,96,6,80,176
"Bolivia","Potosí","Antonio Quijarro","Tomave","COLEGIO TOMAS FRIAS",235900,129,33,438,567,224,21,160,384
"Bolivia","Potosí","Antonio Quijarro","Tomave","ESCUELA MARISCAL SUCRE",235901,75,14,394,469,179,21,180,359
"Bolivia","Potosí","Antonio Quijarro","Tomave","UNIDAD EDUCATIVA 10 DE NOVIEMBRE",235902,20,1,115,135,46,3,65,111
"Bolivia","Potosí","Antonio Quijarro","Tomave","UNIDAD EDUCATIVA 1RO. DE MAYO",235903,27,3,142,169,60,8,71,131
"Bolivia","Potosí","Antonio Quijarro","Tomave","UNIDAD EDUCATIVA 31 DE OCTUBRE",235904,14,1,128,142,77,5,45,122
"Bolivia","Potosí","Antonio Quijarro","Tomave","UNIDAD EDUCATIVA DANIEL CAMPOS",235905,37,8,144,181,55,6,75,130
"Bolivia","Potosí","Antonio Quijarro","Tomave","UNIDAD EDUCATIVA EDUARDO ABAROA",235906,14,3,133,147,58,5,67,125
"Bolivia","Potosí","Antonio Quijarro","Tomave","UNIDAD EDUCATIVA ELIZARDO PEREZ",235907,12,1,98,110,40,4,53,93
"Bolivia","Potosí","Antonio Quijarro","Tomave","UNIDAD EDUCATIVA FRANZ TAMAYO",235908,89,5,498,587,222,14,257,479
"Bolivia","Potosí","Antonio Quijarro","Tomave","UNIDAD EDUCATIVA FRANZ TAMAYO",235909,89,5,498,587,222,14,257,479
"Bolivia","Potosí","Antonio Quijarro","Tomave","UNIDAD EDUCATIVA FRANZ TAMAYO",235910,89,5,498,587,222,14,257,479
"Bolivia","Potosí","Antonio Quijarro","Tomave","UNIDAD EDUCATIVA GERMAN BUSCH",235911,39,1,267,306,71,13,182,253
"Bolivia","Potosí","Antonio Quijarro","Tomave","UNIDAD EDUCATIVA GERMAN BUSCH",235912,39,1,267,306,71,13,182,253
"Bolivia","Potosí","Antonio Quijarro","Tomave","UNIDAD EDUCATIVA JUANA AZURDUY DE PADILLA",235913,7,1,35,42,14,2,18,32
"Bolivia","Potosí","Antonio Quijarro","Tomave","UNIDAD EDUCATIVA JULIO LAREDO",235914,23,3,125,148,19,2,101,120
"Bolivia","Potosí","Antonio Quijarro","Tomave","UNIDAD EDUCATIVA MARISCAL DE AYACUCHO",235915,43,6,115,158,63,6,40,103
"Bolivia","Potosí","Antonio Quijarro","Tomave","UNIDAD EDUCATIVA MARISCAL JOSE DE SUCRE",235916,129,18,499,628,242,14,225,467
"Bolivia","Potosí","Antonio Quijarro","Tomave","UNIDAD EDUCATIVA RAFAEL PABON",235917,22,4,86,108,25,5,52,77
"Bolivia","Potosí","Antonio Quijarro","Tomave","UNIDAD EDUCATIVA RICARDO CRUZ",235918,67,3,164,231,47,11,103,150
"Bolivia","Potosí","Antonio Quijarro","Tomave","UNIDAD EDUCATIVA SIMON BOLIVAR",235920,11,3,266,277,36,26,201,237
"Bolivia","Potosí","Antonio Quijarro","Tomave","UNIDAD EDUCATIVA SIMON BOLIVAR",235919,11,3,266,277,36,26,201,237
"Bolivia","Potosí","Antonio Quijarro","Tomave","UNIDAD EDUCATIVA TOMAS FRIAS",235921,27,15,191,218,78,4,94,172
"Bolivia","Potosí","Antonio Quijarro","Uyuni","SUB SEDE UNIV. ECONOMIA",235880,301,33,1661,1962,712,68,848,1560
"Bolivia","Potosí","Antonio Quijarro","Uyuni","UNIDAD EDUCATIVA ALTO ALIANZA",235881,4,0,36,40,23,4,9,32
"Bolivia","Potosí","Antonio Quijarro","Uyuni","UNIDAD EDUCATIVA ANTONIO QUIJARRO",235882,654,41,3074,3728,1678,139,1216,2894
"Bolivia","Potosí","Antonio Quijarro","Uyuni","UNIDAD EDUCATIVA EDUARDO AVAROA",235883,21,3,241,262,149,12,77,226
"Bolivia","Potosí","Antonio Quijarro","Uyuni","UNIDAD EDUCATIVA FRANZ TAMAYO",235884,23,4,160,183,94,11,51,145
"Bolivia","Potosí","Antonio Quijarro","Uyuni","UNIDAD EDUCATIVA GERMAN BUSCH",235885,48,4,339,387,183,13,139,322
"Bolivia","Potosí","Antonio Quijarro","Uyuni","UNIDAD EDUCATIVA GUALBERTO VILLARROEL",235886,61,10,312,373,161,28,113,274
"Bolivia","Potosí","Antonio Quijarro","Uyuni","UNIDAD EDUCATIVA JAIME DE ZUDAÑES",235887,736,45,3224,3960,1718,113,1348,3066
"Bolivia","Potosí","Antonio Quijarro","Uyuni","UNIDAD EDUCATIVA JUANA AZURDUY DE PADILLA",235888,9,1,94,103,50,2,41,91
"Bolivia","Potosí","Antonio Quijarro","Uyuni","UNIDAD EDUCATIVA JUAN SANJINEZ",235889,63,42,490,553,250,15,183,433
"Bolivia","Potosí","Antonio Quijarro","Uyuni","UNIDAD EDUCATIVA KATARINA KRSUL",235890,120,26,718,838,476,27,189,665
"Bolivia","Potosí","Antonio Quijarro","Uyuni","UNIDAD EDUCATIVA MARISCAL BRAUN",235891,31,5,316,347,137,20,154,291
"Bolivia","Potosí","Antonio Quijarro","Uyuni","UNIDAD EDUCATIVA MARISCAL DE AYACUCHO",235892,36,8,177,213,57,9,103,160
"Bolivia","Potosí","Antonio Quijarro","Uyuni","UNIDAD EDUCATIVA POTOSI",235893,233,24,1350,1583,706,71,549,1255
"Bolivia","Potosí","Antonio Quijarro","Uyuni","UNIDAD EDUCATIVA PULACAYO A",235894,34,7,219,253,105,11,96,201
"Bolivia","Potosí","Antonio Quijarro","Uyuni","UNIDAD EDUCATIVA RICARDO RODRIGUEZ",235895,52,11,279,331,126,13,129,255
"Bolivia","Potosí","Antonio Quijarro","Uyuni","UNIDAD EDUCATIVA RIO MULATO",235896,71,20,437,508,213,16,188,401
"Bolivia","Potosí","Antonio Quijarro","Uyuni","UNIDAD EDUCATIVA UYUNI A",235897,321,27,1851,2172,1044,65,715,1759
"Bolivia","Potosí","Charcas","San Pedro De Buena Vista","COLEGIO NAL. CHARCAS",235734,855,167,2189,3044,517,100,1405,1922
"Bolivia","Potosí","Charcas","San Pedro De Buena Vista","ESCUELA ARAKANI",235735,1,2,156,157,0,2,152,152
"Bolivia","Potosí","Charcas","San Pedro De Buena Vista","ESCUELA CHIRO CKASA",235736,267,58,1164,1431,257,92,757,1014
"Bolivia","Potosí","Charcas","San Pedro De Buena Vista","ESCUELA IPOTE",235737,1,0,73,74,0,1,72,72
"Bolivia","Potosí","Charcas","San Pedro De Buena Vista","ESCUELA MARTIN CALA",235738,9,0,194,203,2,1,191,193
"Bolivia","Potosí","Charcas","San Pedro De Buena Vista","ESCUELA MOSCARI",235739,218,11,526,744,13,4,498,511
"Bolivia","Potosí","Charcas","San Pedro De Buena Vista","ESCUELA ÑEQUETA",235740,153,60,516,669,76,20,360,436
"Bolivia","Potosí","Charcas","San Pedro De Buena Vista","ESCUELA QUINAMARA",235741,160,3,269,429,11,23,232,243
"Bolivia","Potosí","Charcas","San Pedro De Buena Vista","ESCUELA SAN MARCOS",235742,105,0,617,722,5,0,612,617
"Bolivia","Potosí","Charcas","San Pedro De Buena Vista","ESCUELA SAPACARI",235743,62,10,163,225,40,7,106,146
"Bolivia","Potosí","Charcas","San Pedro De Buena Vista","ESCUELA SECCIONAL COTA COTA",235747,23,2,268,291,20,5,241,261
"Bolivia","Potosí","Charcas","San Pedro De Buena Vista","ESCUELA SECCIONAL ESKENCACHI",235744,95,40,424,519,65,18,301,366
"Bolivia","Potosí","Charcas","San Pedro De Buena Vista","ESCUELA SORA SORA",235745,3,1,62,65,12,1,48,60
"Bolivia","Potosí","Charcas","San Pedro De Buena Vista","ESCUELA TORACARI",235746,246,30,559,805,158,29,342,500
"Bolivia","Potosí","Charcas","San Pedro De Buena Vista","NUCLEO EDUCATIVO BANDURIRI",235748,7,4,358,365,11,7,336,347
"Bolivia","Potosí","Charcas","San Pedro De Buena Vista","NUCLEO ESCOLAR MICANI",235749,114,12,917,1031,13,3,889,902
"Bolivia","Potosí","Charcas","Toro Toro","ESCUELA PALLA PALLA",235750,55,3,412,467,16,6,387,403
"Bolivia","Potosí","Charcas","Toro Toro","ESCUELA SECCIONAL",235751,36,2,390,426,13,4,371,384
"Bolivia","Potosí","Charcas","Toro Toro","ESCUELA SECCIONAL AÑAHUANI",235752,64,9,350,414,17,7,317,334
"Bolivia","Potosí","Charcas","Toro Toro","ESCUELA SECCIONAL CARASI",235753,142,7,453,595,39,12,395,434
"Bolivia","Potosí","Charcas","Toro Toro","ESCUELA TORO TORO",235754,451,37,1814,2265,347,77,1353,1700
"Bolivia","Potosí","Charcas","Toro Toro","ESCUELA TORO TORO",235755,451,37,1814,2265,347,77,1353,1700
"Bolivia","Potosí","Charcas","Toro Toro","ESCUELA YAMBATA",235756,61,3,282,343,25,8,246,271
"Bolivia","Potosí","Charcas","Toro Toro","NUCLEO POCO SUCO",235757,49,4,257,306,11,6,236,247
"Bolivia","Potosí","Chayanta","Colquechaca","COLEGIO TOMAS CATARI",235670,642,157,1752,2394,211,131,1253,1464
"Bolivia","Potosí","Chayanta","Colquechaca","ESCUELA AYOMA",235671,185,45,452,637,69,28,310,379
"Bolivia","Potosí","Chayanta","Colquechaca","ESCUELA CENTRAL ULUCHI",235672,166,47,864,1030,150,65,602,752
"Bolivia","Potosí","Chayanta","Colquechaca","ESCUELA GUADALUPE",235673,143,4,555,698,21,2,528,549
"Bolivia","Potosí","Chayanta","Colquechaca","ESCUELA GUALBERTO VILLARROEL TITIRI",235674,31,3,145,176,7,6,129,136
"Bolivia","Potosí","Chayanta","Colquechaca","ESCUELA JACINTO PINTO DE PHUTINA",235675,207,13,637,844,88,19,517,605
"Bolivia","Potosí","Chayanta","Colquechaca","ESCUELA JAIME MENDOZA",235676,69,8,674,743,66,95,505,571
"Bolivia","Potosí","Chayanta","Colquechaca","ESCUELA JAMANCHIRI",235677,29,3,141,170,5,13,120,125
"Bolivia","Potosí","Chayanta","Colquechaca","ESCUELA JUNIN",235678,269,44,893,1162,355,84,410,765
"Bolivia","Potosí","Chayanta","Colquechaca","ESCUELA MARCELO QUIRVES",235679,110,50,338,448,69,39,180,249
"Bolivia","Potosí","Chayanta","Colquechaca","ESCUELA MEJILLONES DE CAYARANI",235680,32,2,279,311,17,47,213,230
"Bolivia","Potosí","Chayanta","Colquechaca","ESCUELA ROSARIO",235681,59,26,418,477,41,17,334,375
"Bolivia","Potosí","Chayanta","Colquechaca","ESCUELA SALINAS",235682,69,28,711,780,101,33,549,650
"Bolivia","Potosí","Chayanta","Colquechaca","ESCUELA S. BOLIVAR CHOQUECAYARA",235683,35,19,208,243,46,22,121,167
"Bolivia","Potosí","Chayanta","Colquechaca","ESCUELA SECCIONAL SALINAS DE MACHA",235684,41,0,150,191,22,11,117,139
"Bolivia","Potosí","Chayanta","Colquechaca","OFIC. CORREGIMIENTO",235685,231,17,484,715,37,11,419,456
"Bolivia","Potosí","Chayanta","Colquechaca","TOMAYCURI",235686,153,26,508,661,118,26,338,456
"Bolivia","Potosí","Chayanta","Colquechaca","UNIDAD EDUCATIVA AYACUCHO DE SICUTA",235687,19,6,238,257,4,6,222,226
"Bolivia","Potosí","Chayanta","Colquechaca","UNIDAD EDUCATIVA MILLURI",235688,4,1,100,104,14,10,75,89
"Bolivia","Potosí","Chayanta","Colquechaca","UNIDAD EDUCATIVA ROBERTO ALVARADO",235689,235,50,881,1116,414,68,349,763
"Bolivia","Potosí","Chayanta","Ocuri","COLEGIO DANIEL SALAMANCA",232138,338,62,843,1181,256,60,465,721
"Bolivia","Potosí","Chayanta","Ocuri","COLEGIO NAC. MARCELO QUIROGA SANTA CRUZ",232139,364,40,850,1214,226,91,493,719
"Bolivia","Potosí","Chayanta","Ocuri","ESCUELA KARA KARA",232140,102,33,337,439,84,21,199,283
"Bolivia","Potosí","Chayanta","Ocuri","ESCUELA MARAGUA",232141,268,32,515,783,171,59,253,424
"Bolivia","Potosí","Chayanta","Ocuri","ESCUELA ROCO ROCO",232142,17,2,84,101,8,4,70,78
"Bolivia","Potosí","Chayanta","Ocuri","ESCUELA SECCIONAL MARCOMA",232143,87,22,326,413,90,19,195,285
"Bolivia","Potosí","Chayanta","Ocuri","ESCUELA SIMON BOLIVAR DE PEANA",232144,54,6,366,420,31,16,313,344
"Bolivia","Potosí","Chayanta","Ocuri","ESCUELA YURIMATA",232145,63,18,237,300,55,13,151,206
"Bolivia","Potosí","Chayanta","Ocuri","UNIDAD EDUCATIVA CHAUPI LOMA",232146,3,2,65,68,15,11,37,52
"Bolivia","Potosí","Chayanta","Ocuri","UNIDAD EDUCATIVA COLLPA",232147,10,13,158,168,25,7,113,138
"Bolivia","Potosí","Chayanta","Pocoata","ESCUELA ACHACANA",235712,100,2,465,565,12,18,433,445
"Bolivia","Potosí","Chayanta","Pocoata","ESCUELA CACHUYO",235713,39,17,260,299,39,14,190,229
"Bolivia","Potosí","Chayanta","Pocoata","ESCUELA CAMPAYA",235714,68,12,1019,1087,84,12,911,995
"Bolivia","Potosí","Chayanta","Pocoata","ESCUELA CENTRAL JACHATAJO",235715,67,17,231,298,11,8,195,206
"Bolivia","Potosí","Chayanta","Pocoata","ESCUELA CENTRAL VILLA ALCARAPI",235716,19,0,329,348,16,12,301,317
"Bolivia","Potosí","Chayanta","Pocoata","ESCUELA CHAYALA",235717,164,6,291,455,22,5,258,280
"Bolivia","Potosí","Chayanta","Pocoata","ESCUELA COLLANA TUICA",235718,29,12,373,402,17,7,337,354
"Bolivia","Potosí","Chayanta","Pocoata","ESCUELA COLLPA CKASA",235719,36,4,235,271,40,7,184,224
"Bolivia","Potosí","Chayanta","Pocoata","ESCUELA HUANCARANI",235720,146,56,638,784,133,34,415,548
"Bolivia","Potosí","Chayanta","Pocoata","ESCUELA JARANA",235721,65,27,342,407,54,20,241,295
"Bolivia","Potosí","Chayanta","Pocoata","ESCUELA KAPARANCHO",235722,19,7,126,145,19,7,93,112
"Bolivia","Potosí","Chayanta","Pocoata","ESCUELA PACOTANCA",235723,33,2,97,130,6,0,89,95
"Bolivia","Potosí","Chayanta","Pocoata","ESCUELA PEDRO GUTIERREZ",235724,484,118,1818,2302,559,146,995,1554
"Bolivia","Potosí","Chayanta","Pocoata","ESCUELA SAN MIGUEL DE KARI",235725,3,3,385,388,42,14,326,368
"Bolivia","Potosí","Chayanta","Pocoata","ESCUELA SAYI",235726,4,0,174,178,5,12,157,162
"Bolivia","Potosí","Chayanta","Pocoata","ESCUELA SECCIONAL SENAJO",235727,16,5,77,93,30,4,38,68
"Bolivia","Potosí","Chayanta","Pocoata","ESCUELA SECCIONAL TURBERIA",235728,118,18,531,649,47,59,407,454
"Bolivia","Potosí","Chayanta","Pocoata","ESCUELA SECCIONAL YAHUACO",235729,14,5,83,97,13,10,55,68
"Bolivia","Potosí","Chayanta","Pocoata","ESCUELA TOMOYO",235730,41,1,187,228,34,5,147,181
"Bolivia","Potosí","Chayanta","Pocoata","ESCUELA VILA VILA",235731,10,3,323,333,26,6,288,314
"Bolivia","Potosí","Chayanta","Pocoata","NUCLEO ESCOLAR JUAN DE ARROZ PATA",235732,8,5,104,112,25,7,67,92
"Bolivia","Potosí","Chayanta","Pocoata","NUCLEO ESCOLAR KESIMPUCU",235733,13,27,399,412,73,33,266,339
"Bolivia","Potosí","Chayanta","Ravelo","COLEGIO JOSE ALONSO DE IBAÑEZ",235690,28,27,252,280,21,9,195,216
"Bolivia","Potosí","Chayanta","Ravelo","ESCUELA ANTORA",235691,72,21,278,350,52,30,175,227
"Bolivia","Potosí","Chayanta","Ravelo","ESCUELA CENTRAL 1º DE MAYO",235692,78,9,235,313,36,19,171,207
"Bolivia","Potosí","Chayanta","Ravelo","ESCUELA CENTRAL RODEO HUAYLLAS",235693,107,36,358,465,67,14,241,308
"Bolivia","Potosí","Chayanta","Ravelo","ESCUELA CENTRAL SAUCY MAYU",235694,65,20,359,424,59,17,263,322
"Bolivia","Potosí","Chayanta","Ravelo","ESCUELA CHALLUMA",235695,9,8,119,128,12,6,93,105
"Bolivia","Potosí","Chayanta","Ravelo","ESCUELA CHIPIRINA",235696,23,1,101,124,19,10,71,90
"Bolivia","Potosí","Chayanta","Ravelo","ESCUELA HUAYCOMA",235697,75,23,189,264,34,19,113,147
"Bolivia","Potosí","Chayanta","Ravelo","ESCUELA LACAYANI",235698,52,30,271,323,37,14,190,227
"Bolivia","Potosí","Chayanta","Ravelo","ESCUELA LAMPHASUNI",235699,18,1,116,134,7,9,99,106
"Bolivia","Potosí","Chayanta","Ravelo","ESCUELA M. ASCENCIO PADILLA",235700,378,54,1383,1761,459,96,774,1233
"Bolivia","Potosí","Chayanta","Ravelo","ESCUELA MOROTO",235701,13,9,77,90,2,4,62,64
"Bolivia","Potosí","Chayanta","Ravelo","ESCUELA PITANTORA",235702,99,5,266,365,14,20,227,241
"Bolivia","Potosí","Chayanta","Ravelo","ESCUELA SASANTA",235703,35,3,243,278,52,13,175,227
"Bolivia","Potosí","Chayanta","Ravelo","ESCUELA SECCIONAL MOKO KOTANI",235704,65,14,132,197,7,5,106,113
"Bolivia","Potosí","Chayanta","Ravelo","ESCUELA SECCIONAL MOLLE MOLLE",235705,68,52,444,512,55,19,318,373
"Bolivia","Potosí","Chayanta","Ravelo","ESCUELA SECC. LUQUI PAMPA",235706,44,5,98,142,19,17,57,76
"Bolivia","Potosí","Chayanta","Ravelo","ESCUELA SECC TEJA MOLINO",235707,71,1,151,222,21,11,118,139
"Bolivia","Potosí","Chayanta","Ravelo","ESCUELA S. YURUBAMBA",235708,56,20,340,396,71,17,232,303
"Bolivia","Potosí","Chayanta","Ravelo","ESCUELA TOMOYO",235709,76,38,316,392,50,27,201,251
"Bolivia","Potosí","Chayanta","Ravelo","TOROCA",235710,22,2,146,168,6,7,131,137
"Bolivia","Potosí","Chayanta","Ravelo","UNIDAD EDUCATIVA JANINA",235711,20,4,199,219,75,14,106,181
"Bolivia","Potosí","Cornelio Saavedra","Betanzos","CENTRAL ELIZARDO PEREZ",235624,89,16,368,457,74,19,259,333
"Bolivia","Potosí","Cornelio Saavedra","Betanzos","COLEGIO R. BOHORQUEZ",235625,334,54,1686,2020,865,95,672,1537
"Bolivia","Potosí","Cornelio Saavedra","Betanzos","ESCUELA ALONZO DE IBAÑEZ",235626,65,11,395,460,90,12,282,372
"Bolivia","Potosí","Cornelio Saavedra","Betanzos","ESCUELA ANCO MAYU",235627,16,0,70,86,3,1,66,69
"Bolivia","Potosí","Cornelio Saavedra","Betanzos","ESCUELA BLAS S. DE PEDRO",235628,35,1,110,145,25,9,75,100
"Bolivia","Potosí","Cornelio Saavedra","Betanzos","ESCUELA BUEY TAMBO",235629,74,7,312,386,93,22,190,283
"Bolivia","Potosí","Cornelio Saavedra","Betanzos","ESCUELA CAMALI",235630,84,17,443,527,54,15,357,411
"Bolivia","Potosí","Cornelio Saavedra","Betanzos","ESCUELA CENTRAL OTUYO",235631,82,13,295,377,49,8,225,274
"Bolivia","Potosí","Cornelio Saavedra","Betanzos","ESCUELA CENTRAL TECOYA",235632,302,112,1167,1469,243,57,755,998
"Bolivia","Potosí","Cornelio Saavedra","Betanzos","ESCUELA CENTRAL VILA VILA",235633,94,6,376,470,70,37,263,333
"Bolivia","Potosí","Cornelio Saavedra","Betanzos","ESCUELA DE HUANO HUANO",235634,48,10,125,173,27,8,80,107
"Bolivia","Potosí","Cornelio Saavedra","Betanzos","ESCUELA DE MAMAHOTA",235635,36,12,238,274,27,6,193,220
"Bolivia","Potosí","Cornelio Saavedra","Betanzos","ESCUELA DE MARIACA",235636,67,12,240,307,19,8,201,220
"Bolivia","Potosí","Cornelio Saavedra","Betanzos","ESCUELA ELIZARDO PEREZ",235637,38,15,182,220,37,7,123,160
"Bolivia","Potosí","Cornelio Saavedra","Betanzos","ESCUELA GERMAN BUSH",235638,47,8,340,387,151,26,155,306
"Bolivia","Potosí","Cornelio Saavedra","Betanzos","ESCUELA MEDIA LUNA",235639,16,0,70,86,4,2,64,68
"Bolivia","Potosí","Cornelio Saavedra","Betanzos","ESCUELA MODESTO OMISTE",235640,347,41,1391,1738,664,70,616,1280
"Bolivia","Potosí","Cornelio Saavedra","Betanzos","ESCUELA POCO POCO",235641,139,8,527,666,109,20,390,499
"Bolivia","Potosí","Cornelio Saavedra","Betanzos","ESCUELA POTOBAMBA",235642,58,0,241,299,21,2,218,239
"Bolivia","Potosí","Cornelio Saavedra","Betanzos","ESCUELA POTONGO ALTO",235643,9,0,65,74,0,2,63,63
"Bolivia","Potosí","Cornelio Saavedra","Betanzos","ESCUELA SECCIONAL DE SAN PEDRO DE COLILA",235644,21,1,132,153,8,2,121,129
"Bolivia","Potosí","Cornelio Saavedra","Betanzos","ESCUELA TARIJA CUCHU",235645,66,17,317,383,67,21,212,279
"Bolivia","Potosí","Cornelio Saavedra","Betanzos","ESCUELA TAURI CANCHA",235646,203,60,1079,1282,541,55,423,964
"Bolivia","Potosí","Cornelio Saavedra","Betanzos","ESCUELA TIRISPAYA",235647,45,2,229,274,2,12,213,215
"Bolivia","Potosí","Cornelio Saavedra","Betanzos","ESCUELA TRAPICHE ALTA",235648,20,1,144,164,66,3,74,140
"Bolivia","Potosí","Cornelio Saavedra","Betanzos","ESCUELA TROJA PAMPA",235649,21,8,189,210,11,6,164,175
"Bolivia","Potosí","Cornelio Saavedra","Betanzos","ESCUELA UNZAGA DE LA VEGA",235650,71,7,515,586,128,22,358,486
"Bolivia","Potosí","Cornelio Saavedra","Betanzos","ESCUELA URIFAYA",235651,4,1,235,239,12,2,220,232
"Bolivia","Potosí","Cornelio Saavedra","Betanzos","ESCUELA VILLA IMPERIAL",235652,84,49,314,398,56,13,196,252
"Bolivia","Potosí","Cornelio Saavedra","Betanzos","ESCUELA VIÑA QUEMADA",235653,15,9,102,117,26,6,61,87
"Bolivia","Potosí","Cornelio Saavedra","Betanzos","KINDER VILLA IMPERIAL",235654,162,42,949,1111,381,65,461,842
"Bolivia","Potosí","Cornelio Saavedra","Chaqui","COLEGIO VILLA IMPERIAL",232129,140,30,512,652,232,72,178,410
"Bolivia","Potosí","Cornelio Saavedra","Chaqui","ESCUELA ANDRES DE SANTA CRUZ",232130,306,52,1152,1458,563,97,440,1003
"Bolivia","Potosí","Cornelio Saavedra","Chaqui","ESCUELA C. CHIUTALUYO",232131,135,37,351,486,137,63,114,251
"Bolivia","Potosí","Cornelio Saavedra","Chaqui","ESCUELA CENTRAL EL PALOMAR",232132,57,5,169,226,28,6,130,158
"Bolivia","Potosí","Cornelio Saavedra","Chaqui","ESCUELA CHARCA FLORIDA",232133,34,1,103,137,26,4,72,98
"Bolivia","Potosí","Cornelio Saavedra","Chaqui","ESCUELA CHICO CHICO",232134,130,41,320,450,72,23,184,256
"Bolivia","Potosí","Cornelio Saavedra","Chaqui","ESCUELA DON DIEGO",232135,66,13,469,535,311,29,116,427
"Bolivia","Potosí","Cornelio Saavedra","Chaqui","ESCUELA RODERO",232136,34,11,166,200,70,14,71,141
"Bolivia","Potosí","Cornelio Saavedra","Chaqui","ESCUELA SAN ANTONIO",232137,90,13,228,318,95,16,104,199
"Bolivia","Potosí","Cornelio Saavedra","Tacobamba","COLEGIO GUALBERTO VILLARROEL",235655,46,8,213,259,133,17,55,188
"Bolivia","Potosí","Cornelio Saavedra","Tacobamba","ESCUELA ANCOMA",235656,58,2,258,316,20,0,236,256
"Bolivia","Potosí","Cornelio Saavedra","Tacobamba","ESCUELA CAJAS ALTA",235657,60,0,163,223,74,14,75,149
"Bolivia","Potosí","Cornelio Saavedra","Tacobamba","ESCUELA CENTRAL MACHACAMARCA",235658,10,0,55,65,32,4,19,51
"Bolivia","Potosí","Cornelio Saavedra","Tacobamba","ESCUELA CHALLVIRI",235659,47,5,210,257,116,14,75,191
"Bolivia","Potosí","Cornelio Saavedra","Tacobamba","ESCUELA C. MIGMA",235660,95,13,197,292,84,16,84,168
"Bolivia","Potosí","Cornelio Saavedra","Tacobamba","ESCUELA GENOVEVA RIOS",235661,57,16,221,278,90,5,110,200
"Bolivia","Potosí","Cornelio Saavedra","Tacobamba","ESCUELA HUAJCHI BAJO",235662,38,1,67,105,17,3,46,63
"Bolivia","Potosí","Cornelio Saavedra","Tacobamba","ESCUELA JURUNA",235663,50,5,284,334,21,10,248,269
"Bolivia","Potosí","Cornelio Saavedra","Tacobamba","ESCUELA RODEO",235664,70,2,182,252,16,12,152,168
"Bolivia","Potosí","Cornelio Saavedra","Tacobamba","ESCUELA SECCIONAL TRAPICHE BAJO",235665,12,1,69,81,26,4,38,64
"Bolivia","Potosí","Cornelio Saavedra","Tacobamba","ESCUELA SIMON BOLIVAR",235666,22,2,44,66,21,3,18,39
"Bolivia","Potosí","Cornelio Saavedra","Tacobamba","ESCUELA TACOBAMBA",235667,264,64,550,814,131,32,323,454
"Bolivia","Potosí","Cornelio Saavedra","Tacobamba","ESCUELA YAGUACARI",235668,20,2,86,106,20,3,61,81
"Bolivia","Potosí","Cornelio Saavedra","Tacobamba","UNIDAD EDUCATIVA FRANZ TAMAYO",235669,37,2,266,303,16,6,242,258
"Bolivia","Potosí","Daniel Campos","Llica","UNIDAD EDUCATIVA BERNABE LEDEZMA",234818,13,0,66,79,8,1,57,65
"Bolivia","Potosí","Daniel Campos","Llica","UNIDAD EDUCATIVA CANQUELLA",234819,14,0,65,79,19,0,46,65
"Bolivia","Potosí","Daniel Campos","Llica","UNIDAD EDUCATIVA ELIZARDO PEREZ",234820,4,1,54,58,6,2,45,51
"Bolivia","Potosí","Daniel Campos","Llica","UNIDAD EDUCATIVA FRANZ TAMAYO",234821,240,14,1053,1293,326,24,689,1015
"Bolivia","Potosí","Daniel Campos","Llica","UNIDAD EDUCATIVA HUANAQUE",234822,24,4,89,113,13,0,72,85
"Bolivia","Potosí","Daniel Campos","Llica","UNIDAD EDUCATIVA MANUAL ANTONIO AGUIRRE",234823,23,1,70,93,10,1,58,68
"Bolivia","Potosí","Daniel Campos","Llica","UNIDAD EDUCATIVA PALAYA",234824,15,3,95,110,16,1,75,91
"Bolivia","Potosí","Daniel Campos","Llica","UNIDAD EDUCATIVA PEDRO GARCIA IGNACIO",234825,16,3,62,78,19,0,40,59
"Bolivia","Potosí","Daniel Campos","Llica","UNIDAD EDUCATIVA VILLQUE",234826,3,1,33,36,4,0,28,32
"Bolivia","Potosí","Daniel Campos","Tahua","ESCUELA JARUMA",234827,9,0,24,33,1,0,23,24
"Bolivia","Potosí","Daniel Campos","Tahua","ESCUELA TAMANCASA",234828,5,0,27,32,5,2,20,25
"Bolivia","Potosí","Daniel Campos","Tahua","UNIDAD EDUCATIVA ANICETO ARCE",234829,2,0,20,22,3,0,17,20
"Bolivia","Potosí","Daniel Campos","Tahua","UNIDAD EDUCATIVA BERNABE LEDEZMA",234830,7,4,60,67,6,0,50,56
"Bolivia","Potosí","Daniel Campos","Tahua","UNIDAD EDUCATIVA CAQUENA",234831,17,1,78,95,34,3,40,74
"Bolivia","Potosí","Daniel Campos","Tahua","UNIDAD EDUCATIVA FRANZ TAMAYO",234832,1,2,120,121,37,1,80,117
"Bolivia","Potosí","Daniel Campos","Tahua","UNIDAD EDUCATIVA GERMAN BUSCH",234833,4,0,35,39,10,1,24,34
"Bolivia","Potosí","Daniel Campos","Tahua","UNIDAD EDUCATIVA JOHN F. KENNEDY",234834,30,5,178,208,35,5,133,168
"Bolivia","Potosí","Enrique Baldivieso","San Agustin","ESCUELA SAN AGUSTIN",233075,67,6,223,290,70,6,141,211
"Bolivia","Potosí","Enrique Baldivieso","San Agustin","ESCUELA VICTOR PAZ ESTENSORO",233076,10,0,132,142,40,3,89,129
"Bolivia","Potosí","Enrique Baldivieso","San Agustin","UNIDAD EDUCATIVA 1RO DE MAYO",233077,4,0,89,93,8,0,81,89
"Bolivia","Potosí","Enrique Baldivieso","San Agustin","UNIDAD EDUCATIVA ELIZARDO PEREZ",233078,10,1,78,88,15,1,61,76
"Bolivia","Potosí","Enrique Baldivieso","San Agustin","UNIDAD EDUCATIVA LITORAL",233079,36,4,223,259,109,5,105,214
"Bolivia","Potosí","General Bernardino B","Acasio","ESCUELA CHURITACA",233043,78,7,417,495,12,9,389,401
"Bolivia","Potosí","General Bernardino B","Acasio","ESCUELA JOSE RIVERO",233044,206,21,746,952,223,27,475,698
"Bolivia","Potosí","General Bernardino B","Acasio","ESCUELA PIRIQUINA",233045,49,9,233,282,15,4,205,220
"Bolivia","Potosí","General Bernardino B","Acasio","ESCUELA TACONI DE CAINE",233046,14,2,81,95,9,0,70,79
"Bolivia","Potosí","General Bernardino B","Acasio","ESCUELA TACONI YAMBATA",233047,72,5,165,237,1,2,157,158
"Bolivia","Potosí","General Bernardino B","Acasio","ESCUELA TUQUIZA",233048,41,11,208,249,15,5,177,192
"Bolivia","Potosí","General Bernardino B","Arampampa","ESCUELA ARAMPAMPA",234807,50,14,225,275,54,27,130,184
"Bolivia","Potosí","General Bernardino B","Arampampa","ESCUELA CALACHUA",234808,17,0,121,138,2,2,117,119
"Bolivia","Potosí","General Bernardino B","Arampampa","ESCUELA CATACORA",234809,43,1,94,137,5,0,88,93
"Bolivia","Potosí","General Bernardino B","Arampampa","ESCUELA CHARCA MARCAVI",234810,7,0,51,58,0,2,49,49
"Bolivia","Potosí","General Bernardino B","Arampampa","ESCUELA HUAYCURI",234811,7,0,28,35,3,0,25,28
"Bolivia","Potosí","General Bernardino B","Arampampa","ESCUELA HUMAVIZA",234812,4,1,16,20,4,2,9,13
"Bolivia","Potosí","General Bernardino B","Arampampa","ESCUELA MOLLEVILQUE",234813,7,0,42,49,3,1,38,41
"Bolivia","Potosí","General Bernardino B","Arampampa","ESCUELA PARARANI",234814,8,0,58,66,0,0,58,58
"Bolivia","Potosí","General Bernardino B","Arampampa","ESCUELA QOARACA",234815,1,0,95,96,2,3,90,92
"Bolivia","Potosí","General Bernardino B","Arampampa","ESCUELA SANTIAGO",234816,88,5,366,454,23,8,330,353
"Bolivia","Potosí","General Bernardino B","Arampampa","ESCUELA SARCURI",234817,37,2,201,238,0,1,198,198
"Bolivia","Potosí","José María Linares","Caiza D","COLEGIO FRANZ TAMAYO",232203,64,17,502,566,318,23,144,462
"Bolivia","Potosí","José María Linares","Caiza D","ESCUELA DE KALTAPI",232204,20,2,123,143,60,3,58,118
"Bolivia","Potosí","José María Linares","Caiza D","ESCUELA DE PANOCOCHI",232205,47,3,145,192,15,9,118,133
"Bolivia","Potosí","José María Linares","Caiza D","ESCUELA HORNOS",232206,92,5,253,345,67,14,167,234
"Bolivia","Potosí","José María Linares","Caiza D","ESCUELA LA FRAGUA",232207,29,4,154,183,18,9,123,141
"Bolivia","Potosí","José María Linares","Caiza D","ESCUELA LA LAVA",232208,79,15,372,451,134,21,202,336
"Bolivia","Potosí","José María Linares","Caiza D","ESCUELA PALCA CANCHA",232209,31,0,74,105,29,2,43,72
"Bolivia","Potosí","José María Linares","Caiza D","ESCUELA SECCIONAL CHILLMA",232210,58,15,309,367,156,23,115,271
"Bolivia","Potosí","José María Linares","Caiza D","ESCUELA TRES CRUCES",232211,253,40,801,1054,299,44,418,717
"Bolivia","Potosí","José María Linares","Caiza D","ESCUELA TUCTAPARI",232212,34,10,210,244,116,10,74,190
"Bolivia","Potosí","José María Linares","Caiza D","NORMAL RURAL CAIZA D",232213,212,28,953,1165,475,31,419,894
"Bolivia","Potosí","José María Linares","Ckochas","ESCUELA ALEJANDRO CORONADO",235957,21,0,167,188,43,19,105,148
"Bolivia","Potosí","José María Linares","Ckochas","ESCUELA CENTRAL EUSEBIO B. FLORES",235958,47,18,238,285,32,9,179,211
"Bolivia","Potosí","José María Linares","Ckochas","ESCUELA CKOCHAS",235959,152,26,698,850,265,39,368,633
"Bolivia","Potosí","José María Linares","Ckochas","ESCUELA DE CALAPAYA",235960,74,22,182,256,54,6,100,154
"Bolivia","Potosí","José María Linares","Ckochas","ESCUELA DE MELENA ALTA",235961,37,4,221,258,55,7,155,210
"Bolivia","Potosí","José María Linares","Ckochas","ESCUELA DE MOJON CKASA",235962,115,7,349,464,60,11,271,331
"Bolivia","Potosí","José María Linares","Ckochas","ESCUELA DE QUELUYO",235963,128,8,297,425,61,24,204,265
"Bolivia","Potosí","José María Linares","Ckochas","ESCUELA DURAZNOS",235964,56,4,240,296,54,12,170,224
"Bolivia","Potosí","José María Linares","Ckochas","ESCUELA ESQUIRI",235965,15,1,72,87,37,4,30,67
"Bolivia","Potosí","José María Linares","Ckochas","ESCUELA JOSE MA.LINARES",235966,46,2,140,186,41,7,90,131
"Bolivia","Potosí","José María Linares","Ckochas","ESCUELA LAJAS",235967,16,0,152,168,2,0,150,152
"Bolivia","Potosí","José María Linares","Ckochas","ESCUELA MEDIA LUNA",235968,20,4,255,275,7,4,240,247
"Bolivia","Potosí","José María Linares","Ckochas","ESCUELA RODEO PAMPA",235969,1,1,75,76,5,0,69,74
"Bolivia","Potosí","José María Linares","Ckochas","ESCUELA SAN PEDRO DE ESQUIRI",235970,14,1,63,77,22,0,40,62
"Bolivia","Potosí","José María Linares","Ckochas","ESCUELA SECCIONAL",235971,215,9,538,753,29,19,481,510
"Bolivia","Potosí","José María Linares","Ckochas","ESCUELA SECCIONAL CAPILLANI",235972,35,3,104,139,33,7,61,94
"Bolivia","Potosí","José María Linares","Ckochas","ESCUELA SECCIONAL HUAYLLAJARA",235973,35,3,141,176,21,3,114,135
"Bolivia","Potosí","José María Linares","Ckochas","ESCUELA SECCIONAL UYUNI",235974,58,2,132,190,25,3,102,127
"Bolivia","Potosí","José María Linares","Ckochas","ESCUELA SEUCOCHI",235975,111,13,339,450,32,14,280,312
"Bolivia","Potosí","José María Linares","Ckochas","ESCUELA SUCHINA",235976,29,1,83,112,15,2,65,80
"Bolivia","Potosí","José María Linares","Ckochas","SECC. CARPA HUATA",235977,19,1,59,78,12,2,44,56
"Bolivia","Potosí","José María Linares","Puna(C.Villa Talavera)","COLEGIO LITORAL",233165,223,50,819,1042,396,55,318,714
"Bolivia","Potosí","José María Linares","Puna(C.Villa Talavera)","ESCUELA BELEN",233166,88,26,307,395,118,19,144,262
"Bolivia","Potosí","José María Linares","Puna(C.Villa Talavera)","ESCUELA CENTRAL",233167,49,2,195,244,84,14,95,179
"Bolivia","Potosí","José María Linares","Puna(C.Villa Talavera)","ESCUELA CENTRAL JOSE MARIA LINARES",233168,43,4,340,383,119,13,204,323
"Bolivia","Potosí","José María Linares","Puna(C.Villa Talavera)","ESCUELA DE ALCATUYO",233169,106,7,324,430,180,15,122,302
"Bolivia","Potosí","José María Linares","Puna(C.Villa Talavera)","ESCUELA DE HUAYCAYA",233170,52,9,193,245,127,3,54,181
"Bolivia","Potosí","José María Linares","Puna(C.Villa Talavera)","ESCUELA DE KEPALLO",233171,172,8,418,590,127,14,269,396
"Bolivia","Potosí","José María Linares","Puna(C.Villa Talavera)","ESCUELA DE LA ESMERALDA",233172,77,30,307,384,125,13,139,264
"Bolivia","Potosí","José María Linares","Puna(C.Villa Talavera)","ESCUELA DE NUQUI",233173,87,3,221,308,77,5,136,213
"Bolivia","Potosí","José María Linares","Puna(C.Villa Talavera)","ESCUELA DE SUQUICHA",233174,117,7,266,383,111,16,132,243
"Bolivia","Potosí","José María Linares","Puna(C.Villa Talavera)","ESCUELA G. MALDINI CHACABUCO",233175,49,6,301,350,124,16,155,279
"Bolivia","Potosí","José María Linares","Puna(C.Villa Talavera)","ESCUELA INCHASI",233176,31,5,68,99,17,8,38,55
"Bolivia","Potosí","José María Linares","Puna(C.Villa Talavera)","ESCUELA JOSE MA. LINARES",233177,123,4,315,438,89,16,206,295
"Bolivia","Potosí","José María Linares","Puna(C.Villa Talavera)","ESCUELA JOSE MARIA LINARES",233178,195,53,871,1066,435,71,312,747
"Bolivia","Potosí","José María Linares","Puna(C.Villa Talavera)","ESCUELA MARAZA",233179,43,22,174,217,60,7,85,145
"Bolivia","Potosí","José María Linares","Puna(C.Villa Talavera)","ESCUELA MOJONA",233180,72,7,233,305,44,8,174,218
"Bolivia","Potosí","José María Linares","Puna(C.Villa Talavera)","ESCUELA SAN LORENZO",233181,78,24,202,280,77,10,91,168
"Bolivia","Potosí","José María Linares","Puna(C.Villa Talavera)","ESCUELA SECCIONAL PAMPA TAMBO",233182,54,4,125,179,43,5,73,116
"Bolivia","Potosí","José María Linares","Puna(C.Villa Talavera)","ESCUELA SEPULTURAS",233183,82,25,300,382,118,18,139,257
"Bolivia","Potosí","José María Linares","Puna(C.Villa Talavera)","ESCUELA SIMON BOLIVAR",233184,213,15,568,781,153,19,381,534
"Bolivia","Potosí","José María Linares","Puna(C.Villa Talavera)","ESCUELA TOMAS FRIAS",233185,189,42,458,647,89,41,286,375
"Bolivia","Potosí","José María Linares","Puna(C.Villa Talavera)","ESCUELA TURQUIÑA",233186,55,11,113,168,57,5,40,97
"Bolivia","Potosí","José María Linares","Puna(C.Villa Talavera)","ESCUELA VILACAYA",233187,108,5,285,393,122,22,136,258
"Bolivia","Potosí","José María Linares","Puna(C.Villa Talavera)","ESCUELA YASPACI",233188,66,2,174,240,59,6,107,166
"Bolivia","Potosí","José María Linares","Puna(C.Villa Talavera)","UNIDAD VILAMANI",233189,38,4,142,180,40,6,92,132
"Bolivia","Potosí","Modesto Omiste","Villazón","COLEGIO 9 DE ABRIL",233050,712,61,2350,3062,1008,98,1183,2191
"Bolivia","Potosí","Modesto Omiste","Villazón","COLEGIO FRANZ TAMAYO",233049,64,5,226,290,43,6,172,215
"Bolivia","Potosí","Modesto Omiste","Villazón","COLEGIO MARISCAL ANDRES DE SANTA CRUZ",233051,17,5,130,147,28,5,92,120
"Bolivia","Potosí","Modesto Omiste","Villazón","COLEGIO MODESTO OMISTE",233052,587,24,1715,2302,859,63,769,1628
"Bolivia","Potosí","Modesto Omiste","Villazón","ESCUELA BERQUE",233053,56,5,155,211,11,9,130,141
"Bolivia","Potosí","Modesto Omiste","Villazón","ESCUELA CORNELIO SAAVEDRA",233054,818,44,2770,3588,1274,117,1335,2609
"Bolivia","Potosí","Modesto Omiste","Villazón","ESCUELA DANIEL CAMPOS",233055,611,77,2640,3251,841,173,1549,2390
"Bolivia","Potosí","Modesto Omiste","Villazón","ESCUELA LIZARDO PEREZ",233056,32,9,178,210,46,10,113,159
"Bolivia","Potosí","Modesto Omiste","Villazón","ESCUELA MAX FERNANDEZ",233057,543,53,1897,2440,690,118,1036,1726
"Bolivia","Potosí","Modesto Omiste","Villazón","ESCUELA MORAYA",233058,37,2,146,183,23,9,112,135
"Bolivia","Potosí","Modesto Omiste","Villazón","ESCUELA SALITRE",233059,33,1,136,169,22,15,98,120
"Bolivia","Potosí","Modesto Omiste","Villazón","ESCUELA SAN PEDRO DE SOCOCHA",233060,66,2,168,234,21,5,140,161
"Bolivia","Potosí","Modesto Omiste","Villazón","ESCUELA SARCARI",233061,37,3,70,107,11,3,53,64
"Bolivia","Potosí","Modesto Omiste","Villazón","ESCUELA SARGENTO M. PAREDES",233062,56,1,187,243,16,4,166,182
"Bolivia","Potosí","Modesto Omiste","Villazón","ESCUELA SECCIONAL CHAGUA",233063,71,1,191,262,34,9,147,181
"Bolivia","Potosí","Modesto Omiste","Villazón","ESCUELA SECCIONAL SELOCHA",233064,30,2,96,126,8,2,84,92
"Bolivia","Potosí","Modesto Omiste","Villazón","ESCUELA SECCIONAL SOCOCHA",233065,93,14,166,259,19,10,123,142
"Bolivia","Potosí","Modesto Omiste","Villazón","ESCUELA YURUMA",233066,38,2,209,247,62,10,135,197
"Bolivia","Potosí","Modesto Omiste","Villazón","NUCLEO DE MOJO",233067,40,2,153,193,38,8,105,143
"Bolivia","Potosí","Modesto Omiste","Villazón","UNIDAD EDUCATIVA 1RO DE MAYO",233073,999,107,4246,5245,1384,208,2547,3931
"Bolivia","Potosí","Modesto Omiste","Villazón","UNIDAD EDUCATIVA ALONSO DE IBAÑEZ",233074,1085,73,2868,3953,950,184,1661,2611
"Bolivia","Potosí","Modesto Omiste","Villazón","UNIDAD EDUCATIVA CALDERILLA",233068,0,2,74,74,6,1,65,71
"Bolivia","Potosí","Modesto Omiste","Villazón","UNIDAD EDUCATIVA CUARTOS",233069,1,0,27,28,6,1,20,26
"Bolivia","Potosí","Modesto Omiste","Villazón","UNIDAD EDUCATIVA MANTACILLAS",233070,10,16,249,259,67,19,147,214
"Bolivia","Potosí","Modesto Omiste","Villazón","UNIDAD EDUCATIVA MONSEÑOR FELIX GAINZA",233071,4,0,81,85,15,4,62,77
"Bolivia","Potosí","Modesto Omiste","Villazón","UNIDAD EDUCATIVA OJO DE AGUA",233072,0,2,53,53,5,2,44,49
"Bolivia","Potosí","Nor Chichas","Cotagaita","COLEGIO CARLOS MEDINACELI",235758,230,38,1159,1389,468,41,612,1080
"Bolivia","Potosí","Nor Chichas","Cotagaita","UNIDAD EDUCATIVA 2 DE ABRIL",235759,31,4,145,176,50,2,89,139
"Bolivia","Potosí","Nor Chichas","Cotagaita","UNIDAD EDUCATIVA 6 DE JUNIO",235760,27,2,236,263,30,5,199,229
"Bolivia","Potosí","Nor Chichas","Cotagaita","UNIDAD EDUCATIVA ASCANTY",235761,24,11,234,258,19,4,200,219
"Bolivia","Potosí","Nor Chichas","Cotagaita","UNIDAD EDUCATIVA CARLOS MEDINACELI DE TASNA ROSARIO",235762,182,16,841,1023,236,44,545,781
"Bolivia","Potosí","Nor Chichas","Cotagaita","UNIDAD EDUCATIVA CERRO COLORADO",235763,9,0,49,58,2,0,47,49
"Bolivia","Potosí","Nor Chichas","Cotagaita","UNIDAD EDUCATIVA CHATI",235764,39,1,123,162,27,10,85,112
"Bolivia","Potosí","Nor Chichas","Cotagaita","UNIDAD EDUCATIVA CHUI CHUI",235765,29,0,59,88,3,2,54,57
"Bolivia","Potosí","Nor Chichas","Cotagaita","UNIDAD EDUCATIVA COLLPA UNO",235766,22,3,231,253,65,1,162,227
"Bolivia","Potosí","Nor Chichas","Cotagaita","UNIDAD EDUCATIVA CORNACA",235767,33,1,192,225,39,4,148,187
"Bolivia","Potosí","Nor Chichas","Cotagaita","UNIDAD EDUCATIVA COTAGAITILLA",235768,49,7,252,301,34,15,196,230
"Bolivia","Potosí","Nor Chichas","Cotagaita","UNIDAD EDUCATIVA ELIZARDO PEREZ DE SAN JORGE",235769,39,1,74,113,7,7,59,66
"Bolivia","Potosí","Nor Chichas","Cotagaita","UNIDAD EDUCATIVA EL MANZANAL",235770,15,4,75,90,12,1,58,70
"Bolivia","Potosí","Nor Chichas","Cotagaita","UNIDAD EDUCATIVA EL PORVENIR A DE TOTORA I",235771,194,22,614,808,148,18,426,574
"Bolivia","Potosí","Nor Chichas","Cotagaita","UNIDAD EDUCATIVA EL RANCHO",235772,10,1,66,76,9,0,56,65
"Bolivia","Potosí","Nor Chichas","Cotagaita","UNIDAD EDUCATIVA JOSE ALONZO DE IBAÑEZ",235773,63,6,354,417,117,19,212,329
"Bolivia","Potosí","Nor Chichas","Cotagaita","UNIDAD EDUCATIVA LAYTAPI",235774,5,4,140,145,6,3,127,133
"Bolivia","Potosí","Nor Chichas","Cotagaita","UNIDAD EDUCATIVA MANUEL JOSE CORTEZ",235775,220,21,1009,1229,404,45,539,943
"Bolivia","Potosí","Nor Chichas","Cotagaita","UNIDAD EDUCATIVA MARISCAL SUCRE",235776,147,10,324,471,71,4,239,310
"Bolivia","Potosí","Nor Chichas","Cotagaita","UNIDAD EDUCATIVA MARTIN PRIMERO DE URUPALCA",235777,47,0,84,131,27,1,56,83
"Bolivia","Potosí","Nor Chichas","Cotagaita","UNIDAD EDUCATIVA MOCKO PATA",235778,15,0,169,184,10,5,154,164
"Bolivia","Potosí","Nor Chichas","Cotagaita","UNIDAD EDUCATIVA PAMPA GRANDE I",235779,20,2,108,128,17,0,89,106
"Bolivia","Potosí","Nor Chichas","Cotagaita","UNIDAD EDUCATIVA PEDRO DOMINGO MURILLO DE SAGRARIO",235780,53,8,326,379,65,14,239,304
"Bolivia","Potosí","Nor Chichas","Cotagaita","UNIDAD EDUCATIVA QUECHISLA",235781,13,1,33,46,7,2,23,30
"Bolivia","Potosí","Nor Chichas","Cotagaita","UNIDAD EDUCATIVA RAMADAS",235782,21,11,147,168,30,1,105,135
"Bolivia","Potosí","Nor Chichas","Cotagaita","UNIDAD EDUCATIVA SAN LORENZO",235783,20,0,83,103,6,0,77,83
"Bolivia","Potosí","Nor Chichas","Cotagaita","UNIDAD EDUCATIVA SAN PEDRO DE CHECOCHI",235784,43,1,102,145,31,4,66,97
"Bolivia","Potosí","Nor Chichas","Cotagaita","UNIDAD EDUCATIVA SANTIAGO WRIGHT",235785,64,10,359,423,65,29,255,320
"Bolivia","Potosí","Nor Chichas","Cotagaita","UNIDAD EDUCATIVA SIMON BOLIVAR A DE TOROPALCA",235786,228,28,555,783,119,16,392,511
"Bolivia","Potosí","Nor Chichas","Cotagaita","UNIDAD EDUCATIVA TAPCHIQUIRA",235787,27,2,98,125,15,7,74,89
"Bolivia","Potosí","Nor Chichas","Cotagaita","UNIDAD EDUCATIVA TUPAC KATARI",235788,87,6,194,281,20,3,165,185
"Bolivia","Potosí","Nor Chichas","Cotagaita","UNIDAD EDUCATIVA VILLA CONCEPCION",235789,64,0,119,183,5,2,112,117
"Bolivia","Potosí","Nor Chichas","Cotagaita","UNIDAD EDUCATIVA VILLA IMPERIAL DE VICHACLA",235790,40,9,208,248,34,15,150,184
"Bolivia","Potosí","Nor Chichas","Cotagaita","UNIDAD EDUCATIVA VILLA SAN LORENZO",235791,46,1,195,241,8,2,184,192
"Bolivia","Potosí","Nor Chichas","Vitichi","UNIDAD EDUCATIVA ARA",235792,84,10,223,307,70,10,133,203
"Bolivia","Potosí","Nor Chichas","Vitichi","UNIDAD EDUCATIVA AYOMA BAJA",235793,65,7,180,245,17,4,152,169
"Bolivia","Potosí","Nor Chichas","Vitichi","UNIDAD EDUCATIVA CALCHA",235794,180,45,415,595,119,25,226,345
"Bolivia","Potosí","Nor Chichas","Vitichi","UNIDAD EDUCATIVA ESTUMILLA",235795,29,3,158,187,23,3,129,152
"Bolivia","Potosí","Nor Chichas","Vitichi","UNIDAD EDUCATIVA FRAY ANGELLO STELLINI DE CALVI",235796,105,19,278,383,34,6,219,253
"Bolivia","Potosí","Nor Chichas","Vitichi","UNIDAD EDUCATIVA JUAN PELLEGRINI",235797,177,38,508,685,86,7,377,463
"Bolivia","Potosí","Nor Chichas","Vitichi","UNIDAD EDUCATIVA MANUEL MORA DE PECKAJSI",235798,85,0,256,341,20,11,225,245
"Bolivia","Potosí","Nor Chichas","Vitichi","UNIDAD EDUCATIVA PRIMO MARTINEZ",235799,19,2,117,136,52,3,60,112
"Bolivia","Potosí","Nor Chichas","Vitichi","UNIDAD EDUCATIVA PULAXI",235800,14,2,32,46,13,2,15,28
"Bolivia","Potosí","Nor Chichas","Vitichi","UNIDAD EDUCATIVA SAN MIGUEL DE TUSQUIÑA",235801,72,9,483,555,95,7,372,467
"Bolivia","Potosí","Nor Chichas","Vitichi","UNIDAD EDUCATIVA TOMAS FRIAS",235802,343,60,904,1247,348,34,462,810
"Bolivia","Potosí","Nor Lípez","Colcha K","ESCUELA ANTOFAGASTA",232166,44,6,213,257,108,5,94,202
"Bolivia","Potosí","Nor Lípez","Colcha K","ESCUELA SANTIAGO",232167,27,6,121,148,64,8,43,107
"Bolivia","Potosí","Nor Lípez","Colcha K","ESCUELA TOMAS FRIAS",232168,3,0,93,96,40,0,53,93
"Bolivia","Potosí","Nor Lípez","Colcha K","UNIDAD EDUCATIVA 2 DE AGOSTO",232169,27,6,195,222,84,7,98,182
"Bolivia","Potosí","Nor Lípez","Colcha K","UNIDAD EDUCATIVA ALFONZO IBAÑES",232170,10,0,56,66,13,1,42,55
"Bolivia","Potosí","Nor Lípez","Colcha K","UNIDAD EDUCATIVA ANTOFAGASTA",232171,35,2,241,276,107,5,127,234
"Bolivia","Potosí","Nor Lípez","Colcha K","UNIDAD EDUCATIVA BUENAS NUEVAS DE VINTO K",232172,24,5,218,242,62,5,146,208
"Bolivia","Potosí","Nor Lípez","Colcha K","UNIDAD EDUCATIVA EDUARDO ABAROA",232173,271,10,797,1068,329,25,433,762
"Bolivia","Potosí","Nor Lípez","Colcha K","UNIDAD EDUCATIVA EDUARDO ABAROA",232174,271,10,797,1068,329,25,433,762
"Bolivia","Potosí","Nor Lípez","Colcha K","UNIDAD EDUCATIVA EDUARDO ABAROA DE VILLA MAR",232175,42,12,182,224,64,4,102,166
"Bolivia","Potosí","Nor Lípez","Colcha K","UNIDAD EDUCATIVA HENRY LAREDO",232176,11,0,38,49,17,0,21,38
"Bolivia","Potosí","Nor Lípez","Colcha K","UNIDAD EDUCATIVA JOSE BALLIVIAN",232177,20,2,213,233,59,1,151,210
"Bolivia","Potosí","Nor Lípez","Colcha K","UNIDAD EDUCATIVA JUANA AZURDUY",232178,2,3,33,35,15,1,14,29
"Bolivia","Potosí","Nor Lípez","Colcha K","UNIDAD EDUCATIVA LADISLAO CABRERA",232179,30,2,122,152,25,8,87,112
"Bolivia","Potosí","Nor Lípez","Colcha K","UNIDAD EDUCATIVA LITORAL",232180,38,0,96,134,33,2,61,94
"Bolivia","Potosí","Nor Lípez","Colcha K","UNIDAD EDUCATIVA LUIS ESPINAL",232181,0,0,57,57,7,1,49,56
"Bolivia","Potosí","Nor Lípez","Colcha K","UNIDAD EDUCATIVA NUEVO AMANECER",232182,88,6,354,442,141,6,201,342
"Bolivia","Potosí","Nor Lípez","Colcha K","UNIDAD EDUCATIVA RICARDO RODRIGUEZ",232183,223,23,1485,1708,468,50,944,1412
"Bolivia","Potosí","Nor Lípez","Colcha K","UNIDAD EDUCATIVA SIMON BOLIVAR",232184,50,4,208,258,58,13,133,191
"Bolivia","Potosí","Nor Lípez","Colcha K","UNIDAD EDUCATIVA TOMAS FRIAS",232185,36,2,196,232,55,10,129,184
"Bolivia","Potosí","Nor Lípez","San Pedro De Quemes","UNIDAD EDUCATIVA CECILIO VELIZ",235871,55,2,227,282,93,1,131,224
"Bolivia","Potosí","Nor Lípez","San Pedro De Quemes","UNIDAD EDUCATIVA CORNELIO SAAVEDRA",235872,20,1,42,62,8,0,33,41
"Bolivia","Potosí","Nor Lípez","San Pedro De Quemes","UNIDAD EDUCATIVA EDUARDO ABAROA",235873,1,0,12,13,3,0,9,12
"Bolivia","Potosí","Nor Lípez","San Pedro De Quemes","UNIDAD EDUCATIVA LADISLAO CABRERA",235874,5,0,25,30,20,0,5,25
"Bolivia","Potosí","Rafael Bustillo","Chayanta","ESCUELA COCAFAYA",235598,34,5,344,378,62,10,267,329
"Bolivia","Potosí","Rafael Bustillo","Chayanta","ESCUELA COPANA",235599,16,27,352,368,34,13,278,312
"Bolivia","Potosí","Rafael Bustillo","Chayanta","ESCUELA MANCO CAPAC",235600,23,22,329,352,40,9,258,298
"Bolivia","Potosí","Rafael Bustillo","Chayanta","ESCUELA MCAL. SANTA CRUZ",235601,263,67,1688,1951,664,77,880,1544
"Bolivia","Potosí","Rafael Bustillo","Chayanta","ESCUELA OCTAVIO MURILLO",235602,53,36,750,803,282,36,396,678
"Bolivia","Potosí","Rafael Bustillo","Chayanta","ESCUELA PHUSUTA PAMPA",235603,13,7,120,133,13,11,89,102
"Bolivia","Potosí","Rafael Bustillo","Chayanta","ESCUELA PICHATA",235604,30,0,284,314,24,7,253,277
"Bolivia","Potosí","Rafael Bustillo","Chayanta","ESCUELA QUINTA PAMPA",235605,55,8,327,382,15,13,291,306
"Bolivia","Potosí","Rafael Bustillo","Chayanta","ESCUELA RAFAEL PABON",235606,68,20,486,554,169,34,263,432
"Bolivia","Potosí","Rafael Bustillo","Chayanta","NUCLEO ESCOLAR",235607,61,28,231,292,92,14,97,189
"Bolivia","Potosí","Rafael Bustillo","Chayanta","NUCLEO ESCOLAR IRUPATA",235608,166,66,924,1090,117,43,698,815
"Bolivia","Potosí","Rafael Bustillo","Chayanta","NUCLEO ESCOLAR NUEVA COLCHA",235609,43,0,277,320,13,12,252,265
"Bolivia","Potosí","Rafael Bustillo","Chayanta","NUCLEO ESCOLAR RIO VERDE (QUILA QUILA)",235610,19,8,187,206,70,4,105,175
"Bolivia","Potosí","Rafael Bustillo","Chuquihuta Ayllu Jucumani","COLEGIO PABLO ZARATE VILLCA",235932,286,101,1568,1854,526,127,814,1340
"Bolivia","Potosí","Rafael Bustillo","Chuquihuta Ayllu Jucumani","ESCUELA LULUNI",235933,41,59,284,325,40,17,168,208
"Bolivia","Potosí","Rafael Bustillo","Chuquihuta Ayllu Jucumani","ESCUELA TACOPALCA",235934,222,52,923,1145,240,103,528,768
"Bolivia","Potosí","Rafael Bustillo","Llallagua","COLEGIO 1RO. DE MAYO",235611,553,104,3722,4275,1973,182,1463,3436
"Bolivia","Potosí","Rafael Bustillo","Llallagua","COLEGIO JUNIN",235612,342,69,2250,2592,986,166,1029,2015
"Bolivia","Potosí","Rafael Bustillo","Llallagua","COLEGIO SIGLO XX-AMERICA",235613,562,67,3368,3930,1690,164,1447,3137
"Bolivia","Potosí","Rafael Bustillo","Llallagua","ESCUELA 6 DE JUNIO",235614,227,47,1161,1388,537,83,494,1031
"Bolivia","Potosí","Rafael Bustillo","Llallagua","ESCUELA BARTOLINA SISA",235615,50,34,503,553,130,37,302,432
"Bolivia","Potosí","Rafael Bustillo","Llallagua","ESCUELA CAPUNITA",235616,47,6,279,326,67,16,190,257
"Bolivia","Potosí","Rafael Bustillo","Llallagua","ESCUELA CARLOS MEDINACELI",235617,279,53,2121,2400,1133,106,829,1962
"Bolivia","Potosí","Rafael Bustillo","Llallagua","ESCUELA CHIRU CHIRU",235618,14,3,207,221,21,9,174,195
"Bolivia","Potosí","Rafael Bustillo","Llallagua","ESCUELA JAIME MENDOZA",235619,401,65,3191,3592,1809,148,1169,2978
"Bolivia","Potosí","Rafael Bustillo","Llallagua","ESCUELA UYUNI",235620,24,0,318,342,16,37,265,281
"Bolivia","Potosí","Rafael Bustillo","Llallagua","HUMANISTICO LLALLAGUA",235621,422,73,2559,2981,1343,152,991,2334
"Bolivia","Potosí","Rafael Bustillo","Llallagua","MARTIN CARDENAS",235622,358,96,2566,2924,1036,215,1219,2255
"Bolivia","Potosí","Rafael Bustillo","Llallagua","NUCLEO JISK'ANQUI",235623,20,21,253,273,106,11,115,221
"Bolivia","Potosí","Rafael Bustillo","Uncia","CÁRCEL SAN MIGUEL DE UNCÍA",234511,7,1,29,36,15,0,13,28
"Bolivia","Potosí","Rafael Bustillo","Uncia","CHILCA PALCA",234512,82,33,384,466,93,49,209,302
"Bolivia","Potosí","Rafael Bustillo","Uncia","COLEGIO INTERMEDIO INDEPENDENCIA",234514,276,72,1938,2214,1068,136,662,1730
"Bolivia","Potosí","Rafael Bustillo","Uncia","COLEGIO RAFAEL BUSTILLO",234513,466,77,2251,2717,1085,97,992,2077
"Bolivia","Potosí","Rafael Bustillo","Uncia","ESCUELA CHOCO CHICO",234515,17,7,91,108,57,5,22,79
"Bolivia","Potosí","Rafael Bustillo","Uncia","ESCUELA HUACUTA A",234516,20,10,123,143,62,5,46,108
"Bolivia","Potosí","Rafael Bustillo","Uncia","ESCUELA JUANA AZURDUY DE PADILLA",234517,272,60,1759,2031,826,94,779,1605
"Bolivia","Potosí","Rafael Bustillo","Uncia","ESCUELA MODESTO OMISTE",234518,162,35,1160,1322,707,45,373,1080
"Bolivia","Potosí","Rafael Bustillo","Uncia","ESCUELA MOROCOMARCA",234519,116,29,334,450,80,28,197,277
"Bolivia","Potosí","Rafael Bustillo","Uncia","ESCUELA SUBCENTRAL LAGUNILLAS",234520,46,18,337,383,57,19,243,300
"Bolivia","Potosí","Rafael Bustillo","Uncia","NUCLEO ESCOLAR CALA CALA",234521,109,35,991,1100,173,48,735,908
"Bolivia","Potosí","Sur Chichas","Atocha","COLEGIO CHOROLQUE",235859,145,28,1092,1237,316,50,698,1014
"Bolivia","Potosí","Sur Chichas","Atocha","COLEGIO GREGORIO PACHECO",235860,181,20,751,932,293,33,405,698
"Bolivia","Potosí","Sur Chichas","Atocha","ESCUELA CHOCAYA",235861,14,1,72,86,10,4,57,67
"Bolivia","Potosí","Sur Chichas","Atocha","ESCUELA CHOROLUE VIEJO",235862,4,0,12,16,2,0,10,12
"Bolivia","Potosí","Sur Chichas","Atocha","ESCUELA DE ANIMAS",235863,83,20,677,760,312,15,330,642
"Bolivia","Potosí","Sur Chichas","Atocha","ESCUELA DE SIETE SUYOS",235864,91,16,527,618,176,23,312,488
"Bolivia","Potosí","Sur Chichas","Atocha","ESCUELA DE TACMARI",235865,0,0,21,21,3,1,17,20
"Bolivia","Potosí","Sur Chichas","Atocha","ESCUELA EDUARDO AVAROA",235866,123,20,606,729,213,35,338,551
"Bolivia","Potosí","Sur Chichas","Atocha","ESCUELA GUADALUPE",235867,17,0,46,63,9,3,34,43
"Bolivia","Potosí","Sur Chichas","Atocha","ESCUELA JULIO URQUIETA",235868,94,12,473,567,137,26,298,435
"Bolivia","Potosí","Sur Chichas","Atocha","ESCUELA PORTUGALETE",235869,50,8,310,360,74,13,215,289
"Bolivia","Potosí","Sur Chichas","Atocha","UNIDAD EDUCATIVA TELAMAYU",235870,84,5,369,453,122,13,229,351
"Bolivia","Potosí","Sur Chichas","Tupiza","CÁRCEL TUPIZA",235813,1,0,27,28,11,0,16,27
"Bolivia","Potosí","Sur Chichas","Tupiza","COLEGIO ANTOFAGASTA",235814,364,38,1879,2243,788,83,970,1758
"Bolivia","Potosí","Sur Chichas","Tupiza","COLEGIO NAL. MIXTO CHICHAS",235815,22,6,107,129,9,5,87,96
"Bolivia","Potosí","Sur Chichas","Tupiza","EL MOLINO",235816,13,0,58,71,11,1,46,57
"Bolivia","Potosí","Sur Chichas","Tupiza","ESCUELA CHACO PAMPA",235817,69,7,283,352,46,10,220,266
"Bolivia","Potosí","Sur Chichas","Tupiza","ESCUELA CHIFLOCA",235818,13,3,95,108,36,5,51,87
"Bolivia","Potosí","Sur Chichas","Tupiza","ESCUELA CHILLCO",235819,28,4,104,132,29,8,63,92
"Bolivia","Potosí","Sur Chichas","Tupiza","ESCUELA CHUQUI",235820,12,1,42,54,3,2,36,39
"Bolivia","Potosí","Sur Chichas","Tupiza","ESCUELA CHUQUIAGO",235821,60,9,225,285,37,9,170,207
"Bolivia","Potosí","Sur Chichas","Tupiza","ESCUELA CONCEPCION",235822,2,0,12,14,1,0,11,12
"Bolivia","Potosí","Sur Chichas","Tupiza","ESCUELA DE ALMONA",235823,23,10,118,141,21,2,85,106
"Bolivia","Potosí","Sur Chichas","Tupiza","ESCUELA DE MOCHARA",235824,25,5,218,243,14,5,194,208
"Bolivia","Potosí","Sur Chichas","Tupiza","ESCUELA DE OPLOCA",235825,68,17,365,433,94,32,222,316
"Bolivia","Potosí","Sur Chichas","Tupiza","ESCUELA DE RIO BLANCO",235826,33,0,125,158,10,6,109,119
"Bolivia","Potosí","Sur Chichas","Tupiza","ESCUELA DE SALO",235827,32,7,183,215,28,4,144,172
"Bolivia","Potosí","Sur Chichas","Tupiza","ESCUELA DE SAN MIGUEL",235828,28,1,121,149,21,7,92,113
"Bolivia","Potosí","Sur Chichas","Tupiza","ESCUELA ESMORACA",235829,20,6,202,222,64,5,127,191
"Bolivia","Potosí","Sur Chichas","Tupiza","ESCUELA ESPICAYA",235830,32,2,165,197,32,7,124,156
"Bolivia","Potosí","Sur Chichas","Tupiza","ESCUELA ESTARCA",235831,22,0,138,160,21,1,116,137
"Bolivia","Potosí","Sur Chichas","Tupiza","ESCUELA HUARIRACA",235832,5,1,33,38,5,0,27,32
"Bolivia","Potosí","Sur Chichas","Tupiza","ESCUELA KUCHU",235833,11,1,54,65,11,1,41,52
"Bolivia","Potosí","Sur Chichas","Tupiza","ESCUELA MIXTA 7 DE NOVIEMBRE",235834,415,23,2101,2516,1080,80,918,1998
"Bolivia","Potosí","Sur Chichas","Tupiza","ESCUELA NAZARENO",235835,50,15,251,301,40,11,185,225
"Bolivia","Potosí","Sur Chichas","Tupiza","ESCUELA ORO INGENIO",235836,13,1,44,57,7,5,31,38
"Bolivia","Potosí","Sur Chichas","Tupiza","ESCUELA REYNECILLA",235837,45,0,113,158,19,4,90,109
"Bolivia","Potosí","Sur Chichas","Tupiza","ESCUELA SAN JOSE PAMPA GRANDE",235838,52,15,178,230,14,7,142,156
"Bolivia","Potosí","Sur Chichas","Tupiza","ESCUELA SANTO DOMINCO",235839,8,0,19,27,2,0,17,19
"Bolivia","Potosí","Sur Chichas","Tupiza","ESCUELA SECCIONAL",235840,31,1,128,159,18,8,101,119
"Bolivia","Potosí","Sur Chichas","Tupiza","ESCUELA SUIPACHA",235841,178,29,560,738,155,37,339,494
"Bolivia","Potosí","Sur Chichas","Tupiza","ESCUELA SUPIRA",235842,31,6,148,179,40,15,87,127
"Bolivia","Potosí","Sur Chichas","Tupiza","ESCUELA TALINA",235843,47,8,129,176,10,2,109,119
"Bolivia","Potosí","Sur Chichas","Tupiza","ESCUELA TAPAXA",235844,15,4,96,111,13,5,74,87
"Bolivia","Potosí","Sur Chichas","Tupiza","ESCUELA TITIHOYO",235845,8,1,78,86,10,6,61,71
"Bolivia","Potosí","Sur Chichas","Tupiza","ESCUELA TOCLOCA",235846,74,11,285,359,57,10,207,264
"Bolivia","Potosí","Sur Chichas","Tupiza","ESCUELA VILLA FATIMA ANDRES DE SANTA CRUZ",235847,330,63,1990,2320,775,115,1037,1812
"Bolivia","Potosí","Sur Chichas","Tupiza","ESCUELA ZAPATERA",235848,5,0,33,38,9,0,24,33
"Bolivia","Potosí","Sur Chichas","Tupiza","INSTITUTO SAN JUAN",235849,468,37,2402,2870,1277,102,986,2263
"Bolivia","Potosí","Sur Chichas","Tupiza","KINDER REMEDIOS",235850,738,87,3803,4541,1206,200,2310,3516
"Bolivia","Potosí","Sur Chichas","Tupiza","NUCLEO ESCOLAR QUIRIZA",235851,45,10,223,268,28,2,183,211
"Bolivia","Potosí","Sur Chichas","Tupiza","UNIDAD EDUCATIVA G. BERRIOS",235852,22,5,137,159,39,5,88,127
"Bolivia","Potosí","Sur Chichas","Tupiza","UNIDAD EDUCATIVA NACIONAL 6 DE JUNIO",235853,19,13,280,299,70,33,164,234
"Bolivia","Potosí","Sur Chichas","Tupiza","UNIDAD EDUCATIVA P. HARRIS",235854,16,7,157,173,37,15,98,135
"Bolivia","Potosí","Sur Chichas","Tupiza","UNIDAD EDUCATIVA RITA ROMANO",235856,296,40,1575,1871,586,98,851,1437
"Bolivia","Potosí","Sur Chichas","Tupiza","UNIDAD EDUCATIVA TOMATAS",235855,11,4,115,126,20,13,78,98
"Bolivia","Potosí","Sur Chichas","Tupiza","UNIDAD EDUCATIVA TUPIZA B",235857,337,30,1464,1801,493,78,863,1356
"Bolivia","Potosí","Sur Chichas","Tupiza","VETERINARIA SUB SEDE UATF",235858,199,29,1070,1269,460,53,528,988
"Bolivia","Potosí","Sur Lípez","Mojinete","ESCUELA BONETE PALCA",235875,0,0,13,13,1,0,12,13
"Bolivia","Potosí","Sur Lípez","Mojinete","ESCUELA CASA GRANDE",235876,14,4,64,78,3,3,54,57
"Bolivia","Potosí","Sur Lípez","Mojinete","ESCUELA LA CIENEGA",235877,7,0,24,31,2,1,21,23
"Bolivia","Potosí","Sur Lípez","Mojinete","ESCUELA PUEBLO VIEJO",235878,2,0,20,22,1,0,19,20
"Bolivia","Potosí","Sur Lípez","Mojinete","H. ALCALDIA MUNICIPAL",235879,24,2,97,121,12,2,81,93
"Bolivia","Potosí","Sur Lípez","San Antonio De Esmoruco","ESCUELA 10 DE NOVIEMBRE",232197,20,0,73,93,12,0,61,73
"Bolivia","Potosí","Sur Lípez","San Antonio De Esmoruco","ESCUELA ANTOFAGASTA",232198,34,6,112,146,31,3,72,103
"Bolivia","Potosí","Sur Lípez","San Antonio De Esmoruco","ESCUELA CENTRAL CALAMA",232199,55,7,252,307,56,9,180,236
"Bolivia","Potosí","Sur Lípez","San Antonio De Esmoruco","ESCUELA DE RIO SECO",232200,4,1,76,80,14,2,59,73
"Bolivia","Potosí","Sur Lípez","San Antonio De Esmoruco","ESCUELA OCKE ORCKO",232201,7,2,48,55,6,0,40,46
"Bolivia","Potosí","Sur Lípez","San Antonio De Esmoruco","ESCUELA RANCHO CHILENO",232202,9,0,29,38,8,0,21,29
"Bolivia","Potosí","Sur Lípez","San Pablo De Lipez","ESCUELA EDUARDO AVAROA",232186,3,8,53,56,28,5,12,40
"Bolivia","Potosí","Sur Lípez","San Pablo De Lipez","ESCUELA KOLLPANI",232187,6,0,51,57,7,3,41,48
"Bolivia","Potosí","Sur Lípez","San Pablo De Lipez","ESCUELA QUETENA CHICO",232188,18,4,223,241,104,3,112,216
"Bolivia","Potosí","Sur Lípez","San Pablo De Lipez","ESCUELA RELAVE",232189,15,1,45,60,16,4,24,40
"Bolivia","Potosí","Sur Lípez","San Pablo De Lipez","ESCUELA SANTA ISABEL",232190,19,0,30,49,1,0,29,30
"Bolivia","Potosí","Sur Lípez","San Pablo De Lipez","ESCUELA SECCIONAL RIO SAN PABLO",232191,12,3,89,101,23,2,61,84
"Bolivia","Potosí","Sur Lípez","San Pablo De Lipez","ESCUELA SECCIONAL VILUYO",232192,16,0,83,99,5,3,75,80
"Bolivia","Potosí","Sur Lípez","San Pablo De Lipez","ESCUELA VILLA PORVENIR",232193,23,3,111,134,37,9,62,99
"Bolivia","Potosí","Sur Lípez","San Pablo De Lipez","SALON DE COMUNIDAD",232194,3,3,91,94,26,3,59,85
"Bolivia","Potosí","Sur Lípez","San Pablo De Lipez","SALON DE PLAZA",232195,27,4,126,153,38,13,71,109
"Bolivia","Potosí","Sur Lípez","San Pablo De Lipez","UNIDAD EDUCATIVA COLORADOS DE BOLIVIA",232196,12,0,70,82,23,7,40,63
"Bolivia","Potosí","Tomás Frías","Potosí","CENTRO ED. FRAY VICENTE BERNEDO",232039,551,40,4272,4823,3555,124,553,4108
"Bolivia","Potosí","Tomás Frías","Potosí","COLEGIO 31 DE OCTUBRE",232040,181,3,1186,1367,1006,30,147,1153
"Bolivia","Potosí","Tomás Frías","Potosí","COLEGIO ANICETO ARCE",232041,113,4,841,954,719,21,97,816
"Bolivia","Potosí","Tomás Frías","Potosí","COLEGIO ANTOFAGASTA",232044,368,17,2803,3171,2396,54,336,2732
"Bolivia","Potosí","Tomás Frías","Potosí","COLEGIO BANCARIO",232045,131,3,1009,1140,910,9,87,997
"Bolivia","Potosí","Tomás Frías","Potosí","COLEGIO CARLOS MEDINACELI",232042,96,3,731,827,641,9,78,719
"Bolivia","Potosí","Tomás Frías","Potosí","COLEGIO CRISTO MAESTRO",232046,63,1,548,611,497,4,46,543
"Bolivia","Potosí","Tomás Frías","Potosí","COLEGIO DAVID BERRIOS",232047,223,4,1576,1799,1323,42,207,1530
"Bolivia","Potosí","Tomás Frías","Potosí","COLEGIO DIVINO MAESTRO",232043,348,7,2512,2860,2122,54,329,2451
"Bolivia","Potosí","Tomás Frías","Potosí","COLEGIO DON BOSCO",232048,129,0,985,1114,887,10,88,975
"Bolivia","Potosí","Tomás Frías","Potosí","COLEGIO FRANCISCANO",232049,94,2,927,1021,851,6,68,919
"Bolivia","Potosí","Tomás Frías","Potosí","COLEGIO LUIS ESPINAL",232050,525,34,3280,3805,2729,106,411,3140
"Bolivia","Potosí","Tomás Frías","Potosí","COLEGIO SAN RAFAEL",232051,99,17,822,921,503,89,213,716
"Bolivia","Potosí","Tomás Frías","Potosí","ESCUELA 12 DE ABRIL",232052,119,5,898,1017,739,33,121,860
"Bolivia","Potosí","Tomás Frías","Potosí","ESCUELA 1RO DE ABRIL",232053,61,2,526,587,456,9,59,515
"Bolivia","Potosí","Tomás Frías","Potosí","ESCUELA 6 DE JUNIO",232054,182,25,1695,1877,1122,88,460,1582
"Bolivia","Potosí","Tomás Frías","Potosí","ESCUELA ANTONIO QUIJARRO",232055,73,0,552,625,505,6,41,546
"Bolivia","Potosí","Tomás Frías","Potosí","ESCUELA BENICIO MONTERO MALLO",232056,221,7,1868,2089,1631,42,188,1819
"Bolivia","Potosí","Tomás Frías","Potosí","ESCUELA BOLIVIANO ALEMÁN",232057,155,20,1233,1388,1012,37,164,1176
"Bolivia","Potosí","Tomás Frías","Potosí","ESCUELA CLETO LOAYZA",232058,352,27,2543,2895,2186,56,274,2460
"Bolivia","Potosí","Tomás Frías","Potosí","ESCUELA COBIJA",232059,465,17,3334,3799,2826,73,418,3244
"Bolivia","Potosí","Tomás Frías","Potosí","ESCUELA COPACABANA",232060,282,10,2160,2442,1905,52,193,2098
"Bolivia","Potosí","Tomás Frías","Potosí","ESCUELA DANIEL CAMPOS",232061,792,30,4956,5748,4150,132,644,4794
"Bolivia","Potosí","Tomás Frías","Potosí","ESCUELA ENRIQUE VIANA",232062,487,23,3819,4306,3238,81,477,3715
"Bolivia","Potosí","Tomás Frías","Potosí","ESCUELA GERMAN BUSCH",232063,332,27,2128,2460,1676,100,325,2001
"Bolivia","Potosí","Tomás Frías","Potosí","ESCUELA GREGORIO BARRIGA",232064,58,1,383,441,344,3,35,379
"Bolivia","Potosí","Tomás Frías","Potosí","ESCUELA GUALBERTO VILLARROEL",232065,282,19,2176,2458,1756,77,324,2080
"Bolivia","Potosí","Tomás Frías","Potosí","ESCUELA JAIME MENDOZA",232066,201,21,1240,1441,981,41,197,1178
"Bolivia","Potosí","Tomás Frías","Potosí","ESCUELA JESUS DE NAZARET",232067,321,28,2478,2799,1917,83,450,2367
"Bolivia","Potosí","Tomás Frías","Potosí","ESCUELA JOSÉ ALONSO DE IBÁÑEZ",232086,191,4,1307,1498,1167,22,114,1281
"Bolivia","Potosí","Tomás Frías","Potosí","ESCUELA JOSE A.ZAMPA",232068,175,9,725,900,613,18,85,698
"Bolivia","Potosí","Tomás Frías","Potosí","ESCUELA JOSE MARIA LINARES",232069,225,10,1835,2060,1593,46,186,1779
"Bolivia","Potosí","Tomás Frías","Potosí","ESCUELA KARACHIPAMPA",232070,98,6,576,674,402,46,122,524
"Bolivia","Potosí","Tomás Frías","Potosí","ESCUELA KENNY PRIETO MELGAREJO",232071,443,43,3315,3758,2636,101,535,3171
"Bolivia","Potosí","Tomás Frías","Potosí","ESCUELA LITORAL",232072,329,5,2262,2591,1948,37,272,2220
"Bolivia","Potosí","Tomás Frías","Potosí","ESCUELA L.SUBIETA SAGARNAGA",232073,287,16,1934,2221,1405,81,432,1837
"Bolivia","Potosí","Tomás Frías","Potosí","ESCUELA MANQUIRI",232074,42,6,191,233,126,21,38,164
"Bolivia","Potosí","Tomás Frías","Potosí","ESCUELA MARTIN CRUZ",232075,47,18,411,458,227,13,153,380
"Bolivia","Potosí","Tomás Frías","Potosí","ESCUELA MODESTO OMISTE",232076,80,1,498,578,428,9,60,488
"Bolivia","Potosí","Tomás Frías","Potosí","ESCUELA OCKORURO",232077,39,14,148,187,84,12,38,122
"Bolivia","Potosí","Tomás Frías","Potosí","ESCUELA PARANTACA",232078,14,2,126,140,91,2,31,122
"Bolivia","Potosí","Tomás Frías","Potosí","ESCUELA PARANTURI",232079,8,5,86,94,55,8,18,73
"Bolivia","Potosí","Tomás Frías","Potosí","ESCUELA SALVADOR REVILLA",232080,99,3,1074,1173,953,16,102,1055
"Bolivia","Potosí","Tomás Frías","Potosí","ESCUELA SAN JOSE",232081,167,2,1693,1860,1478,35,178,1656
"Bolivia","Potosí","Tomás Frías","Potosí","ESCUELA SIMON RODRIGUEZ",232082,172,5,1428,1600,1227,28,168,1395
"Bolivia","Potosí","Tomás Frías","Potosí","ESCUELA TARAPAYA",232083,23,2,220,243,144,29,45,189
"Bolivia","Potosí","Tomás Frías","Potosí","ESCUELA TOMAS FRIAS",232084,2,0,105,107,82,0,23,105
"Bolivia","Potosí","Tomás Frías","Potosí","ESCUELA TOPATER",232085,524,19,3624,4148,3119,89,397,3516
"Bolivia","Potosí","Tomás Frías","Potosí","FE Y ALEGRIA Y SAN CLEMENTE",232087,481,21,4159,4640,3662,81,395,4057
"Bolivia","Potosí","Tomás Frías","Potosí","INSTITUTO I.S.E.C.",232088,109,3,1199,1308,1062,19,115,1177
"Bolivia","Potosí","Tomás Frías","Potosí","INSTITUTO SAN JUAN",232089,116,7,1018,1134,866,30,115,981
"Bolivia","Potosí","Tomás Frías","Potosí","KINDER CONCEPCION",232090,207,14,1372,1579,1117,43,198,1315
"Bolivia","Potosí","Tomás Frías","Potosí","KINDER ISMAEL MONTES",232091,448,37,3719,4167,3177,82,423,3600
"Bolivia","Potosí","Tomás Frías","Potosí","LIC. SUCRE",232092,226,9,1737,1963,1560,19,149,1709
"Bolivia","Potosí","Tomás Frías","Potosí","MARISCAL SANTA CRUZ",232093,599,43,4278,4877,3492,139,604,4096
"Bolivia","Potosí","Tomás Frías","Potosí","PENAL DE CANTUMARCA",232038,39,1,106,145,70,4,31,101
"Bolivia","Potosí","Tomás Frías","Potosí","UNIDAD EDUCATIVA 31 DE OCTUBRE",232095,458,27,3685,4143,3094,76,488,3582
"Bolivia","Potosí","Tomás Frías","Potosí","UNIDAD EDUCATIVA ANTONIO JOSE DE SUCRE",232096,500,36,3678,4178,2914,151,577,3491
"Bolivia","Potosí","Tomás Frías","Potosí","UNIDAD EDUCATIVA CECILIO GUZMAN ROJAS",232097,22,2,192,214,155,8,27,182
"Bolivia","Potosí","Tomás Frías","Potosí","UNIDAD EDUCATIVA DON BOSCO B",232098,27,6,257,284,200,7,44,244
"Bolivia","Potosí","Tomás Frías","Potosí","UNIDAD EDUCATIVA DR. GONZALO CALDERON RIOS",232099,21,8,312,333,219,17,68,287
"Bolivia","Potosí","Tomás Frías","Potosí","UNIDAD EDUCATIVA HUMBERTO IPORRE SALINAS",232100,368,35,2350,2718,1653,127,535,2188
"Bolivia","Potosí","Tomás Frías","Potosí","UNIDAD EDUCATIVA JUAN PABLO II",232101,490,50,4248,4738,3330,175,693,4023
"Bolivia","Potosí","Tomás Frías","Potosí","UNIDAD EDUCATIVA MEJILLONES",232102,544,58,3993,4537,3174,181,580,3754
"Bolivia","Potosí","Tomás Frías","Potosí","UNIDAD EDUCATIVA OSCAR ALFARO",232105,130,4,1045,1175,928,18,95,1023
"Bolivia","Potosí","Tomás Frías","Potosí","UNIDAD EDUCATIVA SANTA ROSA",232103,182,3,1341,1523,1180,35,123,1303
"Bolivia","Potosí","Tomás Frías","Potosí","UNIDAD EDUCATIVA VILLA COLON",232104,531,60,3875,4406,2921,197,697,3618
"Bolivia","Potosí","Tomás Frías","Tinguipaya","ESCUELA ACTARA",232106,227,26,575,802,212,110,227,439
"Bolivia","Potosí","Tomás Frías","Tinguipaya","ESCUELA CALASAYA",232107,88,1,192,280,3,10,178,181
"Bolivia","Potosí","Tomás Frías","Tinguipaya","ESCUELA CENTRAL ANTHURA",232108,146,56,983,1129,145,112,670,815
"Bolivia","Potosí","Tomás Frías","Tinguipaya","ESCUELA CENTRAL JAHUACAYA",232109,187,103,720,907,183,57,377,560
"Bolivia","Potosí","Tomás Frías","Tinguipaya","ESCUELA CENTRAL UTACALLA",232110,111,18,327,438,124,20,165,289
"Bolivia","Potosí","Tomás Frías","Tinguipaya","ESCUELA EJE CAQUENA",232111,75,30,320,395,122,15,153,275
"Bolivia","Potosí","Tomás Frías","Tinguipaya","ESCUELA FOROCTIRI",232112,108,2,354,462,38,14,300,338
"Bolivia","Potosí","Tomás Frías","Tinguipaya","ESCUELA ISLA",232113,15,2,69,84,47,5,15,62
"Bolivia","Potosí","Tomás Frías","Tinguipaya","ESCUELA ITHINOCA",232114,53,4,370,423,50,18,298,348
"Bolivia","Potosí","Tomás Frías","Tinguipaya","ESCUELA LEÑAS",232115,52,23,262,314,102,26,111,213
"Bolivia","Potosí","Tomás Frías","Tinguipaya","ESCUELA MARISCAL SUCRE",232116,349,99,1428,1777,403,82,844,1247
"Bolivia","Potosí","Tomás Frías","Tinguipaya","ESCUELA MARISCAL SUCRE",232117,349,99,1428,1777,403,82,844,1247
"Bolivia","Potosí","Tomás Frías","Tinguipaya","ESCUELA MATANSUYO",232118,83,20,208,291,83,15,90,173
"Bolivia","Potosí","Tomás Frías","Tinguipaya","ESCUELA MCAL. A. JOSE DE SUCRE",232119,151,7,326,477,82,18,219,301
"Bolivia","Potosí","Tomás Frías","Tinguipaya","ESCUELA PUCA PUNTA",232120,62,5,209,271,20,10,174,194
"Bolivia","Potosí","Tomás Frías","Tinguipaya","ESCUELA SAYACA",232122,3,6,91,94,26,6,53,79
"Bolivia","Potosí","Tomás Frías","Tinguipaya","ESCUELA TACOHUARA",232121,45,5,194,239,13,3,173,186
"Bolivia","Potosí","Tomás Frías","Tinguipaya","UNIDAD EDUCATIVA CIENEGOMA",232123,0,1,256,256,52,19,184,236
"Bolivia","Potosí","Tomás Frías","Tinguipaya","UNIDAD EDUCATIVA MACHAC MARCA",232124,12,24,195,207,131,10,30,161
"Bolivia","Potosí","Tomás Frías","Urmiri","ESCUELA CAHUAYO",232125,6,2,87,93,14,3,68,82
"Bolivia","Potosí","Tomás Frías","Urmiri","ESCUELA JUAN JOSE PEREZ",232126,27,2,267,294,85,12,168,253
"Bolivia","Potosí","Tomás Frías","Urmiri","ESCUELA PUITUCO",232127,19,3,112,131,47,2,60,107
"Bolivia","Potosí","Tomás Frías","Urmiri","ESCUELA SECC. VACUYO",232128,24,7,164,188,111,5,41,152
"Bolivia","Potosí","Tomás Frías","Yocalla","COLEGIO ELIZARDO PEREZ",232982,35,8,259,294,83,5,163,246
"Bolivia","Potosí","Tomás Frías","Yocalla","ESCUELA ALONSO DE IBANEZ",232983,24,9,243,267,178,5,51,229
"Bolivia","Potosí","Tomás Frías","Yocalla","ESCUELA CAYARA",232984,70,16,403,473,262,13,112,374
"Bolivia","Potosí","Tomás Frías","Yocalla","ESCUELA CHIRACORO",232985,32,8,298,330,146,28,116,262
"Bolivia","Potosí","Tomás Frías","Yocalla","ESCUELA EDUARDO AVAROA",232986,136,39,634,770,339,35,221,560
"Bolivia","Potosí","Tomás Frías","Yocalla","ESCUELA JOSE ANTONIO ZAMPA",232987,63,29,503,566,281,26,167,448
"Bolivia","Potosí","Tomás Frías","Yocalla","ESCUELA JUAN XXIII",232988,58,8,360,418,99,9,244,343
"Bolivia","Potosí","Tomás Frías","Yocalla","ESCUELA SAN ANTONIO",232989,59,7,397,456,293,17,80,373
"Bolivia","Potosí","Tomás Frías","Yocalla","ESCUELA SANTA LUCIA",232990,35,12,372,407,291,4,65,356
"Bolivia","Santa Cruz","Andrés Ibáñez","Cotoca","COLEGIO NAL. BENEMERITOS DE LA PATRIA",235978,546,58,3675,4221,2367,95,1155,3522
"Bolivia","Santa Cruz","Andrés Ibáñez","Cotoca","ESCUELA COLEGIO LORENZO CORTEZ RIVERA",235981,642,69,3952,4594,2513,117,1253,3766
"Bolivia","Santa Cruz","Andrés Ibáñez","Cotoca","ESCUELA COLEGIO MANUEL ANGEL CORTEZ",235982,443,33,2682,3125,1574,77,998,2572
"Bolivia","Santa Cruz","Andrés Ibáñez","Cotoca","ESCUELA COLEGIO SAN MARCOS",235983,629,27,3675,4304,2039,131,1478,3517
"Bolivia","Santa Cruz","Andrés Ibáñez","Cotoca","ESCUELA DEMETRIO AÑEZ",235984,462,16,2146,2608,1158,33,939,2097
"Bolivia","Santa Cruz","Andrés Ibáñez","Cotoca","ESCUELA GERMAN BUSCH",235985,141,9,1072,1213,316,70,677,993
"Bolivia","Santa Cruz","Andrés Ibáñez","Cotoca","ESCUELA GREMIAL CORTEZ",235979,60,8,454,514,194,17,235,429
"Bolivia","Santa Cruz","Andrés Ibáñez","Cotoca","ESCUELA JESUS GOMEZ",235986,187,14,991,1178,558,16,403,961
"Bolivia","Santa Cruz","Andrés Ibáñez","Cotoca","ESCUELA MARISCAL ANTONIO JOSE DE SUCRE",235980,135,14,821,956,497,26,284,781
"Bolivia","Santa Cruz","Andrés Ibáñez","Cotoca","ESCUELA REP. DE MEXICO",235987,279,27,1621,1900,356,137,1101,1457
"Bolivia","Santa Cruz","Andrés Ibáñez","Cotoca","ESCUELA UNIDAD EDUCATIVA CALLEJAS",235988,203,8,978,1181,666,14,290,956
"Bolivia","Santa Cruz","Andrés Ibáñez","Cotoca","ESCUELA UNIDAD EDUCATIVA CLUB SOCIAL 24 DE SEPTIEMBRE",235989,258,14,1674,1932,891,70,699,1590
"Bolivia","Santa Cruz","Andrés Ibáñez","Cotoca","ESCUELA UNIDADEDUCATIVA OSCAR ALFARO",235990,202,26,1730,1932,356,66,1282,1638
"Bolivia","Santa Cruz","Andrés Ibáñez","Cotoca","UNIDAD EDUCATIVA FIDEL SAUCEDO",235993,110,23,1116,1226,609,32,452,1061
"Bolivia","Santa Cruz","Andrés Ibáñez","Cotoca","UNIDAD EDUCATIVA PATUJU",235991,12,4,236,248,146,8,78,224
"Bolivia","Santa Cruz","Andrés Ibáñez","Cotoca","UNIDAD EDUCATIVA SAN ANTONIO",235992,7,1,62,69,39,1,21,60
"Bolivia","Santa Cruz","Andrés Ibáñez","El Torno","ESC, NUCLEO SAN LUIS",236002,216,30,1305,1521,675,57,543,1218
"Bolivia","Santa Cruz","Andrés Ibáñez","El Torno","ESCUELA 23 DE MARZO",236005,61,3,374,435,57,16,298,355
"Bolivia","Santa Cruz","Andrés Ibáñez","El Torno","ESCUELA 29 DE JUNIO",235994,314,62,2328,2642,1063,112,1091,2154
"Bolivia","Santa Cruz","Andrés Ibáñez","El Torno","ESCUELA ALBERTO RIBERA TAPIA",235995,150,24,994,1144,371,105,494,865
"Bolivia","Santa Cruz","Andrés Ibáñez","El Torno","ESCUELA ANDRES IBAÑEZ",236006,178,35,1785,1963,749,106,895,1644
"Bolivia","Santa Cruz","Andrés Ibáñez","El Torno","ESCUELA CAÑADA DOS",235996,31,15,261,292,34,6,206,240
"Bolivia","Santa Cruz","Andrés Ibáñez","El Torno","ESCUELA CENTRAL MONTEVERDE",235997,20,5,154,174,23,5,121,144
"Bolivia","Santa Cruz","Andrés Ibáñez","El Torno","ESCUELA ELENA VACA ANTELO",235998,864,64,5819,6683,2753,271,2731,5484
"Bolivia","Santa Cruz","Andrés Ibáñez","El Torno","ESCUELA FE Y ALEGRIA",235999,42,6,369,411,114,11,238,352
"Bolivia","Santa Cruz","Andrés Ibáñez","El Torno","ESCUELA LA ELVIRA",236000,0,2,24,24,13,0,9,22
"Bolivia","Santa Cruz","Andrés Ibáñez","El Torno","ESCUELA NACIONES UNIDAS",236001,921,129,6202,7123,2304,309,3460,5764
"Bolivia","Santa Cruz","Andrés Ibáñez","El Torno","ESCUELA PUERTO RICO",236007,357,48,2672,3029,1015,131,1478,2493
"Bolivia","Santa Cruz","Andrés Ibáñez","El Torno","ESCUELA QUEBRADA LEON",236003,17,3,140,157,39,4,94,133
"Bolivia","Santa Cruz","Andrés Ibáñez","El Torno","ESCUELA SANTA MARTHA",236008,157,13,1125,1282,334,110,668,1002
"Bolivia","Santa Cruz","Andrés Ibáñez","El Torno","ESCUELA SECCIONAL SANTA RITA",236004,207,32,1700,1907,740,72,856,1596
"Bolivia","Santa Cruz","Andrés Ibáñez","El Torno","ESCUELA TIQUIPAYA",236009,134,43,1060,1194,224,42,751,975
"Bolivia","Santa Cruz","Andrés Ibáñez","El Torno","ESCUELA VILLA BARRIENTOS",236010,14,3,90,104,16,3,68,84
"Bolivia","Santa Cruz","Andrés Ibáñez","El Torno","NUCLEO CENTRAL TARUMA",236011,66,19,532,598,229,36,248,477
"Bolivia","Santa Cruz","Andrés Ibáñez","El Torno","SECCIONAL PARABANOCITO",236012,14,6,135,149,53,3,73,126
"Bolivia","Santa Cruz","Andrés Ibáñez","El Torno","UNIDAD EDUCATIVA BICENTENARIO",236013,21,4,178,199,71,2,101,172
"Bolivia","Santa Cruz","Andrés Ibáñez","El Torno","UNIDAD EDUCATIVA BICENTENARIO II",236014,1,0,9,10,6,0,3,9
"Bolivia","Santa Cruz","Andrés Ibáñez","El Torno","UNIDAD EDUCATIVA LIC. ZACHARY MACY",236015,25,2,199,224,72,4,121,193
"Bolivia","Santa Cruz","Andrés Ibáñez","El Torno","UNIDAD EDUCATIVA LIC. ZACHARY MACY",236016,25,2,199,224,72,4,121,193
"Bolivia","Santa Cruz","Andrés Ibáñez","La Guardia","CAMBAO",233005,79,6,822,901,397,22,397,794
"Bolivia","Santa Cruz","Andrés Ibáñez","La Guardia","ESCUELA CENTRAL ANGEL FOIANINI",233006,572,78,4598,5170,2218,245,2057,4275
"Bolivia","Santa Cruz","Andrés Ibáñez","La Guardia","ESCUELA CENTRAL BASILIO",233007,232,44,1398,1630,516,71,767,1283
"Bolivia","Santa Cruz","Andrés Ibáñez","La Guardia","ESCUELA JOSE GIL SORUCO",233016,141,15,850,991,457,61,317,774
"Bolivia","Santa Cruz","Andrés Ibáñez","La Guardia","ESCUELA JOSE MIGUEL DE VELASCO",233008,35,5,282,317,172,5,100,272
"Bolivia","Santa Cruz","Andrés Ibáñez","La Guardia","ESCUELA JOSE VICENTE SOLIZ Y RAMOS",233009,554,77,3290,3844,1744,169,1300,3044
"Bolivia","Santa Cruz","Andrés Ibáñez","La Guardia","ESCUELA JUANA AZURDUY DE PADILLA",233010,350,17,2453,2803,1373,98,965,2338
"Bolivia","Santa Cruz","Andrés Ibáñez","La Guardia","ESCUELA LA PEÑA- BRECHA-3",233011,67,17,470,537,213,13,227,440
"Bolivia","Santa Cruz","Andrés Ibáñez","La Guardia","ESCUELA MAESTRO PITAGORAS",233017,625,47,4633,5258,1776,151,2659,4435
"Bolivia","Santa Cruz","Andrés Ibáñez","La Guardia","ESCUELA NATANIEL VERDUGEZ",233012,1438,62,9085,10523,4641,248,4134,8775
"Bolivia","Santa Cruz","Andrés Ibáñez","La Guardia","ESCUELA NUEVA ESPERANZA",233018,440,17,2777,3217,1817,65,878,2695
"Bolivia","Santa Cruz","Andrés Ibáñez","La Guardia","ESCUELA RUBEN DARIO SOLIZ",233013,357,51,2252,2609,1051,76,1074,2125
"Bolivia","Santa Cruz","Andrés Ibáñez","La Guardia","ESCUELA TOMAS JOSE MORALES",233014,650,39,4522,5172,2617,193,1673,4290
"Bolivia","Santa Cruz","Andrés Ibáñez","La Guardia","ESCUELA UNIDAD EDUCATIVA ALFREDO IBAÑEZ FRANCO",233015,637,105,4629,5266,2224,296,2004,4228
"Bolivia","Santa Cruz","Andrés Ibáñez","La Guardia","MADRE TERESA DE CALCUTA",233019,42,3,536,578,228,31,274,502
"Bolivia","Santa Cruz","Andrés Ibáñez","La Guardia","NUCLEO SAN CARLOS",233020,22,4,142,164,78,4,56,134
"Bolivia","Santa Cruz","Andrés Ibáñez","La Guardia","UNIDAD EDUCATIVA ANGEL FOIANINI BANZER II",233021,20,2,253,273,130,10,111,241
"Bolivia","Santa Cruz","Andrés Ibáñez","La Guardia","UNIDAD EDUCATIVA AYACUCHO",233022,21,3,359,380,135,7,214,349
"Bolivia","Santa Cruz","Andrés Ibáñez","La Guardia","UNIDAD EDUCATIVA BARRIO LINDO",233023,42,3,588,630,249,28,308,557
"Bolivia","Santa Cruz","Andrés Ibáñez","La Guardia","UNIDAD EDUCATIVA BICENTENARIO ARCO IRIS",233024,22,1,180,202,112,5,62,174
"Bolivia","Santa Cruz","Andrés Ibáñez","La Guardia","UNIDAD EDUCATIVA CORDECRUZ",233025,124,3,858,982,477,30,348,825
"Bolivia","Santa Cruz","Andrés Ibáñez","La Guardia","UNIDAD EDUCATIVA HERNANDO ZANABRIA",233026,17,3,251,268,95,10,143,238
"Bolivia","Santa Cruz","Andrés Ibáñez","La Guardia","UNIDAD EDUCATIVA INTEGRACION DE LAS AMERICAS",233027,42,6,608,650,88,10,504,592
"Bolivia","Santa Cruz","Andrés Ibáñez","La Guardia","UNIDAD EDUCATIVA JOSE MARIANO SERRANO",233028,48,2,639,687,318,19,300,618
"Bolivia","Santa Cruz","Andrés Ibáñez","La Guardia","UNIDAD EDUCATIVA LUZ DE ESPERANZA",233029,10,1,168,178,106,1,60,166
"Bolivia","Santa Cruz","Andrés Ibáñez","La Guardia","UNIDAD EDUCATIVA NACIONAL LA GUARDIA",233030,31,6,451,482,215,18,212,427
"Bolivia","Santa Cruz","Andrés Ibáñez","La Guardia","UNIDAD EDUCATIVA NATANIEL GARCIA CHAVEZ",233031,69,0,485,554,295,15,175,470
"Bolivia","Santa Cruz","Andrés Ibáñez","La Guardia","UNIDAD EDUCATIVA QUEBRADA SECA",233032,0,1,41,41,26,1,13,39
"Bolivia","Santa Cruz","Andrés Ibáñez","La Guardia","UNIDAD EDUCATIVA TOMAS MORALES PADILLA",233033,21,4,374,395,95,94,181,276
"Bolivia","Santa Cruz","Andrés Ibáñez","Porongo","ESCUELA 6 DE AGOSTO",232994,26,4,694,720,568,75,47,615
"Bolivia","Santa Cruz","Andrés Ibáñez","Porongo","ESCUELA CENTRAL ANICETO PARADA ROCA",232995,61,4,252,313,205,5,38,243
"Bolivia","Santa Cruz","Andrés Ibáñez","Porongo","ESCUELA CENTRAL SOMBRERITO",232996,55,6,203,258,93,11,93,186
"Bolivia","Santa Cruz","Andrés Ibáñez","Porongo","ESCUELA FRAY SANTIAGO DE RIVERO",232991,312,34,2277,2589,1348,50,845,2193
"Bolivia","Santa Cruz","Andrés Ibáñez","Porongo","ESCUELA IRENIA MONTERO",232997,46,1,107,153,27,9,70,97
"Bolivia","Santa Cruz","Andrés Ibáñez","Porongo","ESCUELA JOSE PARADA LAGUINDEY",232992,141,12,570,711,379,7,172,551
"Bolivia","Santa Cruz","Andrés Ibáñez","Porongo","ESCUELA NUCLEO CENTRAL SANTA FE",232993,52,7,329,381,63,4,255,318
"Bolivia","Santa Cruz","Andrés Ibáñez","Porongo","ESCUELA PUERTO ICHILO",232998,51,5,266,317,183,12,66,249
"Bolivia","Santa Cruz","Andrés Ibáñez","Porongo","ESCUELA SAN LORENZO",232999,211,13,1196,1407,842,30,311,1153
"Bolivia","Santa Cruz","Andrés Ibáñez","Porongo","ESCUELA TARUMATU",233000,71,2,360,431,263,12,83,346
"Bolivia","Santa Cruz","Andrés Ibáñez","Porongo","UNIDAD EDUCATIVA LAS CRUCES",233001,8,0,72,80,48,4,20,68
"Bolivia","Santa Cruz","Andrés Ibáñez","Porongo","UNIDAD EDUCATIVA SAN PEDRO",233002,0,0,50,50,23,0,27,50
"Bolivia","Santa Cruz","Andrés Ibáñez","Porongo","UNIDAD EDUCATIVA TACUAREMBO",233003,1,0,6,7,0,0,6,6
"Bolivia","Santa Cruz","Andrés Ibáñez","Porongo","URUBO OPEN MALL",233004,60,1,510,570,463,7,39,502
"Bolivia","Santa Cruz","Andrés Ibáñez","Santa Cruz De La Sierra","16 DE FEBRERO",235072,0,1,139,139,82,14,42,124
"Bolivia","Santa Cruz","Andrés Ibáñez","Santa Cruz De La Sierra","16 DE JULIO",235073,72,8,775,847,460,54,253,713
"Bolivia","Santa Cruz","Andrés Ibáñez","Santa Cruz De La Sierra","ANGELINA RIVERA",235074,21,0,214,235,126,2,86,212
"Bolivia","Santa Cruz","Andrés Ibáñez","Santa Cruz De La Sierra","CAMPUS UNIVERSITARIO",235075,566,6,2742,3308,2256,35,445,2701
"Bolivia","Santa Cruz","Andrés Ibáñez","Santa Cruz De La Sierra","COL. BERTHA CUELLAR",235095,1101,25,5105,6206,3293,345,1442,4735
"Bolivia","Santa Cruz","Andrés Ibáñez","Santa Cruz De La Sierra","COLEGIO 12 DE DICIEMBRE",235076,1193,53,6567,7760,3871,178,2465,6336
"Bolivia","Santa Cruz","Andrés Ibáñez","Santa Cruz De La Sierra","COLEGIO 18 DE MARZO",235077,855,52,5021,5876,3225,153,1591,4816
"Bolivia","Santa Cruz","Andrés Ibáñez","Santa Cruz De La Sierra","COLEGIO 23 DE ABRIL",235120,444,9,2730,3174,1761,123,837,2598
"Bolivia","Santa Cruz","Andrés Ibáñez","Santa Cruz De La Sierra","COLEGIO 27 DE MAYO",235079,655,18,3291,3946,1750,112,1411,3161
"Bolivia","Santa Cruz","Andrés Ibáñez","Santa Cruz De La Sierra","COLEGIO 30 DE MARZO",235080,532,11,3569,4101,2721,91,746,3467
"Bolivia","Santa Cruz","Andrés Ibáñez","Santa Cruz De La Sierra","COLEGIO 6 DE JUNIO",235121,600,7,2213,2813,1755,93,358,2113
"Bolivia","Santa Cruz","Andrés Ibáñez","Santa Cruz De La Sierra","COLEGIO 7 DE SEPTIEMBRE",235081,552,10,3062,3614,2429,83,540,2969
"Bolivia","Santa Cruz","Andrés Ibáñez","Santa Cruz De La Sierra","COLEGIO ADELA ZAMUDIO",235122,935,25,5934,6869,3515,228,2166,5681
"Bolivia","Santa Cruz","Andrés Ibáñez","Santa Cruz De La Sierra","COLEGIO ADVENTISTA SANTA CRUZ",235082,575,13,3616,4191,2831,147,625,3456
"Bolivia","Santa Cruz","Andrés Ibáñez","Santa Cruz De La Sierra","COLEGIO ALAN FARAH",235083,566,18,3107,3673,1992,150,947,2939
"Bolivia","Santa Cruz","Andrés Ibáñez","Santa Cruz De La Sierra","COLEGIO ALFA Y OMEGA",235084,212,7,1587,1799,1123,72,385,1508
"Bolivia","Santa Cruz","Andrés Ibáñez","Santa Cruz De La Sierra","COLEGIO AMERICAN SCHOOL COOP.",235085,315,4,1992,2307,1772,56,160,1932
"Bolivia","Santa Cruz","Andrés Ibáñez","Santa Cruz De La Sierra","COLEGIO ANGELA PINCKERT",235086,889,30,5378,6267,2843,179,2326,5169
"Bolivia","Santa Cruz","Andrés Ibáñez","Santa Cruz De La Sierra","COLEGIO ANGLO AMERICANO",235087,45,29,643,688,557,8,49,606
"Bolivia","Santa Cruz","Andrés Ibáñez","Santa Cruz De La Sierra","COLEGIO ANITA SUAREZ DE LEYGUE",235088,262,17,2119,2381,1164,42,896,2060
"Bolivia","Santa Cruz","Andrés Ibáñez","Santa Cruz De La Sierra","COLEGIO ANTONIO VICENTE SEOANE",235089,281,9,2239,2520,1749,88,393,2142
"Bolivia","Santa Cruz","Andrés Ibáñez","Santa Cruz De La Sierra","COLEGIO ARTURO MEDEIROS",235090,192,8,1349,1541,855,41,445,1300
"Bolivia","Santa Cruz","Andrés Ibáñez","Santa Cruz De La Sierra","COLEGIO ARZ. DANIEL RIVERO",235091,25,0,137,162,108,1,28,136
"Bolivia","Santa Cruz","Andrés Ibáñez","Santa Cruz De La Sierra","COLEGIO BAILON MERCADO ORTIZ",235092,376,11,2633,3009,2098,62,462,2560
"Bolivia","Santa Cruz","Andrés Ibáñez","Santa Cruz De La Sierra","COLEGIO BASILIO DE CUELLAR",235093,145,1,778,923,709,15,53,762
"Bolivia","Santa Cruz","Andrés Ibáñez","Santa Cruz De La Sierra","COLEGIO BATALLON TREN",235094,243,9,1562,1805,1055,77,421,1476
"Bolivia","Santa Cruz","Andrés Ibáñez","Santa Cruz De La Sierra","COLEGIO BERTHA CUELLAR",235123,187,5,856,1043,652,12,187,839
"Bolivia","Santa Cruz","Andrés Ibáñez","Santa Cruz De La Sierra","COLEGIO BOSTON COLLEGE",235096,188,3,1410,1598,1246,22,139,1385
"Bolivia","Santa Cruz","Andrés Ibáñez","Santa Cruz De La Sierra","COLEGIO BRITANICO",235097,381,4,2798,3179,2581,31,182,2763
"Bolivia","Santa Cruz","Andrés Ibáñez","Santa Cruz De La Sierra","COLEGIO BUENAS NUEVAS",235098,978,116,6445,7423,3805,205,2319,6124
"Bolivia","Santa Cruz","Andrés Ibáñez","Santa Cruz De La Sierra","COLEGIO CAÑADA EL CARMEN",235099,450,8,3510,3960,2813,87,602,3415
"Bolivia","Santa Cruz","Andrés Ibáñez","Santa Cruz De La Sierra","COLEGIO CAÑADA PAILITAS",235100,401,11,2507,2908,1766,63,667,2433
"Bolivia","Santa Cruz","Andrés Ibáñez","Santa Cruz De La Sierra","COLEGIO CARCEL PUBLICA",235101,400,3,530,930,265,9,253,518
"Bolivia","Santa Cruz","Andrés Ibáñez","Santa Cruz De La Sierra","COLEGIO CARDENAL CUSHING JESUS MARIA",235102,318,11,1929,2247,1566,41,311,1877
"Bolivia","Santa Cruz","Andrés Ibáñez","Santa Cruz De La Sierra","COLEGIO CASTILLA LA MANCHA",235104,1619,151,9549,11168,5034,419,3945,8979
"Bolivia","Santa Cruz","Andrés Ibáñez","Santa Cruz De La Sierra","COLEGIO CASTULO CHAVEZ",235124,395,14,2078,2473,1772,24,268,2040
"Bolivia","Santa Cruz","Andrés Ibáñez","Santa Cruz De La Sierra","COLEGIO CENTRAL OBRERA DEPARTAMENTAL",235105,771,69,4763,5534,2602,171,1921,4523
"Bolivia","Santa Cruz","Andrés Ibáñez","Santa Cruz De La Sierra","COLEGIO CENTRO APRONDY",235106,251,34,2255,2506,1823,114,284,2107
"Bolivia","Santa Cruz","Andrés Ibáñez","Santa Cruz De La Sierra","COLEGIO CENTRO EDUCATIVO CARITAS",235107,520,11,4777,5297,3648,162,956,4604
"Bolivia","Santa Cruz","Andrés Ibáñez","Santa Cruz De La Sierra","COLEGIO CENTRO INTERNO BOL. ALEMAN",235108,1431,53,6686,8117,3081,196,3356,6437
"Bolivia","Santa Cruz","Andrés Ibáñez","Santa Cruz De La Sierra","COLEGIO CIUDAD NIÑO JESUS",235109,643,18,4033,4676,2573,199,1243,3816
"Bolivia","Santa Cruz","Andrés Ibáñez","Santa Cruz De La Sierra","COLEGIO CLUB DE LEONES",235110,245,6,1758,2003,1297,32,423,1720
"Bolivia","Santa Cruz","Andrés Ibáñez","Santa Cruz De La Sierra","COLEGIO CLUB DE LEONES #10",235111,148,32,1130,1278,930,34,134,1064
"Bolivia","Santa Cruz","Andrés Ibáñez","Santa Cruz De La Sierra","COLEGIO CLUB DE LEONES #6",235112,118,3,670,788,450,45,172,622
"Bolivia","Santa Cruz","Andrés Ibáñez","Santa Cruz De La Sierra","COLEGIO COMPLEJO EDUCATIVO JAPON",235113,777,27,4684,5461,2821,182,1654,4475
"Bolivia","Santa Cruz","Andrés Ibáñez","Santa Cruz De La Sierra","COLEGIO COVIPAL",235114,151,14,933,1084,341,31,547,888
"Bolivia","Santa Cruz","Andrés Ibáñez","Santa Cruz De La Sierra","COLEGIO CUPESI TERRADO",235115,764,46,4206,4970,1806,173,2181,3987
"Bolivia","Santa Cruz","Andrés Ibáñez","Santa Cruz De La Sierra","COLEGIO CUPESO DE LOS REYES",235125,609,21,3885,4494,1653,152,2059,3712
"Bolivia","Santa Cruz","Andrés Ibáñez","Santa Cruz De La Sierra","COLEGIO DIOS ES AMOR",235116,174,8,1294,1468,1097,20,169,1266
"Bolivia","Santa Cruz","Andrés Ibáñez","Santa Cruz De La Sierra","COLEGIO DOMINGO LEIGUE (BOLIVIANO CANADIENSE",235117,265,5,1803,2068,1519,31,248,1767
"Bolivia","Santa Cruz","Andrés Ibáñez","Santa Cruz De La Sierra","COLEGIO DOMINGO SAVIO - DON BOSCO",235126,1167,39,7171,8338,4296,250,2586,6882
"Bolivia","Santa Cruz","Andrés Ibáñez","Santa Cruz De La Sierra","COLEGIO DON BOSCO",235127,346,5,2023,2369,1752,37,229,1981
"Bolivia","Santa Cruz","Andrés Ibáñez","Santa Cruz De La Sierra","COLEGIO EDUCATIVO COTOCA",235118,506,85,3026,3532,1654,128,1159,2813
"Bolivia","Santa Cruz","Andrés Ibáñez","Santa Cruz De La Sierra","COLEGIO EDUCATIVO SAN ISIDRO",235119,850,54,5300,6150,3113,144,1989,5102
"Bolivia","Santa Cruz","Andrés Ibáñez","Santa Cruz De La Sierra","COLEGIO EL BUEN SAMARITANO",235147,231,16,1724,1955,830,68,810,1640
"Bolivia","Santa Cruz","Andrés Ibáñez","Santa Cruz De La Sierra","COLEGIO EL CARMEN 16 DE JULIO",235148,301,12,2046,2347,1548,58,428,1976
"Bolivia","Santa Cruz","Andrés Ibáñez","Santa Cruz De La Sierra","COLEGIO ELFI RIVERA DE BARBERY",235149,1594,50,8265,9859,4971,298,2946,7917
"Bolivia","Santa Cruz","Andrés Ibáñez","Santa Cruz De La Sierra","COLEGIO EL PAJONAL",235150,284,11,1633,1917,1353,29,240,1593
"Bolivia","Santa Cruz","Andrés Ibáñez","Santa Cruz De La Sierra","COLEGIO EL PROGRESO",235128,926,33,5004,5930,2443,242,2286,4729
"Bolivia","Santa Cruz","Andrés Ibáñez","Santa Cruz De La Sierra","COLEGIO ELVIRA PARADA",235129,646,16,3534,4180,2305,104,1109,3414
"Bolivia","Santa Cruz","Andrés Ibáñez","Santa Cruz De La Sierra","COLEGIO ESCUELA 29 DE DICIEMBRE",235151,337,8,1915,2252,1112,58,737,1849
"Bolivia","Santa Cruz","Andrés Ibáñez","Santa Cruz De La Sierra","COLEGIO ESCUELA 2 DE AGOSTO",235169,390,9,2532,2922,2063,32,428,2491
"Bolivia","Santa Cruz","Andrés Ibáñez","Santa Cruz De La Sierra","COLEGIO ESCUELA AMBROCIO VILLARROEL",235170,294,53,1659,1953,859,44,703,1562
"Bolivia","Santa Cruz","Andrés Ibáñez","Santa Cruz De La Sierra","COLEGIO ESCUELA AMSTERDAN",235152,408,8,2357,2765,922,70,1357,2279
"Bolivia","Santa Cruz","Andrés Ibáñez","Santa Cruz De La Sierra","COLEGIO ESCUELA BOLIVIA HOLANDA",235171,595,21,3656,4251,1247,190,2198,3445
"Bolivia","Santa Cruz","Andrés Ibáñez","Santa Cruz De La Sierra","COLEGIO ESCUELA CORONEL IGNACIO WARNES",235153,150,2,585,735,466,21,96,562
"Bolivia","Santa Cruz","Andrés Ibáñez","Santa Cruz De La Sierra","COLEGIO ESCUELA DELCY MARTINEZ SALINAS",235172,300,8,1829,2129,890,186,745,1635
"Bolivia","Santa Cruz","Andrés Ibáñez","Santa Cruz De La Sierra","COLEGIO ESCUELA EL FUERTE",235173,999,75,5729,6728,2589,398,2667,5256
"Bolivia","Santa Cruz","Andrés Ibáñez","Santa Cruz De La Sierra","COLEGIO ESCUELA GRAL. ISMAEL MONTES GAMBOA",235154,733,84,5227,5960,2676,238,2229,4905
"Bolivia","Santa Cruz","Andrés Ibáñez","Santa Cruz De La Sierra","COLEGIO ESCUELA HILANDERIA",235155,503,17,3062,3565,2090,98,857,2947
"Bolivia","Santa Cruz","Andrés Ibáñez","Santa Cruz De La Sierra","COLEGIO ESCUELA HOLANDA",235156,211,14,1625,1836,662,82,867,1529
"Bolivia","Santa Cruz","Andrés Ibáñez","Santa Cruz De La Sierra","COLEGIO ESCUELA HONORATO MEJIA",235157,335,52,2678,3013,1407,107,1112,2519
"Bolivia","Santa Cruz","Andrés Ibáñez","Santa Cruz De La Sierra","COLEGIO ESCUELA INOCENCIO ROMAN",235158,947,89,4783,5730,1783,171,2740,4523
"Bolivia","Santa Cruz","Andrés Ibáñez","Santa Cruz De La Sierra","COLEGIO ESCUELA JORGE URENDA TRIGO",235174,505,17,3198,3703,2256,120,805,3061
"Bolivia","Santa Cruz","Andrés Ibáñez","Santa Cruz De La Sierra","COLEGIO ESCUELA JUANA AZURDUY DE PADILLA",235159,1216,186,7968,9184,3786,336,3660,7446
"Bolivia","Santa Cruz","Andrés Ibáñez","Santa Cruz De La Sierra","COLEGIO ESCUELA LA BASE",235160,351,14,2562,2913,1613,49,886,2499
"Bolivia","Santa Cruz","Andrés Ibáñez","Santa Cruz De La Sierra","COLEGIO ESCUELA MAGISTERIO",235175,390,43,3336,3726,2735,67,491,3226
"Bolivia","Santa Cruz","Andrés Ibáñez","Santa Cruz De La Sierra","COLEGIO ESCUELA MAGISTERIO SUR",235161,397,20,2581,2978,1301,103,1157,2458
"Bolivia","Santa Cruz","Andrés Ibáñez","Santa Cruz De La Sierra","COLEGIO ESCUELA MANUEL IGNACIO SALVATIERRA",235162,103,1,537,640,458,9,69,527
"Bolivia","Santa Cruz","Andrés Ibáñez","Santa Cruz De La Sierra","COLEGIO ESCUELA MARIA ALICIA PAZ B.",235163,810,32,5206,6016,3276,164,1734,5010
"Bolivia","Santa Cruz","Andrés Ibáñez","Santa Cruz De La Sierra","COLEGIO ESCUELA MAX FERNANDEZ ROJAS B",235164,524,28,3050,3574,1335,156,1531,2866
"Bolivia","Santa Cruz","Andrés Ibáñez","Santa Cruz De La Sierra","COLEGIO ESCUELA NAUN FERNANDEZ",235165,308,11,2526,2834,1607,101,807,2414
"Bolivia","Santa Cruz","Andrés Ibáñez","Santa Cruz De La Sierra","COLEGIO ESCUELA NUEVA ESPERANZA",235176,291,18,1282,1573,511,36,717,1228
"Bolivia","Santa Cruz","Andrés Ibáñez","Santa Cruz De La Sierra","COLEGIO ESCUELA PEREGRINA DAVALOS",235166,589,17,3259,3848,1456,92,1694,3150
"Bolivia","Santa Cruz","Andrés Ibáñez","Santa Cruz De La Sierra","COLEGIO ESCUELA POLY VILLARROEL",235177,206,6,1541,1747,1034,81,420,1454
"Bolivia","Santa Cruz","Andrés Ibáñez","Santa Cruz De La Sierra","COLEGIO ESCUELA ROCA CORONADO",235167,872,36,5345,6217,2591,129,2589,5180
"Bolivia","Santa Cruz","Andrés Ibáñez","Santa Cruz De La Sierra","COLEGIO ESCUELA SARA PORRAS DE PINTO",235178,377,8,2465,2842,1720,127,610,2330
"Bolivia","Santa Cruz","Andrés Ibáñez","Santa Cruz De La Sierra","COLEGIO ESCUELA TIERRAS NUEVAS EL CARMEN",235168,1769,213,9544,11313,4380,453,4498,8878
"Bolivia","Santa Cruz","Andrés Ibáñez","Santa Cruz De La Sierra","COLEGIO ESCUELA UNZAGA DE LA VEGA",235179,1549,91,9194,10743,5199,370,3534,8733
"Bolivia","Santa Cruz","Andrés Ibáñez","Santa Cruz De La Sierra","COLEGIO ESCUELA VIRGEN DE URKUPINA",235180,1331,65,7212,8543,2693,318,4136,6829
"Bolivia","Santa Cruz","Andrés Ibáñez","Santa Cruz De La Sierra","COLEGIO FAUSTO MEDRANO",235181,451,22,2839,3290,1664,130,1023,2687
"Bolivia","Santa Cruz","Andrés Ibáñez","Santa Cruz De La Sierra","COLEGIO FELIX BASCOPE",235182,433,11,3613,4046,2789,79,734,3523
"Bolivia","Santa Cruz","Andrés Ibáñez","Santa Cruz De La Sierra","COLEGIO FELIX BASCOPE SANANDITA",235183,309,8,2073,2382,1667,74,324,1991
"Bolivia","Santa Cruz","Andrés Ibáñez","Santa Cruz De La Sierra","COLEGIO FE Y ALEGRIA",235184,814,26,4302,5116,2823,74,1379,4202
"Bolivia","Santa Cruz","Andrés Ibáñez","Santa Cruz De La Sierra","COLEGIO FE Y ALEGRIA - ANICETO ARZE",235185,684,28,5033,5717,3934,218,853,4787
"Bolivia","Santa Cruz","Andrés Ibáñez","Santa Cruz De La Sierra","COLEGIO FE Y ALEGRIA LA MERCED",235186,575,20,4235,4810,3105,268,842,3947
"Bolivia","Santa Cruz","Andrés Ibáñez","Santa Cruz De La Sierra","COLEGIO FE Y ALEGRIA NUEVA AMERICA",235187,1332,62,7094,8426,3674,208,3150,6824
"Bolivia","Santa Cruz","Andrés Ibáñez","Santa Cruz De La Sierra","COLEGIO FUENTE DEL SABER",235130,100,7,766,866,296,23,440,736
"Bolivia","Santa Cruz","Andrés Ibáñez","Santa Cruz De La Sierra","COLEGIO GABRIEL RENE MORENO",235188,230,2,1393,1623,1170,25,196,1366
"Bolivia","Santa Cruz","Andrés Ibáñez","Santa Cruz De La Sierra","COLEGIO GASTON GUILLAUX",235189,728,6,2912,3640,2454,57,395,2849
"Bolivia","Santa Cruz","Andrés Ibáñez","Santa Cruz De La Sierra","COLEGIO GILBERTO MENACHO",235190,871,62,5200,6071,3129,216,1793,4922
"Bolivia","Santa Cruz","Andrés Ibáñez","Santa Cruz De La Sierra","COLEGIO GUALBERTO VILLARROEL",235191,402,10,2624,3026,2179,45,390,2569
"Bolivia","Santa Cruz","Andrés Ibáñez","Santa Cruz De La Sierra","COLEGIO GUAPILO JUNIN",235192,769,31,4730,5499,3204,127,1368,4572
"Bolivia","Santa Cruz","Andrés Ibáñez","Santa Cruz De La Sierra","COLEGIO HENRRY PRINCE",235193,243,11,1409,1652,1048,27,323,1371
"Bolivia","Santa Cruz","Andrés Ibáñez","Santa Cruz De La Sierra","COLEGIO HERMANOS CAVANIS",235194,703,20,5427,6130,4031,164,1212,5243
"Bolivia","Santa Cruz","Andrés Ibáñez","Santa Cruz De La Sierra","COLEGIO HERNANDO SILES",235195,1926,71,10283,12209,5075,366,4771,9846
"Bolivia","Santa Cruz","Andrés Ibáñez","Santa Cruz De La Sierra","COLEGIO HEROES DEL CHACO",235196,730,21,4927,5657,3419,210,1277,4696
"Bolivia","Santa Cruz","Andrés Ibáñez","Santa Cruz De La Sierra","COLEGIO HISPANO AMERICANO",235197,319,12,1765,2084,1102,27,624,1726
"Bolivia","Santa Cruz","Andrés Ibáñez","Santa Cruz De La Sierra","COLEGIO HNAS. ARREDONDO (COLEGIO JESUS PEREDO)",235198,533,39,3512,4045,2482,141,850,3332
"Bolivia","Santa Cruz","Andrés Ibáñez","Santa Cruz De La Sierra","COLEGIO HUMBERTO EGUEZ",235199,405,29,2887,3292,1660,168,1030,2690
"Bolivia","Santa Cruz","Andrés Ibáñez","Santa Cruz De La Sierra","COLEGIO IGNACIO WARNES",235131,614,20,3784,4398,1638,145,1981,3619
"Bolivia","Santa Cruz","Andrés Ibáñez","Santa Cruz De La Sierra","COLEGIO INST. DOMINGO SAVIO",235200,178,1,870,1048,738,20,111,849
"Bolivia","Santa Cruz","Andrés Ibáñez","Santa Cruz De La Sierra","COLEGIO INSTITUTO AMERICANO JUAN WESLEY",235201,395,8,2843,3238,2379,93,363,2742
"Bolivia","Santa Cruz","Andrés Ibáñez","Santa Cruz De La Sierra","COLEGIO INTERNACIONAL (BETHESDA)",235202,344,14,2344,2688,1489,99,742,2231
"Bolivia","Santa Cruz","Andrés Ibáñez","Santa Cruz De La Sierra","COLEGIO JHON KENNEDY",235203,988,55,5951,6939,4339,182,1375,5714
"Bolivia","Santa Cruz","Andrés Ibáñez","Santa Cruz De La Sierra","COLEGIO JOSEFINA BALSAMO ( LOS TUSEQUIS)",235132,539,50,3818,4357,2803,157,808,3611
"Bolivia","Santa Cruz","Andrés Ibáñez","Santa Cruz De La Sierra","COLEGIO JOSEFINA GOYTIA",235204,144,2,989,1133,860,20,107,967
"Bolivia","Santa Cruz","Andrés Ibáñez","Santa Cruz De La Sierra","COLEGIO JOSE MALKY JESUS MARIA",235205,895,13,4268,5163,3254,109,892,4146
"Bolivia","Santa Cruz","Andrés Ibáñez","Santa Cruz De La Sierra","COLEGIO JUAN LA BORDE MOREL",235206,282,3,2193,2475,1706,40,444,2150
"Bolivia","Santa Cruz","Andrés Ibáñez","Santa Cruz De La Sierra","COLEGIO JUAN PABLO II",235207,397,9,3247,3644,2813,126,299,3112
"Bolivia","Santa Cruz","Andrés Ibáñez","Santa Cruz De La Sierra","COLEGIO JULIO A. GUTIERREZ",235208,341,5,1524,1865,1214,30,275,1489
"Bolivia","Santa Cruz","Andrés Ibáñez","Santa Cruz De La Sierra","COLEGIO JUSTO LEIGUE",235133,132,4,1430,1562,1189,65,172,1361
"Bolivia","Santa Cruz","Andrés Ibáñez","Santa Cruz De La Sierra","COLEGIO KINDER FANNY ANTELO",235209,107,3,704,811,537,13,151,688
"Bolivia","Santa Cruz","Andrés Ibáñez","Santa Cruz De La Sierra","COLEGIO LA MADRE",235210,598,17,3800,4398,2524,79,1180,3704
"Bolivia","Santa Cruz","Andrés Ibáñez","Santa Cruz De La Sierra","COLEGIO LAS AMERICAS II",235211,595,38,4929,5524,2664,348,1879,4543
"Bolivia","Santa Cruz","Andrés Ibáñez","Santa Cruz De La Sierra","COLEGIO LA SANTA CRUZ",235212,280,4,1998,2278,1757,54,183,1940
"Bolivia","Santa Cruz","Andrés Ibáñez","Santa Cruz De La Sierra","COLEGIO LICEO MARIA VACADIEZ",235213,164,1,1623,1787,1381,89,152,1533
"Bolivia","Santa Cruz","Andrés Ibáñez","Santa Cruz De La Sierra","COLEGIO LUIS BARRANCO ALVAREZ",235214,1072,48,5995,7067,2744,137,3066,5810
"Bolivia","Santa Cruz","Andrés Ibáñez","Santa Cruz De La Sierra","COLEGIO LUIS ESPINAL CAMPOS",235215,876,29,4883,5759,2253,222,2379,4632
"Bolivia","Santa Cruz","Andrés Ibáñez","Santa Cruz De La Sierra","COLEGIO LUZ DEL ORIENTE",235216,592,18,2849,3441,1917,78,836,2753
"Bolivia","Santa Cruz","Andrés Ibáñez","Santa Cruz De La Sierra","COLEGIO LUZ Y SABER II",235217,590,14,3343,3933,2463,113,753,3216
"Bolivia","Santa Cruz","Andrés Ibáñez","Santa Cruz De La Sierra","COLEGIO LUZ Y VERDAD",235134,472,18,2520,2992,1136,76,1290,2426
"Bolivia","Santa Cruz","Andrés Ibáñez","Santa Cruz De La Sierra","COLEGIO MADRE CLARA RICCI (JESUS ROMAN VACA",235218,208,2,1639,1847,1102,52,483,1585
"Bolivia","Santa Cruz","Andrés Ibáñez","Santa Cruz De La Sierra","COLEGIO MAGDALENA POSTEL",235219,569,19,3862,4431,2894,147,802,3696
"Bolivia","Santa Cruz","Andrés Ibáñez","Santa Cruz De La Sierra","COLEGIO MARCELINO CHAMPAGNAT",235135,315,15,2690,3005,1976,107,592,2568
"Bolivia","Santa Cruz","Andrés Ibáñez","Santa Cruz De La Sierra","COLEGIO MARIA TERESA PULIDO",235220,850,109,5129,5979,2601,250,2169,4770
"Bolivia","Santa Cruz","Andrés Ibáñez","Santa Cruz De La Sierra","COLEGIO MARISCAL SUCRE",235221,352,11,2646,2998,2240,45,350,2590
"Bolivia","Santa Cruz","Andrés Ibáñez","Santa Cruz De La Sierra","COLEGIO MARISTA",235136,250,6,1698,1948,1523,21,148,1671
"Bolivia","Santa Cruz","Andrés Ibáñez","Santa Cruz De La Sierra","COLEGIO MARTIN SAPP",235137,828,25,5678,6506,3614,179,1860,5474
"Bolivia","Santa Cruz","Andrés Ibáñez","Santa Cruz De La Sierra","COLEGIO MATEO KULJIS SECUNDARIO",235222,463,43,4733,5196,2542,333,1815,4357
"Bolivia","Santa Cruz","Andrés Ibáñez","Santa Cruz De La Sierra","COLEGIO MIRETTE SCIARONI",235223,351,6,2162,2513,1833,48,275,2108
"Bolivia","Santa Cruz","Andrés Ibáñez","Santa Cruz De La Sierra","COLEGIO M. NELLY VDA. DE BERTERO",235224,271,13,1544,1815,770,44,717,1487
"Bolivia","Santa Cruz","Andrés Ibáñez","Santa Cruz De La Sierra","COLEGIO MODULO # 5 ELVA ANTELO JORDAN",235225,564,36,3171,3735,1558,63,1514,3072
"Bolivia","Santa Cruz","Andrés Ibáñez","Santa Cruz De La Sierra","COLEGIO MODULO FLAMINGO",235226,368,8,2480,2848,1922,45,505,2427
"Bolivia","Santa Cruz","Andrés Ibáñez","Santa Cruz De La Sierra","COLEGIO MONSEÑOR LUIS RODRIGUEZ P.",235227,916,24,5119,6035,3131,124,1840,4971
"Bolivia","Santa Cruz","Andrés Ibáñez","Santa Cruz De La Sierra","COLEGIO NACIONAL 9 DE OCTUBRE",235228,526,50,4490,5016,2931,218,1291,4222
"Bolivia","Santa Cruz","Andrés Ibáñez","Santa Cruz De La Sierra","COLEGIO NACIONAL FLORIDA",235229,150,4,1339,1489,1123,89,123,1246
"Bolivia","Santa Cruz","Andrés Ibáñez","Santa Cruz De La Sierra","COLEGIO NACIONAL SALESIANO",235230,276,6,1510,1786,1204,34,266,1470
"Bolivia","Santa Cruz","Andrés Ibáñez","Santa Cruz De La Sierra","COLEGIO NESTOR SUAREZ",235138,548,12,3694,4242,2568,146,968,3536
"Bolivia","Santa Cruz","Andrés Ibáñez","Santa Cruz De La Sierra","COLEGIO NIMIA CENTELLA",235231,637,31,4115,4752,2457,170,1457,3914
"Bolivia","Santa Cruz","Andrés Ibáñez","Santa Cruz De La Sierra","COLEGIO NORMANDIA JOSEFINA BALSAMO",235232,559,35,3871,4430,1769,114,1953,3722
"Bolivia","Santa Cruz","Andrés Ibáñez","Santa Cruz De La Sierra","COLEGIO NUCLEO ESCOLAR RAMAFA",235233,238,7,1704,1942,1458,26,213,1671
"Bolivia","Santa Cruz","Andrés Ibáñez","Santa Cruz De La Sierra","COLEGIO NUEVA AMERICA",235234,330,8,1992,2322,1579,40,365,1944
"Bolivia","Santa Cruz","Andrés Ibáñez","Santa Cruz De La Sierra","COLEGIO NUEVA ESPERANZA",235235,384,10,1860,2244,1446,42,362,1808
"Bolivia","Santa Cruz","Andrés Ibáñez","Santa Cruz De La Sierra","COLEGIO OBISPO SANTISTEVAN",235236,113,2,731,844,653,16,60,713
"Bolivia","Santa Cruz","Andrés Ibáñez","Santa Cruz De La Sierra","COLEGIO OSCAR ARNULFO",235237,590,47,3909,4499,2207,272,1383,3590
"Bolivia","Santa Cruz","Andrés Ibáñez","Santa Cruz De La Sierra","COLEGIO OVIDIO SANTISTEVAN",235238,841,12,4602,5443,3526,130,934,4460
"Bolivia","Santa Cruz","Andrés Ibáñez","Santa Cruz De La Sierra","COLEGIO PABLO SEXTO",235239,256,3,1888,2144,1481,35,369,1850
"Bolivia","Santa Cruz","Andrés Ibáñez","Santa Cruz De La Sierra","COLEGIO PAMPA DE LA CRUZ",235240,436,15,2714,3150,1905,82,712,2617
"Bolivia","Santa Cruz","Andrés Ibáñez","Santa Cruz De La Sierra","COLEGIO PAMPA DE LA ISLA",235241,483,15,2007,2490,1340,39,613,1953
"Bolivia","Santa Cruz","Andrés Ibáñez","Santa Cruz De La Sierra","COLEGIO PART. ALFRED B. NOBEL",235242,275,8,1762,2037,1287,42,425,1712
"Bolivia","Santa Cruz","Andrés Ibáñez","Santa Cruz De La Sierra","COLEGIO PEDRO AÑEZ",235243,815,27,4613,5428,2861,161,1564,4425
"Bolivia","Santa Cruz","Andrés Ibáñez","Santa Cruz De La Sierra","COLEGIO PEDRO GUTIERREZ",235244,264,7,2337,2601,2046,87,197,2243
"Bolivia","Santa Cruz","Andrés Ibáñez","Santa Cruz De La Sierra","COLEGIO PLACIDO MOLILNA",235245,506,21,2269,2775,1364,83,801,2165
"Bolivia","Santa Cruz","Andrés Ibáñez","Santa Cruz De La Sierra","COLEGIO PLAN 4000",235139,685,37,4624,5309,1666,153,2768,4434
"Bolivia","Santa Cruz","Andrés Ibáñez","Santa Cruz De La Sierra","COLEGIO POLIFUNCIONAL CALAMA",235246,533,26,3216,3749,1588,88,1514,3102
"Bolivia","Santa Cruz","Andrés Ibáñez","Santa Cruz De La Sierra","COLEGIO PRIMAVERA",235247,900,61,5207,6107,2346,200,2600,4946
"Bolivia","Santa Cruz","Andrés Ibáñez","Santa Cruz De La Sierra","COLEGIO RAFAEL BUSTILLOS",235248,625,21,3368,3993,1706,84,1557,3263
"Bolivia","Santa Cruz","Andrés Ibáñez","Santa Cruz De La Sierra","COLEGIO RAMON DARIO GUTIERREZ",235249,196,0,1418,1614,1210,36,172,1382
"Bolivia","Santa Cruz","Andrés Ibáñez","Santa Cruz De La Sierra","COLEGIO RAQUEL SOSSA",235140,94,1,888,982,789,15,83,872
"Bolivia","Santa Cruz","Andrés Ibáñez","Santa Cruz De La Sierra","COLEGIO REPUBLICA DEL URUGUAY",235250,459,9,2705,3164,2296,35,365,2661
"Bolivia","Santa Cruz","Andrés Ibáñez","Santa Cruz De La Sierra","COLEGIO RODOLFO JOEM",235251,1478,51,8097,9575,4736,285,3025,7761
"Bolivia","Santa Cruz","Andrés Ibáñez","Santa Cruz De La Sierra","COLEGIO ROMULO HERRERA",235252,217,5,1177,1394,840,29,303,1143
"Bolivia","Santa Cruz","Andrés Ibáñez","Santa Cruz De La Sierra","COLEGIO SAGRADO CORAZON",235253,139,5,937,1076,667,23,242,909
"Bolivia","Santa Cruz","Andrés Ibáñez","Santa Cruz De La Sierra","COLEGIO SAN CARLOS",235254,229,7,2142,2371,1689,94,352,2041
"Bolivia","Santa Cruz","Andrés Ibáñez","Santa Cruz De La Sierra","COLEGIO SAN FELIPE",235141,1279,166,7396,8675,3972,234,3024,6996
"Bolivia","Santa Cruz","Andrés Ibáñez","Santa Cruz De La Sierra","COLEGIO SAN FRANCISCO DE ASIS",235142,46,5,434,480,220,6,203,423
"Bolivia","Santa Cruz","Andrés Ibáñez","Santa Cruz De La Sierra","COLEGIO SAN FRANCISCO DE SALES DON BOSCO",235255,1196,51,7315,8511,5448,217,1599,7047
"Bolivia","Santa Cruz","Andrés Ibáñez","Santa Cruz De La Sierra","COLEGIO SAN FRANCISCO SUR",235256,562,26,3415,3977,1453,94,1842,3295
"Bolivia","Santa Cruz","Andrés Ibáñez","Santa Cruz De La Sierra","COLEGIO SAN JORGE",235143,466,49,2424,2890,1129,98,1148,2277
"Bolivia","Santa Cruz","Andrés Ibáñez","Santa Cruz De La Sierra","COLEGIO SAN MARTIN DE PORRES",235257,1088,30,7593,8681,4828,450,2285,7113
"Bolivia","Santa Cruz","Andrés Ibáñez","Santa Cruz De La Sierra","COLEGIO SAN MARTIN NORTE",235258,580,23,3799,4379,2529,217,1030,3559
"Bolivia","Santa Cruz","Andrés Ibáñez","Santa Cruz De La Sierra","COLEGIO SAN PABLO",235259,232,1,2029,2261,1671,29,328,1999
"Bolivia","Santa Cruz","Andrés Ibáñez","Santa Cruz De La Sierra","COLEGIO SAN SILVESTRE",235260,713,30,4262,4975,2053,119,2060,4113
"Bolivia","Santa Cruz","Andrés Ibáñez","Santa Cruz De La Sierra","COLEGIO SANTA RAFAELA",235261,378,44,2450,2828,1644,66,696,2340
"Bolivia","Santa Cruz","Andrés Ibáñez","Santa Cruz De La Sierra","COLEGIO SECCIONAL MONSEÑOR SANTIESTEVAN",235262,326,9,1516,1842,1195,25,287,1482
"Bolivia","Santa Cruz","Andrés Ibáñez","Santa Cruz De La Sierra","COLEGIO SEFERINO NAMUCARA DON BOSCO",235263,88,1,570,658,532,3,34,566
"Bolivia","Santa Cruz","Andrés Ibáñez","Santa Cruz De La Sierra","COLEGIO SIMON BOLIVAR",235144,745,64,4324,5069,1870,135,2255,4125
"Bolivia","Santa Cruz","Andrés Ibáñez","Santa Cruz De La Sierra","COLEGIO SOCIEDAD DE INGENIEROS",235264,427,8,3497,3924,2745,160,584,3329
"Bolivia","Santa Cruz","Andrés Ibáñez","Santa Cruz De La Sierra","COLEGIO SOR MARIA CRISTINA PEREZ",235265,1026,27,7718,8744,6347,174,1170,7517
"Bolivia","Santa Cruz","Andrés Ibáñez","Santa Cruz De La Sierra","COLEGIO TECNOLOGICO SANTA CRUZ",235266,192,8,1437,1629,1227,17,185,1412
"Bolivia","Santa Cruz","Andrés Ibáñez","Santa Cruz De La Sierra","COLEGIO TOKIO",235145,273,2,1112,1385,708,25,377,1085
"Bolivia","Santa Cruz","Andrés Ibáñez","Santa Cruz De La Sierra","COLEGIO TRISTAN ROCA",235267,376,11,2502,2878,1972,52,467,2439
"Bolivia","Santa Cruz","Andrés Ibáñez","Santa Cruz De La Sierra","COLEGIO UNIDAD EDUCATIVA 23 DE DICIEMBRE (J. CARLOS TRUJI",235268,847,40,4357,5204,3046,95,1176,4222
"Bolivia","Santa Cruz","Andrés Ibáñez","Santa Cruz De La Sierra","COLEGIO UNIDAD EDUCATIVA 26 DE SEPTIEMBRE",235269,994,45,5166,6160,2338,118,2665,5003
"Bolivia","Santa Cruz","Andrés Ibáñez","Santa Cruz De La Sierra","COLEGIO UNIDAD EDUCATIVA ALFREDO BARBERY CHAVEZ",235270,1039,47,6218,7257,3563,368,2240,5803
"Bolivia","Santa Cruz","Andrés Ibáñez","Santa Cruz De La Sierra","COLEGIO UNIDAD EDUCATIVA CARLOS LA TORRE",235271,515,47,3281,3796,2362,146,726,3088
"Bolivia","Santa Cruz","Andrés Ibáñez","Santa Cruz De La Sierra","COLEGIO UNIDAD EDUCATIVA EL DORADO NORTE",235272,1662,45,8177,9839,4100,353,3679,7779
"Bolivia","Santa Cruz","Andrés Ibáñez","Santa Cruz De La Sierra","COLEGIO UNIDAD EDUCATIVA EL RETOÑO",235273,1068,34,5500,6568,3218,183,2065,5283
"Bolivia","Santa Cruz","Andrés Ibáñez","Santa Cruz De La Sierra","COLEGIO UNIDAD EDUCATIVA ESCUELA ÑUFLO DE CHAVEZ",235274,284,6,2043,2327,1766,43,228,1994
"Bolivia","Santa Cruz","Andrés Ibáñez","Santa Cruz De La Sierra","COLEGIO UNIDAD EDUCATIVA ESPAÑA",235277,401,41,3081,3482,1827,141,1072,2899
"Bolivia","Santa Cruz","Andrés Ibáñez","Santa Cruz De La Sierra","COLEGIO UNIDAD EDUCATIVA LA COLINA",235278,705,25,4472,5177,2993,165,1289,4282
"Bolivia","Santa Cruz","Andrés Ibáñez","Santa Cruz De La Sierra","COLEGIO UNIDAD EDUCATIVA LA RESURECCION -ESCUELA CONVIF",235275,189,4,1609,1798,1478,10,117,1595
"Bolivia","Santa Cruz","Andrés Ibáñez","Santa Cruz De La Sierra","COLEGIO UNIDAD EDUCATIVA LORENZO CABALLERO",235279,241,8,1776,2017,1354,74,340,1694
"Bolivia","Santa Cruz","Andrés Ibáñez","Santa Cruz De La Sierra","COLEGIO UNIDAD EDUCATIVA NUEVO HORIZONTE",235276,541,15,3152,3693,1403,265,1469,2872
"Bolivia","Santa Cruz","Andrés Ibáñez","Santa Cruz De La Sierra","COLEGIO UNIDAD EDUCATIVA SAN JORGE",235280,853,25,5194,6047,1655,299,3215,4870
"Bolivia","Santa Cruz","Andrés Ibáñez","Santa Cruz De La Sierra","COLEGIO UV. LA MADRE",235281,739,24,5166,5905,3851,183,1108,4959
"Bolivia","Santa Cruz","Andrés Ibáñez","Santa Cruz De La Sierra","COLEGIO VENANCIO AQUINO VILLEGAS",235282,176,1,1415,1591,1231,21,162,1393
"Bolivia","Santa Cruz","Andrés Ibáñez","Santa Cruz De La Sierra","COLEGIO VICTOR PAZ ESTENSORO",235283,729,26,4631,5360,2955,167,1483,4438
"Bolivia","Santa Cruz","Andrés Ibáñez","Santa Cruz De La Sierra","COLEGIO VILLA ALEGRE",235284,345,11,2083,2428,659,99,1314,1973
"Bolivia","Santa Cruz","Andrés Ibáñez","Santa Cruz De La Sierra","COLEGIO VILLA BOLIVIA",235285,746,17,3594,4340,2670,144,763,3433
"Bolivia","Santa Cruz","Andrés Ibáñez","Santa Cruz De La Sierra","COLEGIO VILLA FATIMA",235286,719,27,4231,4950,2904,118,1182,4086
"Bolivia","Santa Cruz","Andrés Ibáñez","Santa Cruz De La Sierra","COLEGIO VILLA GLADYS THEVENETH",235146,709,42,4643,5352,1923,222,2456,4379
"Bolivia","Santa Cruz","Andrés Ibáñez","Santa Cruz De La Sierra","COLEGIO VILLA ROSARIO",235287,787,24,3893,4680,2047,122,1700,3747
"Bolivia","Santa Cruz","Andrés Ibáñez","Santa Cruz De La Sierra","COLEGIO VIRGEN DE COTOCA",235288,463,14,3401,3864,2656,37,694,3350
"Bolivia","Santa Cruz","Andrés Ibáñez","Santa Cruz De La Sierra","COLEGIO WENSESLAO MONTERO",235289,370,12,2532,2902,2121,53,346,2467
"Bolivia","Santa Cruz","Andrés Ibáñez","Santa Cruz De La Sierra","ESCUELA 1RO DE MAYO",235305,226,7,1399,1625,1031,62,299,1330
"Bolivia","Santa Cruz","Andrés Ibáñez","Santa Cruz De La Sierra","ESCUELA 23 DE MARZO",235306,544,17,2990,3534,1885,104,984,2869
"Bolivia","Santa Cruz","Andrés Ibáñez","Santa Cruz De La Sierra","ESCUELA ADOLFO ROMAN HIJO",235307,180,9,1323,1503,805,61,448,1253
"Bolivia","Santa Cruz","Andrés Ibáñez","Santa Cruz De La Sierra","ESCUELA APONTE TINEO (ESCUELA GREGORIO MORENO)",235290,245,3,1632,1877,1412,54,163,1575
"Bolivia","Santa Cruz","Andrés Ibáñez","Santa Cruz De La Sierra","ESCUELA BERNARDO CADARIO (COLEGIO KURT RICHTER)",235291,537,11,2828,3365,2099,70,648,2747
"Bolivia","Santa Cruz","Andrés Ibáñez","Santa Cruz De La Sierra","ESCUELA CANOTO",235308,162,3,1077,1239,867,14,193,1060
"Bolivia","Santa Cruz","Andrés Ibáñez","Santa Cruz De La Sierra","ESCUELA CLARACUTA",235292,342,10,2088,2430,1626,49,403,2029
"Bolivia","Santa Cruz","Andrés Ibáñez","Santa Cruz De La Sierra","ESCUELA GABRIEL JOSE MORENO",235293,170,32,1584,1754,1141,42,369,1510
"Bolivia","Santa Cruz","Andrés Ibáñez","Santa Cruz De La Sierra","ESCUELA GERMAN BUSCH",235294,401,6,2476,2877,1995,55,420,2415
"Bolivia","Santa Cruz","Andrés Ibáñez","Santa Cruz De La Sierra","ESCUELA HUGO BANZER SUAREZ",235295,164,10,1245,1409,597,29,609,1206
"Bolivia","Santa Cruz","Andrés Ibáñez","Santa Cruz De La Sierra","ESCUELA JOSE MARIANO SERRANO",235296,212,3,1279,1491,1103,12,161,1264
"Bolivia","Santa Cruz","Andrés Ibáñez","Santa Cruz De La Sierra","ESCUELA KM 9",235309,574,11,3766,4340,2661,110,984,3645
"Bolivia","Santa Cruz","Andrés Ibáñez","Santa Cruz De La Sierra","ESCUELA LA PEÑA",235297,138,12,741,879,95,28,606,701
"Bolivia","Santa Cruz","Andrés Ibáñez","Santa Cruz De La Sierra","ESCUELA LOS SAUCES I",235298,408,10,2328,2736,1633,63,622,2255
"Bolivia","Santa Cruz","Andrés Ibáñez","Santa Cruz De La Sierra","ESCUELA MAMERTO CUELLAR COSTA",235299,246,9,1758,2004,1254,46,449,1703
"Bolivia","Santa Cruz","Andrés Ibáñez","Santa Cruz De La Sierra","ESCUELA NORMAL ENRIQUET FINOT",235300,709,2,3948,4657,3621,20,305,3926
"Bolivia","Santa Cruz","Andrés Ibáñez","Santa Cruz De La Sierra","ESCUELA NUEVA AURORA",235310,40,0,63,103,48,3,12,60
"Bolivia","Santa Cruz","Andrés Ibáñez","Santa Cruz De La Sierra","ESCUELA PRIMAVERA",235311,121,7,508,629,337,11,153,490
"Bolivia","Santa Cruz","Andrés Ibáñez","Santa Cruz De La Sierra","ESCUELA REAL AMERICA (ESCUELA F.FLORIDA)",235301,237,4,1785,2022,1336,27,418,1754
"Bolivia","Santa Cruz","Andrés Ibáñez","Santa Cruz De La Sierra","ESCUELA RENE BARRIENTOS",235302,590,10,3093,3683,2349,44,690,3039
"Bolivia","Santa Cruz","Andrés Ibáñez","Santa Cruz De La Sierra","ESCUELA SAN CARLOS",235312,467,7,2738,3205,2256,39,436,2692
"Bolivia","Santa Cruz","Andrés Ibáñez","Santa Cruz De La Sierra","ESCUELA SAN JOAQUIN",235313,354,15,2179,2533,1317,129,718,2035
"Bolivia","Santa Cruz","Andrés Ibáñez","Santa Cruz De La Sierra","ESCUELA SECCIONAL GUAPILO",235314,401,16,2227,2628,1374,81,756,2130
"Bolivia","Santa Cruz","Andrés Ibáñez","Santa Cruz De La Sierra","ESCUELA SECCIONAL VILLA FLOR",235303,92,11,643,735,324,20,288,612
"Bolivia","Santa Cruz","Andrés Ibáñez","Santa Cruz De La Sierra","ESCUELA SECCIONAL ZAFRANILLA",235315,43,2,314,357,199,9,104,303
"Bolivia","Santa Cruz","Andrés Ibáñez","Santa Cruz De La Sierra","ESCUELA SOLIDARIDAD 55",235304,644,32,4023,4667,1800,199,1992,3792
"Bolivia","Santa Cruz","Andrés Ibáñez","Santa Cruz De La Sierra","ESCUELA USURI APONTE",235316,60,2,218,278,132,7,77,209
"Bolivia","Santa Cruz","Andrés Ibáñez","Santa Cruz De La Sierra","ESCUELA VILLA NORTE",235317,265,5,1467,1732,1193,13,256,1449
"Bolivia","Santa Cruz","Andrés Ibáñez","Santa Cruz De La Sierra","ESCUELA ZENOVIA APONTE",235318,277,11,1687,1964,782,39,855,1637
"Bolivia","Santa Cruz","Andrés Ibáñez","Santa Cruz De La Sierra","FACULTAD DE CIENCIAS AGRICOLAS UAGRM",235319,22,2,303,325,207,8,86,293
"Bolivia","Santa Cruz","Andrés Ibáñez","Santa Cruz De La Sierra","FRED NUÑEZ GONZALES",235320,88,9,1011,1099,453,26,523,976
"Bolivia","Santa Cruz","Andrés Ibáñez","Santa Cruz De La Sierra","GLADYS RIVERO DE JIMENEZ",235321,469,14,3062,3531,2000,229,819,2819
"Bolivia","Santa Cruz","Andrés Ibáñez","Santa Cruz De La Sierra","KINDER CARIÑOSITO",235322,1,0,3,4,2,0,1,3
"Bolivia","Santa Cruz","Andrés Ibáñez","Santa Cruz De La Sierra","KINDER FERROVIARIO",235323,2,0,19,21,12,0,7,19
"Bolivia","Santa Cruz","Andrés Ibáñez","Santa Cruz De La Sierra","KINDER GUARDERIA EL CARMEN",235324,1,1,48,49,39,2,6,45
"Bolivia","Santa Cruz","Andrés Ibáñez","Santa Cruz De La Sierra","KINDER LIBERTAD",235325,0,0,9,9,7,1,1,8
"Bolivia","Santa Cruz","Andrés Ibáñez","Santa Cruz De La Sierra","KINDER LUISA SAUCEDO",235326,103,0,758,861,677,5,76,753
"Bolivia","Santa Cruz","Andrés Ibáñez","Santa Cruz De La Sierra","KINDER NIMIA CENTELLA",235327,0,0,45,45,31,10,4,35
"Bolivia","Santa Cruz","Andrés Ibáñez","Santa Cruz De La Sierra","LUZ DEL MUNDO C",235328,10,0,142,152,98,0,44,142
"Bolivia","Santa Cruz","Andrés Ibáñez","Santa Cruz De La Sierra","MISIONES DE JESUS",235329,0,1,285,285,130,53,101,231
"Bolivia","Santa Cruz","Andrés Ibáñez","Santa Cruz De La Sierra","MODULO EDUCATIVO 24 DE SEPTIEMBRE",235330,28,1,110,138,73,4,32,105
"Bolivia","Santa Cruz","Andrés Ibáñez","Santa Cruz De La Sierra","MODULO EDUCATIVO 3 LAGUNAS",235331,286,14,1915,2201,1082,40,779,1861
"Bolivia","Santa Cruz","Andrés Ibáñez","Santa Cruz De La Sierra","MODULO EDUCATIVO CENETROP",235332,6,0,53,59,32,1,20,52
"Bolivia","Santa Cruz","Andrés Ibáñez","Santa Cruz De La Sierra","MODULO EDUCATIVO GERMAN BUSCH",235333,13,2,151,164,126,2,21,147
"Bolivia","Santa Cruz","Andrés Ibáñez","Santa Cruz De La Sierra","MODULO EDUCATIVO JARDIN LATINO",235334,0,0,65,65,52,3,10,62
"Bolivia","Santa Cruz","Andrés Ibáñez","Santa Cruz De La Sierra","MODULO EDUCATIVO JOSE MIGUEL DE VELASCO",235335,703,54,4506,5209,3568,115,769,4337
"Bolivia","Santa Cruz","Andrés Ibáñez","Santa Cruz De La Sierra","MODULO EDUCATIVO MARIA DE MATTIAS",235336,5,0,79,84,57,1,21,78
"Bolivia","Santa Cruz","Andrés Ibáñez","Santa Cruz De La Sierra","MODULO EDUCATIVO REPUBLICA DE COLOMBIA",235337,18,4,196,214,84,0,108,192
"Bolivia","Santa Cruz","Andrés Ibáñez","Santa Cruz De La Sierra","MODULO RANCHO NUEVO",235338,256,9,1188,1444,735,28,416,1151
"Bolivia","Santa Cruz","Andrés Ibáñez","Santa Cruz De La Sierra","MOTACUSAL",235339,0,1,176,176,14,46,115,129
"Bolivia","Santa Cruz","Andrés Ibáñez","Santa Cruz De La Sierra","NACIONES UNIDAS",235340,532,11,3355,3887,2418,150,776,3194
"Bolivia","Santa Cruz","Andrés Ibáñez","Santa Cruz De La Sierra","PEDRO DIEZ",235341,31,0,133,164,83,2,48,131
"Bolivia","Santa Cruz","Andrés Ibáñez","Santa Cruz De La Sierra","PROGRESO",235342,27,1,147,174,99,4,43,142
"Bolivia","Santa Cruz","Andrés Ibáñez","Santa Cruz De La Sierra","SAHARA GUARDIA",235343,35,7,616,651,413,32,164,577
"Bolivia","Santa Cruz","Andrés Ibáñez","Santa Cruz De La Sierra","UNIDAD EDUCATIVA 18 DE JULIO",235344,149,7,1028,1177,520,59,442,962
"Bolivia","Santa Cruz","Andrés Ibáñez","Santa Cruz De La Sierra","UNIDAD EDUCATIVA 19 DE MARZO",235345,16,1,294,310,91,1,201,292
"Bolivia","Santa Cruz","Andrés Ibáñez","Santa Cruz De La Sierra","UNIDAD EDUCATIVA 24 DE MARZO",235346,16,1,153,169,51,6,95,146
"Bolivia","Santa Cruz","Andrés Ibáñez","Santa Cruz De La Sierra","UNIDAD EDUCATIVA 25 DE OCTUBRE",235347,29,1,294,323,117,38,138,255
"Bolivia","Santa Cruz","Andrés Ibáñez","Santa Cruz De La Sierra","UNIDAD EDUCATIVA 26 DE JUNIO",235348,37,2,245,282,100,9,134,234
"Bolivia","Santa Cruz","Andrés Ibáñez","Santa Cruz De La Sierra","UNIDAD EDUCATIVA 26 DE NOVIEMBRE",235349,9,0,91,100,62,1,28,90
"Bolivia","Santa Cruz","Andrés Ibáñez","Santa Cruz De La Sierra","UNIDAD EDUCATIVA 2 DE ABRIL",235350,17,1,111,128,86,3,21,107
"Bolivia","Santa Cruz","Andrés Ibáñez","Santa Cruz De La Sierra","UNIDAD EDUCATIVA 3 DE MAYO",235351,95,7,635,730,284,19,325,609
"Bolivia","Santa Cruz","Andrés Ibáñez","Santa Cruz De La Sierra","UNIDAD EDUCATIVA APONTE DE JORORI",235352,122,15,709,831,249,40,405,654
"Bolivia","Santa Cruz","Andrés Ibáñez","Santa Cruz De La Sierra","UNIDAD EDUCATIVA ARBOLEDA DE FATIMA",235353,60,7,638,698,386,63,182,568
"Bolivia","Santa Cruz","Andrés Ibáñez","Santa Cruz De La Sierra","UNIDAD EDUCATIVA ARCA DE NOE",235354,0,39,1073,1073,561,123,350,911
"Bolivia","Santa Cruz","Andrés Ibáñez","Santa Cruz De La Sierra","UNIDAD EDUCATIVA BIBOSI",235355,16,1,109,125,53,2,53,106
"Bolivia","Santa Cruz","Andrés Ibáñez","Santa Cruz De La Sierra","UNIDAD EDUCATIVA CIELITO LINDO",235356,97,39,1192,1289,746,61,346,1092
"Bolivia","Santa Cruz","Andrés Ibáñez","Santa Cruz De La Sierra","UNIDAD EDUCATIVA CLARA SERRANO",235357,10,2,136,146,66,0,68,134
"Bolivia","Santa Cruz","Andrés Ibáñez","Santa Cruz De La Sierra","UNIDAD EDUCATIVA DOMINGO FAUSTINO",235358,203,11,1367,1570,1142,21,193,1335
"Bolivia","Santa Cruz","Andrés Ibáñez","Santa Cruz De La Sierra","UNIDAD EDUCATIVA EL ARENAL C",235359,0,3,29,29,10,0,16,26
"Bolivia","Santa Cruz","Andrés Ibáñez","Santa Cruz De La Sierra","UNIDAD EDUCATIVA HACIA LA CUMBRE",235360,15,0,67,82,52,0,15,67
"Bolivia","Santa Cruz","Andrés Ibáñez","Santa Cruz De La Sierra","UNIDAD EDUCATIVA ISUTO",235361,77,1,524,601,385,16,122,507
"Bolivia","Santa Cruz","Andrés Ibáñez","Santa Cruz De La Sierra","UNIDAD EDUCATIVA JOSEFINA BALSAMO CORDECRUZ",235362,2,0,25,27,20,2,3,23
"Bolivia","Santa Cruz","Andrés Ibáñez","Santa Cruz De La Sierra","UNIDAD EDUCATIVA JOSEFINA BALSAMO LOS PINOS",235363,10,3,107,117,67,0,37,104
"Bolivia","Santa Cruz","Andrés Ibáñez","Santa Cruz De La Sierra","UNIDAD EDUCATIVA LOS CUSIS",235364,106,9,849,955,516,58,266,782
"Bolivia","Santa Cruz","Andrés Ibáñez","Santa Cruz De La Sierra","UNIDAD EDUCATIVA LUIS ANTONIO AÑEZ CAMPOS",235365,18,0,117,135,49,4,64,113
"Bolivia","Santa Cruz","Andrés Ibáñez","Santa Cruz De La Sierra","UNIDAD EDUCATIVA MANANTIAL DE VIDA",235366,64,8,804,868,307,17,472,779
"Bolivia","Santa Cruz","Andrés Ibáñez","Santa Cruz De La Sierra","UNIDAD EDUCATIVA MANOS UNIDAS",235367,6,0,30,36,13,1,16,29
"Bolivia","Santa Cruz","Andrés Ibáñez","Santa Cruz De La Sierra","UNIDAD EDUCATIVA MARIA DE LAS CANDELARIAS",235368,0,0,3,3,3,0,0,3
"Bolivia","Santa Cruz","Andrés Ibáñez","Santa Cruz De La Sierra","UNIDAD EDUCATIVA MATEO KULJIS LLIC II",235369,19,2,65,84,35,3,25,60
"Bolivia","Santa Cruz","Andrés Ibáñez","Santa Cruz De La Sierra","UNIDAD EDUCATIVA MIGUEL APONTE",235370,1,0,3,4,3,0,0,3
"Bolivia","Santa Cruz","Andrés Ibáñez","Santa Cruz De La Sierra","UNIDAD EDUCATIVA NESTOR PAZ ZAMORA",235371,35,5,249,284,157,2,85,242
"Bolivia","Santa Cruz","Andrés Ibáñez","Santa Cruz De La Sierra","UNIDAD EDUCATIVA PALMAR DEL ORIENTE",235372,0,0,38,38,23,4,11,34
"Bolivia","Santa Cruz","Andrés Ibáñez","Santa Cruz De La Sierra","UNIDAD EDUCATIVA PASTORCITO DE FÁTIMA (DON BOSCO)",235373,5,0,32,37,27,0,5,32
"Bolivia","Santa Cruz","Andrés Ibáñez","Santa Cruz De La Sierra","UNIDAD EDUCATIVA POMPEYA SANTISIMO REDENTOR",235392,1180,25,6120,7300,3745,175,2175,5920
"Bolivia","Santa Cruz","Andrés Ibáñez","Santa Cruz De La Sierra","UNIDAD EDUCATIVA REP. DEL PARAGUAY",235374,9,0,74,83,38,6,30,68
"Bolivia","Santa Cruz","Andrés Ibáñez","Santa Cruz De La Sierra","UNIDAD EDUCATIVA SAN CAYETANO",235375,122,9,946,1068,529,14,394,923
"Bolivia","Santa Cruz","Andrés Ibáñez","Santa Cruz De La Sierra","UNIDAD EDUCATIVA SAN DIEGO DE SAMARIA",235376,39,0,237,276,99,3,135,234
"Bolivia","Santa Cruz","Andrés Ibáñez","Santa Cruz De La Sierra","UNIDAD EDUCATIVA SAN JORGE NORTE",235393,366,6,2032,2398,1567,47,412,1979
"Bolivia","Santa Cruz","Andrés Ibáñez","Santa Cruz De La Sierra","UNIDAD EDUCATIVA SAN JUAN",235394,101,5,661,762,458,19,179,637
"Bolivia","Santa Cruz","Andrés Ibáñez","Santa Cruz De La Sierra","UNIDAD EDUCATIVA SAN JUAN BAUTISTA",235377,27,2,323,350,143,9,169,312
"Bolivia","Santa Cruz","Andrés Ibáñez","Santa Cruz De La Sierra","UNIDAD EDUCATIVA SAN JUAN DEL ESTE",235378,15,1,80,95,36,2,41,77
"Bolivia","Santa Cruz","Andrés Ibáñez","Santa Cruz De La Sierra","UNIDAD EDUCATIVA SAN MIGUEL APONTE",235379,4,6,133,137,73,2,52,125
"Bolivia","Santa Cruz","Andrés Ibáñez","Santa Cruz De La Sierra","UNIDAD EDUCATIVA SANTA ANA C",235380,19,0,118,137,66,2,50,116
"Bolivia","Santa Cruz","Andrés Ibáñez","Santa Cruz De La Sierra","UNIDAD EDUCATIVA SANTA CRUZ DE LA SIERRA",235381,415,6,3367,3782,2847,58,456,3303
"Bolivia","Santa Cruz","Andrés Ibáñez","Santa Cruz De La Sierra","UNIDAD EDUCATIVA SEÑOR DE LOS MILAGROS",235382,0,0,124,124,69,12,43,112
"Bolivia","Santa Cruz","Andrés Ibáñez","Santa Cruz De La Sierra","UNIDAD EDUCATIVA SIXTO SUAREZ NAVARRO",235384,23,7,321,344,119,8,187,306
"Bolivia","Santa Cruz","Andrés Ibáñez","Santa Cruz De La Sierra","UNIDAD EDUCATIVA SIXTO SUAREZ NAVARRO",235383,23,7,321,344,119,8,187,306
"Bolivia","Santa Cruz","Andrés Ibáñez","Santa Cruz De La Sierra","UNIDAD EDUCATIVA THEVENET DE VIANA",235385,17,7,275,292,122,5,141,263
"Bolivia","Santa Cruz","Andrés Ibáñez","Santa Cruz De La Sierra","UNIDAD EDUCATIVA UNION Y PROGRESO",235386,633,27,3331,3964,1659,127,1518,3177
"Bolivia","Santa Cruz","Andrés Ibáñez","Santa Cruz De La Sierra","UNIDAD EDUCATIVA VICTORIA",235387,35,1,113,148,55,1,56,111
"Bolivia","Santa Cruz","Andrés Ibáñez","Santa Cruz De La Sierra","UNIDAD EDUCATIVA VICTORIA DIEZ",235388,2,0,37,39,21,5,11,32
"Bolivia","Santa Cruz","Andrés Ibáñez","Santa Cruz De La Sierra","UNIDAD EDUCATIVA VILLA ALBA",235389,4,1,12,16,7,0,4,11
"Bolivia","Santa Cruz","Andrés Ibáñez","Santa Cruz De La Sierra","UNIDAD EDUCATIVA VILLA MODERNA",235390,59,10,444,503,158,7,269,427
"Bolivia","Santa Cruz","Andrés Ibáñez","Santa Cruz De La Sierra","UNIDAD EDUCATIVA ZARAGOZA",235391,71,5,839,910,460,27,347,807
"Bolivia","Santa Cruz","Andrés Ibáñez","Santa Cruz De La Sierra","UNIVERSITARIO SUR",235395,11,2,203,214,138,10,53,191
"Bolivia","Santa Cruz","Andrés Ibáñez","Santa Cruz De La Sierra","URKUPIÑA",235396,39,51,579,618,278,20,230,508
"Bolivia","Santa Cruz","Andrés Ibáñez","Santa Cruz De La Sierra","VIRGEN DE GUADALUPE",235397,178,21,1962,2140,1155,89,697,1852
"Bolivia","Santa Cruz","Ángel Sandoval","San Matías","ESCUELA BENJAMIN CATACORA",232445,104,6,544,648,294,40,204,498
"Bolivia","Santa Cruz","Ángel Sandoval","San Matías","ESCUELA LAS PETAS",232446,94,4,318,412,206,3,105,311
"Bolivia","Santa Cruz","Ángel Sandoval","San Matías","ESCUELA SAN FERNANDO",232447,29,0,41,70,32,0,9,41
"Bolivia","Santa Cruz","Ángel Sandoval","San Matías","ESCUELA SANTA ISABEL",232448,15,0,96,111,24,1,71,95
"Bolivia","Santa Cruz","Ángel Sandoval","San Matías","ESCUELA SANTO CORAZON",232449,65,1,218,283,144,3,70,214
"Bolivia","Santa Cruz","Ángel Sandoval","San Matías","ESCUELA SECCIONAL CANDELARIA",232450,92,1,259,351,132,5,121,253
"Bolivia","Santa Cruz","Ángel Sandoval","San Matías","ESCUELA UNIDAD EDUCATIVA EMILIA RODAT",232451,635,77,2354,2989,1139,27,1111,2250
"Bolivia","Santa Cruz","Ángel Sandoval","San Matías","ESCUELA UNIDAD EDUCATIVA TECNICA VOCACIONAL",232452,559,83,1882,2441,855,36,908,1763
"Bolivia","Santa Cruz","Chiquitos","Pailón","ESCUELA 25 DE MAYO (CHIQUITOS)",233304,7,2,97,104,18,4,73,91
"Bolivia","Santa Cruz","Chiquitos","Pailón","ESCUELA 3 DE MAYO",233305,240,24,1005,1245,435,32,514,949
"Bolivia","Santa Cruz","Chiquitos","Pailón","ESCUELA EL TINTO",233306,41,1,104,145,58,2,43,101
"Bolivia","Santa Cruz","Chiquitos","Pailón","ESCUELA EMILIO SUNCER SALINAS",233307,99,4,358,457,159,6,189,348
"Bolivia","Santa Cruz","Chiquitos","Pailón","ESCUELA FE ALEGRIA",233308,1615,81,7072,8687,4100,231,2660,6760
"Bolivia","Santa Cruz","Chiquitos","Pailón","ESCUELA MUNICIPAL ROSAL CENTRO",233309,80,3,517,597,281,14,219,500
"Bolivia","Santa Cruz","Chiquitos","Pailón","ESCUELA POZA VERDE",233310,18,0,93,111,17,3,73,90
"Bolivia","Santa Cruz","Chiquitos","Pailón","ESCUELA PUESTO PAZ",233311,0,2,75,75,20,15,38,58
"Bolivia","Santa Cruz","Chiquitos","Pailón","ESCUELA SECCIONAL CAÑADA LARGA",233312,57,2,278,335,167,2,107,274
"Bolivia","Santa Cruz","Chiquitos","Pailón","ESCUELA TUNAS NUEVO",233313,195,9,605,800,105,8,483,588
"Bolivia","Santa Cruz","Chiquitos","Pailón","UNIDAD EDUCATIVA 12 DE OCTUBRE",233314,0,1,39,39,26,0,12,38
"Bolivia","Santa Cruz","Chiquitos","Pailón","UNIDAD EDUCATIVA ING. JORGE MAURICIO ROJAS P.",233315,9,3,129,138,85,4,37,122
"Bolivia","Santa Cruz","Chiquitos","Roboré","ESCUELA DON BOSCO",233316,506,10,1459,1965,962,17,470,1432
"Bolivia","Santa Cruz","Chiquitos","Roboré","ESCUELA GUIDO OSWALDO SUANZO",233317,343,17,1223,1566,824,15,367,1191
"Bolivia","Santa Cruz","Chiquitos","Roboré","ESCUELA LOS SOTOS",233318,19,0,90,109,38,1,51,89
"Bolivia","Santa Cruz","Chiquitos","Roboré","ESCUELA MARISTA",233319,455,11,1400,1855,909,18,462,1371
"Bolivia","Santa Cruz","Chiquitos","Roboré","ESCUELA NAPOLEON MONTERO MONTERO",233320,176,7,616,792,463,5,141,604
"Bolivia","Santa Cruz","Chiquitos","Roboré","ESCUELA SAGRADA FAMILIA",233321,484,17,1757,2241,1185,43,512,1697
"Bolivia","Santa Cruz","Chiquitos","Roboré","ESCUELA SAN ANTONIO DEL POTRERO",233322,8,1,45,53,13,1,30,43
"Bolivia","Santa Cruz","Chiquitos","Roboré","ESCUELA SECCIONAL AGUAS CALIENTES",233323,55,5,346,401,108,12,221,329
"Bolivia","Santa Cruz","Chiquitos","Roboré","ESCUELA SECCIONAL CHOCHIS",233324,94,3,453,547,350,8,92,442
"Bolivia","Santa Cruz","Chiquitos","San José","ESCUELA EDUCACIONAL TAPERAS",233294,113,6,445,558,267,8,164,431
"Bolivia","Santa Cruz","Chiquitos","San José","ESCUELA GERMAN BUSCH",233295,794,15,2574,3368,1633,53,873,2506
"Bolivia","Santa Cruz","Chiquitos","San José","ESCUELA LEONOR RIVERA",233296,673,19,2279,2952,1367,33,860,2227
"Bolivia","Santa Cruz","Chiquitos","San José","ESCUELA MUNICIPAL",233297,29,1,233,262,140,4,88,228
"Bolivia","Santa Cruz","Chiquitos","San José","ESCUELA NUEVO HORIZONTE",233298,0,15,75,75,40,0,20,60
"Bolivia","Santa Cruz","Chiquitos","San José","ESCUELA SAN JUAN",233299,129,6,304,433,169,1,128,297
"Bolivia","Santa Cruz","Chiquitos","San José","ESCUELA SANTA TERESITA",233300,0,0,13,13,0,0,13,13
"Bolivia","Santa Cruz","Chiquitos","San José","ESCUELA UNZAGA DE LA VEGA",233301,603,63,2603,3206,1663,52,825,2488
"Bolivia","Santa Cruz","Chiquitos","San José","UNIDAD EDUCATIVA BUENA VISTA",233302,12,2,166,178,98,3,63,161
"Bolivia","Santa Cruz","Chiquitos","San José","UNIDAD EDUCATIVA RAMADA",233303,2,1,41,43,22,1,17,39
"Bolivia","Santa Cruz","Cordillera","Boyuibe","ESCUELA CENTRAL RAFAEL PABON",236177,615,20,1770,2385,806,55,889,1695
"Bolivia","Santa Cruz","Cordillera","Boyuibe","ESCUELA SECC. CHOROQUETAL LA ELE",236178,11,0,13,24,8,0,5,13
"Bolivia","Santa Cruz","Cordillera","Boyuibe","ESCUELA SECC. POZO DE MONTE",236179,0,1,85,85,25,13,46,71
"Bolivia","Santa Cruz","Cordillera","Cabezas","ESCUELA 12 DE ABRIL",236084,296,37,1584,1880,796,61,690,1486
"Bolivia","Santa Cruz","Cordillera","Cabezas","ESCUELA COTOCA (CORDILLERA)",236085,10,1,82,92,65,1,15,80
"Bolivia","Santa Cruz","Cordillera","Cabezas","ESCUELA EDUARDO ABAROA",236086,20,2,178,198,77,25,74,151
"Bolivia","Santa Cruz","Cordillera","Cabezas","ESCUELA PAMPA DEL COSCAL",236087,48,2,226,274,68,10,146,214
"Bolivia","Santa Cruz","Cordillera","Cabezas","ESCUELA PTO. CAMACHO",236088,301,26,1630,1931,899,68,637,1536
"Bolivia","Santa Cruz","Cordillera","Cabezas","ESCUELA RIO SECO FLORIDA",236089,93,3,413,506,207,28,175,382
"Bolivia","Santa Cruz","Cordillera","Cabezas","ESCUELA SANTA ROSA",236090,30,3,145,175,74,1,67,141
"Bolivia","Santa Cruz","Cordillera","Cabezas","ESCUELA SECC. EL CURICHI",236091,15,0,105,120,68,6,31,99
"Bolivia","Santa Cruz","Cordillera","Cabezas","ESCUELA SECCIONAL EL FILO",236092,0,1,22,22,20,0,1,21
"Bolivia","Santa Cruz","Cordillera","Cabezas","ESCUELA SECCIONAL PUEBLO VIEJO",236093,66,8,221,287,116,2,95,211
"Bolivia","Santa Cruz","Cordillera","Cabezas","ESCUELA SECC SAN FRANCISCO DE ASIS",236094,75,8,297,372,97,11,181,278
"Bolivia","Santa Cruz","Cordillera","Cabezas","ESCUELA SERAFIN RODRIGUEZ",236095,419,19,1402,1821,760,94,529,1289
"Bolivia","Santa Cruz","Cordillera","Cabezas","ESCUELA YATIRENDA",236096,11,3,196,207,147,4,42,189
"Bolivia","Santa Cruz","Cordillera","Cabezas","ESCUELA ZANJA HONDA",236097,219,23,1238,1457,611,41,563,1174
"Bolivia","Santa Cruz","Cordillera","Camiri","AULAS U.A.G.R.M.",236105,635,37,2928,3563,1600,107,1184,2784
"Bolivia","Santa Cruz","Cordillera","Camiri","COLEGIO HUGO ARTEAGA",236106,214,14,968,1182,600,25,329,929
"Bolivia","Santa Cruz","Cordillera","Camiri","ESCUELA 12 DE JULIO",236107,431,27,2244,2675,1228,122,867,2095
"Bolivia","Santa Cruz","Cordillera","Camiri","ESCUELA 16 DE MARZO",236108,254,22,1233,1487,640,50,521,1161
"Bolivia","Santa Cruz","Cordillera","Camiri","ESCUELA 24 DE SEPTIEMBRE",236109,370,17,1891,2261,1173,60,641,1814
"Bolivia","Santa Cruz","Cordillera","Camiri","ESCUELA ABEL ITURRALDE",236110,309,11,1455,1764,906,35,503,1409
"Bolivia","Santa Cruz","Cordillera","Camiri","ESCUELA APONTE J. MANUEL O.H. DEL CHACO",236111,240,15,1528,1768,949,36,528,1477
"Bolivia","Santa Cruz","Cordillera","Camiri","ESCUELA CENTRAL DE ITANAMBIKUA",236112,70,15,484,554,109,26,334,443
"Bolivia","Santa Cruz","Cordillera","Camiri","ESCUELA CENTRAL URBANA",236113,231,14,718,949,327,20,357,684
"Bolivia","Santa Cruz","Cordillera","Camiri","ESCUELA CRISTIANA EVANGELICA",236114,153,7,889,1042,590,17,275,865
"Bolivia","Santa Cruz","Cordillera","Camiri","ESCUELA GABRIEL RENE MORENO",236115,393,15,1646,2039,957,42,632,1589
"Bolivia","Santa Cruz","Cordillera","Camiri","ESCUELA JOSE CASTRILLO",236116,301,18,1404,1705,708,42,636,1344
"Bolivia","Santa Cruz","Cordillera","Camiri","ESCUELA NIÑO JESUS",236117,165,7,916,1081,635,21,253,888
"Bolivia","Santa Cruz","Cordillera","Camiri","ESCUELA SECC. CURUNDAITY",236118,39,5,284,323,44,4,231,275
"Bolivia","Santa Cruz","Cordillera","Camiri","ESCUELA SECC. GUIRARAPO",236119,18,2,120,138,41,5,72,113
"Bolivia","Santa Cruz","Cordillera","Camiri","ESCUELA SECC. IMBOCHI",236120,19,9,114,133,36,3,66,102
"Bolivia","Santa Cruz","Cordillera","Camiri","ESCUELA SECCIONAL EL RODEO",236121,31,9,205,236,31,13,152,183
"Bolivia","Santa Cruz","Cordillera","Camiri","ESCUELA SECCIONAL PIPI",236122,37,2,147,184,22,2,121,143
"Bolivia","Santa Cruz","Cordillera","Camiri","ESCUELA SECC. PUENTE VIEJO",236123,36,9,185,221,49,5,122,171
"Bolivia","Santa Cruz","Cordillera","Charagua","ESCUELA 25 DE MAYO",236056,47,0,79,126,12,1,66,78
"Bolivia","Santa Cruz","Cordillera","Charagua","ESCUELA CENTRAL FE Y ALEGRIA",236076,461,28,2212,2673,1281,67,836,2117
"Bolivia","Santa Cruz","Cordillera","Charagua","ESCUELA CENTRAL IYOBI",236057,129,14,596,725,249,13,320,569
"Bolivia","Santa Cruz","Cordillera","Charagua","ESCUELA COOPERE BRECHA",236058,146,6,419,565,105,14,294,399
"Bolivia","Santa Cruz","Cordillera","Charagua","ESCUELA ENRIQUE QUINTELA",236059,116,10,549,665,228,14,297,525
"Bolivia","Santa Cruz","Cordillera","Charagua","ESCUELA ESTACION CHARAGUA",236060,181,15,819,1000,392,22,390,782
"Bolivia","Santa Cruz","Cordillera","Charagua","ESCUELA NUCLEO ESCOLAR LA BRECHA",236061,150,8,547,697,188,10,341,529
"Bolivia","Santa Cruz","Cordillera","Charagua","ESCUELA NUEVA ESPERANZA",236062,53,0,84,137,19,1,64,83
"Bolivia","Santa Cruz","Cordillera","Charagua","ESCUELA OKITA",236063,16,2,72,88,10,0,60,70
"Bolivia","Santa Cruz","Cordillera","Charagua","ESCUELA PUEBLO NUEVO PARAPETI",236064,31,3,163,194,63,8,89,152
"Bolivia","Santa Cruz","Cordillera","Charagua","ESCUELA SECC. CENTRAL MASAVI",236065,63,14,348,411,84,9,241,325
"Bolivia","Santa Cruz","Cordillera","Charagua","ESCUELA SECC. DE KAIPEPE",236066,29,5,264,293,72,7,180,252
"Bolivia","Santa Cruz","Cordillera","Charagua","ESCUELA SECC. EL ESPINO",236067,47,8,394,441,54,8,324,378
"Bolivia","Santa Cruz","Cordillera","Charagua","ESCUELA SECC. HUARIRENDA NUEVA",236068,120,7,310,430,104,6,193,297
"Bolivia","Santa Cruz","Cordillera","Charagua","ESCUELA SECCIONAL ISIPORENDA",236069,49,0,112,161,28,2,82,110
"Bolivia","Santa Cruz","Cordillera","Charagua","ESCUELA SECCIONAL ITATIQUE",236070,11,0,82,93,8,1,73,81
"Bolivia","Santa Cruz","Cordillera","Charagua","ESCUELA SECCIONAL SAIPURU",236077,0,2,132,132,56,27,47,103
"Bolivia","Santa Cruz","Cordillera","Charagua","ESCUELA SECCIONAL SAN F. DE PARAPETI",236071,36,7,144,180,43,2,92,135
"Bolivia","Santa Cruz","Cordillera","Charagua","ESCUELA SECCIONAL SAN LORENZO",236072,19,0,87,106,36,4,47,83
"Bolivia","Santa Cruz","Cordillera","Charagua","ESCUELA SECC. RANCHO NUEVO",236073,117,18,387,504,160,11,198,358
"Bolivia","Santa Cruz","Cordillera","Charagua","ESCUELA SECC. TACOBO",236074,26,7,216,242,50,9,150,200
"Bolivia","Santa Cruz","Cordillera","Charagua","ESCUELA SECC. TAPUTA",236075,0,33,272,272,13,9,217,230
"Bolivia","Santa Cruz","Cordillera","Charagua","UNIDAD EDUCATIVA 24 DE SEPTIEMBRE",236078,1,4,65,66,16,5,40,56
"Bolivia","Santa Cruz","Cordillera","Charagua","UNIDAD EDUCATIVA JOSERAVI",236079,19,0,62,81,36,1,25,61
"Bolivia","Santa Cruz","Cordillera","Charagua","UNIDAD EDUCATIVA JUAN LUIS OTIN",236080,2,2,90,92,37,6,45,82
"Bolivia","Santa Cruz","Cordillera","Charagua","UNIDAD EDUCATIVA MACHIPO",236081,6,8,100,106,36,4,52,88
"Bolivia","Santa Cruz","Cordillera","Charagua","UNIDAD EDUCATIVA PEDRO RAMOS",236082,3,2,121,124,49,2,68,117
"Bolivia","Santa Cruz","Cordillera","Charagua","UNIDAD EDUCATIVA YAPIROA",236083,5,1,185,190,112,5,67,179
"Bolivia","Santa Cruz","Cordillera","Cuevo","ESCUELA SECC. EL ARENAL",236098,0,0,8,8,1,0,7,8
"Bolivia","Santa Cruz","Cordillera","Cuevo","ESCUELA SECC. ITAKUATIA",236099,10,2,64,74,42,3,17,59
"Bolivia","Santa Cruz","Cordillera","Cuevo","ESCUELA UB. ANGEL SANDOVAL",236100,502,20,1218,1720,706,26,466,1172
"Bolivia","Santa Cruz","Cordillera","Cuevo","ESCUELA UNIDAD EDUCATIVA IVICUATI",236101,42,3,144,186,95,0,46,141
"Bolivia","Santa Cruz","Cordillera","Cuevo","ESCUELA UNIDAD SECCIONAL HUARACA",236102,29,2,116,145,83,3,28,111
"Bolivia","Santa Cruz","Cordillera","Cuevo","UNIDAD EDUCATIVA EL ARENAL",236103,9,2,98,107,5,3,88,93
"Bolivia","Santa Cruz","Cordillera","Cuevo","UNIDAD EDUCATIVA SALINAS",236104,16,1,93,109,19,2,71,90
"Bolivia","Santa Cruz","Cordillera","Gutiérrez","ESCUELA CENTRAL IPATIMIRI",232418,85,7,515,600,167,30,311,478
"Bolivia","Santa Cruz","Cordillera","Gutiérrez","ESCUELA EMILIO FINOT",232419,196,10,749,945,446,15,278,724
"Bolivia","Santa Cruz","Cordillera","Gutiérrez","ESCUELA IBAMIRAPINTA",232420,90,18,552,642,185,17,332,517
"Bolivia","Santa Cruz","Cordillera","Gutiérrez","ESCUELA KURUGUAKUA",232421,20,1,107,127,22,1,83,105
"Bolivia","Santa Cruz","Cordillera","Gutiérrez","ESCUELA MARCELINO REVOLLO",232422,92,19,566,658,229,16,302,531
"Bolivia","Santa Cruz","Cordillera","Gutiérrez","ESCUELA MARISCAL SUCRE",232423,67,15,298,365,181,4,98,279
"Bolivia","Santa Cruz","Cordillera","Gutiérrez","ESCUELA MIGUEL LANDIVAR",232424,59,8,348,407,111,21,208,319
"Bolivia","Santa Cruz","Cordillera","Gutiérrez","ESCUELA PALMARITO",232425,69,2,267,336,21,11,233,254
"Bolivia","Santa Cruz","Cordillera","Gutiérrez","ESCUELA SECC. GUASANTI",232426,32,4,243,275,57,7,175,232
"Bolivia","Santa Cruz","Cordillera","Gutiérrez","ESCUELA SECCIONAL CAIPIPENDI",232427,0,5,54,54,11,0,38,49
"Bolivia","Santa Cruz","Cordillera","Gutiérrez","ESCUELA SECCIONAL CAPIRENDA",232428,36,5,225,261,45,10,165,210
"Bolivia","Santa Cruz","Cordillera","Gutiérrez","ESCUELA SECCIONAL ITEMBEGUAZU",232429,33,7,181,214,80,4,90,170
"Bolivia","Santa Cruz","Cordillera","Gutiérrez","ESCUELA SECCIONAL S. MIGUEL POCITO",232430,16,5,126,142,78,3,40,118
"Bolivia","Santa Cruz","Cordillera","Gutiérrez","ESCUELA TATARENDA VIEJA",232431,62,8,339,401,94,18,219,313
"Bolivia","Santa Cruz","Cordillera","Lagunillas","ESCUELA LAGUNILLAS",236046,334,18,1086,1420,478,26,564,1042
"Bolivia","Santa Cruz","Cordillera","Lagunillas","ESCUELA PROF. DELFIN ARTEAGA IPATI",236047,99,17,666,765,316,21,312,628
"Bolivia","Santa Cruz","Cordillera","Lagunillas","ESCUELA SECCIONAL AGUADA GRANDE",236048,40,5,191,231,76,7,103,179
"Bolivia","Santa Cruz","Cordillera","Lagunillas","ESCUELA SECCIONAL ALTO PARAPETI",236049,15,2,67,82,11,5,49,60
"Bolivia","Santa Cruz","Cordillera","Lagunillas","ESCUELA SECCIONAL AQUIO",236051,6,1,69,75,49,2,17,66
"Bolivia","Santa Cruz","Cordillera","Lagunillas","ESCUELA TASETE",236050,3,0,40,43,7,3,30,37
"Bolivia","Santa Cruz","Cordillera","Lagunillas","UNIDAD EDUCATIVA CARPARICITO",236052,41,5,145,186,44,10,86,130
"Bolivia","Santa Cruz","Cordillera","Lagunillas","UNIDAD EDUCATIVA PAMPA REDONDA",236053,5,4,73,78,26,4,39,65
"Bolivia","Santa Cruz","Cordillera","Lagunillas","UNIDAD EDUCATIVA TENTA PIAU",236054,12,0,73,85,32,5,36,68
"Bolivia","Santa Cruz","Cordillera","Lagunillas","UNIDAD EDUCATIVA YAITY",236055,9,2,80,89,15,3,60,75
"Bolivia","Santa Cruz","Florida","Mairana","ESCUELA ANANIAS MELENDRES",235453,99,18,599,698,203,31,347,550
"Bolivia","Santa Cruz","Florida","Mairana","ESCUELA ANGEL SAAVEDRA CHAVEZ",235454,19,5,139,158,74,8,52,126
"Bolivia","Santa Cruz","Florida","Mairana","ESCUELA RENE BARRIENTOS ORTUÑO",235455,690,134,4900,5590,2049,323,2394,4443
"Bolivia","Santa Cruz","Florida","Pampagrande","ESCUELA NUCLEO SANTA ROSA",235448,18,2,172,190,68,4,98,166
"Bolivia","Santa Cruz","Florida","Pampagrande","ESCUELA PALMASOLA (EL CARMEN)",235449,23,6,156,179,47,4,99,146
"Bolivia","Santa Cruz","Florida","Pampagrande","ESCUELA PEDRO ARISTIDES",235450,98,21,602,700,372,15,194,566
"Bolivia","Santa Cruz","Florida","Pampagrande","ESCUELA SAN IGNACIO DE LOYOLA",235451,83,12,457,540,294,18,133,427
"Bolivia","Santa Cruz","Florida","Pampagrande","ESCUELA UNIDAD EDUCATIVA EDUARDO AVAROA",235452,457,72,2948,3405,980,151,1745,2725
"Bolivia","Santa Cruz","Florida","Quirusillas","ESCUELA NESTOR PAZ ZAMORA",235456,208,27,865,1073,465,56,317,782
"Bolivia","Santa Cruz","Florida","Samaipata","ESCUELA CENTRAL BELLA VICTORIA",235441,74,23,893,967,436,49,385,821
"Bolivia","Santa Cruz","Florida","Samaipata","ESCUELA GRAL. AGUSTIN SAAVEDRA",235442,270,15,1483,1753,850,94,524,1374
"Bolivia","Santa Cruz","Florida","Samaipata","ESCUELA NAPOLEON GOMEZ",235443,229,45,1779,2008,1079,74,581,1660
"Bolivia","Santa Cruz","Florida","Samaipata","ESCUELA NUCLEO SAN JUAN DEL ROSARIO",235444,63,2,193,256,108,6,77,185
"Bolivia","Santa Cruz","Florida","Samaipata","ESCUELA SANTIAGO DEL VALLE",235445,62,7,327,389,224,7,89,313
"Bolivia","Santa Cruz","Florida","Samaipata","ESCUELA TIMOTEO RONDALES",235446,64,12,341,405,206,23,100,306
"Bolivia","Santa Cruz","Florida","Samaipata","ESCUELA UNIDAD EDUCATIVA 27 DE MAYO",235447,18,3,110,128,39,2,66,105
"Bolivia","Santa Cruz","Germán Busch","El Carmen Rivero Torrez","ESCUELA CANDELARIA (CHIQUITOS)",232507,11,1,59,70,26,2,30,56
"Bolivia","Santa Cruz","Germán Busch","El Carmen Rivero Torrez","ESCUELA DANIEL ZAMBRANA",232508,546,24,1737,2283,910,29,774,1684
"Bolivia","Santa Cruz","Germán Busch","El Carmen Rivero Torrez","ESCUELA EVANGELICA RINCON DEL TIGRE",232509,90,4,199,289,104,8,83,187
"Bolivia","Santa Cruz","Germán Busch","El Carmen Rivero Torrez","ESCUELA PALMERAS",232510,39,2,87,126,41,4,40,81
"Bolivia","Santa Cruz","Germán Busch","El Carmen Rivero Torrez","ESCUELA SANTA ANA",232511,59,0,181,240,87,4,90,177
"Bolivia","Santa Cruz","Germán Busch","El Carmen Rivero Torrez","UNIDAD EDUCATIVA PALMITO",232512,19,0,34,53,21,0,13,34
"Bolivia","Santa Cruz","Germán Busch","Puerto Suarez","ESCUELA ANGELICA RIVERO",232498,171,7,812,983,542,10,253,795
"Bolivia","Santa Cruz","Germán Busch","Puerto Suarez","ESCUELA COLONIA WARNES",232499,0,0,62,62,12,9,41,53
"Bolivia","Santa Cruz","Germán Busch","Puerto Suarez","ESCUELA COOP EDUCACIONAL PUERTO SUAREZ",232500,674,24,2287,2961,1408,33,822,2230
"Bolivia","Santa Cruz","Germán Busch","Puerto Suarez","ESCUELA ELIODORO PAZ",232501,357,6,946,1303,644,18,278,922
"Bolivia","Santa Cruz","Germán Busch","Puerto Suarez","ESCUELA GERMAN BUSCH YACUSES",232502,80,10,382,462,167,11,194,361
"Bolivia","Santa Cruz","Germán Busch","Puerto Suarez","ESCUELA JOSEFINA GOYTIA",232503,351,10,1330,1681,944,20,356,1300
"Bolivia","Santa Cruz","Germán Busch","Puerto Suarez","ESCUELA MIGUEL SUAREZ ARANA",232504,533,19,2294,2827,1447,108,720,2167
"Bolivia","Santa Cruz","Germán Busch","Puerto Suarez","UNIDAD EDUCATIVA EL SALAO",232505,3,0,4,7,3,0,1,4
"Bolivia","Santa Cruz","Germán Busch","Puerto Suarez","UNIDAD EDUCATIVA MOTACUCITO",232506,2,1,19,21,6,0,12,18
"Bolivia","Santa Cruz","Germán Busch","Quijarro","ESCUELA GISELA BRUN SCIARONI",235505,238,24,2908,3146,1610,453,821,2431
"Bolivia","Santa Cruz","Germán Busch","Quijarro","ESCUELA MIXTA LA FRONTERA",235506,1229,24,2836,4065,1399,111,1302,2701
"Bolivia","Santa Cruz","Germán Busch","Quijarro","ESCUELA SAMUEL LOPEZ MENDOZA",235507,971,14,2691,3662,1543,66,1068,2611
"Bolivia","Santa Cruz","Germán Busch","Quijarro","UNIDAD EDUCATIVA SAN SALVADOR",235508,0,0,13,13,1,0,12,13
"Bolivia","Santa Cruz","Guarayos","Ascención (Guarayos)","COLEGIO JOSE BARRERA",232453,67,4,371,438,230,7,130,360
"Bolivia","Santa Cruz","Guarayos","Ascención (Guarayos)","ESCUELA 17 DE FEBRERO",232454,45,0,218,263,29,4,185,214
"Bolivia","Santa Cruz","Guarayos","Ascención (Guarayos)","ESCUELA 6 DE ABRIL",232455,16,0,86,102,29,2,55,84
"Bolivia","Santa Cruz","Guarayos","Ascención (Guarayos)","ESCUELA ASCENCION CENTRAL",232456,1057,37,3873,4930,2022,94,1720,3742
"Bolivia","Santa Cruz","Guarayos","Ascención (Guarayos)","ESCUELA COLONIA 5 DE MARZO",232457,39,3,163,202,65,4,91,156
"Bolivia","Santa Cruz","Guarayos","Ascención (Guarayos)","ESCUELA ESTEBAN GEBARD",232458,1040,40,4564,5604,2575,136,1813,4388
"Bolivia","Santa Cruz","Guarayos","Ascención (Guarayos)","ESCUELA SAN PABLO",232459,82,14,476,558,174,17,271,445
"Bolivia","Santa Cruz","Guarayos","Ascención (Guarayos)","ESCUELA SANTA MARIA",232460,48,11,345,393,103,9,222,325
"Bolivia","Santa Cruz","Guarayos","Ascención (Guarayos)","KINDER MI DULCE HOGAR",232461,68,1,480,548,214,13,252,466
"Bolivia","Santa Cruz","Guarayos","El Puente","ESCUELA 10 DE NOVIEMBRE",235509,95,13,493,588,137,13,330,467
"Bolivia","Santa Cruz","Guarayos","El Puente","ESCUELA ALFREDO SMITH",235510,442,29,1732,2174,1003,42,658,1661
"Bolivia","Santa Cruz","Guarayos","El Puente","ESCUELA CACHUELA",235511,10,1,65,75,11,2,51,62
"Bolivia","Santa Cruz","Guarayos","El Puente","ESCUELA CORRALON",235512,83,0,220,303,32,2,186,218
"Bolivia","Santa Cruz","Guarayos","El Puente","ESCUELA EL COMBATE",235513,5,0,34,39,10,0,24,34
"Bolivia","Santa Cruz","Guarayos","El Puente","ESCUELA LOS CHACOS",235514,19,0,51,70,46,1,4,50
"Bolivia","Santa Cruz","Guarayos","El Puente","ESCUELA PUEBLOS UNIDOS",235515,154,1,222,376,30,8,183,213
"Bolivia","Santa Cruz","Guarayos","El Puente","ESCUELA SAN JOSE DE YOTAU",235517,257,20,1041,1298,322,29,670,992
"Bolivia","Santa Cruz","Guarayos","El Puente","ESCUELA SECCIONAL EL CARMEN",235519,75,5,346,421,128,15,198,326
"Bolivia","Santa Cruz","Guarayos","El Puente","ESCUELA SECCIONAL LIMONCITO",235520,15,0,33,48,21,1,11,32
"Bolivia","Santa Cruz","Guarayos","El Puente","ESCUELA UNIDAD EDUCATIVA BOLIVAR",235521,35,13,255,290,70,13,159,229
"Bolivia","Santa Cruz","Guarayos","El Puente","MONTE SINAI",235522,32,2,224,256,32,7,183,215
"Bolivia","Santa Cruz","Guarayos","El Puente","UNIDAD EDUCATIVA EL CORRALON",235523,0,4,104,104,12,9,79,91
"Bolivia","Santa Cruz","Guarayos","Urubichá","ESC, MARIA DE LOS ANGELES",236239,404,27,1715,2119,720,44,924,1644
"Bolivia","Santa Cruz","Guarayos","Urubichá","ESCUELA NUCLEO ESCOLAR YAGUARU",236240,180,14,860,1040,538,28,280,818
"Bolivia","Santa Cruz","Guarayos","Urubichá","ESCUELA SANTA TERESITA (CURURU)",236241,15,2,57,72,45,0,10,55
"Bolivia","Santa Cruz","Guarayos","Urubichá","ESCUELA SECC. MON. SALVATIERRA",236242,29,1,78,107,32,0,45,77
"Bolivia","Santa Cruz","Ichilo","Buena Vista","ESCUELA ADHEMAR ORTIZ",236022,31,1,213,244,81,1,130,211
"Bolivia","Santa Cruz","Ichilo","Buena Vista","ESCUELA EDUARDO ABAROA",236023,109,14,762,871,218,30,500,718
"Bolivia","Santa Cruz","Ichilo","Buena Vista","ESCUELA MARIANO SAUCEDO SEVILLA",236024,380,13,1750,2130,1047,43,647,1694
"Bolivia","Santa Cruz","Ichilo","Buena Vista","ESCUELA OVIDIO SUAREZ",236025,473,25,1661,2134,850,75,711,1561
"Bolivia","Santa Cruz","Ichilo","Buena Vista","ESCUELA UNIDAD EDUCATIVA CARANDA",236026,117,15,643,760,262,21,345,607
"Bolivia","Santa Cruz","Ichilo","Buena Vista","ESCUELA UNIDAD EDUCATIVA LUCIO PEREZ",236027,34,3,182,216,140,5,34,174
"Bolivia","Santa Cruz","Ichilo","Buena Vista","ESCUELA UNIDAD EDUCATIVA PEDRO DOMINGO MURILLO",236028,75,8,459,534,57,10,384,441
"Bolivia","Santa Cruz","Ichilo","Buena Vista","ESCUELA UNIDAD EDUCATIVA SAN ISIDRO",236029,44,1,199,243,175,0,23,198
"Bolivia","Santa Cruz","Ichilo","Buena Vista","ESCUELA UNIDAD EDUCATIVA SAN JAVIER",236030,0,0,48,48,36,3,9,45
"Bolivia","Santa Cruz","Ichilo","Buena Vista","ESCUELA UNIDAD EDUCATIVA SANTO ESPOSORIO",236031,40,0,158,198,130,2,26,156
"Bolivia","Santa Cruz","Ichilo","Buena Vista","UNIDAD EDUCATIVA 5 DE SEPTIEMBRE",236032,3,2,89,92,5,0,82,87
"Bolivia","Santa Cruz","Ichilo","Buena Vista","UNIDAD EDUCATIVA 6 DE AGOSTO",236033,6,6,265,271,214,5,40,254
"Bolivia","Santa Cruz","Ichilo","San Carlos","ESCUELA CENTRAL SAN CARLOS",236124,456,40,2762,3218,1740,104,878,2618
"Bolivia","Santa Cruz","Ichilo","San Carlos","ESCUELA FISCAL DE NINOS SANTA FE",236125,865,58,4764,5629,1936,215,2555,4491
"Bolivia","Santa Cruz","Ichilo","San Carlos","ESCUELA NUCLEO CENTRAL",236126,95,14,740,835,148,14,564,712
"Bolivia","Santa Cruz","Ichilo","San Carlos","ESCUELA UNIDAD EDUCATIVA POPULAR DON BOSCO",236127,66,11,934,1000,533,123,267,800
"Bolivia","Santa Cruz","Ichilo","San Juan De Yapacaní","ESCUELA POPULAR DON BOSCO",236392,435,75,2475,2910,1395,47,958,2353
"Bolivia","Santa Cruz","Ichilo","San Juan De Yapacaní","NUCLEO CENTRAL LA ENCONADA",236393,105,17,652,757,203,21,411,614
"Bolivia","Santa Cruz","Ichilo","San Juan De Yapacaní","UNIDAD EDUCATIVA AYACUCHO",236394,54,6,288,342,90,2,190,280
"Bolivia","Santa Cruz","Ichilo","San Juan De Yapacaní","UNIDAD EDUCATIVA NUCLEO CENTRAL",236395,34,1,126,160,31,2,92,123
"Bolivia","Santa Cruz","Ichilo","San Juan De Yapacaní","UNIDAD EDUCATIVA RAUL MENACHO",236396,44,1,225,269,61,7,156,217
"Bolivia","Santa Cruz","Ichilo","Yapacaní","ESCUELA CESAR BANZER ALIAGA",233276,1311,94,7132,8443,2413,387,4238,6651
"Bolivia","Santa Cruz","Ichilo","Yapacaní","ESCUELA CORTE HONDO",233286,0,0,69,69,7,1,61,68
"Bolivia","Santa Cruz","Ichilo","Yapacaní","ESCUELA DON BOSCO FE Y ALEGRIA",233277,419,24,2019,2438,432,50,1513,1945
"Bolivia","Santa Cruz","Ichilo","Yapacaní","ESCUELA EL PALLAR",233278,77,6,197,274,57,4,130,187
"Bolivia","Santa Cruz","Ichilo","Yapacaní","ESCUELA GERMAN BUSCH",233279,683,66,4440,5123,1652,151,2571,4223
"Bolivia","Santa Cruz","Ichilo","Yapacaní","ESCUELA MARISCAL SUCRE",233280,129,16,997,1126,226,24,731,957
"Bolivia","Santa Cruz","Ichilo","Yapacaní","ESCUELA NACIONAL BOLIVIA",233281,69,3,372,441,99,37,233,332
"Bolivia","Santa Cruz","Ichilo","Yapacaní","ESCUELA NOEL KENP MERCADO",233282,217,16,1115,1332,156,22,921,1077
"Bolivia","Santa Cruz","Ichilo","Yapacaní","ESCUELA NUEVO SIMON BOLLIVAR",233283,847,37,4136,4983,1514,94,2491,4005
"Bolivia","Santa Cruz","Ichilo","Yapacaní","ESCUELA UNIDAD EDUCATIVA CASCABEL",233284,124,8,494,618,84,11,391,475
"Bolivia","Santa Cruz","Ichilo","Yapacaní","ESCUELA UNIDAD EDUCATIVA GERMAN BUSCH (P. GRETHER)",233285,68,7,299,367,99,14,179,278
"Bolivia","Santa Cruz","Ichilo","Yapacaní","ESCUELA UNIDAD EDUCATIVA NUCLEO CENTRAL",233287,85,5,625,710,145,15,460,605
"Bolivia","Santa Cruz","Ichilo","Yapacaní","ESCUELA UNIDAD EDUCATIVA NUCLEO CENTRAL EL CONDOR",233288,44,6,251,295,49,5,191,240
"Bolivia","Santa Cruz","Ichilo","Yapacaní","ESCUELA UNIDAD EDUCATIVA NUCLEO CENTRAL LOS POZOS",233289,31,5,228,259,64,9,150,214
"Bolivia","Santa Cruz","Ichilo","Yapacaní","ESCUELA UNIDAD EDUCATIVA PUERTO AVAROA",233290,58,6,402,460,113,8,275,388
"Bolivia","Santa Cruz","Ichilo","Yapacaní","UNIDAD EDUCATIVA JUANA AZURDUY",233291,7,0,58,65,21,5,32,53
"Bolivia","Santa Cruz","Ichilo","Yapacaní","UNIDAD EDUCATIVA NUEVO HORIZONTE",233292,25,12,394,419,57,13,312,369
"Bolivia","Santa Cruz","Ichilo","Yapacaní","UNIDAD EDUCATIVA SAN RAFAEL",233293,5,0,121,126,14,3,104,118
"Bolivia","Santa Cruz","Manuel M. Caballero","Comarapa","ESCUELA EL JAGUE",235488,10,0,48,58,26,0,22,48
"Bolivia","Santa Cruz","Manuel M. Caballero","Comarapa","ESCUELA ESCUELA SAN MATEO",235489,19,4,205,224,24,4,173,197
"Bolivia","Santa Cruz","Manuel M. Caballero","Comarapa","ESCUELA GABRIEL RENE MORENO",235490,532,73,3949,4481,1439,227,2210,3649
"Bolivia","Santa Cruz","Manuel M. Caballero","Comarapa","ESCUELA HABRA DE CAPILLA",235491,9,2,116,125,17,6,91,108
"Bolivia","Santa Cruz","Manuel M. Caballero","Comarapa","ESCUELA MANZANAL",235492,12,0,98,110,8,3,87,95
"Bolivia","Santa Cruz","Manuel M. Caballero","Comarapa","ESCUELA MARCELINO CHAIPANA",235493,48,4,372,420,158,19,191,349
"Bolivia","Santa Cruz","Manuel M. Caballero","Comarapa","ESCUELA SAN ISIDRO",235494,162,14,909,1071,427,43,425,852
"Bolivia","Santa Cruz","Manuel M. Caballero","Comarapa","ESCUELA SAN JOSE DE LA CAPILLA",235495,56,8,365,421,160,23,174,334
"Bolivia","Santa Cruz","Manuel M. Caballero","Comarapa","ESCUELA SAN JUAN DEL POTRERO",235496,53,13,331,384,164,12,142,306
"Bolivia","Santa Cruz","Manuel M. Caballero","Comarapa","ESCUELA SIBERIA",235497,10,0,120,130,30,3,87,117
"Bolivia","Santa Cruz","Manuel M. Caballero","Comarapa","ESCUELA TORRECILLAS",235498,67,28,740,807,112,60,540,652
"Bolivia","Santa Cruz","Manuel M. Caballero","Comarapa","ESCUELA UNIDAD EDUCATIVA LA PALIZADA",235499,45,13,328,373,126,12,177,303
"Bolivia","Santa Cruz","Manuel M. Caballero","Saipina","ESCUELA EMILIA CABALLERO",235500,1,0,33,34,6,1,26,32
"Bolivia","Santa Cruz","Manuel M. Caballero","Saipina","ESCUELA HUMBERTO VILLARROEL",235501,322,35,2105,2427,718,73,1279,1997
"Bolivia","Santa Cruz","Manuel M. Caballero","Saipina","ESCUELA OCONI",235502,21,3,103,124,6,2,92,98
"Bolivia","Santa Cruz","Manuel M. Caballero","Saipina","ESCUELA SAN RAFAEL",235503,16,1,207,223,54,6,146,200
"Bolivia","Santa Cruz","Manuel M. Caballero","Saipina","ESCUELA UNIDAD EDUCATIVA SANTA CATALINA CHILON",235504,65,8,397,462,99,15,275,374
"Bolivia","Santa Cruz","Ñuflo De Chávez","Concepción","ESCUELA CENT. JULIO FLORES FRANCO",236297,26,7,207,233,112,3,85,197
"Bolivia","Santa Cruz","Ñuflo De Chávez","Concepción","ESCUELA CENTRAL SAN PEDRO",236298,28,0,143,171,94,3,46,140
"Bolivia","Santa Cruz","Ñuflo De Chávez","Concepción","ESCUELA EDUCATIVA MAKANATE",236299,15,2,109,124,4,3,100,104
"Bolivia","Santa Cruz","Ñuflo De Chávez","Concepción","ESCUELA GUADALUPE FE Y ALEGRIA",236300,1293,115,7052,8345,3589,185,3163,6752
"Bolivia","Santa Cruz","Ñuflo De Chávez","Concepción","ESCUELA PALESTINA",236301,0,0,73,73,3,12,58,61
"Bolivia","Santa Cruz","Ñuflo De Chávez","Concepción","ESCUELA SECCIONAL CALENDARIA",236302,13,5,188,201,64,7,112,176
"Bolivia","Santa Cruz","Ñuflo De Chávez","Concepción","ESCUELA SECCIONAL PALMARITO",236303,29,2,211,240,155,3,51,206
"Bolivia","Santa Cruz","Ñuflo De Chávez","Concepción","ESCUELA TIERRA HERMOZA",236304,116,6,486,602,42,11,427,469
"Bolivia","Santa Cruz","Ñuflo De Chávez","Concepción","ESCUELA UNIDAD EDUCATIVA ALTAMIRA",236305,74,10,374,448,166,18,180,346
"Bolivia","Santa Cruz","Ñuflo De Chávez","Concepción","ESCUELA UNIDAD EDUCATIVA GUAYABA",236306,9,4,130,139,16,2,108,124
"Bolivia","Santa Cruz","Ñuflo De Chávez","Concepción","ESCUELA UNIDAD EDUCATIVA LAS MERCEDES",236307,13,1,38,51,18,0,19,37
"Bolivia","Santa Cruz","Ñuflo De Chávez","Concepción","ESCUELA UNIDAD EDUCATIVA SAN SILVESTRE",236308,14,1,123,137,45,8,69,114
"Bolivia","Santa Cruz","Ñuflo De Chávez","Concepción","ESCUELA UNIDAD EDUCATIVA SANTA MONICA",236309,13,1,91,104,6,0,84,90
"Bolivia","Santa Cruz","Ñuflo De Chávez","Concepción","ESCUELA UNIDAD EDUCATIVA ZAPOCO",236310,7,0,14,21,9,0,5,14
"Bolivia","Santa Cruz","Ñuflo De Chávez","Concepción","MEDIO MONTE",236311,6,0,108,114,10,1,97,107
"Bolivia","Santa Cruz","Ñuflo De Chávez","Concepción","UNIDAD EDUCATIVA JOSE ORTIZ SENAR",236312,9,0,63,72,6,0,57,63
"Bolivia","Santa Cruz","Ñuflo De Chávez","Concepción","UNIDAD EDUCATIVA NUBIASIX",236313,4,2,59,63,16,2,39,55
"Bolivia","Santa Cruz","Ñuflo De Chávez","Concepción","UNIDAD EDUCATIVA SAN FRANCISCO DE ASIS",236314,3,2,80,83,13,4,61,74
"Bolivia","Santa Cruz","Ñuflo De Chávez","Cuatro Cañadas","COLEGIO NACIONAL CUATRO CAÑANDAS",232484,21,5,147,168,40,4,98,138
"Bolivia","Santa Cruz","Ñuflo De Chávez","Cuatro Cañadas","ESCUELA 26 DE AGOSTO",232485,89,14,703,792,226,29,434,660
"Bolivia","Santa Cruz","Ñuflo De Chávez","Cuatro Cañadas","ESCUELA JOSE LUIS CASTRO",232486,180,17,1297,1477,418,39,823,1241
"Bolivia","Santa Cruz","Ñuflo De Chávez","Cuatro Cañadas","ESCUELA JUAN PABLO SEGUNDO",232487,996,72,5934,6930,2113,310,3439,5552
"Bolivia","Santa Cruz","Ñuflo De Chávez","Cuatro Cañadas","ESCUELA LOS TRONCOS",232488,25,3,182,207,96,3,80,176
"Bolivia","Santa Cruz","Ñuflo De Chávez","Cuatro Cañadas","ESCUELA MONTE RICO",232489,34,2,206,240,24,1,179,203
"Bolivia","Santa Cruz","Ñuflo De Chávez","Cuatro Cañadas","UNIDAD EDUCATIVA HAZIEL",232490,13,2,235,248,181,7,45,226
"Bolivia","Santa Cruz","Ñuflo De Chávez","San Antonio De Lomerio","ESCUELA CENTRAL EL PUQUIO",235588,54,3,400,454,4,3,390,394
"Bolivia","Santa Cruz","Ñuflo De Chávez","San Antonio De Lomerio","ESCUELA HOLANDA",235589,0,0,7,7,0,2,5,5
"Bolivia","Santa Cruz","Ñuflo De Chávez","San Antonio De Lomerio","ESCUELA PADRE MATIAS LENS",235590,209,11,1149,1358,496,36,606,1102
"Bolivia","Santa Cruz","Ñuflo De Chávez","San Antonio De Lomerio","ESCUELA SAN LORENZO",235591,31,7,265,296,5,1,252,257
"Bolivia","Santa Cruz","Ñuflo De Chávez","San Antonio De Lomerio","ESCUELA SECCIONAL SALINAS",235592,43,8,188,231,72,5,103,175
"Bolivia","Santa Cruz","Ñuflo De Chávez","San Antonio De Lomerio","ESCUELA UNIDAD EDUCATIVA LAS TRANCAS",235593,9,0,109,118,6,2,101,107
"Bolivia","Santa Cruz","Ñuflo De Chávez","San Antonio De Lomerio","ESCUELA UNIDAD EDUCATIVA MONTERITO",235594,8,1,173,181,0,0,172,172
"Bolivia","Santa Cruz","Ñuflo De Chávez","San Antonio De Lomerio","ESCUELA UNIDAD EDUCATIVA PADRE PIO",235595,16,1,147,163,10,2,134,144
"Bolivia","Santa Cruz","Ñuflo De Chávez","San Antonio De Lomerio","PEDRO PABLO PEÑA GARCIA",235596,2,0,60,62,0,0,60,60
"Bolivia","Santa Cruz","Ñuflo De Chávez","San Javier","ESCUELA ADOLFO BURTON",235583,877,109,4625,5502,2881,73,1562,4443
"Bolivia","Santa Cruz","Ñuflo De Chávez","San Javier","ESCUELA SECCIONAL CORONACION",235582,59,6,424,483,132,9,277,409
"Bolivia","Santa Cruz","Ñuflo De Chávez","San Javier","ESCUELA UNIDAD EDUCATIVA LAS ABRAS",235584,37,2,195,232,16,2,175,191
"Bolivia","Santa Cruz","Ñuflo De Chávez","San Javier","ESCUELA UNIDAD EDUCATIVA SAN PABLO",235585,12,0,104,116,4,0,100,104
"Bolivia","Santa Cruz","Ñuflo De Chávez","San Javier","ESCUELA UNIDAD EDUCATIVA SANTA RITA",235586,10,0,59,69,21,0,38,59
"Bolivia","Santa Cruz","Ñuflo De Chávez","San Javier","ESCUELA UNIDAD EDUCATIVA TURUX NAPEZ",235587,13,2,86,99,1,1,82,83
"Bolivia","Santa Cruz","Ñuflo De Chávez","San Julian","ESCUELA 26 DE OCT. FE Y ALEGRIA",236243,48,4,501,549,43,6,448,491
"Bolivia","Santa Cruz","Ñuflo De Chávez","San Julian","ESCUELA CENTRAL FRANZ TAMAYO",236244,153,26,865,1018,190,43,606,796
"Bolivia","Santa Cruz","Ñuflo De Chávez","San Julian","ESCUELA COLEGIO CIRO MEALLA",236245,1235,165,9306,10541,2619,651,5871,8490
"Bolivia","Santa Cruz","Ñuflo De Chávez","San Julian","ESCUELA EDUARDO AVAROA",236259,143,17,1026,1169,287,40,682,969
"Bolivia","Santa Cruz","Ñuflo De Chávez","San Julian","ESCUELA EL PROGRESO",236246,74,4,498,572,116,38,340,456
"Bolivia","Santa Cruz","Ñuflo De Chávez","San Julian","ESCUELA FE Y ALEGRIA",236247,153,16,786,939,385,26,359,744
"Bolivia","Santa Cruz","Ñuflo De Chávez","San Julian","ESCUELA GRAL SAN MARTIN",236248,81,9,499,580,90,17,383,473
"Bolivia","Santa Cruz","Ñuflo De Chávez","San Julian","ESCUELA LA ASUNTA SAN BERNARDO",236249,171,17,1201,1372,445,34,705,1150
"Bolivia","Santa Cruz","Ñuflo De Chávez","San Julian","ESCUELA LIMONCITO",236250,51,6,223,274,60,6,151,211
"Bolivia","Santa Cruz","Ñuflo De Chávez","San Julian","ESCUELA LUZ Y VERDAD",236260,35,10,282,317,75,11,186,261
"Bolivia","Santa Cruz","Ñuflo De Chávez","San Julian","ESCUELA MAX FERNANDEZ ROJAS",236251,44,11,477,521,101,13,352,453
"Bolivia","Santa Cruz","Ñuflo De Chávez","San Julian","ESCUELA NUCLEO 66 2 DE AGOSTO",236252,55,8,417,472,128,9,272,400
"Bolivia","Santa Cruz","Ñuflo De Chávez","San Julian","ESCUELA PATUJU",236253,65,2,497,562,133,19,343,476
"Bolivia","Santa Cruz","Ñuflo De Chávez","San Julian","ESCUELA SAN ANTONIO",236254,7,1,125,132,24,1,99,123
"Bolivia","Santa Cruz","Ñuflo De Chávez","San Julian","ESCUELA SAN SALVADOR NUCLEO 38",236255,94,7,480,574,50,23,400,450
"Bolivia","Santa Cruz","Ñuflo De Chávez","San Julian","ESCUELA SEBASTIAN PAGADOR",236256,9,0,104,113,6,0,98,104
"Bolivia","Santa Cruz","Ñuflo De Chávez","San Julian","ESCUELA UNIDAD EDUCATIVA 16 DE MARZO",236257,42,5,276,318,23,25,223,246
"Bolivia","Santa Cruz","Ñuflo De Chávez","San Julian","ESCUELA UNIDAD EDUCATIVA EL LIMONAL",236258,41,5,263,304,34,8,216,250
"Bolivia","Santa Cruz","Ñuflo De Chávez","San Julian","ESCUELA UNIDAD EDUCATIVA SEGUNDA MILLA",236261,12,1,123,135,89,6,27,116
"Bolivia","Santa Cruz","Ñuflo De Chávez","San Julian","UNIDAD EDUCATIVA 27 DE ABRIL",236262,3,0,28,31,10,2,16,26
"Bolivia","Santa Cruz","Ñuflo De Chávez","San Julian","UNIDAD EDUCATIVA GUILLERMO JORDAN",236263,350,19,2052,2402,535,122,1376,1911
"Bolivia","Santa Cruz","Ñuflo De Chávez","San Julian","UNIDAD EDUCATIVA JOSE DAVID BERRIOS",236264,0,0,20,20,6,2,12,18
"Bolivia","Santa Cruz","Ñuflo De Chávez","San Julian","UNIDAD EDUCATIVA SAN JULIAN DE BERLIN",236265,3,1,31,34,6,3,21,27
"Bolivia","Santa Cruz","Ñuflo De Chávez","San Julian","UNIDAD EDUCATIVA SANTA ANA",236266,3,2,98,101,8,2,86,94
"Bolivia","Santa Cruz","Ñuflo De Chávez","San Ramón","ESCUELA CENTRAL SAN RAMON",236267,737,58,3465,4202,1874,146,1387,3261
"Bolivia","Santa Cruz","Ñuflo De Chávez","San Ramón","ESCUELA SANTA ROSA DE LA MINA",236268,19,1,156,175,89,9,57,146
"Bolivia","Santa Cruz","Obispo Santisteban","Fernández Alonzo","ESCUELA AGUAICES",232491,33,3,274,307,88,14,169,257
"Bolivia","Santa Cruz","Obispo Santisteban","Fernández Alonzo","ESCUELA EDUARDO AVAROA",232492,63,12,499,562,156,15,316,472
"Bolivia","Santa Cruz","Obispo Santisteban","Fernández Alonzo","ESCUELA NUCLEO MARISCAL SUCRE",232493,276,20,1815,2091,575,67,1153,1728
"Bolivia","Santa Cruz","Obispo Santisteban","Fernández Alonzo","ESCUELA SECCIONAL",232494,4,0,20,24,2,1,17,19
"Bolivia","Santa Cruz","Obispo Santisteban","Fernández Alonzo","ESCUELA SECCIONAL FAJA BOLIVAR",232495,0,1,10,10,0,0,9,9
"Bolivia","Santa Cruz","Obispo Santisteban","Fernández Alonzo","ESCUELA UNIDAD EDUCATIVA BETANIA",232496,5,3,106,111,30,2,71,101
"Bolivia","Santa Cruz","Obispo Santisteban","Fernández Alonzo","ESCUELA UNIDAD EDUCATIVA VICTOR HUGO OTALORA",232497,494,52,3096,3590,1080,138,1826,2906
"Bolivia","Santa Cruz","Obispo Santisteban","General Saavedra","COLEGIO PRINCIPE DE PAZ",232434,523,39,3217,3740,1900,134,1144,3044
"Bolivia","Santa Cruz","Obispo Santisteban","General Saavedra","ESCUELA 1 DE SEPTIEMBRE",232435,78,7,379,457,140,7,225,365
"Bolivia","Santa Cruz","Obispo Santisteban","General Saavedra","ESCUELA NUCLEO CENTRAL NUEVA ESPERANZA",232436,129,9,823,952,363,22,429,792
"Bolivia","Santa Cruz","Obispo Santisteban","General Saavedra","ESCUELA NUCLEO MARISCAL SUCRE",232437,149,17,857,1006,283,34,523,806
"Bolivia","Santa Cruz","Obispo Santisteban","General Saavedra","ESCUELA UNIDAD EDUCATIVA CHANE BEDOYA",232438,68,3,313,381,109,8,193,302
"Bolivia","Santa Cruz","Obispo Santisteban","General Saavedra","ESCUELA UNIDAD EDUCATIVA GUALBERTO VILLARROEL",232439,96,12,458,554,129,25,292,421
"Bolivia","Santa Cruz","Obispo Santisteban","General Saavedra","ESCUELA UNIDAD EDUCATIVA SANTIAGO CORNEN",232440,53,1,352,405,171,13,167,338
"Bolivia","Santa Cruz","Obispo Santisteban","General Saavedra","UNIDAD EDUCATIVA ARMINDA MERCADO P.",232442,4,4,81,85,57,2,18,75
"Bolivia","Santa Cruz","Obispo Santisteban","General Saavedra","UNIDAD EDUCATIVA MARCELO QUIROGA SANTA CRUZ",232443,1,6,81,82,17,1,57,74
"Bolivia","Santa Cruz","Obispo Santisteban","General Saavedra","UNIDAD EDUCATIVA SAN FELIX",232444,6,3,45,51,15,2,25,40
"Bolivia","Santa Cruz","Obispo Santisteban","Mineros","ESCUELA LA PATRIA",236365,48,6,220,268,99,10,105,204
"Bolivia","Santa Cruz","Obispo Santisteban","Mineros","ESCUELA LAS PALMAS",236366,46,5,326,372,115,11,195,310
"Bolivia","Santa Cruz","Obispo Santisteban","Mineros","ESCUELA NUCLEO CENTRAL MINERO",236367,1568,165,9457,11025,5140,371,3781,8921
"Bolivia","Santa Cruz","Obispo Santisteban","Mineros","ESCUELA SUB. CENTRAL LA PORFIA",236368,98,5,388,486,144,6,233,377
"Bolivia","Santa Cruz","Obispo Santisteban","Mineros","ESCUELA UNIDAD EDUCATIVA SAN JUAN DEL CARMEN",236369,6,1,58,64,21,3,33,54
"Bolivia","Santa Cruz","Obispo Santisteban","Mineros","UNIDAD EDUCATIVA 24 DE JUNIO",236370,0,0,88,88,14,7,67,81
"Bolivia","Santa Cruz","Obispo Santisteban","Mineros","UNIDAD EDUCATIVA ALIANZA EL PROGRESO",236371,0,19,183,183,42,5,117,159
"Bolivia","Santa Cruz","Obispo Santisteban","Mineros","UNIDAD EDUCATIVA ALICE ALVAREZ DE AREDONDO I",236372,81,9,560,641,305,11,235,540
"Bolivia","Santa Cruz","Obispo Santisteban","Mineros","UNIDAD EDUCATIVA BENJAMIN BANEGAS VACA",236373,37,5,252,289,131,4,112,243
"Bolivia","Santa Cruz","Obispo Santisteban","Montero","CARCEL PUBLICA DE MONTERO",235457,84,0,26,110,15,4,7,22
"Bolivia","Santa Cruz","Obispo Santisteban","Montero","COLEGIO ANGEL LIMPIAS",235458,384,28,2254,2638,929,72,1225,2154
"Bolivia","Santa Cruz","Obispo Santisteban","Montero","COLEGIO DANIEL RIVERO",235459,1029,58,5460,6489,2066,169,3167,5233
"Bolivia","Santa Cruz","Obispo Santisteban","Montero","COLEGIO EDUARDO ABAROA",235460,331,15,2193,2524,1362,54,762,2124
"Bolivia","Santa Cruz","Obispo Santisteban","Montero","COLEGIO FE Y ALEGRIA",235461,222,13,1807,2029,1483,28,283,1766
"Bolivia","Santa Cruz","Obispo Santisteban","Montero","COLEGIO FRANZ TAMAYO",235462,343,21,2293,2636,1066,76,1130,2196
"Bolivia","Santa Cruz","Obispo Santisteban","Montero","COLEGIO GUILLERMO KRUEGLER",235463,475,19,2960,3435,2154,119,668,2822
"Bolivia","Santa Cruz","Obispo Santisteban","Montero","COLEGIO JOSE CRONEMBOL",235464,404,15,2141,2545,1565,78,483,2048
"Bolivia","Santa Cruz","Obispo Santisteban","Montero","COLEGIO JUAN ZABALA",235465,770,35,4491,5261,2796,132,1528,4324
"Bolivia","Santa Cruz","Obispo Santisteban","Montero","COLEGIO MARCELIANO MONTERO",235466,325,42,2464,2789,1844,86,492,2336
"Bolivia","Santa Cruz","Obispo Santisteban","Montero","COLEGIO MARCOS CHAVEZ",235467,348,23,2349,2697,1490,51,785,2275
"Bolivia","Santa Cruz","Obispo Santisteban","Montero","COLEGIO NACIONAL GUABIRA",235468,346,11,2427,2773,1400,126,890,2290
"Bolivia","Santa Cruz","Obispo Santisteban","Montero","COLEGIO OBISPO SANTISTEBAN",235469,253,4,1683,1936,1226,41,412,1638
"Bolivia","Santa Cruz","Obispo Santisteban","Montero","COLEGIO RAFAEL TERRAZAS",235470,325,8,1954,2279,1572,46,328,1900
"Bolivia","Santa Cruz","Obispo Santisteban","Montero","COLEGIO RENE MORENO",235471,199,9,2754,2953,2172,155,418,2590
"Bolivia","Santa Cruz","Obispo Santisteban","Montero","COLEGIO SAN JOSE OBRERO",235472,621,38,3672,4293,1383,137,2114,3497
"Bolivia","Santa Cruz","Obispo Santisteban","Montero","COLEGIO SIMON BOLIVAR",235473,173,8,1404,1577,983,110,303,1286
"Bolivia","Santa Cruz","Obispo Santisteban","Montero","COLEGIO UNIDAD EDUCATIVA ELVIRA FRIAS",235474,929,77,5774,6703,1833,287,3577,5410
"Bolivia","Santa Cruz","Obispo Santisteban","Montero","COLEGIO UNIDAD EDUCATIVA LA ESPERANZA",235476,304,10,2210,2514,1188,81,931,2119
"Bolivia","Santa Cruz","Obispo Santisteban","Montero","COLEGIO UNIDAD EDUCATIVA MONTECRISTO",235475,359,13,1873,2232,738,310,812,1550
"Bolivia","Santa Cruz","Obispo Santisteban","Montero","COLEGIO UNIDAD EDUCATIVA VILLA VIRGINIA",235477,358,24,1977,2335,563,86,1304,1867
"Bolivia","Santa Cruz","Obispo Santisteban","Montero","COLEGIO VICTOR SALVATIERRA",235478,266,8,1851,2117,1398,42,403,1801
"Bolivia","Santa Cruz","Obispo Santisteban","Montero","ESCUELA UNIDAD EDUCATIVA MARILUZ ESTREMADOIRO",235479,27,4,158,185,74,8,72,146
"Bolivia","Santa Cruz","Obispo Santisteban","Montero","UNIDAD EDUCATIVA 12 DE ABRIL",235480,23,3,331,354,148,19,161,309
"Bolivia","Santa Cruz","Obispo Santisteban","Montero","UNIDAD EDUCATIVA JUANCITO PINTO",235481,44,15,922,966,189,31,687,876
"Bolivia","Santa Cruz","Obispo Santisteban","Montero","UNIDAD EDUCATIVA MARCELIANO MONTERO",235482,251,14,1663,1914,1287,33,329,1616
"Bolivia","Santa Cruz","Obispo Santisteban","Montero","UNIDAD EDUCATIVA MAXIMILIANO KOLBE",235483,613,29,4199,4812,2592,165,1413,4005
"Bolivia","Santa Cruz","Obispo Santisteban","Montero","UNIDAD EDUCATIVA NUEVO MILENIO",235484,31,2,170,201,62,5,101,163
"Bolivia","Santa Cruz","Obispo Santisteban","Montero","UNIDAD EDUCATIVA SAN RAMON DE LA VIBORA",235485,15,0,154,169,41,4,109,150
"Bolivia","Santa Cruz","Obispo Santisteban","Montero","UNIDAD EDUCATIVA SAN SILVESTRE",235486,33,3,234,267,96,9,126,222
"Bolivia","Santa Cruz","Obispo Santisteban","Montero","UNIDAD EDUCATIVA SANTA ROSITA",235487,0,0,4,4,3,0,1,4
"Bolivia","Santa Cruz","Obispo Santisteban","San Pedro","ESCUELA 9 DE ABRIL",236374,106,9,588,694,180,12,387,567
"Bolivia","Santa Cruz","Obispo Santisteban","San Pedro","ESCUELA CANANDOA",236375,80,6,343,423,68,13,256,324
"Bolivia","Santa Cruz","Obispo Santisteban","San Pedro","ESCUELA FE Y ALEGRIA",236376,301,38,1758,2059,789,34,897,1686
"Bolivia","Santa Cruz","Obispo Santisteban","San Pedro","ESCUELA FE Y ALEGRIA TITO BOLTAN",236377,113,7,864,977,420,12,425,845
"Bolivia","Santa Cruz","Obispo Santisteban","San Pedro","ESCUELA NUCLEO CENTRAL MURILLO",236378,15,4,178,193,62,4,108,170
"Bolivia","Santa Cruz","Obispo Santisteban","San Pedro","ESCUELA OBISPO SANTISTEBAN",236379,77,6,601,678,162,34,399,561
"Bolivia","Santa Cruz","Obispo Santisteban","San Pedro","ESCUELA PADRE REMO PRANDINI VIOTTI",236380,195,29,1059,1254,380,22,628,1008
"Bolivia","Santa Cruz","Obispo Santisteban","San Pedro","ESCUELA SAN SILVESTRE",236381,16,0,113,129,34,1,78,112
"Bolivia","Santa Cruz","Obispo Santisteban","San Pedro","ESCUELA SECCIONAL LITORAL",236382,28,2,270,298,75,1,192,267
"Bolivia","Santa Cruz","Obispo Santisteban","San Pedro","ESCUELA UNIDAD EDUCATIVA PETA GRANDE",236383,25,1,112,137,24,8,79,103
"Bolivia","Santa Cruz","Obispo Santisteban","San Pedro","ESCUELA VILLA ROSARIO",236384,74,5,291,365,47,8,231,278
"Bolivia","Santa Cruz","Sara","La Bélgica","ESC, REPUBLICA DEL BRASIL",236357,109,8,689,798,478,20,183,661
"Bolivia","Santa Cruz","Sara","La Bélgica","ESCUELA LOLA TERRAZAS DE GASSER",236356,440,15,2358,2798,1357,39,947,2304
"Bolivia","Santa Cruz","Sara","Portachuelo","ESCUELA ANGEL MARIA LIMPIAS",236358,236,11,1770,2006,1310,24,425,1735
"Bolivia","Santa Cruz","Sara","Portachuelo","ESCUELA JULIO LANDIVAR",236359,176,6,1373,1549,1085,23,259,1344
"Bolivia","Santa Cruz","Sara","Portachuelo","ESCUELA LA APLICACION",236360,368,54,3185,3553,2389,107,635,3024
"Bolivia","Santa Cruz","Sara","Portachuelo","ESCUELA MARTINA DORADO",236361,365,60,2771,3136,1964,71,676,2640
"Bolivia","Santa Cruz","Sara","Portachuelo","ESCUELA NUCLEO CENTRAL",236362,88,9,595,683,403,4,179,582
"Bolivia","Santa Cruz","Sara","Portachuelo","ESCUELA PEROTO",236363,0,0,53,53,38,2,13,51
"Bolivia","Santa Cruz","Sara","Portachuelo","ESCUELA SAN IGNACIO",236364,59,3,363,422,225,7,128,353
"Bolivia","Santa Cruz","Sara","Santa Rosa","ESCUELA 4 DE MARZO",236034,35,5,293,328,31,10,247,278
"Bolivia","Santa Cruz","Sara","Santa Rosa","ESCUELA ALFREDO VACA FLOR",236035,100,8,454,554,58,13,375,433
"Bolivia","Santa Cruz","Sara","Santa Rosa","ESCUELA ALFREDO VASQUEZ",236036,65,7,575,640,438,33,97,535
"Bolivia","Santa Cruz","Sara","Santa Rosa","ESCUELA EL COLORADO",236037,18,2,97,115,40,3,52,92
"Bolivia","Santa Cruz","Sara","Santa Rosa","ESCUELA GALILEA",236038,63,2,404,467,71,4,327,398
"Bolivia","Santa Cruz","Sara","Santa Rosa","ESCUELA LA CONQUISTA",236039,72,6,363,435,53,17,287,340
"Bolivia","Santa Cruz","Sara","Santa Rosa","ESCUELA MIXTO LOS ANDES",236040,206,20,1067,1273,175,44,828,1003
"Bolivia","Santa Cruz","Sara","Santa Rosa","ESCUELA PALOMETAS",236041,16,0,83,99,46,0,37,83
"Bolivia","Santa Cruz","Sara","Santa Rosa","ESCUELA PASTO MERCADO QUIROGA",236042,64,6,318,382,145,12,155,300
"Bolivia","Santa Cruz","Sara","Santa Rosa","ESCUELA RINCON DE PALOMETA",236043,67,7,405,472,263,2,133,396
"Bolivia","Santa Cruz","Sara","Santa Rosa","ESCUELA SAN LUIS",236044,63,4,295,358,39,11,241,280
"Bolivia","Santa Cruz","Sara","Santa Rosa","ESCUELA SANTA ROSA",236045,565,37,2833,3398,1803,52,941,2744
"Bolivia","Santa Cruz","Valle Grande","Moromoro","ESCUELA ASTILLERO",232975,4,9,119,123,26,5,79,105
"Bolivia","Santa Cruz","Valle Grande","Moromoro","ESCUELA LA LAJA",232976,14,8,175,189,96,9,62,158
"Bolivia","Santa Cruz","Valle Grande","Moromoro","ESCUELA MOROMORO",232977,94,11,646,740,393,30,212,605
"Bolivia","Santa Cruz","Valle Grande","Moromoro","ESCUELA NUCLEO AÑAPACO",232978,0,0,25,25,15,1,9,24
"Bolivia","Santa Cruz","Valle Grande","Moromoro","ESCUELA NUCLEO ARIRUMA",232979,23,1,155,178,65,8,81,146
"Bolivia","Santa Cruz","Valle Grande","Moromoro","ESCUELA NUCLEO CENTRAL",232980,6,0,61,67,17,2,42,59
"Bolivia","Santa Cruz","Valle Grande","Moromoro","ESCUELA UNIDAD EDUCATIVA EL VELADERO",232981,39,8,245,284,114,14,109,223
"Bolivia","Santa Cruz","Valle Grande","Postrervalle","ESCUELA NUCLEO POSTERVALLE",235437,143,19,603,746,398,23,163,561
"Bolivia","Santa Cruz","Valle Grande","Postrervalle","ESCUELA SAN PABLO DE LA LADERA",235438,7,0,36,43,18,1,17,35
"Bolivia","Santa Cruz","Valle Grande","Postrervalle","ESCUELA TIERRAS NUEVAS",235439,16,0,105,121,87,3,15,102
"Bolivia","Santa Cruz","Valle Grande","Postrervalle","ESCUELA UNIDAD EDUCATIVA MOSQUERA",235440,31,5,92,123,68,3,16,84
"Bolivia","Santa Cruz","Valle Grande","Pucará","ESCUELA EDEY CORBAN SEHALLER",232432,99,9,593,692,262,18,304,566
"Bolivia","Santa Cruz","Valle Grande","Pucará","ESCUELA LA HIGUERA",232433,54,8,322,376,195,10,109,304
"Bolivia","Santa Cruz","Valle Grande","Trigal","ESCUELA LA AGUADA",232971,0,1,53,53,29,7,16,45
"Bolivia","Santa Cruz","Valle Grande","Trigal","ESCUELA LAGUNILLAS",232972,39,4,276,315,113,60,99,212
"Bolivia","Santa Cruz","Valle Grande","Trigal","ESCUELA SAN JOSE AGUIRRE ACHA",232973,136,10,533,669,266,15,242,508
"Bolivia","Santa Cruz","Valle Grande","Trigal","ESCUELA TTE. ROMAN ALDERETTE",232974,29,2,156,185,88,7,59,147
"Bolivia","Santa Cruz","Valle Grande","Vallegrande","ESCUELA ALTO SECO",236180,53,5,285,338,151,12,117,268
"Bolivia","Santa Cruz","Valle Grande","Vallegrande","ESCUELA CASAMONTES",236181,44,4,138,182,90,3,41,131
"Bolivia","Santa Cruz","Valle Grande","Vallegrande","ESCUELA CENTRAL GUADALUPE",236182,39,12,378,417,196,9,161,357
"Bolivia","Santa Cruz","Valle Grande","Vallegrande","ESCUELA DE CHACOPATA",236183,11,8,153,164,77,21,47,124
"Bolivia","Santa Cruz","Valle Grande","Vallegrande","ESCUELA DE MANKAILLPA",236184,0,0,61,61,44,7,10,54
"Bolivia","Santa Cruz","Valle Grande","Vallegrande","ESCUELA IGNACIO TERAN",236185,362,42,2095,2457,1261,109,683,1944
"Bolivia","Santa Cruz","Valle Grande","Vallegrande","ESCUELA JUANA CARMEN ROMAN",236186,300,25,1457,1757,857,71,504,1361
"Bolivia","Santa Cruz","Valle Grande","Vallegrande","ESCUELA LOMA LARGA",236187,13,1,88,101,67,1,19,86
"Bolivia","Santa Cruz","Valle Grande","Vallegrande","ESCUELA LOS SITANOS",236188,31,4,151,182,116,3,28,144
"Bolivia","Santa Cruz","Valle Grande","Vallegrande","ESCUELA MASICURI",236189,30,3,166,196,109,7,47,156
"Bolivia","Santa Cruz","Valle Grande","Vallegrande","ESCUELA NARANJO",236190,9,1,69,78,55,0,13,68
"Bolivia","Santa Cruz","Valle Grande","Vallegrande","ESCUELA NUCLEO EL BELLO",236191,8,4,90,98,76,0,10,86
"Bolivia","Santa Cruz","Valle Grande","Vallegrande","ESCUELA NUCLEO SAN JUAN",236192,15,5,158,173,101,3,49,150
"Bolivia","Santa Cruz","Valle Grande","Vallegrande","ESCUELA NUCLEO TUCUMANCILLO",236193,4,1,54,58,37,0,16,53
"Bolivia","Santa Cruz","Valle Grande","Vallegrande","ESCUELA OBISPO MANUEL JOSE PEÑA",236194,343,26,1917,2260,1149,100,642,1791
"Bolivia","Santa Cruz","Valle Grande","Vallegrande","ESCUELA PIRAIMIRI",236195,13,5,83,96,46,7,25,71
"Bolivia","Santa Cruz","Valle Grande","Vallegrande","ESCUELA SANTA ANA",236196,11,1,108,119,52,5,50,102
"Bolivia","Santa Cruz","Valle Grande","Vallegrande","ESCUELA SANTA ROSITA",236197,22,3,132,154,85,3,41,126
"Bolivia","Santa Cruz","Valle Grande","Vallegrande","ESCUELA TEMPORAL",236198,6,0,29,35,21,1,7,28
"Bolivia","Santa Cruz","Valle Grande","Vallegrande","ESCUELA UNIDAD EDUCATIVA ARENALES",236199,28,0,113,141,87,4,22,109
"Bolivia","Santa Cruz","Valle Grande","Vallegrande","KINDER SANTA MARIA",236200,239,26,1628,1867,968,80,554,1522
"Bolivia","Santa Cruz","Velasco","San Ignacio","15 DE AGOSTO",233224,28,5,192,220,13,6,168,181
"Bolivia","Santa Cruz","Velasco","San Ignacio","ESCUELA ALBERTO NATUSCH BUSCH",233225,6,0,36,42,11,0,25,36
"Bolivia","Santa Cruz","Velasco","San Ignacio","ESCUELA CAMPAMENTO",233226,121,10,391,512,206,16,159,365
"Bolivia","Santa Cruz","Velasco","San Ignacio","ESCUELA CARLOS MAYSER",233227,751,52,3206,3957,2263,74,817,3080
"Bolivia","Santa Cruz","Velasco","San Ignacio","ESCUELA CENTRAL EL PORVENIR",233228,89,2,119,208,46,1,70,116
"Bolivia","Santa Cruz","Velasco","San Ignacio","ESCUELA CENTRAL PISO FIRME",233229,32,4,143,175,49,6,84,133
"Bolivia","Santa Cruz","Velasco","San Ignacio","ESCUELA DON BOSCO",233230,500,65,2505,3005,1494,60,886,2380
"Bolivia","Santa Cruz","Velasco","San Ignacio","ESCUELA EL CARMEN DE RUIZ",233231,92,6,488,580,359,13,110,469
"Bolivia","Santa Cruz","Velasco","San Ignacio","ESCUELA LIC. SENORITAS MONSENOR DANIEL RIVE",233232,1047,45,4525,5572,3400,116,964,4364
"Bolivia","Santa Cruz","Velasco","San Ignacio","ESCUELA MARISCAL SUCRE",233233,890,47,3456,4346,2594,78,737,3331
"Bolivia","Santa Cruz","Velasco","San Ignacio","ESCUELA MIRAFLORES",233234,9,0,31,40,25,0,6,31
"Bolivia","Santa Cruz","Velasco","San Ignacio","ESCUELA NUCLEO CENTRAL ESPIRITU",233235,116,5,244,360,164,3,72,236
"Bolivia","Santa Cruz","Velasco","San Ignacio","ESCUELA PAILITA",233236,12,1,54,66,22,0,31,53
"Bolivia","Santa Cruz","Velasco","San Ignacio","ESCUELA RECREO",233237,17,1,108,125,38,1,68,106
"Bolivia","Santa Cruz","Velasco","San Ignacio","ESCUELA SAN JOSEMA",233238,6,5,97,103,27,4,61,88
"Bolivia","Santa Cruz","Velasco","San Ignacio","ESCUELA SAN JUAN DEL MACOÑO",233239,8,0,56,64,37,3,16,53
"Bolivia","Santa Cruz","Velasco","San Ignacio","ESCUELA SAN MARTIN",233240,193,14,705,898,97,29,565,662
"Bolivia","Santa Cruz","Velasco","San Ignacio","ESCUELA SANTA ANA",233241,107,2,363,470,274,4,83,357
"Bolivia","Santa Cruz","Velasco","San Ignacio","ESCUELA SANTA ROSA ROCA",233242,394,22,1053,1447,549,45,437,986
"Bolivia","Santa Cruz","Velasco","San Ignacio","ESCUELA SAN VICENTE",233243,61,5,229,290,122,10,92,214
"Bolivia","Santa Cruz","Velasco","San Ignacio","ESCUELA UNIDAD EDUCATIVA 25 DE JULIO",233244,18,1,67,85,41,5,20,61
"Bolivia","Santa Cruz","Velasco","San Ignacio","ESCUELA UNIDAD EDUCATIVA LA ESTRELLA",233245,44,5,337,381,106,13,213,319
"Bolivia","Santa Cruz","Velasco","San Ignacio","ESCUELA UNIDAD EDUCATIVA SIMON BOLIVAR",233247,14,0,118,132,55,6,57,112
"Bolivia","Santa Cruz","Velasco","San Ignacio","UNIDAD EDUCATIVA 15 DE AGOSTO",233248,5,0,105,110,16,2,87,103
"Bolivia","Santa Cruz","Velasco","San Ignacio","UNIDAD EDUCATIVA 19 DE MARZO",233249,8,0,0,8,0,0,0,0
"Bolivia","Santa Cruz","Velasco","San Ignacio","UNIDAD EDUCATIVA BERNARDO MONTEAGUDO",233251,11,1,94,105,6,2,85,91
"Bolivia","Santa Cruz","Velasco","San Ignacio","UNIDAD EDUCATIVA CELEDONIO CORTEZON",233252,4,0,0,4,0,0,0,0
"Bolivia","Santa Cruz","Velasco","San Ignacio","UNIDAD EDUCATIVA JOSE CHAVEZ",233253,1,0,75,76,41,1,33,74
"Bolivia","Santa Cruz","Velasco","San Ignacio","UNIDAD EDUCATIVA JOSE FERREIRA",233254,3,0,41,44,25,0,16,41
"Bolivia","Santa Cruz","Velasco","San Ignacio","UNIDAD EDUCATIVA JOSE PESSOA",233255,0,2,42,42,23,2,15,38
"Bolivia","Santa Cruz","Velasco","San Ignacio","UNIDAD EDUCATIVA MERCEDES DE LAS MINAS",233257,3,2,50,53,27,0,21,48
"Bolivia","Santa Cruz","Velasco","San Ignacio","UNIDAD EDUCATIVA SAN BARTOLO DE LA FRONTERA",233258,22,1,109,131,57,5,46,103
"Bolivia","Santa Cruz","Velasco","San Ignacio","UNIDAD EDUCATIVA SAN JAVIERITO",233259,12,3,247,259,155,21,68,223
"Bolivia","Santa Cruz","Velasco","San Ignacio","UNIDAD EDUCATIVA SAN LORENCITO DE LA FRONTERA",233260,12,1,107,119,68,2,36,104
"Bolivia","Santa Cruz","Velasco","San Ignacio","UNIDAD EDUCATIVA SAN RAFAELITO DE SUPONEMA",233261,4,1,107,111,86,1,19,105
"Bolivia","Santa Cruz","Velasco","San Ignacio","UNIDAD EDUCATIVA SANTA ANITA DE LA FRONTERA",233262,5,1,64,69,9,1,53,62
"Bolivia","Santa Cruz","Velasco","San Ignacio","UNIDAD EDUCATIVA TARCILA JUSTINIANO",233263,4,1,68,72,30,3,34,64
"Bolivia","Santa Cruz","Velasco","San Ignacio","UNIDAD EDUCATIVA TIERRA FIRME",233264,13,1,123,136,7,4,111,118
"Bolivia","Santa Cruz","Velasco","San Miguel","ESCUELA BELISARIO SANTISTEBAN",233265,369,14,1819,2188,784,34,987,1771
"Bolivia","Santa Cruz","Velasco","San Miguel","ESCUELA JOSE J. DORADO",233266,431,61,2409,2840,1178,44,1126,2304
"Bolivia","Santa Cruz","Velasco","San Miguel","ESCUELA MONSEÑOR BONIFACIO",233267,59,9,378,437,203,7,159,362
"Bolivia","Santa Cruz","Velasco","San Miguel","ESCUELA UNIDAD EDUCATIVA CRUZ DEL TOCOIGO",233269,14,3,112,126,27,1,81,108
"Bolivia","Santa Cruz","Velasco","San Miguel","ESCUELA UNIDAD EDUCATIVA SAN LUISITO DE LIMA",233270,2,0,20,22,1,2,17,18
"Bolivia","Santa Cruz","Velasco","San Miguel","ESCUELA UNIDAD EDUCATIVA SAN PEDRO DEL CERRITO",233271,6,0,49,55,17,2,30,47
"Bolivia","Santa Cruz","Velasco","San Miguel","UNIDAD EDUCATIVA ALTAMIRA",233272,6,2,49,55,6,1,40,46
"Bolivia","Santa Cruz","Velasco","San Miguel","UNIDAD EDUCATIVA SAPOCO",233275,0,3,85,85,11,1,70,81
"Bolivia","Santa Cruz","Velasco","San Rafael","ESCUELA EL TUNA",236017,32,0,138,170,106,3,29,135
"Bolivia","Santa Cruz","Velasco","San Rafael","ESCUELA GODOFREDO TRENKER",236018,458,24,1673,2131,1119,39,491,1610
"Bolivia","Santa Cruz","Velasco","San Rafael","ESCUELA MIRAFLORES II",236019,64,0,228,292,56,5,167,223
"Bolivia","Santa Cruz","Velasco","San Rafael","ESCUELA VILLA FATIMA",236021,17,1,52,69,34,3,14,48
"Bolivia","Santa Cruz","Warnes","Okinawa 1","ESCUELA COLEGIO EVANGELICO METODISTA",236171,486,66,3233,3719,2007,172,988,2995
"Bolivia","Santa Cruz","Warnes","Okinawa 1","ESCUELA NUEVA AURORA",236170,7,0,48,55,39,0,9,48
"Bolivia","Santa Cruz","Warnes","Okinawa 1","ESCUELA UNIDAD EDUCATIVA NUEVA ESPERANZA",236173,30,5,201,231,107,6,83,190
"Bolivia","Santa Cruz","Warnes","Okinawa 1","ESCUELA UNIDAD EDUCATIVA NUEVO HORIZONTE",236172,135,14,934,1069,639,9,272,911
"Bolivia","Santa Cruz","Warnes","Okinawa 1","ESCUELA UNIDAD EDUCATIVA SAN MIGUEL",236174,60,3,373,433,217,8,145,362
"Bolivia","Santa Cruz","Warnes","Okinawa 1","ESCUELA UNIDAD EDUCATIVA SECCIONAL PUERTO NUEVO",236175,52,5,338,390,251,5,77,328
"Bolivia","Santa Cruz","Warnes","Okinawa 1","ESCUELA UNIDAD EDUCATIVA VILLA REYES",236176,19,0,129,148,54,5,70,124
"Bolivia","Santa Cruz","Warnes","Warnes","26 DE MARZO",236128,25,2,152,177,57,28,65,122
"Bolivia","Santa Cruz","Warnes","Warnes","ESCUELA ADRIAN JUSTINIANO ROCA",236129,73,12,474,547,287,10,165,452
"Bolivia","Santa Cruz","Warnes","Warnes","ESCUELA CIUDAD SATELITE NORTE",236130,1688,57,8634,10322,3703,302,4572,8275
"Bolivia","Santa Cruz","Warnes","Warnes","ESCUELA COLEGIO CONSTANTINO CUELLAR",236131,477,89,3386,3863,2007,85,1205,3212
"Bolivia","Santa Cruz","Warnes","Warnes","ESCUELA COLEGIO JULIA SAID",236132,1125,51,6745,7870,3208,253,3233,6441
"Bolivia","Santa Cruz","Warnes","Warnes","ESCUELA EL JIPA",236133,34,5,450,484,197,17,231,428
"Bolivia","Santa Cruz","Warnes","Warnes","ESCUELA FISCAL POTRERO LARGO",236134,448,24,2508,2956,1064,103,1317,2381
"Bolivia","Santa Cruz","Warnes","Warnes","ESCUELA JUANA AZURDUY DE PADILLA",236135,633,32,4061,4694,1485,187,2357,3842
"Bolivia","Santa Cruz","Warnes","Warnes","ESCUELA TERRACOR",236136,324,24,2002,2326,1188,49,741,1929
"Bolivia","Santa Cruz","Warnes","Warnes","ESCUELA UNIDAD EDUCATIVA 21 DE OCTUBRE",236144,30,5,171,201,27,5,134,161
"Bolivia","Santa Cruz","Warnes","Warnes","ESCUELA UNIDAD EDUCATIVA ANGELMIRA MONTE. DE DALENCE",236137,46,6,429,475,269,9,145,414
"Bolivia","Santa Cruz","Warnes","Warnes","ESCUELA UNIDAD EDUCATIVA DON BOSCO",236145,91,4,566,657,333,17,212,545
"Bolivia","Santa Cruz","Warnes","Warnes","ESCUELA UNIDAD EDUCATIVA EL TAJIBO",236146,146,14,736,882,434,18,270,704
"Bolivia","Santa Cruz","Warnes","Warnes","ESCUELA UNIDAD EDUCATIVA FELIX PAZ VIEIRA",236147,26,17,287,313,127,9,134,261
"Bolivia","Santa Cruz","Warnes","Warnes","ESCUELA UNIDAD EDUCATIVA JUAN LATINO",236148,59,5,392,451,188,17,182,370
"Bolivia","Santa Cruz","Warnes","Warnes","ESCUELA UNIDAD EDUCATIVA LA REFORMA",236149,87,13,627,714,301,7,306,607
"Bolivia","Santa Cruz","Warnes","Warnes","ESCUELA UNIDAD EDUCATIVA LAS BARRERAS",236138,189,29,1575,1764,761,101,684,1445
"Bolivia","Santa Cruz","Warnes","Warnes","ESCUELA UNIDAD EDUCATIVA LOS CHACOS",236150,54,5,360,414,251,2,102,353
"Bolivia","Santa Cruz","Warnes","Warnes","ESCUELA UNIDAD EDUCATIVA MARIANO VACA MONTERO",236139,163,10,849,1012,458,49,332,790
"Bolivia","Santa Cruz","Warnes","Warnes","ESCUELA UNIDAD EDUCATIVA MOTACU",236151,30,2,206,236,140,3,61,201
"Bolivia","Santa Cruz","Warnes","Warnes","ESCUELA UNIDAD EDUCATIVA NUCLEO CENTRAL CLARA CHUCHIO",236140,84,8,615,699,397,14,196,593
"Bolivia","Santa Cruz","Warnes","Warnes","ESCUELA UNIDAD EDUCATIVA SECCIONAL AZUZAQUI",236141,33,3,340,373,149,13,175,324
"Bolivia","Santa Cruz","Warnes","Warnes","ESCUELA UNIDAD EDUCATIVA SECCIONAL EL FUTURO",236152,6,3,73,79,27,2,41,68
"Bolivia","Santa Cruz","Warnes","Warnes","ESCUELA UNIDAD EDUCATIVA SECCIONAL LA MARINA",236142,62,9,345,407,123,8,205,328
"Bolivia","Santa Cruz","Warnes","Warnes","ESCUELA UNIDAD EDUCATIVA TUROBITO",236143,26,5,314,340,193,16,100,293
"Bolivia","Santa Cruz","Warnes","Warnes","ESCUELA VALLE SANCHEZ",236153,523,14,2806,3329,1988,78,726,2714
"Bolivia","Santa Cruz","Warnes","Warnes","POLITECNICO PENTAGUAZU",236154,8,0,53,61,23,0,30,53
"Bolivia","Santa Cruz","Warnes","Warnes","UNIDAD EDUCATIVA AKUALAND",236155,23,1,330,353,217,5,107,324
"Bolivia","Santa Cruz","Warnes","Warnes","UNIDAD EDUCATIVA ANTONIO ANZUATI",236156,12,2,163,175,52,8,101,153
"Bolivia","Santa Cruz","Warnes","Warnes","UNIDAD EDUCATIVA BUENA FE",236157,52,5,673,725,181,55,432,613
"Bolivia","Santa Cruz","Warnes","Warnes","UNIDAD EDUCATIVA CAMPO ROSSO 4 DE ABRIL",236158,157,9,1048,1205,489,28,522,1011
"Bolivia","Santa Cruz","Warnes","Warnes","UNIDAD EDUCATIVA EL MANANTIAL",236159,94,2,738,832,407,14,315,722
"Bolivia","Santa Cruz","Warnes","Warnes","UNIDAD EDUCATIVA IGNACIO WARNES",236160,1162,44,7429,8591,4224,228,2933,7157
"Bolivia","Santa Cruz","Warnes","Warnes","UNIDAD EDUCATIVA JOSE MANUEL VACA",236161,34,5,235,269,134,4,92,226
"Bolivia","Santa Cruz","Warnes","Warnes","UNIDAD EDUCATIVA JUANCITO PINTO",236162,19,1,252,271,78,6,167,245
"Bolivia","Santa Cruz","Warnes","Warnes","UNIDAD EDUCATIVA MAXIMO NOVILLO",236163,0,10,975,975,320,107,538,858
"Bolivia","Santa Cruz","Warnes","Warnes","UNIDAD EDUCATIVA MONTE CARMELO",236164,26,2,251,277,104,37,108,212
"Bolivia","Santa Cruz","Warnes","Warnes","UNIDAD EDUCATIVA NUEVA JERUSALEN-PENTAGUAZU",236165,30,1,377,407,155,8,213,368
"Bolivia","Santa Cruz","Warnes","Warnes","UNIDAD EDUCATIVA PAITITI",236166,18,3,232,250,68,5,156,224
"Bolivia","Santa Cruz","Warnes","Warnes","UNIDAD EDUCATIVA SAN JUAN",236167,122,3,865,987,414,31,417,831
"Bolivia","Santa Cruz","Warnes","Warnes","UNIDAD EDUCATIVA SATELITE NORTE",236168,91,3,565,656,251,25,286,537
"Bolivia","Santa Cruz","Warnes","Warnes","UNIDAD EDUCATIVA WAJOJO",236169,12,5,225,237,89,15,116,205
"Bolivia","Tarija","Arce","Bermejo","CARCELETA BERMEJO",234935,1,0,14,15,6,0,8,14
"Bolivia","Tarija","Arce","Bermejo","UNIDAD EDUCATIVA 25 DE MAYO",234936,751,34,2989,3740,1773,60,1122,2895
"Bolivia","Tarija","Arce","Bermejo","UNIDAD EDUCATIVA 8 DE SEPTIEMBRE",234937,499,33,1867,2366,936,54,844,1780
"Bolivia","Tarija","Arce","Bermejo","UNIDAD EDUCATIVA ANTONIO JOSE DE SUCRE",234938,197,5,812,1009,408,22,377,785
"Bolivia","Tarija","Arce","Bermejo","UNIDAD EDUCATIVA ARROZALES",234939,45,2,187,232,72,6,107,179
"Bolivia","Tarija","Arce","Bermejo","UNIDAD EDUCATIVA AULIO ARAOZ",234940,444,32,1518,1962,708,62,716,1424
"Bolivia","Tarija","Arce","Bermejo","UNIDAD EDUCATIVA BARREDERO",234941,59,6,258,317,42,5,205,247
"Bolivia","Tarija","Arce","Bermejo","UNIDAD EDUCATIVA CAMPO GRANDE (ARCE)",234942,111,12,300,411,84,30,174,258
"Bolivia","Tarija","Arce","Bermejo","UNIDAD EDUCATIVA COLONIA LINARES",234943,127,18,486,613,124,20,324,448
"Bolivia","Tarija","Arce","Bermejo","UNIDAD EDUCATIVA EDUARDO AVAROA",234944,920,44,3542,4462,1931,103,1464,3395
"Bolivia","Tarija","Arce","Bermejo","UNIDAD EDUCATIVA FLOR DE ORO",234945,47,3,141,188,56,4,78,134
"Bolivia","Tarija","Arce","Bermejo","UNIDAD EDUCATIVA GUIDO VILLAGOMEZ",234946,648,45,2524,3172,1332,71,1076,2408
"Bolivia","Tarija","Arce","Bermejo","UNIDAD EDUCATIVA LA ESPERANZA",234947,16,6,289,305,77,5,201,278
"Bolivia","Tarija","Arce","Bermejo","UNIDAD EDUCATIVA MOTO MENDEZ",234948,78,11,209,287,71,8,119,190
"Bolivia","Tarija","Arce","Bermejo","UNIDAD EDUCATIVA MSCAL. ANDRES DE SANTA CRUZ",234949,620,20,1911,2531,1155,37,699,1854
"Bolivia","Tarija","Arce","Bermejo","UNIDAD EDUCATIVA OCTAVIO CAMPERO ECHAZU (BERMEJO)",234950,795,42,3075,3870,1617,101,1315,2932
"Bolivia","Tarija","Arce","Bermejo","UNIDAD EDUCATIVA PORCELANA",234951,40,6,97,137,28,3,60,88
"Bolivia","Tarija","Arce","Padcaya","ESCUELA SECCIONAL QUEÑAHUAYCO",234904,31,2,259,290,37,9,211,248
"Bolivia","Tarija","Arce","Padcaya","ESCUELA TACUARA SIMON BOLIVAR",234905,38,2,154,192,30,2,120,150
"Bolivia","Tarija","Arce","Padcaya","NUCLEO 9 DE OCTUBRE",234906,73,5,169,242,30,7,127,157
"Bolivia","Tarija","Arce","Padcaya","NUCLEO SAN TELMO/PRIMERO DE MAYO",234907,50,8,278,328,124,16,130,254
"Bolivia","Tarija","Arce","Padcaya","UNIDAD EDUCATIVA 2 DE AGOSTO",234908,66,3,248,314,30,8,207,237
"Bolivia","Tarija","Arce","Padcaya","UNIDAD EDUCATIVA ABRA DE SAN MIGUEL",234909,12,1,213,225,80,1,131,211
"Bolivia","Tarija","Arce","Padcaya","UNIDAD EDUCATIVA ANICETO ARCE",234910,317,26,1759,2076,975,41,717,1692
"Bolivia","Tarija","Arce","Padcaya","UNIDAD EDUCATIVA ANZELMO ONTIVEROS",234911,73,4,365,438,71,8,282,353
"Bolivia","Tarija","Arce","Padcaya","UNIDAD EDUCATIVA BLANCA NAVAJAS",234912,89,6,384,473,105,31,242,347
"Bolivia","Tarija","Arce","Padcaya","UNIDAD EDUCATIVA CAMACHO",234913,64,5,367,431,84,9,269,353
"Bolivia","Tarija","Arce","Padcaya","UNIDAD EDUCATIVA CANCHAS MAYU",234914,28,2,209,237,42,2,163,205
"Bolivia","Tarija","Arce","Padcaya","UNIDAD EDUCATIVA EL CARMEN",234915,25,1,135,160,32,1,101,133
"Bolivia","Tarija","Arce","Padcaya","UNIDAD EDUCATIVA ELOY APARICIO",234916,116,8,518,634,188,12,310,498
"Bolivia","Tarija","Arce","Padcaya","UNIDAD EDUCATIVA JUAN PABLO II",234917,54,1,127,181,50,3,73,123
"Bolivia","Tarija","Arce","Padcaya","UNIDAD EDUCATIVA LA HUERTA",234918,43,7,209,252,27,6,169,196
"Bolivia","Tarija","Arce","Padcaya","UNIDAD EDUCATIVA LA MERCED",234919,64,4,338,402,171,11,152,323
"Bolivia","Tarija","Arce","Padcaya","UNIDAD EDUCATIVA LIMAL",234920,21,0,107,128,35,3,69,104
"Bolivia","Tarija","Arce","Padcaya","UNIDAD EDUCATIVA NARANJO AGRIO",234921,23,1,100,123,17,1,81,98
"Bolivia","Tarija","Arce","Padcaya","UNIDAD EDUCATIVA OROZAS ARRIBA",234922,90,15,505,595,137,23,330,467
"Bolivia","Tarija","Arce","Padcaya","UNIDAD EDUCATIVA OSCAR HIZA BASTIAS",234923,117,9,466,583,149,19,289,438
"Bolivia","Tarija","Arce","Padcaya","UNIDAD EDUCATIVA PAMPA GRANDE",234924,181,23,464,645,110,17,314,424
"Bolivia","Tarija","Arce","Padcaya","UNIDAD EDUCATIVA QUEBRADA DE CAÑAS",234925,25,3,135,160,19,6,107,126
"Bolivia","Tarija","Arce","Padcaya","UNIDAD EDUCATIVA RIO NEGRO",234926,53,11,305,358,103,11,180,283
"Bolivia","Tarija","Arce","Padcaya","UNIDAD EDUCATIVA ROSILLAS II",234927,110,10,525,635,211,11,293,504
"Bolivia","Tarija","Arce","Padcaya","UNIDAD EDUCATIVA RUMY CANCHA",234928,45,6,146,191,57,6,77,134
"Bolivia","Tarija","Arce","Padcaya","UNIDAD EDUCATIVA SALADO CONCHAS",234929,15,0,122,137,27,2,93,120
"Bolivia","Tarija","Arce","Padcaya","UNIDAD EDUCATIVA SAN ANTONIO DE MACOYA",234930,92,6,233,325,164,12,51,215
"Bolivia","Tarija","Arce","Padcaya","UNIDAD EDUCATIVA SAN FRANCISCO (ARCE)",234931,22,1,151,173,34,5,111,145
"Bolivia","Tarija","Arce","Padcaya","UNIDAD EDUCATIVA SAN JOSE DE MARAÑUELO",234932,20,3,175,195,18,2,152,170
"Bolivia","Tarija","Arce","Padcaya","UNIDAD EDUCATIVA SIMON BOLIVAR DE REJARA",234933,49,2,271,320,21,4,244,265
"Bolivia","Tarija","Arce","Padcaya","UNIDAD EDUCATIVA VIRGEN DE CHAGUAYA",234934,70,4,296,366,108,11,173,281
"Bolivia","Tarija","Avilés","Concepción (Uriondo)","COLEGIO DELFIN PINO ICHAZU",233100,359,20,1833,2192,1080,75,658,1738
"Bolivia","Tarija","Avilés","Concepción (Uriondo)","ESCUELA FELIPE ARAOZ",233101,72,8,255,327,107,10,130,237
"Bolivia","Tarija","Avilés","Concepción (Uriondo)","ESCUELA MULLI CANCHA 27 DE MAYO",233102,15,2,67,82,23,7,35,58
"Bolivia","Tarija","Avilés","Concepción (Uriondo)","ESCUELA NICOLAS GARECA",233103,18,8,125,143,36,8,73,109
"Bolivia","Tarija","Avilés","Concepción (Uriondo)","ESCUELA WALTER MADALLENO",233104,79,4,223,302,48,8,163,211
"Bolivia","Tarija","Avilés","Concepción (Uriondo)","UNIDAD EDUCATIVA 15 DE OCTUBRE",233105,121,9,347,468,82,12,244,326
"Bolivia","Tarija","Avilés","Concepción (Uriondo)","UNIDAD EDUCATIVA 19 DE MARZO",233106,44,4,203,247,73,7,119,192
"Bolivia","Tarija","Avilés","Concepción (Uriondo)","UNIDAD EDUCATIVA ANCON CHICO",233107,37,5,295,332,106,4,180,286
"Bolivia","Tarija","Avilés","Concepción (Uriondo)","UNIDAD EDUCATIVA ANCON GRANDE",233108,9,0,129,138,82,8,39,121
"Bolivia","Tarija","Avilés","Concepción (Uriondo)","UNIDAD EDUCATIVA ANICETO ARCE",233109,181,22,870,1051,431,28,389,820
"Bolivia","Tarija","Avilés","Concepción (Uriondo)","UNIDAD EDUCATIVA LA CHOZA",233110,85,13,590,675,323,32,222,545
"Bolivia","Tarija","Avilés","Concepción (Uriondo)","UNIDAD EDUCATIVA LA COMPAÑIA",233111,37,7,329,366,106,14,202,308
"Bolivia","Tarija","Avilés","Concepción (Uriondo)","UNIDAD EDUCATIVA NUEVO AMANECER",233112,178,17,888,1066,450,19,402,852
"Bolivia","Tarija","Avilés","Concepción (Uriondo)","UNIDAD EDUCATIVA ROSARIO JARAMILLO",233113,261,40,1842,2103,823,84,895,1718
"Bolivia","Tarija","Avilés","Concepción (Uriondo)","UNIDAD EDUCATIVA VIRGEN DE LADERAS",233114,27,4,166,193,45,9,108,153
"Bolivia","Tarija","Avilés","Yunchara","COLEGIO 6 DE ABRIL",232214,67,1,260,327,61,12,186,247
"Bolivia","Tarija","Avilés","Yunchara","UNIDAD EDUCATIVA 13 DE ABRIL",232215,28,1,162,190,10,8,143,153
"Bolivia","Tarija","Avilés","Yunchara","UNIDAD EDUCATIVA 15 DE ABRIL",232216,13,3,67,80,8,2,54,62
"Bolivia","Tarija","Avilés","Yunchara","UNIDAD EDUCATIVA 25 DE MAYO",232217,39,2,194,233,26,7,159,185
"Bolivia","Tarija","Avilés","Yunchara","UNIDAD EDUCATIVA CHORCOYA AVILES",232218,24,4,123,147,43,5,71,114
"Bolivia","Tarija","Avilés","Yunchara","UNIDAD EDUCATIVA FELIX RAMOS",232219,23,0,54,77,7,2,45,52
"Bolivia","Tarija","Avilés","Yunchara","UNIDAD EDUCATIVA HUGO AMABLE HOYOS",232220,8,1,45,53,3,0,41,44
"Bolivia","Tarija","Avilés","Yunchara","UNIDAD EDUCATIVA JOSE BALLIVIAN",232221,90,10,208,298,44,6,148,192
"Bolivia","Tarija","Avilés","Yunchara","UNIDAD EDUCATIVA JOSE MARIA AVILES",232222,18,1,99,117,15,7,76,91
"Bolivia","Tarija","Avilés","Yunchara","UNIDAD EDUCATIVA NARCISO CAMPERO",232223,36,6,124,160,23,6,89,112
"Bolivia","Tarija","Avilés","Yunchara","UNIDAD EDUCATIVA ÑOQUERA",232224,35,5,151,186,53,3,90,143
"Bolivia","Tarija","Avilés","Yunchara","UNIDAD EDUCATIVA PASAJES",232225,48,5,272,320,50,10,207,257
"Bolivia","Tarija","Avilés","Yunchara","UNIDAD EDUCATIVA QUEBRADA HONDA",232226,36,0,125,161,19,5,101,120
"Bolivia","Tarija","Avilés","Yunchara","UNIDAD EDUCATIVA SAN JOSE DE CHURQUIS",232227,22,3,68,90,8,6,51,59
"Bolivia","Tarija","Avilés","Yunchara","UNIDAD EDUCATIVA SATURNINO URZAGASTE",232228,18,0,123,141,15,0,108,123
"Bolivia","Tarija","Avilés","Yunchara","UNIDAD EDUCATIVA YUTICANCHA",232229,4,2,91,95,13,5,71,84
"Bolivia","Tarija","Burnet O'Connor","Entre Rios","CENTRO P.A.N TENTAGUAZU",233193,35,0,116,151,75,4,37,112
"Bolivia","Tarija","Burnet O'Connor","Entre Rios","UNIDAD EDUCATIVA 12 DE ABRIL",233194,69,5,350,419,235,5,105,340
"Bolivia","Tarija","Burnet O'Connor","Entre Rios","UNIDAD EDUCATIVA CANALETAS CENTRO",233195,32,2,134,166,33,7,92,125
"Bolivia","Tarija","Burnet O'Connor","Entre Rios","UNIDAD EDUCATIVA CHIQUIACA CENTRO",233196,64,14,431,495,153,11,253,406
"Bolivia","Tarija","Burnet O'Connor","Entre Rios","UNIDAD EDUCATIVA CNL. EUSTAQUIO MENDEZ",233197,43,6,346,389,94,14,232,326
"Bolivia","Tarija","Burnet O'Connor","Entre Rios","UNIDAD EDUCATIVA FRANZ TAMAYO",233198,870,75,4070,4940,2194,116,1685,3879
"Bolivia","Tarija","Burnet O'Connor","Entre Rios","UNIDAD EDUCATIVA HUAICO ACERRADERO",233199,53,4,244,297,90,12,138,228
"Bolivia","Tarija","Burnet O'Connor","Entre Rios","UNIDAD EDUCATIVA JUAN SAAVEDRA MEALLA",233200,62,5,262,324,119,11,127,246
"Bolivia","Tarija","Burnet O'Connor","Entre Rios","UNIDAD EDUCATIVA LAGUNITAS",233201,42,2,101,143,61,5,33,94
"Bolivia","Tarija","Burnet O'Connor","Entre Rios","UNIDAD EDUCATIVA LUIS VACA GALLARDO",233202,47,5,176,223,98,7,66,164
"Bolivia","Tarija","Burnet O'Connor","Entre Rios","UNIDAD EDUCATIVA MISTOLAR",233203,80,1,146,226,86,4,55,141
"Bolivia","Tarija","Burnet O'Connor","Entre Rios","UNIDAD EDUCATIVA ÑAURENDA",233204,58,4,265,323,100,9,152,252
"Bolivia","Tarija","Burnet O'Connor","Entre Rios","UNIDAD EDUCATIVA PAJONAL",233205,34,4,161,195,74,3,80,154
"Bolivia","Tarija","Burnet O'Connor","Entre Rios","UNIDAD EDUCATIVA PAMPA REDONDA",233206,16,0,118,134,23,3,92,115
"Bolivia","Tarija","Burnet O'Connor","Entre Rios","UNIDAD EDUCATIVA POTRERILLOS (O CONNOR)",233207,45,13,250,295,105,3,129,234
"Bolivia","Tarija","Burnet O'Connor","Entre Rios","UNIDAD EDUCATIVA PROF. EMILIANO VILLARRUBIA",233208,44,2,226,270,114,6,104,218
"Bolivia","Tarija","Burnet O'Connor","Entre Rios","UNIDAD EDUCATIVA PROFESOR RENE AVILA BAYON",233209,141,13,504,645,179,21,291,470
"Bolivia","Tarija","Burnet O'Connor","Entre Rios","UNIDAD EDUCATIVA PUESTO MARGARITA",233210,27,3,108,135,65,4,36,101
"Bolivia","Tarija","Burnet O'Connor","Entre Rios","UNIDAD EDUCATIVA REMIGIO VACA",233211,31,2,118,149,60,23,33,93
"Bolivia","Tarija","Burnet O'Connor","Entre Rios","UNIDAD EDUCATIVA SAN DIEGO CENTRO",233212,69,6,263,332,70,4,183,253
"Bolivia","Tarija","Burnet O'Connor","Entre Rios","UNIDAD EDUCATIVA SAN SIMON",233213,20,7,123,143,56,1,59,115
"Bolivia","Tarija","Burnet O'Connor","Entre Rios","UNIDAD EDUCATIVA SECCIONAL BERETY",233214,24,1,127,151,60,3,63,123
"Bolivia","Tarija","Burnet O'Connor","Entre Rios","UNIDAD EDUCATIVA SECCIONAL CAÑADAS",233215,11,1,25,36,15,0,9,24
"Bolivia","Tarija","Burnet O'Connor","Entre Rios","UNIDAD EDUCATIVA SIVINGAL",233216,30,3,188,218,23,8,154,177
"Bolivia","Tarija","Burnet O'Connor","Entre Rios","UNIDAD EDUCATIVA TAQUILLOS",233217,15,3,75,90,18,2,52,70
"Bolivia","Tarija","Burnet O'Connor","Entre Rios","UNIDAD EDUCATIVA TARUPAYO",233218,52,0,129,181,63,5,61,124
"Bolivia","Tarija","Burnet O'Connor","Entre Rios","UNIDAD EDUCATIVA TENTAPIAO",233219,27,1,72,99,53,2,16,69
"Bolivia","Tarija","Burnet O'Connor","Entre Rios","UNIDAD EDUCATIVA TIMBOY",233220,106,7,357,463,203,16,131,334
"Bolivia","Tarija","Burnet O'Connor","Entre Rios","UNIDAD EDUCATIVA TTE. GUALBERTO VILLARROEL",233221,54,3,223,277,80,10,130,210
"Bolivia","Tarija","Burnet O'Connor","Entre Rios","UNIDAD EDUCATIVA VALLECITO DE LOS LAPACHOS",233222,25,8,157,182,91,6,52,143
"Bolivia","Tarija","Burnet O'Connor","Entre Rios","UNIDAD EDUCATIVA YUKIMBIA",233223,21,0,128,149,17,3,108,125
"Bolivia","Tarija","Cercado","Tarija","ALDEAS S.O.S ALTO SENAC",234835,133,11,842,975,603,19,209,812
"Bolivia","Tarija","Cercado","Tarija","C.E.B.A.",234837,571,37,2861,3432,1716,96,1012,2728
"Bolivia","Tarija","Cercado","Tarija","LOCAL PALO SANTO",234838,342,12,1738,2080,1148,35,543,1691
"Bolivia","Tarija","Cercado","Tarija","PENAL DE MORROS BLANCOS",234836,38,3,153,191,66,5,79,145
"Bolivia","Tarija","Cercado","Tarija","SALON CAPACITACION BARRIO CATEDRAL",234839,107,8,696,803,472,9,207,679
"Bolivia","Tarija","Cercado","Tarija","U.A.J.M.S CAMPUS",234840,396,6,2039,2435,1603,47,383,1986
"Bolivia","Tarija","Cercado","Tarija","UNIDAD EDUCATIVA 15 DE ABRIL",234841,49,7,209,258,155,5,42,197
"Bolivia","Tarija","Cercado","Tarija","UNIDAD EDUCATIVA 6 DE JUNIO",234842,168,11,904,1072,604,25,264,868
"Bolivia","Tarija","Cercado","Tarija","UNIDAD EDUCATIVA ALTO DE ESPAÑA NORTE",234843,58,9,212,270,63,34,106,169
"Bolivia","Tarija","Cercado","Tarija","UNIDAD EDUCATIVA AUDELIO QUIFRE",234844,53,4,178,231,57,7,110,167
"Bolivia","Tarija","Cercado","Tarija","UNIDAD EDUCATIVA AVELINA RAÑA",234845,614,26,3520,4134,2628,50,816,3444
"Bolivia","Tarija","Cercado","Tarija","UNIDAD EDUCATIVA BANCARIO",234846,86,4,639,725,518,7,110,628
"Bolivia","Tarija","Cercado","Tarija","UNIDAD EDUCATIVA BELGRANO",234847,965,25,5409,6374,4355,105,924,5279
"Bolivia","Tarija","Cercado","Tarija","UNIDAD EDUCATIVA BELLA VISTA",234848,124,17,444,568,153,27,247,400
"Bolivia","Tarija","Cercado","Tarija","UNIDAD EDUCATIVA BOLIVIA",234849,581,18,4290,4871,3316,114,842,4158
"Bolivia","Tarija","Cercado","Tarija","UNIDAD EDUCATIVA CARLAZO CENTRO",234850,34,4,140,174,67,6,63,130
"Bolivia","Tarija","Cercado","Tarija","UNIDAD EDUCATIVA CARMEN ECHAZU",234851,223,7,1348,1571,1121,17,203,1324
"Bolivia","Tarija","Cercado","Tarija","UNIDAD EDUCATIVA CASTELFORT CASTELLANOS",234852,639,22,4069,4708,3124,110,813,3937
"Bolivia","Tarija","Cercado","Tarija","UNIDAD EDUCATIVA CHURQUIS",234853,82,13,263,345,95,19,136,231
"Bolivia","Tarija","Cercado","Tarija","UNIDAD EDUCATIVA EL PORTILLO",234854,204,13,1138,1342,681,39,405,1086
"Bolivia","Tarija","Cercado","Tarija","UNIDAD EDUCATIVA ESTEBAN MIGLIACI",234855,800,38,5623,6423,4074,138,1373,5447
"Bolivia","Tarija","Cercado","Tarija","UNIDAD EDUCATIVA EULOGIO RUIZ",234856,764,39,3787,4551,2177,103,1468,3645
"Bolivia","Tarija","Cercado","Tarija","UNIDAD EDUCATIVA FE Y ALEGRIA",234857,933,40,4992,5925,3342,135,1475,4817
"Bolivia","Tarija","Cercado","Tarija","UNIDAD EDUCATIVA GAMONEDA",234858,24,5,176,200,69,10,92,161
"Bolivia","Tarija","Cercado","Tarija","UNIDAD EDUCATIVA HERMANN GMEINER",234859,1019,72,5020,6039,2440,227,2281,4721
"Bolivia","Tarija","Cercado","Tarija","UNIDAD EDUCATIVA IGNACIA NAZARIA MARCH",234860,406,37,3082,3488,1585,128,1332,2917
"Bolivia","Tarija","Cercado","Tarija","UNIDAD EDUCATIVA J. NAVAL MONZON",234861,406,33,2559,2965,1560,71,895,2455
"Bolivia","Tarija","Cercado","Tarija","UNIDAD EDUCATIVA JOSE MANUEL AVILA",234862,1334,41,7435,8769,5604,189,1601,7205
"Bolivia","Tarija","Cercado","Tarija","UNIDAD EDUCATIVA JUANA AZURDUY DE PADILLA",234863,372,5,2667,3039,2048,73,541,2589
"Bolivia","Tarija","Cercado","Tarija","UNIDAD EDUCATIVA JUAN PABLO II",234864,542,40,3599,4141,2092,185,1282,3374
"Bolivia","Tarija","Cercado","Tarija","UNIDAD EDUCATIVA JUAN XXIII",234865,604,19,3610,4214,2932,81,578,3510
"Bolivia","Tarija","Cercado","Tarija","UNIDAD EDUCATIVA JULIO CALVO",234866,1247,70,7131,8378,3926,272,2863,6789
"Bolivia","Tarija","Cercado","Tarija","UNIDAD EDUCATIVA JUNACAS SUD",234867,40,9,223,263,71,16,127,198
"Bolivia","Tarija","Cercado","Tarija","UNIDAD EDUCATIVA LA PAZ",234868,663,36,3836,4499,2671,143,986,3657
"Bolivia","Tarija","Cercado","Tarija","UNIDAD EDUCATIVA LA PINTADA",234869,106,19,823,929,502,18,284,786
"Bolivia","Tarija","Cercado","Tarija","UNIDAD EDUCATIVA LICEO CAMPERO",234870,213,4,1162,1375,981,11,166,1147
"Bolivia","Tarija","Cercado","Tarija","UNIDAD EDUCATIVA LOS CALLEJONES",234871,151,13,922,1073,666,27,216,882
"Bolivia","Tarija","Cercado","Tarija","UNIDAD EDUCATIVA LUIS DE FUENTES",234872,178,6,323,501,173,6,138,311
"Bolivia","Tarija","Cercado","Tarija","UNIDAD EDUCATIVA MARIA LAURA JUSTINIANO",234873,334,7,2046,2380,1770,27,242,2012
"Bolivia","Tarija","Cercado","Tarija","UNIDAD EDUCATIVA MONS ABEL COSTAS",234874,304,28,2615,2919,1621,107,859,2480
"Bolivia","Tarija","Cercado","Tarija","UNIDAD EDUCATIVA MONTE CERCADO",234875,25,3,145,170,109,8,25,134
"Bolivia","Tarija","Cercado","Tarija","UNIDAD EDUCATIVA NACIONAL SAN LUIS",234876,326,7,1721,2047,1459,27,228,1687
"Bolivia","Tarija","Cercado","Tarija","UNIDAD EDUCATIVA NARCISO CAMPERO",234877,210,4,1059,1269,898,14,143,1041
"Bolivia","Tarija","Cercado","Tarija","UNIDAD EDUCATIVA NUESTRA SEÑORA DEL ROSARIO",234878,401,16,1990,2391,1276,72,626,1902
"Bolivia","Tarija","Cercado","Tarija","UNIDAD EDUCATIVA OCTAVIO CAMPERO ECHAZU",234879,969,50,5770,6739,3400,197,2123,5523
"Bolivia","Tarija","Cercado","Tarija","UNIDAD EDUCATIVA OSCAR ZAMORA",234880,184,12,596,780,237,49,298,535
"Bolivia","Tarija","Cercado","Tarija","UNIDAD EDUCATIVA PAPACHACRA",234881,46,7,152,198,39,12,94,133
"Bolivia","Tarija","Cercado","Tarija","UNIDAD EDUCATIVA PINOS SUD",234882,110,10,328,438,73,19,226,299
"Bolivia","Tarija","Cercado","Tarija","UNIDAD EDUCATIVA ROSA ARCE",234883,344,12,2149,2493,1788,41,308,2096
"Bolivia","Tarija","Cercado","Tarija","UNIDAD EDUCATIVA SAN AGUSTIN SUD",234884,56,1,136,192,70,6,59,129
"Bolivia","Tarija","Cercado","Tarija","UNIDAD EDUCATIVA SAN ANDRES",234885,273,22,1369,1642,580,61,706,1286
"Bolivia","Tarija","Cercado","Tarija","UNIDAD EDUCATIVA SAN BLAS",234886,84,8,466,550,313,8,137,450
"Bolivia","Tarija","Cercado","Tarija","UNIDAD EDUCATIVA SAN FRANCISCO DE ASIS",234887,37,7,307,344,190,9,101,291
"Bolivia","Tarija","Cercado","Tarija","UNIDAD EDUCATIVA SAN GERONIMO",234888,1257,22,3256,4513,2473,73,688,3161
"Bolivia","Tarija","Cercado","Tarija","UNIDAD EDUCATIVA SAN JACINTO SUD",234889,63,8,325,388,138,16,163,301
"Bolivia","Tarija","Cercado","Tarija","UNIDAD EDUCATIVA SAN JORGE",234890,693,30,3914,4607,2790,120,974,3764
"Bolivia","Tarija","Cercado","Tarija","UNIDAD EDUCATIVA SAN LAZARO DE GUERRA HUAYCO",234891,385,34,1176,1561,414,45,683,1097
"Bolivia","Tarija","Cercado","Tarija","UNIDAD EDUCATIVA SAN LUIS",234892,265,18,1518,1783,1013,55,432,1445
"Bolivia","Tarija","Cercado","Tarija","UNIDAD EDUCATIVA SAN MATEO",234893,207,20,1239,1446,713,42,464,1177
"Bolivia","Tarija","Cercado","Tarija","UNIDAD EDUCATIVA SAN ROQUE",234894,465,6,2503,2968,2108,32,357,2465
"Bolivia","Tarija","Cercado","Tarija","UNIDAD EDUCATIVA SANTA ANA LA NUEVA",234895,80,12,467,547,250,5,200,450
"Bolivia","Tarija","Cercado","Tarija","UNIDAD EDUCATIVA SELLA QUEBRADA",234896,86,21,257,343,112,18,106,218
"Bolivia","Tarija","Cercado","Tarija","UNIDAD EDUCATIVA TARIJA",234897,455,25,2446,2901,1404,85,932,2336
"Bolivia","Tarija","Cercado","Tarija","UNIDAD EDUCATIVA TERESA DE CALCUTA",234898,284,25,2053,2337,1317,79,632,1949
"Bolivia","Tarija","Cercado","Tarija","UNIDAD EDUCATIVA TOLOMOSITA",234899,41,15,259,300,101,18,125,226
"Bolivia","Tarija","Cercado","Tarija","UNIDAD EDUCATIVA TORRECILLAS",234900,205,19,1434,1639,862,61,492,1354
"Bolivia","Tarija","Cercado","Tarija","UNIDAD EDUCATIVA YESERA CENTRO",234901,36,6,220,256,102,6,106,208
"Bolivia","Tarija","Cercado","Tarija","UNIDAD EDUCATIVA YESERA NORTE",234902,59,11,251,310,111,17,112,223
"Bolivia","Tarija","Cercado","Tarija","UNIDAD EDUCATIVA YESERA SUD",234903,55,5,255,310,165,15,70,235
"Bolivia","Tarija","Gran Chaco","Carapari","POSTA SANITARIA KEREIMBA RENDA (INDIGENA)",233080,0,0,23,23,0,0,23,23
"Bolivia","Tarija","Gran Chaco","Carapari","UNIDAD EDUCATIVA 15 DE ABRIL",233081,25,5,180,205,77,2,96,173
"Bolivia","Tarija","Gran Chaco","Carapari","UNIDAD EDUCATIVA 17 DE AGOSTO",233082,20,1,72,92,16,2,53,69
"Bolivia","Tarija","Gran Chaco","Carapari","UNIDAD EDUCATIVA 2 DE AGOSTO",233083,60,4,224,284,32,5,183,215
"Bolivia","Tarija","Gran Chaco","Carapari","UNIDAD EDUCATIVA 3 DE MAYO",233084,723,46,3404,4127,1593,70,1695,3288
"Bolivia","Tarija","Gran Chaco","Carapari","UNIDAD EDUCATIVA 6 DE AGOSTO",233085,29,8,236,265,80,9,139,219
"Bolivia","Tarija","Gran Chaco","Carapari","UNIDAD EDUCATIVA BERETY CHACO",233086,43,3,221,264,65,5,148,213
"Bolivia","Tarija","Gran Chaco","Carapari","UNIDAD EDUCATIVA BOLIVIA",233087,10,0,168,178,82,2,84,166
"Bolivia","Tarija","Gran Chaco","Carapari","UNIDAD EDUCATIVA BOLIVIA DE CARAPARI",233088,0,8,103,103,46,3,46,92
"Bolivia","Tarija","Gran Chaco","Carapari","UNIDAD EDUCATIVA CAMPO LARGO HITO 22",233089,30,2,132,162,33,2,95,128
"Bolivia","Tarija","Gran Chaco","Carapari","UNIDAD EDUCATIVA CAÑITAS",233090,3,1,74,77,21,1,51,72
"Bolivia","Tarija","Gran Chaco","Carapari","UNIDAD EDUCATIVA CELSO RAFFAELLI",233091,136,6,508,644,246,11,245,491
"Bolivia","Tarija","Gran Chaco","Carapari","UNIDAD EDUCATIVA EUSTAQUIO MENDEZ/FRAY QUEBRACHO",233092,84,8,516,600,240,10,258,498
"Bolivia","Tarija","Gran Chaco","Carapari","UNIDAD EDUCATIVA FRAY QUEBRACHO",233093,109,7,413,522,185,13,208,393
"Bolivia","Tarija","Gran Chaco","Carapari","UNIDAD EDUCATIVA JULIO RAMOS VALDEZ",233094,79,5,361,440,142,10,204,346
"Bolivia","Tarija","Gran Chaco","Carapari","UNIDAD EDUCATIVA LIDIA GALARZA",233095,141,12,631,772,234,25,360,594
"Bolivia","Tarija","Gran Chaco","Carapari","UNIDAD EDUCATIVA SAN ALBERTO",233096,108,13,522,630,210,20,279,489
"Bolivia","Tarija","Gran Chaco","Carapari","UNIDAD EDUCATIVA SAN JUAN",233097,0,0,31,31,11,1,19,30
"Bolivia","Tarija","Gran Chaco","Carapari","UNIDAD EDUCATIVA SAN NICOLAS",233098,2,3,52,54,13,2,34,47
"Bolivia","Tarija","Gran Chaco","Carapari","UNIDAD EDUCATIVA ZAPATERA NORTE",233099,61,5,285,346,111,5,164,275
"Bolivia","Tarija","Gran Chaco","Villa Montes","CASA DEL NOTARIO",234986,14,0,30,44,10,0,20,30
"Bolivia","Tarija","Gran Chaco","Villa Montes","CENTRO COMUNAL",234987,84,7,297,381,88,10,192,280
"Bolivia","Tarija","Gran Chaco","Villa Montes","KINDER COLORADOS DE BOLIVIA",234988,136,7,521,657,246,10,258,504
"Bolivia","Tarija","Gran Chaco","Villa Montes","SEDE SOCIAL DE LA COMUNIDAD",234989,15,0,41,56,25,0,16,41
"Bolivia","Tarija","Gran Chaco","Villa Montes","UNIDAD EDUCATIVA 27 DE MAYO",234990,48,9,345,393,130,3,203,333
"Bolivia","Tarija","Gran Chaco","Villa Montes","UNIDAD EDUCATIVA 27 DE MAYO",234991,48,9,345,393,130,3,203,333
"Bolivia","Tarija","Gran Chaco","Villa Montes","UNIDAD EDUCATIVA ADELA HOYOS",234992,568,12,2111,2679,1303,35,761,2064
"Bolivia","Tarija","Gran Chaco","Villa Montes","UNIDAD EDUCATIVA AGUARAGÜE",234993,44,2,147,191,81,7,57,138
"Bolivia","Tarija","Gran Chaco","Villa Montes","UNIDAD EDUCATIVA ALGARROBAL",234994,27,1,123,150,14,3,105,119
"Bolivia","Tarija","Gran Chaco","Villa Montes","UNIDAD EDUCATIVA ANTONIO JOSE DE SUCRE",234995,31,3,170,201,67,10,90,157
"Bolivia","Tarija","Gran Chaco","Villa Montes","UNIDAD EDUCATIVA ASAMBLEA DE DIOS",234996,742,53,3006,3748,1552,71,1330,2882
"Bolivia","Tarija","Gran Chaco","Villa Montes","UNIDAD EDUCATIVA CABO JUAN",234997,95,12,497,592,222,10,253,475
"Bolivia","Tarija","Gran Chaco","Villa Montes","UNIDAD EDUCATIVA CAPIRENDA",234998,14,0,30,44,25,0,5,30
"Bolivia","Tarija","Gran Chaco","Villa Montes","UNIDAD EDUCATIVA CAPIRENDITA",234999,337,12,589,926,81,72,424,505
"Bolivia","Tarija","Gran Chaco","Villa Montes","UNIDAD EDUCATIVA CENTRAL CUTAIQUI",235000,11,0,49,60,18,0,31,49
"Bolivia","Tarija","Gran Chaco","Villa Montes","UNIDAD EDUCATIVA CHACO BOREAL",235001,2,1,13,15,3,0,9,12
"Bolivia","Tarija","Gran Chaco","Villa Montes","UNIDAD EDUCATIVA CHIMEO",235002,19,4,249,268,68,5,172,240
"Bolivia","Tarija","Gran Chaco","Villa Montes","UNIDAD EDUCATIVA COLORADOS DE BOLIVIA",235003,825,44,3487,4312,1600,147,1696,3296
"Bolivia","Tarija","Gran Chaco","Villa Montes","UNIDAD EDUCATIVA IBIBOBO",235004,198,2,133,331,62,1,68,130
"Bolivia","Tarija","Gran Chaco","Villa Montes","UNIDAD EDUCATIVA IBOPEITI",235005,34,2,197,231,43,2,150,193
"Bolivia","Tarija","Gran Chaco","Villa Montes","UNIDAD EDUCATIVA ISMAEL MONTES",235006,512,24,2204,2716,1419,47,714,2133
"Bolivia","Tarija","Gran Chaco","Villa Montes","UNIDAD EDUCATIVA JUANA AZURDUY DE PADILLA (V.M.)",235007,558,31,2820,3378,1845,58,886,2731
"Bolivia","Tarija","Gran Chaco","Villa Montes","UNIDAD EDUCATIVA JULIO CREVAUX",235008,764,16,2612,3376,1752,60,784,2536
"Bolivia","Tarija","Gran Chaco","Villa Montes","UNIDAD EDUCATIVA LA ESMERALDA",235009,12,0,25,37,11,0,14,25
"Bolivia","Tarija","Gran Chaco","Villa Montes","UNIDAD EDUCATIVA NUEVA ESPERANZA",235010,13,0,48,61,16,3,29,45
"Bolivia","Tarija","Gran Chaco","Villa Montes","UNIDAD EDUCATIVA REBECA AGUIRRE",235011,173,12,610,783,301,16,281,582
"Bolivia","Tarija","Gran Chaco","Villa Montes","UNIDAD EDUCATIVA RESISTENCIA",235012,0,32,154,154,20,4,98,118
"Bolivia","Tarija","Gran Chaco","Villa Montes","UNIDAD EDUCATIVA SAN ANTONIO (VILLA MONTES)",235013,150,9,776,926,419,15,333,752
"Bolivia","Tarija","Gran Chaco","Villa Montes","UNIDAD EDUCATIVA SAN ISIDRO LA VICTORIA",235014,23,1,45,68,35,0,9,44
"Bolivia","Tarija","Gran Chaco","Villa Montes","UNIDAD EDUCATIVA TENIENTE VICTOR ZEBALLOS CLAROS",235015,57,11,345,402,129,11,194,323
"Bolivia","Tarija","Gran Chaco","Yacuiba","CARCELETA PUBLICA",234952,26,0,76,102,29,2,45,74
"Bolivia","Tarija","Gran Chaco","Yacuiba","ESCUELA 27 DE MAYO",234954,25,4,217,242,90,9,114,204
"Bolivia","Tarija","Gran Chaco","Yacuiba","ESCUELA 2 DE AGOSTO",234953,291,32,1763,2054,834,72,825,1659
"Bolivia","Tarija","Gran Chaco","Yacuiba","UNIDAD EDUCATIVA 12 DE AGOSTO",234955,175,13,808,983,318,45,432,750
"Bolivia","Tarija","Gran Chaco","Yacuiba","UNIDAD EDUCATIVA 21 DE SEPTIEMBRE",234956,37,3,131,168,76,6,46,122
"Bolivia","Tarija","Gran Chaco","Yacuiba","UNIDAD EDUCATIVA 27 DE MAYO",234957,313,13,1107,1420,402,30,662,1064
"Bolivia","Tarija","Gran Chaco","Yacuiba","UNIDAD EDUCATIVA 4 DE MAYO",234958,144,28,822,966,246,27,521,767
"Bolivia","Tarija","Gran Chaco","Yacuiba","UNIDAD EDUCATIVA ALCIDES D`ORBIGNI",234959,184,11,334,518,45,15,263,308
"Bolivia","Tarija","Gran Chaco","Yacuiba","UNIDAD EDUCATIVA CAMPO GRANDE (GRAN CHACO)",234960,324,33,1779,2103,805,57,884,1689
"Bolivia","Tarija","Gran Chaco","Yacuiba","UNIDAD EDUCATIVA CAÑON OCULTO",234961,38,7,220,258,71,6,136,207
"Bolivia","Tarija","Gran Chaco","Yacuiba","UNIDAD EDUCATIVA CLUB DE LEONES (BÁSICO Y MEDIO)",234962,967,29,4201,5168,2720,104,1348,4068
"Bolivia","Tarija","Gran Chaco","Yacuiba","UNIDAD EDUCATIVA CREVAUX SUD",234963,227,7,600,827,116,23,454,570
"Bolivia","Tarija","Gran Chaco","Yacuiba","UNIDAD EDUCATIVA FERROVIARIA",234964,451,15,1736,2187,1017,39,665,1682
"Bolivia","Tarija","Gran Chaco","Yacuiba","UNIDAD EDUCATIVA GERMAN BUSCH",234965,369,14,1322,1691,789,29,490,1279
"Bolivia","Tarija","Gran Chaco","Yacuiba","UNIDAD EDUCATIVA HEROES DE BOQUERON",234966,292,6,502,794,242,25,229,471
"Bolivia","Tarija","Gran Chaco","Yacuiba","UNIDAD EDUCATIVA HEROES DEL CHACO",234967,1086,37,2919,4005,1380,60,1442,2822
"Bolivia","Tarija","Gran Chaco","Yacuiba","UNIDAD EDUCATIVA JOSE MANUEL BELGRANO (YACUIBA)",234968,713,18,3055,3768,1888,64,1085,2973
"Bolivia","Tarija","Gran Chaco","Yacuiba","UNIDAD EDUCATIVA JUANA AZURDUY DE PADILLA (YACUIBA)",234969,864,40,3561,4425,2125,120,1276,3401
"Bolivia","Tarija","Gran Chaco","Yacuiba","UNIDAD EDUCATIVA LA PURISIMA",234970,35,0,90,125,17,0,73,90
"Bolivia","Tarija","Gran Chaco","Yacuiba","UNIDAD EDUCATIVA LICEO GRAN CHACO",234971,538,19,2359,2897,1600,47,693,2293
"Bolivia","Tarija","Gran Chaco","Yacuiba","UNIDAD EDUCATIVA MARISCAL SUCRE",234972,193,9,806,999,434,17,346,780
"Bolivia","Tarija","Gran Chaco","Yacuiba","UNIDAD EDUCATIVA MIGUEL ESTENSORO",234973,1277,31,4464,5741,2800,94,1539,4339
"Bolivia","Tarija","Gran Chaco","Yacuiba","UNIDAD EDUCATIVA NACIONAL MIXTO EL PALMAR",234974,371,23,1426,1797,756,47,600,1356
"Bolivia","Tarija","Gran Chaco","Yacuiba","UNIDAD EDUCATIVA NESTOR PAZ GALARZA",234975,587,19,2316,2903,1276,96,925,2201
"Bolivia","Tarija","Gran Chaco","Yacuiba","UNIDAD EDUCATIVA OLIVERIO PELICHELLI",234976,251,15,1090,1341,568,26,481,1049
"Bolivia","Tarija","Gran Chaco","Yacuiba","UNIDAD EDUCATIVA PROF. BAUTISTA JURADO",234977,183,23,797,980,323,17,434,757
"Bolivia","Tarija","Gran Chaco","Yacuiba","UNIDAD EDUCATIVA SACHAPERA",234978,55,14,607,662,150,24,419,569
"Bolivia","Tarija","Gran Chaco","Yacuiba","UNIDAD EDUCATIVA SAN FRANCISCO DE INTI",234979,55,10,394,449,133,12,239,372
"Bolivia","Tarija","Gran Chaco","Yacuiba","UNIDAD EDUCATIVA SIMON BOLIVAR",234980,1095,94,3863,4958,1415,130,2224,3639
"Bolivia","Tarija","Gran Chaco","Yacuiba","UNIDAD EDUCATIVA SUNCHAL",234981,35,2,95,130,44,1,48,92
"Bolivia","Tarija","Gran Chaco","Yacuiba","UNIDAD EDUCATIVA TIERRAS NUEVAS",234982,124,15,653,777,131,35,472,603
"Bolivia","Tarija","Gran Chaco","Yacuiba","UNIDAD EDUCATIVA TIMBOY TIGUAZU",234983,32,4,170,202,34,6,126,160
"Bolivia","Tarija","Gran Chaco","Yacuiba","UNIDAD EDUCATIVA VILLA EL CARMEN",234984,185,28,1001,1186,310,45,618,928
"Bolivia","Tarija","Gran Chaco","Yacuiba","UNIDAD EDUCATIVA YACUIBA",234985,784,52,3662,4446,1964,126,1520,3484
"Bolivia","Tarija","Méndez","El Puente","CENTRO COMUNAL",235048,24,3,170,194,83,3,81,164
"Bolivia","Tarija","Méndez","El Puente","NUCLEO ANDRES ZAMORA",235049,18,3,120,138,51,2,64,115
"Bolivia","Tarija","Méndez","El Puente","SEDE CLUB DE MADRES",235050,15,0,53,68,19,6,28,47
"Bolivia","Tarija","Méndez","El Puente","SEDE COMUNAL",235051,58,8,254,312,134,7,105,239
"Bolivia","Tarija","Méndez","El Puente","UNIDAD EDUCATIVA 1RO. DE JULIO",235052,166,13,751,917,347,21,370,717
"Bolivia","Tarija","Méndez","El Puente","UNIDAD EDUCATIVA CHINCHILLA",235053,10,0,60,70,18,1,41,59
"Bolivia","Tarija","Méndez","El Puente","UNIDAD EDUCATIVA CHORCOYA MENDEZ",235054,78,10,175,253,30,5,130,160
"Bolivia","Tarija","Méndez","El Puente","UNIDAD EDUCATIVA CUMBRE DE SAMA",235055,57,12,236,293,62,10,152,214
"Bolivia","Tarija","Méndez","El Puente","UNIDAD EDUCATIVA EDUARDO ABAROA",235056,3,1,70,73,17,2,50,67
"Bolivia","Tarija","Méndez","El Puente","UNIDAD EDUCATIVA EL MOLINO",235057,80,8,282,362,70,18,186,256
"Bolivia","Tarija","Méndez","El Puente","UNIDAD EDUCATIVA FRANZ TAMAYO",235058,285,44,1112,1397,392,78,598,990
"Bolivia","Tarija","Méndez","El Puente","UNIDAD EDUCATIVA GERALDINO GUERRERO",235059,94,3,280,374,145,11,121,266
"Bolivia","Tarija","Méndez","El Puente","UNIDAD EDUCATIVA HUARMACHI",235060,22,0,131,153,74,5,52,126
"Bolivia","Tarija","Méndez","El Puente","UNIDAD EDUCATIVA HUERTA HUAYCO",235061,35,2,87,122,27,6,52,79
"Bolivia","Tarija","Méndez","El Puente","UNIDAD EDUCATIVA IRCALAYA",235062,14,1,48,62,15,1,31,46
"Bolivia","Tarija","Méndez","El Puente","UNIDAD EDUCATIVA JESUS ZAMORA",235063,33,4,145,178,83,2,56,139
"Bolivia","Tarija","Méndez","El Puente","UNIDAD EDUCATIVA LIC. SEGUNDINO UGARTE DURAN",235064,39,2,153,192,98,5,48,146
"Bolivia","Tarija","Méndez","El Puente","UNIDAD EDUCATIVA MONTE GRANDE",235065,33,2,113,146,76,3,32,108
"Bolivia","Tarija","Méndez","El Puente","UNIDAD EDUCATIVA OBISPO EL CARMEN",235066,38,2,81,119,48,4,27,75
"Bolivia","Tarija","Méndez","El Puente","UNIDAD EDUCATIVA PUEBLO NUEVO",235067,115,15,236,351,36,14,171,207
"Bolivia","Tarija","Méndez","El Puente","UNIDAD EDUCATIVA SAN ANTONIO DE CURQUI",235068,36,4,196,232,99,5,88,187
"Bolivia","Tarija","Méndez","El Puente","UNIDAD EDUCATIVA SAN ANTONIO (MENDEZ)",235069,67,8,235,302,60,29,138,198
"Bolivia","Tarija","Méndez","El Puente","UNIDAD EDUCATIVA SANTA ROSA",235070,40,1,58,98,1,1,55,56
"Bolivia","Tarija","Méndez","El Puente","UNIDAD EDUCATIVA VILLA NUEVA",235071,39,1,122,161,43,10,68,111
"Bolivia","Tarija","Méndez","San Lorenzo","PUESTO DE SALUD JARCAS",235016,4,0,66,70,19,3,44,63
"Bolivia","Tarija","Méndez","San Lorenzo","UNIDAD EDUCATIVA 15 DE ABRIL ERQUIS",235017,110,15,734,844,409,48,262,671
"Bolivia","Tarija","Méndez","San Lorenzo","UNIDAD EDUCATIVA 1RO. DE MAYO",235018,59,8,134,193,24,7,95,119
"Bolivia","Tarija","Méndez","San Lorenzo","UNIDAD EDUCATIVA ALTO DE CAJAS",235019,29,2,70,99,40,4,24,64
"Bolivia","Tarija","Méndez","San Lorenzo","UNIDAD EDUCATIVA ANGEL CALABI PASOLINNI",235020,258,18,1513,1771,907,47,541,1448
"Bolivia","Tarija","Méndez","San Lorenzo","UNIDAD EDUCATIVA BORDO EL MOLLAR",235021,66,9,403,469,226,23,145,371
"Bolivia","Tarija","Méndez","San Lorenzo","UNIDAD EDUCATIVA CARACHIMAYO CENTRO",235022,153,23,433,586,207,34,169,376
"Bolivia","Tarija","Méndez","San Lorenzo","UNIDAD EDUCATIVA CHAUPICANCHA",235023,33,6,56,89,18,3,29,47
"Bolivia","Tarija","Méndez","San Lorenzo","UNIDAD EDUCATIVA COCHAS",235024,10,4,71,81,17,3,47,64
"Bolivia","Tarija","Méndez","San Lorenzo","UNIDAD EDUCATIVA COLORADO NORTE",235025,62,0,124,186,7,8,109,116
"Bolivia","Tarija","Méndez","San Lorenzo","UNIDAD EDUCATIVA EL PAJONAL",235026,23,0,61,84,28,4,29,57
"Bolivia","Tarija","Méndez","San Lorenzo","UNIDAD EDUCATIVA EL PUESTO",235027,30,1,57,87,10,6,40,50
"Bolivia","Tarija","Méndez","San Lorenzo","UNIDAD EDUCATIVA EUSTAQUIO MENDEZ",235028,943,72,3042,3985,1845,129,996,2841
"Bolivia","Tarija","Méndez","San Lorenzo","UNIDAD EDUCATIVA EUSTAQUIO MENDEZ",235029,943,72,3042,3985,1845,129,996,2841
"Bolivia","Tarija","Méndez","San Lorenzo","UNIDAD EDUCATIVA EUSTAQUIO MENDEZ",235030,943,72,3042,3985,1845,129,996,2841
"Bolivia","Tarija","Méndez","San Lorenzo","UNIDAD EDUCATIVA HUANCOIRO",235031,13,1,68,81,31,4,32,63
"Bolivia","Tarija","Méndez","San Lorenzo","UNIDAD EDUCATIVA JUAN MISAEL SARACHO",235032,47,7,407,454,257,17,126,383
"Bolivia","Tarija","Méndez","San Lorenzo","UNIDAD EDUCATIVA JULIO SUCRE SELLA MENDEZ",235033,95,9,360,455,248,12,91,339
"Bolivia","Tarija","Méndez","San Lorenzo","UNIDAD EDUCATIVA LEON CANCHA",235034,128,13,219,347,62,12,132,194
"Bolivia","Tarija","Méndez","San Lorenzo","UNIDAD EDUCATIVA MANDOR GRANDE",235035,29,1,25,54,13,1,10,23
"Bolivia","Tarija","Méndez","San Lorenzo","UNIDAD EDUCATIVA NESTOR PAZ ZAMORA",235036,114,24,499,613,269,22,184,453
"Bolivia","Tarija","Méndez","San Lorenzo","UNIDAD EDUCATIVA OSVALDO GALVEZ",235037,136,24,514,650,241,15,234,475
"Bolivia","Tarija","Méndez","San Lorenzo","UNIDAD EDUCATIVA PEÑADERIA",235038,3,3,67,70,25,7,32,57
"Bolivia","Tarija","Méndez","San Lorenzo","UNIDAD EDUCATIVA RANCHO SUD",235039,69,4,455,524,331,9,111,442
"Bolivia","Tarija","Méndez","San Lorenzo","UNIDAD EDUCATIVA SAN LORENCITO",235040,14,1,71,85,6,7,57,63
"Bolivia","Tarija","Méndez","San Lorenzo","UNIDAD EDUCATIVA SAN PEDRO DE LAS PEÑAS",235041,37,2,49,86,17,1,29,46
"Bolivia","Tarija","Méndez","San Lorenzo","UNIDAD EDUCATIVA SERAPIO MARTINEZ",235042,121,11,876,997,602,23,240,842
"Bolivia","Tarija","Méndez","San Lorenzo","UNIDAD EDUCATIVA SIMON BOLIVAR",235043,97,14,791,888,565,31,181,746
"Bolivia","Tarija","Méndez","San Lorenzo","UNIDAD EDUCATIVA TARIJA CANCHA SUD",235044,88,9,532,620,331,16,176,507
"Bolivia","Tarija","Méndez","San Lorenzo","UNIDAD EDUCATIVA TOMATAS GRANDE",235045,101,10,429,530,235,21,163,398
"Bolivia","Tarija","Méndez","San Lorenzo","UNIDAD EDUCATIVA TRANCAS",235046,44,3,127,171,65,12,47,112
"Bolivia","Tarija","Méndez","San Lorenzo","UNIDAD EDUCATIVA TUCUMILLAS",235047,18,2,104,122,16,3,83,99